PokerStars Zoom Hand #258026849797:  Hold'em No Limit (€0.01/€0.02) [ADM ID: M62BD3044A1E13PD] - 2025/10/07 0:03:25 CET [2025/10/06 18:03:25 ET]
Table 'Sirio' 6-max Seat #1 is the button
Seat 1: SebaRapy14 (€2.85 in chips) 
Seat 2: gigysk (€0.95 in chips) 
Seat 3: caduceus369 (€2 in chips) 
Seat 4: Clajito17 (€3.69 in chips) 
Seat 5: H.Quinn.1987 (€6.15 in chips) 
Seat 6: heitel (€1.98 in chips) 
gigysk: posts small blind €0.01
caduceus369: posts big blind €0.02
*** HOLE CARDS ***
Dealt to caduceus369 [4d Ac]
Clajito17: folds 
H.Quinn.1987: folds 
heitel: raises €0.04 to €0.06
SebaRapy14: folds 
gigysk: folds 
caduceus369: folds 
Uncalled bet (€0.04) returned to heitel
heitel collected €0.05 from pot
heitel: doesn't show hand 
*** SUMMARY ***
Total pot €0.05 | Rake €0 
Seat 1: SebaRapy14 (button) folded before Flop (didn't bet)
Seat 2: gigysk (small blind) folded before Flop
Seat 3: caduceus369 (big blind) folded before Flop
Seat 4: Clajito17 folded before Flop (didn't bet)
Seat 5: H.Quinn.1987 folded before Flop (didn't bet)
Seat 6: heitel collected (€0.05)



PokerStars Zoom Hand #258026854662:  Hold'em No Limit (€0.01/€0.02) [ADM ID: M62BD3044A1E13PD] - 2025/10/07 0:03:48 CET [2025/10/06 18:03:48 ET]
Table 'Sirio' 6-max Seat #1 is the button
Seat 1: Wildag00 (€1.33 in chips) 
Seat 2: caduceus369 (€2 in chips) 
Seat 3: heitel (€2.01 in chips) 
Seat 4: Curanto17 (€1.26 in chips) 
Seat 5: stfuplzudonk (€1.69 in chips) 
Seat 6: Catania838 (€0.24 in chips) 
caduceus369: posts small blind €0.01
heitel: posts big blind €0.02
*** HOLE CARDS ***
Dealt to caduceus369 [Ah Ad]
Curanto17: folds 
stfuplzudonk: folds 
Catania838: folds 
Wildag00: folds 
caduceus369: raises €0.06 to €0.08
heitel: folds 
Uncalled bet (€0.06) returned to caduceus369
caduceus369 collected €0.04 from pot
caduceus369: doesn't show hand 
*** SUMMARY ***
Total pot €0.04 | Rake €0 
Seat 1: Wildag00 (button) folded before Flop (didn't bet)
Seat 2: caduceus369 (small blind) collected (€0.04)
Seat 3: heitel (big blind) folded before Flop
Seat 4: Curanto17 folded before Flop (didn't bet)
Seat 5: stfuplzudonk folded before Flop (didn't bet)
Seat 6: Catania838 folded before Flop (didn't bet)



PokerStars Zoom Hand #258026857606:  Hold'em No Limit (€0.01/€0.02) [ADM ID: M62BD3044A1E13PD] - 2025/10/07 0:04:02 CET [2025/10/06 18:04:02 ET]
Table 'Sirio' 6-max Seat #1 is the button
Seat 1: caduceus369 (€2.02 in chips) 
Seat 2: stfuplzudonk (€1.69 in chips) 
Seat 3: pistaKKio23 (€8.25 in chips) 
Seat 4: IKARO_3 (€7.61 in chips) 
Seat 5: heitel (€1.99 in chips) 
Seat 6: teicano98 (€3.85 in chips) 
stfuplzudonk: posts small blind €0.01
pistaKKio23: posts big blind €0.02
*** HOLE CARDS ***
Dealt to caduceus369 [Qs As]
IKARO_3: folds 
heitel: folds 
teicano98: folds 
caduceus369: raises €0.04 to €0.06
stfuplzudonk: calls €0.05
pistaKKio23: folds 
*** FLOP *** [3h 3c 2d]
stfuplzudonk: checks 
caduceus369: checks 
*** TURN *** [3h 3c 2d] [8d]
stfuplzudonk: checks 
caduceus369: checks 
*** RIVER *** [3h 3c 2d 8d] [Jc]
stfuplzudonk: checks 
caduceus369: checks 
*** SHOW DOWN ***
stfuplzudonk: shows [Ks Td] (a pair of Threes)
caduceus369: shows [Qs As] (a pair of Threes - Ace kicker)
caduceus369 collected €0.14 from pot
*** SUMMARY ***
Total pot €0.14 | Rake €0 
Board [3h 3c 2d 8d Jc]
Seat 1: caduceus369 (button) showed [Qs As] and won (€0.14) with a pair of Threes
Seat 2: stfuplzudonk (small blind) showed [Ks Td] and lost with a pair of Threes
Seat 3: pistaKKio23 (big blind) folded before Flop
Seat 4: IKARO_3 folded before Flop (didn't bet)
Seat 5: heitel folded before Flop (didn't bet)
Seat 6: teicano98 folded before Flop (didn't bet)



PokerStars Zoom Hand #258026864037:  Hold'em No Limit (€0.01/€0.02) [ADM ID: M62BD3044A1E13PD] - 2025/10/07 0:04:32 CET [2025/10/06 18:04:32 ET]
Table 'Sirio' 6-max Seat #1 is the button
Seat 1: CIKO71131 (€0.81 in chips) 
Seat 2: Catania838 (€1.44 in chips) 
Seat 3: Gaboops (€1.81 in chips) 
Seat 4: IKARO_3 (€4.62 in chips) 
Seat 5: stfuplzudonk (€1.63 in chips) 
Seat 6: caduceus369 (€2.10 in chips) 
Catania838: posts small blind €0.01
Gaboops: posts big blind €0.02
*** HOLE CARDS ***
Dealt to caduceus369 [2h 3h]
IKARO_3: folds 
stfuplzudonk: raises €0.04 to €0.06
caduceus369: folds 
CIKO71131: folds 
Catania838: folds 
Gaboops: folds 
Uncalled bet (€0.04) returned to stfuplzudonk
stfuplzudonk collected €0.05 from pot
stfuplzudonk: doesn't show hand 
*** SUMMARY ***
Total pot €0.05 | Rake €0 
Seat 1: CIKO71131 (button) folded before Flop (didn't bet)
Seat 2: Catania838 (small blind) folded before Flop
Seat 3: Gaboops (big blind) folded before Flop
Seat 4: IKARO_3 folded before Flop (didn't bet)
Seat 5: stfuplzudonk collected (€0.05)
Seat 6: caduceus369 folded before Flop (didn't bet)



PokerStars Zoom Hand #258026865061:  Hold'em No Limit (€0.01/€0.02) [ADM ID: M62BD3044A1E13PD] - 2025/10/07 0:04:37 CET [2025/10/06 18:04:37 ET]
Table 'Sirio' 6-max Seat #1 is the button
Seat 1: cap e'bomb95 (€2.77 in chips) 
Seat 2: M@verick781 (€3.40 in chips) 
Seat 3: IKARO_3 (€2.18 in chips) 
Seat 4: pistaKKio23 (€8.63 in chips) 
Seat 5: caduceus369 (€2.10 in chips) 
Seat 6: mondie73100 (€2.08 in chips) 
M@verick781: posts small blind €0.01
IKARO_3: posts big blind €0.02
*** HOLE CARDS ***
Dealt to caduceus369 [4c 3h]
pistaKKio23: raises €0.04 to €0.06
caduceus369: folds 
mondie73100: folds 
cap e'bomb95: folds 
M@verick781: folds 
IKARO_3: folds 
Uncalled bet (€0.04) returned to pistaKKio23
pistaKKio23 collected €0.05 from pot
pistaKKio23: doesn't show hand 
*** SUMMARY ***
Total pot €0.05 | Rake €0 
Seat 1: cap e'bomb95 (button) folded before Flop (didn't bet)
Seat 2: M@verick781 (small blind) folded before Flop
Seat 3: IKARO_3 (big blind) folded before Flop
Seat 4: pistaKKio23 collected (€0.05)
Seat 5: caduceus369 folded before Flop (didn't bet)
Seat 6: mondie73100 folded before Flop (didn't bet)



PokerStars Zoom Hand #258026866003:  Hold'em No Limit (€0.01/€0.02) [ADM ID: M62BD3044A1E13PD] - 2025/10/07 0:04:41 CET [2025/10/06 18:04:41 ET]
Table 'Sirio' 6-max Seat #1 is the button
Seat 1: stfuplzudonk (€0.79 in chips) 
Seat 2: caduceus369 (€2.10 in chips) 
Seat 3: mashallahh (€4.30 in chips) 
Seat 4: cap e'bomb95 (€2.77 in chips) 
Seat 5: H.Quinn.1987 (€6.26 in chips) 
Seat 6: M@verick781 (€3.39 in chips) 
caduceus369: posts small blind €0.01
mashallahh: posts big blind €0.02
*** HOLE CARDS ***
Dealt to caduceus369 [Td 4h]
cap e'bomb95: folds 
H.Quinn.1987: folds 
M@verick781: folds 
stfuplzudonk: folds 
caduceus369: folds 
Uncalled bet (€0.01) returned to mashallahh
mashallahh collected €0.02 from pot
mashallahh: doesn't show hand 
*** SUMMARY ***
Total pot €0.02 | Rake €0 
Seat 1: stfuplzudonk (button) folded before Flop (didn't bet)
Seat 2: caduceus369 (small blind) folded before Flop
Seat 3: mashallahh (big blind) collected (€0.02)
Seat 4: cap e'bomb95 folded before Flop (didn't bet)
Seat 5: H.Quinn.1987 folded before Flop (didn't bet)
Seat 6: M@verick781 folded before Flop (didn't bet)



PokerStars Zoom Hand #258026868821:  Hold'em No Limit (€0.01/€0.02) [ADM ID: M62BD3044A1E13PD] - 2025/10/07 0:04:54 CET [2025/10/06 18:04:54 ET]
Table 'Sirio' 6-max Seat #1 is the button
Seat 1: Curanto17 (€1.16 in chips) 
Seat 2: stfuplzudonk (€0.79 in chips) 
Seat 3: caduceus369 (€2.09 in chips) 
Seat 4: cap e'bomb95 (€4.05 in chips) 
Seat 5: mondie73100 (€2.08 in chips) 
Seat 6: CIKO71131 (€0.80 in chips) 
stfuplzudonk: posts small blind €0.01
caduceus369: posts big blind €0.02
*** HOLE CARDS ***
Dealt to caduceus369 [Qd 3c]
cap e'bomb95: folds 
mondie73100: folds 
CIKO71131: calls €0.02
Curanto17: folds 
stfuplzudonk: folds 
caduceus369: checks 
*** FLOP *** [9h Ks Kh]
caduceus369: checks 
CIKO71131: checks 
*** TURN *** [9h Ks Kh] [Td]
caduceus369: bets €0.02
CIKO71131: calls €0.02
*** RIVER *** [9h Ks Kh Td] [9c]
caduceus369: checks 
CIKO71131: checks 
*** SHOW DOWN ***
caduceus369: shows [Qd 3c] (two pair, Kings and Nines)
CIKO71131: mucks hand 
caduceus369 collected €0.09 from pot
*** SUMMARY ***
Total pot €0.09 | Rake €0 
Board [9h Ks Kh Td 9c]
Seat 1: Curanto17 (button) folded before Flop (didn't bet)
Seat 2: stfuplzudonk (small blind) folded before Flop
Seat 3: caduceus369 (big blind) showed [Qd 3c] and won (€0.09) with two pair, Kings and Nines
Seat 4: cap e'bomb95 folded before Flop (didn't bet)
Seat 5: mondie73100 folded before Flop (didn't bet)
Seat 6: CIKO71131 mucked [6c 6s]



PokerStars Zoom Hand #258026884578:  Hold'em No Limit (€0.01/€0.02) [ADM ID: M62BD3044A1E13PD] - 2025/10/07 0:06:06 CET [2025/10/06 18:06:06 ET]
Table 'Sirio' 6-max Seat #1 is the button
Seat 1: cap e'bomb95 (€4.05 in chips) 
Seat 2: 19kappa88 (€2.03 in chips) 
Seat 3: pistaKKio23 (€3.47 in chips) 
Seat 4: caduceus369 (€2.14 in chips) 
Seat 5: Wildag00 (€1.48 in chips) 
Seat 6: stfuplzudonk (€0.76 in chips) 
19kappa88: posts small blind €0.01
pistaKKio23: posts big blind €0.02
*** HOLE CARDS ***
Dealt to caduceus369 [Tc 5h]
caduceus369: folds 
Wildag00: folds 
stfuplzudonk: raises €0.04 to €0.06
cap e'bomb95: folds 
19kappa88: folds 
pistaKKio23: folds 
Uncalled bet (€0.04) returned to stfuplzudonk
stfuplzudonk collected €0.05 from pot
stfuplzudonk: doesn't show hand 
*** SUMMARY ***
Total pot €0.05 | Rake €0 
Seat 1: cap e'bomb95 (button) folded before Flop (didn't bet)
Seat 2: 19kappa88 (small blind) folded before Flop
Seat 3: pistaKKio23 (big blind) folded before Flop
Seat 4: caduceus369 folded before Flop (didn't bet)
Seat 5: Wildag00 folded before Flop (didn't bet)
Seat 6: stfuplzudonk collected (€0.05)



PokerStars Zoom Hand #258026889272:  Hold'em No Limit (€0.01/€0.02) [ADM ID: M62BD3044A1E13PD] - 2025/10/07 0:06:28 CET [2025/10/06 18:06:28 ET]
Table 'Sirio' 6-max Seat #1 is the button
Seat 1: M@verick781 (€6.20 in chips) 
Seat 2: cap e'bomb95 (€2.31 in chips) 
Seat 3: caduceus369 (€2.14 in chips) 
Seat 4: stfuplzudonk (€0.79 in chips) 
Seat 5: gigysk (€0.97 in chips) 
Seat 6: pistaKKio23 (€3.45 in chips) 
cap e'bomb95: posts small blind €0.01
caduceus369: posts big blind €0.02
*** HOLE CARDS ***
Dealt to caduceus369 [Js 4d]
stfuplzudonk: raises €0.04 to €0.06
gigysk: folds 
pistaKKio23: folds 
M@verick781: folds 
cap e'bomb95: folds 
caduceus369: folds 
Uncalled bet (€0.04) returned to stfuplzudonk
stfuplzudonk collected €0.05 from pot
stfuplzudonk: doesn't show hand 
*** SUMMARY ***
Total pot €0.05 | Rake €0 
Seat 1: M@verick781 (button) folded before Flop (didn't bet)
Seat 2: cap e'bomb95 (small blind) folded before Flop
Seat 3: caduceus369 (big blind) folded before Flop
Seat 4: stfuplzudonk collected (€0.05)
Seat 5: gigysk folded before Flop (didn't bet)
Seat 6: pistaKKio23 folded before Flop (didn't bet)



PokerStars Zoom Hand #258026885584:  Hold'em No Limit (€0.01/€0.02) [ADM ID: M62BD3044A1E13PD] - 2025/10/07 0:06:10 CET [2025/10/06 18:06:10 ET]
Table 'Sirio' 6-max Seat #1 is the button
Seat 1: cap e'bomb95 (€2.31 in chips) 
Seat 2: SebaRapy14 (€3.13 in chips) 
Seat 3: mashallahh (€2.16 in chips) 
Seat 4: H.Quinn.1987 (€5.89 in chips) 
Seat 5: barmiencas (€2.64 in chips) 
Seat 6: caduceus369 (€2.14 in chips) 
SebaRapy14: posts small blind €0.01
mashallahh: posts big blind €0.02
*** HOLE CARDS ***
Dealt to caduceus369 [8h 4h]
H.Quinn.1987: folds 
barmiencas: calls €0.02
caduceus369: folds 
cap e'bomb95: folds 
SebaRapy14: folds 
mashallahh: checks 
*** FLOP *** [2s Th Jc]
mashallahh: checks 
barmiencas: checks 
*** TURN *** [2s Th Jc] [Jd]
mashallahh: bets €0.05
barmiencas: calls €0.05
*** RIVER *** [2s Th Jc Jd] [3d]
mashallahh: bets €0.15
barmiencas: folds 
Uncalled bet (€0.15) returned to mashallahh
mashallahh collected €0.15 from pot
mashallahh: doesn't show hand 
*** SUMMARY ***
Total pot €0.15 | Rake €0 
Board [2s Th Jc Jd 3d]
Seat 1: cap e'bomb95 (button) folded before Flop (didn't bet)
Seat 2: SebaRapy14 (small blind) folded before Flop
Seat 3: mashallahh (big blind) collected (€0.15)
Seat 4: H.Quinn.1987 folded before Flop (didn't bet)
Seat 5: barmiencas folded on the River
Seat 6: caduceus369 folded before Flop (didn't bet)



PokerStars Zoom Hand #258026882272:  Hold'em No Limit (€0.01/€0.02) [ADM ID: M62BD3044A1E13PD] - 2025/10/07 0:05:55 CET [2025/10/06 18:05:55 ET]
Table 'Sirio' 6-max Seat #1 is the button
Seat 1: caduceus369 (€2.14 in chips) 
Seat 2: Catania838 (€1.41 in chips) 
Seat 3: MammAnnAILovey (€1.43 in chips) 
Seat 4: H.Quinn.1987 (€6.09 in chips) 
Seat 5: CIKO71131 (€0.76 in chips) 
Seat 6: Wildag00 (€1.48 in chips) 
Catania838: posts small blind €0.01
MammAnnAILovey: posts big blind €0.02
*** HOLE CARDS ***
Dealt to caduceus369 [4c Tc]
H.Quinn.1987: folds 
CIKO71131: calls €0.02
Wildag00: folds 
caduceus369: folds 
Catania838: calls €0.01
MammAnnAILovey: checks 
*** FLOP *** [6c Ac 7c]
Catania838: checks 
MammAnnAILovey: checks 
CIKO71131: checks 
*** TURN *** [6c Ac 7c] [2c]
Catania838: checks 
MammAnnAILovey: bets €0.02
CIKO71131: calls €0.02
Catania838: folds 
*** RIVER *** [6c Ac 7c 2c] [Jc]
MammAnnAILovey: bets €0.09
CIKO71131: folds 
Uncalled bet (€0.09) returned to MammAnnAILovey
MammAnnAILovey collected €0.10 from pot
MammAnnAILovey: doesn't show hand 
*** SUMMARY ***
Total pot €0.10 | Rake €0 
Board [6c Ac 7c 2c Jc]
Seat 1: caduceus369 (button) folded before Flop (didn't bet)
Seat 2: Catania838 (small blind) folded on the Turn
Seat 3: MammAnnAILovey (big blind) collected (€0.10)
Seat 4: H.Quinn.1987 folded before Flop (didn't bet)
Seat 5: CIKO71131 folded on the River
Seat 6: Wildag00 folded before Flop (didn't bet)



PokerStars Zoom Hand #258026891892:  Hold'em No Limit (€0.01/€0.02) [ADM ID: M62BD3044A1E13PD] - 2025/10/07 0:06:40 CET [2025/10/06 18:06:40 ET]
Table 'Sirio' 6-max Seat #1 is the button
Seat 1: mondie73100 (€2 in chips) 
Seat 2: caduceus369 (€2.12 in chips) 
Seat 3: mashallahh (€3.78 in chips) 
Seat 4: Curanto17 (€1.14 in chips) 
Seat 5: H.Quinn.1987 (€5.86 in chips) 
Seat 6: IKARO_3 (€1.97 in chips) 
caduceus369: posts small blind €0.01
mashallahh: posts big blind €0.02
*** HOLE CARDS ***
Dealt to caduceus369 [As 9c]
Curanto17: folds 
H.Quinn.1987: folds 
IKARO_3: folds 
mondie73100: folds 
caduceus369: raises €0.04 to €0.06
mashallahh: folds 
Uncalled bet (€0.04) returned to caduceus369
caduceus369 collected €0.04 from pot
caduceus369: doesn't show hand 
*** SUMMARY ***
Total pot €0.04 | Rake €0 
Seat 1: mondie73100 (button) folded before Flop (didn't bet)
Seat 2: caduceus369 (small blind) collected (€0.04)
Seat 3: mashallahh (big blind) folded before Flop
Seat 4: Curanto17 folded before Flop (didn't bet)
Seat 5: H.Quinn.1987 folded before Flop (didn't bet)
Seat 6: IKARO_3 folded before Flop (didn't bet)



PokerStars Zoom Hand #258026897382:  Hold'em No Limit (€0.01/€0.02) [ADM ID: M62BD3044A1E13PD] - 2025/10/07 0:07:05 CET [2025/10/06 18:07:05 ET]
Table 'Sirio' 6-max Seat #1 is the button
Seat 1: caduceus369 (€2.14 in chips) 
Seat 2: MammAnnAILovey (€1.49 in chips) 
Seat 3: IKARO_3 (€8.33 in chips) 
Seat 4: H.Quinn.1987 (€5.85 in chips) 
Seat 5: mashallahh (€2.23 in chips) 
Seat 6: M@verick781 (€7.90 in chips) 
MammAnnAILovey: posts small blind €0.01
IKARO_3: posts big blind €0.02
*** HOLE CARDS ***
Dealt to caduceus369 [4h 6h]
H.Quinn.1987: folds 
mashallahh: folds 
M@verick781: folds 
caduceus369: raises €0.04 to €0.06
MammAnnAILovey: folds 
IKARO_3: folds 
Uncalled bet (€0.04) returned to caduceus369
caduceus369 collected €0.05 from pot
caduceus369: doesn't show hand 
*** SUMMARY ***
Total pot €0.05 | Rake €0 
Seat 1: caduceus369 (button) collected (€0.05)
Seat 2: MammAnnAILovey (small blind) folded before Flop
Seat 3: IKARO_3 (big blind) folded before Flop
Seat 4: H.Quinn.1987 folded before Flop (didn't bet)
Seat 5: mashallahh folded before Flop (didn't bet)
Seat 6: M@verick781 folded before Flop (didn't bet)



PokerStars Zoom Hand #258026887102:  Hold'em No Limit (€0.01/€0.02) [ADM ID: M62BD3044A1E13PD] - 2025/10/07 0:06:18 CET [2025/10/06 18:06:18 ET]
Table 'Sirio' 6-max Seat #1 is the button
Seat 1: QUATTRODAME (€4.54 in chips) 
Seat 2: IKARO_3 (€1.98 in chips) 
Seat 3: plutonexx (€1.33 in chips) 
Seat 4: jackkk03 (€5.50 in chips) 
Seat 5: caduceus369 (€2.14 in chips) 
Seat 6: SebaRapy14 (€3.04 in chips) 
IKARO_3: posts small blind €0.01
plutonexx: posts big blind €0.02
*** HOLE CARDS ***
Dealt to caduceus369 [Td Jh]
jackkk03: calls €0.02
caduceus369: folds 
SebaRapy14: folds 
QUATTRODAME: calls €0.02
IKARO_3: folds 
plutonexx: checks 
*** FLOP *** [Ks 7s Qs]
plutonexx: checks 
jackkk03: checks 
QUATTRODAME: checks 
*** TURN *** [Ks 7s Qs] [8h]
plutonexx: checks 
jackkk03: checks 
QUATTRODAME: checks 
*** RIVER *** [Ks 7s Qs 8h] [3s]
plutonexx: checks 
jackkk03: bets €0.04
QUATTRODAME has timed out
QUATTRODAME: folds 
plutonexx: folds 
Uncalled bet (€0.04) returned to jackkk03
jackkk03 collected €0.07 from pot
jackkk03: doesn't show hand 
*** SUMMARY ***
Total pot €0.07 | Rake €0 
Board [Ks 7s Qs 8h 3s]
Seat 1: QUATTRODAME (button) folded on the River
Seat 2: IKARO_3 (small blind) folded before Flop
Seat 3: plutonexx (big blind) folded on the River
Seat 4: jackkk03 collected (€0.07)
Seat 5: caduceus369 folded before Flop (didn't bet)
Seat 6: SebaRapy14 folded before Flop (didn't bet)



PokerStars Zoom Hand #258026904910:  Hold'em No Limit (€0.01/€0.02) [ADM ID: M62BD3044A1E13PD] - 2025/10/07 0:07:39 CET [2025/10/06 18:07:39 ET]
Table 'Sirio' 6-max Seat #1 is the button
Seat 1: AlwaisToRun (€0.32 in chips) 
Seat 2: 7chris5 (€3.31 in chips) 
Seat 3: pistaKKio23 (€3.45 in chips) 
Seat 4: MammAnnAILovey (€1.48 in chips) 
Seat 5: Gaboops (€1.41 in chips) 
Seat 6: caduceus369 (€2.17 in chips) 
7chris5: posts small blind €0.01
pistaKKio23: posts big blind €0.02
*** HOLE CARDS ***
Dealt to caduceus369 [9d 9s]
MammAnnAILovey: raises €0.03 to €0.05
Gaboops: folds 
caduceus369: calls €0.05
AlwaisToRun: folds 
7chris5: folds 
pistaKKio23: calls €0.03
*** FLOP *** [Ad 4h 2c]
pistaKKio23: checks 
MammAnnAILovey: bets €0.10
caduceus369: folds 
pistaKKio23: folds 
Uncalled bet (€0.10) returned to MammAnnAILovey
MammAnnAILovey collected €0.16 from pot
MammAnnAILovey: doesn't show hand 
*** SUMMARY ***
Total pot €0.16 | Rake €0 
Board [Ad 4h 2c]
Seat 1: AlwaisToRun (button) folded before Flop (didn't bet)
Seat 2: 7chris5 (small blind) folded before Flop
Seat 3: pistaKKio23 (big blind) folded on the Flop
Seat 4: MammAnnAILovey collected (€0.16)
Seat 5: Gaboops folded before Flop (didn't bet)
Seat 6: caduceus369 folded on the Flop



PokerStars Zoom Hand #258026903310:  Hold'em No Limit (€0.01/€0.02) [ADM ID: M62BD3044A1E13PD] - 2025/10/07 0:07:31 CET [2025/10/06 18:07:31 ET]
Table 'Sirio' 6-max Seat #1 is the button
Seat 1: IKARO_3 (€8.31 in chips) 
Seat 2: heitel (€2.30 in chips) 
Seat 3: SebaRapy14 (€3.24 in chips) 
Seat 4: 7chris5 (€3.31 in chips) 
Seat 5: caduceus369 (€2.17 in chips) 
Seat 6: 19kappa88 (€2.16 in chips) 
heitel: posts small blind €0.01
SebaRapy14: posts big blind €0.02
*** HOLE CARDS ***
Dealt to caduceus369 [8c 7s]
7chris5: folds 
caduceus369: folds 
19kappa88: folds 
IKARO_3 has timed out
IKARO_3: folds 
heitel: raises €0.04 to €0.06
SebaRapy14: raises €0.16 to €0.22
heitel: folds 
Uncalled bet (€0.16) returned to SebaRapy14
SebaRapy14 collected €0.12 from pot
SebaRapy14: doesn't show hand 
*** SUMMARY ***
Total pot €0.12 | Rake €0 
Seat 1: IKARO_3 (button) folded before Flop (didn't bet)
Seat 2: heitel (small blind) folded before Flop
Seat 3: SebaRapy14 (big blind) collected (€0.12)
Seat 4: 7chris5 folded before Flop (didn't bet)
Seat 5: caduceus369 folded before Flop (didn't bet)
Seat 6: 19kappa88 folded before Flop (didn't bet)



PokerStars Zoom Hand #258026911438:  Hold'em No Limit (€0.01/€0.02) [ADM ID: M62BD3044A1E13PD] - 2025/10/07 0:08:09 CET [2025/10/06 18:08:09 ET]
Table 'Sirio' 6-max Seat #1 is the button
Seat 1: cap e'bomb95 (€4 in chips) 
Seat 2: M@verick781 (€6.17 in chips) 
Seat 3: Catania838 (€1.33 in chips) 
Seat 4: caduceus369 (€2.12 in chips) 
Seat 5: MARKNO73 (€0.51 in chips) 
Seat 6: IKARO_3 (€2.19 in chips) 
M@verick781: posts small blind €0.01
Catania838: posts big blind €0.02
*** HOLE CARDS ***
Dealt to caduceus369 [3h 5c]
caduceus369: folds 
MARKNO73: folds 
IKARO_3: folds 
cap e'bomb95: folds 
M@verick781: raises €0.04 to €0.06
Catania838: calls €0.04
*** FLOP *** [9h Td 2c]
M@verick781: bets €0.12
Catania838: raises €0.36 to €0.48
M@verick781: raises €5.63 to €6.11 and is all-in
Catania838: calls €0.79 and is all-in
Uncalled bet (€4.84) returned to M@verick781
*** TURN *** [9h Td 2c] [5h]
*** RIVER *** [9h Td 2c 5h] [8c]
*** SHOW DOWN ***
M@verick781: shows [Js Qh] (a straight, Eight to Queen)
Catania838: shows [Qs Ts] (a pair of Tens)
M@verick781 collected €2.52 from pot
*** SUMMARY ***
Total pot €2.66 | Rake €0.14 
Board [9h Td 2c 5h 8c]
Seat 1: cap e'bomb95 (button) folded before Flop (didn't bet)
Seat 2: M@verick781 (small blind) showed [Js Qh] and won (€2.52) with a straight, Eight to Queen
Seat 3: Catania838 (big blind) showed [Qs Ts] and lost with a pair of Tens
Seat 4: caduceus369 folded before Flop (didn't bet)
Seat 5: MARKNO73 folded before Flop (didn't bet)
Seat 6: IKARO_3 folded before Flop (didn't bet)



PokerStars Zoom Hand #258026913567:  Hold'em No Limit (€0.01/€0.02) [ADM ID: M62BD3044A1E13PD] - 2025/10/07 0:08:19 CET [2025/10/06 18:08:19 ET]
Table 'Sirio' 6-max Seat #1 is the button
Seat 1: simona13890 (€1.53 in chips) 
Seat 2: caduceus369 (€2.12 in chips) 
Seat 3: Giampon78 (€1.44 in chips) 
Seat 4: MARKNO73 (€0.51 in chips) 
Seat 5: stfuplzudonk (€0.73 in chips) 
Seat 6: heitel (€2.24 in chips) 
caduceus369: posts small blind €0.01
Giampon78: posts big blind €0.02
*** HOLE CARDS ***
Dealt to caduceus369 [Tc 6c]
MARKNO73: folds 
stfuplzudonk: folds 
heitel: raises €0.04 to €0.06
simona13890: calls €0.06
caduceus369: folds 
Giampon78: folds 
*** FLOP *** [5s 9c 2s]
heitel: bets €0.08
simona13890: calls €0.08
*** TURN *** [5s 9c 2s] [2d]
heitel: bets €0.15
simona13890: calls €0.15
*** RIVER *** [5s 9c 2s 2d] [6d]
heitel: bets €0.29
simona13890: calls €0.29
*** SHOW DOWN ***
heitel: shows [Th Jc] (a pair of Deuces)
simona13890: shows [Qs 9d] (two pair, Nines and Deuces)
simona13890 collected €1.13 from pot
*** SUMMARY ***
Total pot €1.19 | Rake €0.06 
Board [5s 9c 2s 2d 6d]
Seat 1: simona13890 (button) showed [Qs 9d] and won (€1.13) with two pair, Nines and Deuces
Seat 2: caduceus369 (small blind) folded before Flop
Seat 3: Giampon78 (big blind) folded before Flop
Seat 4: MARKNO73 folded before Flop (didn't bet)
Seat 5: stfuplzudonk folded before Flop (didn't bet)
Seat 6: heitel showed [Th Jc] and lost with a pair of Deuces



PokerStars Zoom Hand #258026917308:  Hold'em No Limit (€0.01/€0.02) [ADM ID: M62BD3044A1E13PD] - 2025/10/07 0:08:36 CET [2025/10/06 18:08:36 ET]
Table 'Sirio' 6-max Seat #1 is the button
Seat 1: cap e'bomb95 (€3.97 in chips) 
Seat 2: IKARO_3 (€4.08 in chips) 
Seat 3: caduceus369 (€2.11 in chips) 
Seat 4: barmiencas (€2.59 in chips) 
Seat 5: Wildag00 (€2.20 in chips) 
Seat 6: 7chris5 (€3.37 in chips) 
IKARO_3: posts small blind €0.01
caduceus369: posts big blind €0.02
*** HOLE CARDS ***
Dealt to caduceus369 [2c 3s]
barmiencas: calls €0.02
Wildag00: folds 
7chris5: folds 
cap e'bomb95: folds 
IKARO_3: folds 
caduceus369: checks 
*** FLOP *** [7h 2h Ah]
caduceus369: checks 
barmiencas: bets €0.08
caduceus369: folds 
Uncalled bet (€0.08) returned to barmiencas
barmiencas collected €0.05 from pot
barmiencas: doesn't show hand 
*** SUMMARY ***
Total pot €0.05 | Rake €0 
Board [7h 2h Ah]
Seat 1: cap e'bomb95 (button) folded before Flop (didn't bet)
Seat 2: IKARO_3 (small blind) folded before Flop
Seat 3: caduceus369 (big blind) folded on the Flop
Seat 4: barmiencas collected (€0.05)
Seat 5: Wildag00 folded before Flop (didn't bet)
Seat 6: 7chris5 folded before Flop (didn't bet)



PokerStars Zoom Hand #258026933122:  Hold'em No Limit (€0.01/€0.02) [ADM ID: M62BD3044A1E13PD] - 2025/10/07 0:09:49 CET [2025/10/06 18:09:49 ET]
Table 'Sirio' 6-max Seat #1 is the button
Seat 1: SebaRapy14 (€2.66 in chips) 
Seat 2: cap e'bomb95 (€3.98 in chips) 
Seat 3: Gabriyx (€0.80 in chips) 
Seat 4: IKARO_3 (€8.36 in chips) 
Seat 5: caduceus369 (€2.09 in chips) 
Seat 6: M@verick781 (€2.84 in chips) 
cap e'bomb95: posts small blind €0.01
Gabriyx: posts big blind €0.02
*** HOLE CARDS ***
Dealt to caduceus369 [Qd Js]
IKARO_3: folds 
caduceus369: raises €0.04 to €0.06
M@verick781: folds 
SebaRapy14: folds 
cap e'bomb95: folds 
Gabriyx: calls €0.04
*** FLOP *** [5h 6h 9s]
Gabriyx: checks 
caduceus369: checks 
*** TURN *** [5h 6h 9s] [7h]
Gabriyx: bets €0.74 and is all-in
caduceus369: folds 
Uncalled bet (€0.74) returned to Gabriyx
Gabriyx collected €0.13 from pot
Gabriyx: doesn't show hand 
*** SUMMARY ***
Total pot €0.13 | Rake €0 
Board [5h 6h 9s 7h]
Seat 1: SebaRapy14 (button) folded before Flop (didn't bet)
Seat 2: cap e'bomb95 (small blind) folded before Flop
Seat 3: Gabriyx (big blind) collected (€0.13)
Seat 4: IKARO_3 folded before Flop (didn't bet)
Seat 5: caduceus369 folded on the Turn
Seat 6: M@verick781 folded before Flop (didn't bet)



PokerStars Zoom Hand #258026929617:  Hold'em No Limit (€0.01/€0.02) [ADM ID: M62BD3044A1E13PD] - 2025/10/07 0:09:33 CET [2025/10/06 18:09:33 ET]
Table 'Sirio' 6-max Seat #1 is the button
Seat 1: 19kappa88 (€2.10 in chips) 
Seat 2: gigysk (€0.88 in chips) 
Seat 3: heitel (€1.60 in chips) 
Seat 4: caduceus369 (€2.09 in chips) 
Seat 5: mondie73100 (€2 in chips) 
Seat 6: mashallahh (€2.08 in chips) 
gigysk: posts small blind €0.01
heitel: posts big blind €0.02
*** HOLE CARDS ***
Dealt to caduceus369 [6h 8s]
caduceus369: folds 
mondie73100: raises €0.04 to €0.06
mashallahh: folds 
19kappa88: folds 
gigysk: folds 
heitel: raises €0.14 to €0.20
mondie73100: calls €0.14
*** FLOP *** [3d 4c 2c]
heitel: checks 
mondie73100: checks 
*** TURN *** [3d 4c 2c] [7s]
heitel: bets €0.24
mondie73100: folds 
Uncalled bet (€0.24) returned to heitel
heitel collected €0.39 from pot
heitel: doesn't show hand 
*** SUMMARY ***
Total pot €0.41 | Rake €0.02 
Board [3d 4c 2c 7s]
Seat 1: 19kappa88 (button) folded before Flop (didn't bet)
Seat 2: gigysk (small blind) folded before Flop
Seat 3: heitel (big blind) collected (€0.39)
Seat 4: caduceus369 folded before Flop (didn't bet)
Seat 5: mondie73100 folded on the Turn
Seat 6: mashallahh folded before Flop (didn't bet)



PokerStars Zoom Hand #258026930478:  Hold'em No Limit (€0.01/€0.02) [ADM ID: M62BD3044A1E13PD] - 2025/10/07 0:09:37 CET [2025/10/06 18:09:37 ET]
Table 'Sirio' 6-max Seat #1 is the button
Seat 1: hedo2008 (€2.01 in chips) 
Seat 2: M@verick781 (€8.43 in chips) 
Seat 3: stfuplzudonk (€1.72 in chips) 
Seat 4: IKARO_3 (€2.16 in chips) 
Seat 5: SebaRapy14 (€2.66 in chips) 
Seat 6: caduceus369 (€2.09 in chips) 
M@verick781: posts small blind €0.01
stfuplzudonk: posts big blind €0.02
*** HOLE CARDS ***
Dealt to caduceus369 [6s 5d]
IKARO_3: folds 
SebaRapy14: folds 
caduceus369: folds 
hedo2008: folds 
M@verick781: raises €0.04 to €0.06
stfuplzudonk: calls €0.04
*** FLOP *** [Qs 9h 8c]
M@verick781: checks 
stfuplzudonk: checks 
*** TURN *** [Qs 9h 8c] [9s]
M@verick781: bets €0.03
stfuplzudonk: calls €0.03
*** RIVER *** [Qs 9h 8c 9s] [Ah]
M@verick781: bets €0.12
stfuplzudonk: calls €0.12
*** SHOW DOWN ***
M@verick781: shows [Kh Jh] (a pair of Nines)
stfuplzudonk: shows [8s As] (two pair, Aces and Nines)
stfuplzudonk collected €0.40 from pot
*** SUMMARY ***
Total pot €0.42 | Rake €0.02 
Board [Qs 9h 8c 9s Ah]
Seat 1: hedo2008 (button) folded before Flop (didn't bet)
Seat 2: M@verick781 (small blind) showed [Kh Jh] and lost with a pair of Nines
Seat 3: stfuplzudonk (big blind) showed [8s As] and won (€0.40) with two pair, Aces and Nines
Seat 4: IKARO_3 folded before Flop (didn't bet)
Seat 5: SebaRapy14 folded before Flop (didn't bet)
Seat 6: caduceus369 folded before Flop (didn't bet)



PokerStars Zoom Hand #258026924739:  Hold'em No Limit (€0.01/€0.02) [ADM ID: M62BD3044A1E13PD] - 2025/10/07 0:09:10 CET [2025/10/06 18:09:10 ET]
Table 'Sirio' 6-max Seat #1 is the button
Seat 1: caduceus369 (€2.09 in chips) 
Seat 2: Giampon78 (€1.45 in chips) 
Seat 3: mondie73100 (€2.64 in chips) 
Seat 4: 7chris5 (€3.36 in chips) 
Seat 5: M@verick781 (€7.36 in chips) 
Seat 6: cap e'bomb95 (€3.98 in chips) 
Giampon78: posts small blind €0.01
mondie73100: posts big blind €0.02
*** HOLE CARDS ***
Dealt to caduceus369 [3h Kd]
7chris5: calls €0.02
M@verick781: folds 
cap e'bomb95: folds 
caduceus369: folds 
Giampon78: calls €0.01
mondie73100: checks 
*** FLOP *** [8s 9h 9c]
Giampon78: checks 
mondie73100: checks 
7chris5: checks 
*** TURN *** [8s 9h 9c] [3s]
Giampon78: checks 
mondie73100: checks 
7chris5: checks 
*** RIVER *** [8s 9h 9c 3s] [9d]
Giampon78: checks 
mondie73100: bets €0.02
7chris5: folds 
Giampon78: folds 
Uncalled bet (€0.02) returned to mondie73100
mondie73100 collected €0.06 from pot
mondie73100: doesn't show hand 
*** SUMMARY ***
Total pot €0.06 | Rake €0 
Board [8s 9h 9c 3s 9d]
Seat 1: caduceus369 (button) folded before Flop (didn't bet)
Seat 2: Giampon78 (small blind) folded on the River
Seat 3: mondie73100 (big blind) collected (€0.06)
Seat 4: 7chris5 folded on the River
Seat 5: M@verick781 folded before Flop (didn't bet)
Seat 6: cap e'bomb95 folded before Flop (didn't bet)



PokerStars Zoom Hand #258026939762:  Hold'em No Limit (€0.01/€0.02) [ADM ID: M62BD3044A1E13PD] - 2025/10/07 0:10:20 CET [2025/10/06 18:10:20 ET]
Table 'Sirio' 6-max Seat #1 is the button
Seat 1: Rorotitti (€2.23 in chips) 
Seat 2: caduceus369 (€2.03 in chips) 
Seat 3: IKARO_3 (€2 in chips) 
Seat 4: mashallahh (€2.08 in chips) 
Seat 5: M@verick781 (€2.84 in chips) 
Seat 6: jackkk03 (€5.54 in chips) 
caduceus369: posts small blind €0.01
IKARO_3: posts big blind €0.02
*** HOLE CARDS ***
Dealt to caduceus369 [Js Td]
mashallahh: folds 
M@verick781: raises €0.03 to €0.05
jackkk03: folds 
Rorotitti: raises €2.18 to €2.23 and is all-in
caduceus369: folds 
IKARO_3: folds 
M@verick781: folds 
Uncalled bet (€2.18) returned to Rorotitti
Rorotitti collected €0.13 from pot
Rorotitti: doesn't show hand 
*** SUMMARY ***
Total pot €0.13 | Rake €0 
Seat 1: Rorotitti (button) collected (€0.13)
Seat 2: caduceus369 (small blind) folded before Flop
Seat 3: IKARO_3 (big blind) folded before Flop
Seat 4: mashallahh folded before Flop (didn't bet)
Seat 5: M@verick781 folded before Flop
Seat 6: jackkk03 folded before Flop (didn't bet)



PokerStars Zoom Hand #258026956839:  Hold'em No Limit (€0.01/€0.02) [ADM ID: M62BD3044A1E13PD] - 2025/10/07 0:11:39 CET [2025/10/06 18:11:39 ET]
Table 'Sirio' 6-max Seat #1 is the button
Seat 1: caduceus369 (€2 in chips) 
Seat 2: mashallahh (€3.56 in chips) 
Seat 3: cap e'bomb95 (€3.94 in chips) 
Seat 4: mondie73100 (€2 in chips) 
Seat 5: IKARO_3 (€2.19 in chips) 
Seat 6: jhonnystecco8 (€1.82 in chips) 
mashallahh: posts small blind €0.01
cap e'bomb95: posts big blind €0.02
*** HOLE CARDS ***
Dealt to caduceus369 [Qd As]
mondie73100: folds 
IKARO_3: raises €0.03 to €0.05
jhonnystecco8: folds 
caduceus369: raises €0.11 to €0.16
mashallahh: folds 
cap e'bomb95: folds 
IKARO_3: calls €0.11
*** FLOP *** [3h 6h 2c]
IKARO_3: checks 
caduceus369: bets €0.13
IKARO_3: raises €0.20 to €0.33
caduceus369: folds 
Uncalled bet (€0.20) returned to IKARO_3
IKARO_3 collected €0.58 from pot
IKARO_3: doesn't show hand 
*** SUMMARY ***
Total pot €0.61 | Rake €0.03 
Board [3h 6h 2c]
Seat 1: caduceus369 (button) folded on the Flop
Seat 2: mashallahh (small blind) folded before Flop
Seat 3: cap e'bomb95 (big blind) folded before Flop
Seat 4: mondie73100 folded before Flop (didn't bet)
Seat 5: IKARO_3 collected (€0.58)
Seat 6: jhonnystecco8 folded before Flop (didn't bet)



PokerStars Zoom Hand #258026967925:  Hold'em No Limit (€0.01/€0.02) [ADM ID: M62BD3044A1E13PD] - 2025/10/07 0:12:30 CET [2025/10/06 18:12:30 ET]
Table 'Sirio' 6-max Seat #1 is the button
Seat 1: Wildag00 (€1.51 in chips) 
Seat 2: jhonnystecco8 (€1.80 in chips) 
Seat 3: IKARO_3 (€2.07 in chips) 
Seat 4: caduceus369 (€2 in chips) 
Seat 5: jackkk03 (€4.16 in chips) 
Seat 6: 19kappa88 (€1.95 in chips) 
jhonnystecco8: posts small blind €0.01
IKARO_3: posts big blind €0.02
*** HOLE CARDS ***
Dealt to caduceus369 [Qh 4s]
caduceus369: folds 
jackkk03: folds 
19kappa88: folds 
Wildag00: raises €0.04 to €0.06
jhonnystecco8: folds 
IKARO_3: folds 
Uncalled bet (€0.04) returned to Wildag00
Wildag00 collected €0.05 from pot
Wildag00: doesn't show hand 
*** SUMMARY ***
Total pot €0.05 | Rake €0 
Seat 1: Wildag00 (button) collected (€0.05)
Seat 2: jhonnystecco8 (small blind) folded before Flop
Seat 3: IKARO_3 (big blind) folded before Flop
Seat 4: caduceus369 folded before Flop (didn't bet)
Seat 5: jackkk03 folded before Flop (didn't bet)
Seat 6: 19kappa88 folded before Flop (didn't bet)



PokerStars Zoom Hand #258026970721:  Hold'em No Limit (€0.01/€0.02) [ADM ID: M62BD3044A1E13PD] - 2025/10/07 0:12:43 CET [2025/10/06 18:12:43 ET]
Table 'Sirio' 6-max Seat #1 is the button
Seat 1: SebaRapy14 (€2.80 in chips) 
Seat 2: caduceus369 (€2 in chips) 
Seat 3: stfuplzudonk (€1.86 in chips) 
Seat 4: 7chris5 (€3.41 in chips) 
Seat 5: 19kappa88 (€1.95 in chips) 
Seat 6: fccmp (€0.72 in chips) 
caduceus369: posts small blind €0.01
stfuplzudonk: posts big blind €0.02
*** HOLE CARDS ***
Dealt to caduceus369 [2d 4s]
7chris5: folds 
19kappa88: folds 
fccmp: folds 
SebaRapy14: folds 
caduceus369: folds 
Uncalled bet (€0.01) returned to stfuplzudonk
stfuplzudonk collected €0.02 from pot
stfuplzudonk: doesn't show hand 
*** SUMMARY ***
Total pot €0.02 | Rake €0 
Seat 1: SebaRapy14 (button) folded before Flop (didn't bet)
Seat 2: caduceus369 (small blind) folded before Flop
Seat 3: stfuplzudonk (big blind) collected (€0.02)
Seat 4: 7chris5 folded before Flop (didn't bet)
Seat 5: 19kappa88 folded before Flop (didn't bet)
Seat 6: fccmp folded before Flop (didn't bet)



PokerStars Zoom Hand #258026972428:  Hold'em No Limit (€0.01/€0.02) [ADM ID: M62BD3044A1E13PD] - 2025/10/07 0:12:51 CET [2025/10/06 18:12:51 ET]
Table 'Sirio' 6-max Seat #1 is the button
Seat 1: IKARO_3 (€2.05 in chips) 
Seat 2: 19kappa88 (€1.95 in chips) 
Seat 3: caduceus369 (€2 in chips) 
Seat 4: SebaRapy14 (€2.80 in chips) 
Seat 5: fccmp (€0.72 in chips) 
Seat 6: jhonnystecco8 (€1.79 in chips) 
19kappa88: posts small blind €0.01
caduceus369: posts big blind €0.02
*** HOLE CARDS ***
Dealt to caduceus369 [3d 3s]
SebaRapy14: folds 
fccmp: folds 
jhonnystecco8: folds 
IKARO_3: folds 
19kappa88: folds 
Uncalled bet (€0.01) returned to caduceus369
caduceus369 collected €0.02 from pot
caduceus369: doesn't show hand 
*** SUMMARY ***
Total pot €0.02 | Rake €0 
Seat 1: IKARO_3 (button) folded before Flop (didn't bet)
Seat 2: 19kappa88 (small blind) folded before Flop
Seat 3: caduceus369 (big blind) collected (€0.02)
Seat 4: SebaRapy14 folded before Flop (didn't bet)
Seat 5: fccmp folded before Flop (didn't bet)
Seat 6: jhonnystecco8 folded before Flop (didn't bet)



PokerStars Zoom Hand #258026965695:  Hold'em No Limit (€0.01/€0.02) [ADM ID: M62BD3044A1E13PD] - 2025/10/07 0:12:20 CET [2025/10/06 18:12:20 ET]
Table 'Sirio' 6-max Seat #1 is the button
Seat 1: 19kappa88 (€1.95 in chips) 
Seat 2: M@verick781 (€7.10 in chips) 
Seat 3: MARKNO73 (€0.43 in chips) 
Seat 4: IKARO_3 (€4.20 in chips) 
Seat 5: stfuplzudonk (€1.24 in chips) 
Seat 6: caduceus369 (€2 in chips) 
M@verick781: posts small blind €0.01
MARKNO73: posts big blind €0.02
*** HOLE CARDS ***
Dealt to caduceus369 [Kc 7h]
IKARO_3: folds 
stfuplzudonk: raises €0.04 to €0.06
caduceus369: folds 
19kappa88: folds 
M@verick781: folds 
MARKNO73: calls €0.04
*** FLOP *** [4s 7c Ad]
MARKNO73: bets €0.02
stfuplzudonk: calls €0.02
*** TURN *** [4s 7c Ad] [7d]
MARKNO73: bets €0.02
stfuplzudonk: calls €0.02
*** RIVER *** [4s 7c Ad 7d] [2c]
MARKNO73: bets €0.02
stfuplzudonk: raises €0.24 to €0.26
MARKNO73: folds 
Uncalled bet (€0.24) returned to stfuplzudonk
stfuplzudonk collected €0.24 from pot
stfuplzudonk: doesn't show hand 
*** SUMMARY ***
Total pot €0.25 | Rake €0.01 
Board [4s 7c Ad 7d 2c]
Seat 1: 19kappa88 (button) folded before Flop (didn't bet)
Seat 2: M@verick781 (small blind) folded before Flop
Seat 3: MARKNO73 (big blind) folded on the River
Seat 4: IKARO_3 folded before Flop (didn't bet)
Seat 5: stfuplzudonk collected (€0.24)
Seat 6: caduceus369 folded before Flop (didn't bet)



PokerStars Zoom Hand #258026969230:  Hold'em No Limit (€0.01/€0.02) [ADM ID: M62BD3044A1E13PD] - 2025/10/07 0:12:36 CET [2025/10/06 18:12:36 ET]
Table 'Sirio' 6-max Seat #1 is the button
Seat 1: simona13890 (€2.34 in chips) 
Seat 2: M@verick781 (€8.38 in chips) 
Seat 3: IKARO_3 (€2.48 in chips) 
Seat 4: 19kappa88 (€1.95 in chips) 
Seat 5: caduceus369 (€2 in chips) 
Seat 6: SebaRapy14 (€2.80 in chips) 
M@verick781: posts small blind €0.01
IKARO_3: posts big blind €0.02
*** HOLE CARDS ***
Dealt to caduceus369 [5c 2d]
19kappa88: folds 
caduceus369: folds 
SebaRapy14: folds 
simona13890: raises €0.02 to €0.04
M@verick781: raises €0.14 to €0.18
IKARO_3: folds 
simona13890: calls €0.14
*** FLOP *** [Th 2h 9h]
M@verick781: checks 
simona13890: checks 
*** TURN *** [Th 2h 9h] [Ts]
M@verick781: checks 
simona13890: checks 
*** RIVER *** [Th 2h 9h Ts] [3c]
M@verick781: checks 
simona13890: bets €0.18
M@verick781: calls €0.18
*** SHOW DOWN ***
simona13890: shows [Jd Ks] (a pair of Tens)
M@verick781: shows [Ad 8d] (a pair of Tens - Ace kicker)
M@verick781 collected €0.70 from pot
*** SUMMARY ***
Total pot €0.74 | Rake €0.04 
Board [Th 2h 9h Ts 3c]
Seat 1: simona13890 (button) showed [Jd Ks] and lost with a pair of Tens
Seat 2: M@verick781 (small blind) showed [Ad 8d] and won (€0.70) with a pair of Tens
Seat 3: IKARO_3 (big blind) folded before Flop
Seat 4: 19kappa88 folded before Flop (didn't bet)
Seat 5: caduceus369 folded before Flop (didn't bet)
Seat 6: SebaRapy14 folded before Flop (didn't bet)



PokerStars Zoom Hand #258026944076:  Hold'em No Limit (€0.01/€0.02) [ADM ID: M62BD3044A1E13PD] - 2025/10/07 0:10:40 CET [2025/10/06 18:10:40 ET]
Table 'Sirio' 6-max Seat #1 is the button
Seat 1: IKARO_3 (€1.98 in chips) 
Seat 2: cap e'bomb95 (€3.08 in chips) 
Seat 3: caduceus369 (€2.02 in chips) 
Seat 4: SebaRapy14 (€3.03 in chips) 
Seat 5: mondie73100 (€2.68 in chips) 
Seat 6: mashallahh (€5.39 in chips) 
cap e'bomb95: posts small blind €0.01
caduceus369: posts big blind €0.02
*** HOLE CARDS ***
Dealt to caduceus369 [6h Th]
SebaRapy14: raises €0.04 to €0.06
mondie73100: calls €0.06
mashallahh: folds 
IKARO_3: folds 
cap e'bomb95: folds 
caduceus369: folds 
*** FLOP *** [5d Td Qc]
SebaRapy14: bets €0.08
mondie73100: calls €0.08
*** TURN *** [5d Td Qc] [7h]
SebaRapy14: bets €0.20
mondie73100 has timed out
mondie73100: folds 
Uncalled bet (€0.20) returned to SebaRapy14
SebaRapy14 collected €0.30 from pot
SebaRapy14: doesn't show hand 
*** SUMMARY ***
Total pot €0.31 | Rake €0.01 
Board [5d Td Qc 7h]
Seat 1: IKARO_3 (button) folded before Flop (didn't bet)
Seat 2: cap e'bomb95 (small blind) folded before Flop
Seat 3: caduceus369 (big blind) folded before Flop
Seat 4: SebaRapy14 collected (€0.30)
Seat 5: mondie73100 folded on the Turn
Seat 6: mashallahh folded before Flop (didn't bet)



PokerStars Zoom Hand #258026976144:  Hold'em No Limit (€0.01/€0.02) [ADM ID: M62BD3044A1E13PD] - 2025/10/07 0:13:08 CET [2025/10/06 18:13:08 ET]
Table 'Sirio' 6-max Seat #1 is the button
Seat 1: cap e'bomb95 (€3.75 in chips) 
Seat 2: MARKNO73 (€0.31 in chips) 
Seat 3: M@verick781 (€7.26 in chips) 
Seat 4: caduceus369 (€2.01 in chips) 
Seat 5: gigysk (€0.97 in chips) 
Seat 6: mashallahh (€3.41 in chips) 
MARKNO73: posts small blind €0.01
M@verick781: posts big blind €0.02
*** HOLE CARDS ***
Dealt to caduceus369 [6d 7d]
caduceus369: folds 
gigysk: folds 
mashallahh: folds 
cap e'bomb95: raises €0.03 to €0.05
MARKNO73: raises €0.05 to €0.10
M@verick781: folds 
cap e'bomb95: raises €0.28 to €0.38
MARKNO73: calls €0.21 and is all-in
Uncalled bet (€0.07) returned to cap e'bomb95
*** FLOP *** [2d Qs 3s]
*** TURN *** [2d Qs 3s] [4d]
*** RIVER *** [2d Qs 3s 4d] [Jh]
*** SHOW DOWN ***
MARKNO73: shows [6s 6h] (a pair of Sixes)
cap e'bomb95: shows [2c 2s] (three of a kind, Deuces)
cap e'bomb95 collected €0.61 from pot
*** SUMMARY ***
Total pot €0.64 | Rake €0.03 
Board [2d Qs 3s 4d Jh]
Seat 1: cap e'bomb95 (button) showed [2c 2s] and won (€0.61) with three of a kind, Deuces
Seat 2: MARKNO73 (small blind) showed [6s 6h] and lost with a pair of Sixes
Seat 3: M@verick781 (big blind) folded before Flop
Seat 4: caduceus369 folded before Flop (didn't bet)
Seat 5: gigysk folded before Flop (didn't bet)
Seat 6: mashallahh folded before Flop (didn't bet)



PokerStars Zoom Hand #258026978222:  Hold'em No Limit (€0.01/€0.02) [ADM ID: M62BD3044A1E13PD] - 2025/10/07 0:13:18 CET [2025/10/06 18:13:18 ET]
Table 'Sirio' 6-max Seat #1 is the button
Seat 1: caduceus369 (€2.01 in chips) 
Seat 2: cap e'bomb95 (€2.77 in chips) 
Seat 3: Wildag00 (€1.53 in chips) 
Seat 4: gigysk (€0.97 in chips) 
Seat 5: mashallahh (€5.79 in chips) 
Seat 6: Poetto65 (€0.62 in chips) 
cap e'bomb95: posts small blind €0.01
Wildag00: posts big blind €0.02
*** HOLE CARDS ***
Dealt to caduceus369 [6s As]
gigysk: folds 
mashallahh: raises €0.04 to €0.06
Poetto65: calls €0.06
caduceus369: calls €0.06
cap e'bomb95: folds 
Wildag00: folds 
*** FLOP *** [7s Qd Ad]
mashallahh: checks 
Poetto65: bets €0.10
caduceus369: calls €0.10
mashallahh: folds 
*** TURN *** [7s Qd Ad] [Qc]
Poetto65: bets €0.06
caduceus369: calls €0.06
*** RIVER *** [7s Qd Ad Qc] [5h]
Poetto65: bets €0.26
caduceus369: raises €0.26 to €0.52
Poetto65: calls €0.14 and is all-in
Uncalled bet (€0.12) returned to caduceus369
*** SHOW DOWN ***
caduceus369: shows [6s As] (two pair, Aces and Queens)
Poetto65: shows [Ah Kc] (two pair, Aces and Queens - King kicker)
Poetto65 collected €1.26 from pot
*** SUMMARY ***
Total pot €1.33 | Rake €0.07 
Board [7s Qd Ad Qc 5h]
Seat 1: caduceus369 (button) showed [6s As] and lost with two pair, Aces and Queens
Seat 2: cap e'bomb95 (small blind) folded before Flop
Seat 3: Wildag00 (big blind) folded before Flop
Seat 4: gigysk folded before Flop (didn't bet)
Seat 5: mashallahh folded on the Flop
Seat 6: Poetto65 showed [Ah Kc] and won (€1.26) with two pair, Aces and Queens



PokerStars Zoom Hand #258027000456:  Hold'em No Limit (€0.01/€0.02) [ADM ID: M62BD3044A1E13PD] - 2025/10/07 0:15:02 CET [2025/10/06 18:15:02 ET]
Table 'Sirio' 6-max Seat #1 is the button
Seat 1: alekappe (€1.33 in chips) 
Seat 2: Wildag00 (€2.41 in chips) 
Seat 3: mashallahh (€5.72 in chips) 
Seat 4: IKARO_3 (€7.75 in chips) 
Seat 5: caduceus369 (€2 in chips) 
Seat 6: M@verick781 (€7.25 in chips) 
Wildag00: posts small blind €0.01
mashallahh: posts big blind €0.02
*** HOLE CARDS ***
Dealt to caduceus369 [4d Kc]
IKARO_3: folds 
caduceus369: folds 
M@verick781: raises €0.03 to €0.05
alekappe: folds 
Wildag00: folds 
mashallahh: folds 
Uncalled bet (€0.03) returned to M@verick781
M@verick781 collected €0.05 from pot
M@verick781: doesn't show hand 
*** SUMMARY ***
Total pot €0.05 | Rake €0 
Seat 1: alekappe (button) folded before Flop (didn't bet)
Seat 2: Wildag00 (small blind) folded before Flop
Seat 3: mashallahh (big blind) folded before Flop
Seat 4: IKARO_3 folded before Flop (didn't bet)
Seat 5: caduceus369 folded before Flop (didn't bet)
Seat 6: M@verick781 collected (€0.05)



PokerStars Zoom Hand #258027001795:  Hold'em No Limit (€0.01/€0.02) [ADM ID: M62BD3044A1E13PD] - 2025/10/07 0:15:08 CET [2025/10/06 18:15:08 ET]
Table 'Sirio' 6-max Seat #1 is the button
Seat 1: Wildag00 (€2.40 in chips) 
Seat 2: Ohhhhyeahhh89 (€2.03 in chips) 
Seat 3: alekappe (€1.33 in chips) 
Seat 4: 7chris5 (€3.40 in chips) 
Seat 5: caduceus369 (€2 in chips) 
Seat 6: heitel (€1.32 in chips) 
Ohhhhyeahhh89: posts small blind €0.01
alekappe: posts big blind €0.02
*** HOLE CARDS ***
Dealt to caduceus369 [2h Qc]
7chris5: folds 
caduceus369: folds 
heitel: folds 
Wildag00: folds 
Ohhhhyeahhh89: calls €0.01
alekappe: raises €1.31 to €1.33 and is all-in
Ohhhhyeahhh89: folds 
Uncalled bet (€1.31) returned to alekappe
alekappe collected €0.04 from pot
alekappe: doesn't show hand 
*** SUMMARY ***
Total pot €0.04 | Rake €0 
Seat 1: Wildag00 (button) folded before Flop (didn't bet)
Seat 2: Ohhhhyeahhh89 (small blind) folded before Flop
Seat 3: alekappe (big blind) collected (€0.04)
Seat 4: 7chris5 folded before Flop (didn't bet)
Seat 5: caduceus369 folded before Flop (didn't bet)
Seat 6: heitel folded before Flop (didn't bet)



PokerStars Zoom Hand #258026997854:  Hold'em No Limit (€0.01/€0.02) [ADM ID: M62BD3044A1E13PD] - 2025/10/07 0:14:50 CET [2025/10/06 18:14:50 ET]
Table 'Sirio' 6-max Seat #1 is the button
Seat 1: Poetto65 (€1.26 in chips) 
Seat 2: IKARO_3 (€2 in chips) 
Seat 3: heitel (€1.34 in chips) 
Seat 4: Rorotitti (€3.22 in chips) 
Seat 5: stfuplzudonk (€1.70 in chips) 
Seat 6: caduceus369 (€2 in chips) 
IKARO_3: posts small blind €0.01
heitel: posts big blind €0.02
*** HOLE CARDS ***
Dealt to caduceus369 [6c 3c]
Rorotitti: calls €0.02
stfuplzudonk: raises €0.07 to €0.09
caduceus369: folds 
Poetto65: folds 
IKARO_3: raises €0.23 to €0.32
heitel: folds 
Rorotitti: folds 
stfuplzudonk: calls €0.23
*** FLOP *** [7c Ts Ad]
IKARO_3: bets €0.33
stfuplzudonk: folds 
Uncalled bet (€0.33) returned to IKARO_3
IKARO_3 collected €0.65 from pot
IKARO_3: doesn't show hand 
*** SUMMARY ***
Total pot €0.68 | Rake €0.03 
Board [7c Ts Ad]
Seat 1: Poetto65 (button) folded before Flop (didn't bet)
Seat 2: IKARO_3 (small blind) collected (€0.65)
Seat 3: heitel (big blind) folded before Flop
Seat 4: Rorotitti folded before Flop
Seat 5: stfuplzudonk folded on the Flop
Seat 6: caduceus369 folded before Flop (didn't bet)



PokerStars Zoom Hand #258027003019:  Hold'em No Limit (€0.01/€0.02) [ADM ID: M62BD3044A1E13PD] - 2025/10/07 0:15:14 CET [2025/10/06 18:15:14 ET]
Table 'Sirio' 6-max Seat #1 is the button
Seat 1: IKARO_3 (€2.13 in chips) 
Seat 2: caduceus369 (€2 in chips) 
Seat 3: 7chris5 (€3.40 in chips) 
Seat 4: MammAnnAILovey (€2.01 in chips) 
Seat 5: montemeru (€1.97 in chips) 
Seat 6: Wildag00 (€2.40 in chips) 
caduceus369: posts small blind €0.01
7chris5: posts big blind €0.02
*** HOLE CARDS ***
Dealt to caduceus369 [7h 5d]
MammAnnAILovey: folds 
montemeru: raises €0.04 to €0.06
Wildag00: calls €0.06
IKARO_3: folds 
caduceus369: folds 
7chris5: folds 
*** FLOP *** [Ad Kd 4h]
montemeru: checks 
Wildag00: bets €0.05
montemeru: folds 
Uncalled bet (€0.05) returned to Wildag00
Wildag00 collected €0.15 from pot
Wildag00: doesn't show hand 
*** SUMMARY ***
Total pot €0.15 | Rake €0 
Board [Ad Kd 4h]
Seat 1: IKARO_3 (button) folded before Flop (didn't bet)
Seat 2: caduceus369 (small blind) folded before Flop
Seat 3: 7chris5 (big blind) folded before Flop
Seat 4: MammAnnAILovey folded before Flop (didn't bet)
Seat 5: montemeru folded on the Flop
Seat 6: Wildag00 collected (€0.15)



PokerStars Zoom Hand #258027004776:  Hold'em No Limit (€0.01/€0.02) [ADM ID: M62BD3044A1E13PD] - 2025/10/07 0:15:22 CET [2025/10/06 18:15:22 ET]
Table 'Sirio' 6-max Seat #1 is the button
Seat 1: Ohhhhyeahhh89 (€2.01 in chips) 
Seat 2: 19kappa88 (€1.86 in chips) 
Seat 3: caduceus369 (€2 in chips) 
Seat 4: cap e'bomb95 (€2.78 in chips) 
Seat 5: jhonnystecco8 (€1.73 in chips) 
Seat 6: 7chris5 (€3.38 in chips) 
19kappa88: posts small blind €0.01
caduceus369: posts big blind €0.02
*** HOLE CARDS ***
Dealt to caduceus369 [7s 6h]
cap e'bomb95: folds 
jhonnystecco8: folds 
7chris5: calls €0.02
Ohhhhyeahhh89: calls €0.02
19kappa88: folds 
caduceus369: checks 
*** FLOP *** [4d 4c Ad]
caduceus369: checks 
7chris5: checks 
Ohhhhyeahhh89: checks 
*** TURN *** [4d 4c Ad] [5c]
caduceus369: bets €0.02
7chris5: calls €0.02
Ohhhhyeahhh89: folds 
*** RIVER *** [4d 4c Ad 5c] [6c]
caduceus369: bets €0.08
7chris5: folds 
Uncalled bet (€0.08) returned to caduceus369
caduceus369 collected €0.11 from pot
caduceus369: doesn't show hand 
*** SUMMARY ***
Total pot €0.11 | Rake €0 
Board [4d 4c Ad 5c 6c]
Seat 1: Ohhhhyeahhh89 (button) folded on the Turn
Seat 2: 19kappa88 (small blind) folded before Flop
Seat 3: caduceus369 (big blind) collected (€0.11)
Seat 4: cap e'bomb95 folded before Flop (didn't bet)
Seat 5: jhonnystecco8 folded before Flop (didn't bet)
Seat 6: 7chris5 folded on the River



PokerStars Zoom Hand #258027023153:  Hold'em No Limit (€0.01/€0.02) [ADM ID: M62BD3044A1E13PD] - 2025/10/07 0:16:48 CET [2025/10/06 18:16:48 ET]
Table 'Sirio' 6-max Seat #1 is the button
Seat 1: SebaRapy14 (€2.76 in chips) 
Seat 2: heitel (€3.04 in chips) 
Seat 3: mashallahh (€2 in chips) 
Seat 4: IKARO_3 (€2.13 in chips) 
Seat 5: M@verick781 (€9.08 in chips) 
Seat 6: caduceus369 (€2.07 in chips) 
heitel: posts small blind €0.01
mashallahh: posts big blind €0.02
*** HOLE CARDS ***
Dealt to caduceus369 [Td 9s]
IKARO_3: folds 
M@verick781: raises €0.03 to €0.05
caduceus369: folds 
SebaRapy14: calls €0.05
heitel: folds 
mashallahh: folds 
*** FLOP *** [Jh Jc 3h]
M@verick781: checks 
SebaRapy14: checks 
*** TURN *** [Jh Jc 3h] [4h]
M@verick781: checks 
SebaRapy14: bets €0.07
M@verick781: folds 
Uncalled bet (€0.07) returned to SebaRapy14
SebaRapy14 collected €0.13 from pot
SebaRapy14: doesn't show hand 
*** SUMMARY ***
Total pot €0.13 | Rake €0 
Board [Jh Jc 3h 4h]
Seat 1: SebaRapy14 (button) collected (€0.13)
Seat 2: heitel (small blind) folded before Flop
Seat 3: mashallahh (big blind) folded before Flop
Seat 4: IKARO_3 folded before Flop (didn't bet)
Seat 5: M@verick781 folded on the Turn
Seat 6: caduceus369 folded before Flop (didn't bet)



PokerStars Zoom Hand #258027027515:  Hold'em No Limit (€0.01/€0.02) [ADM ID: M62BD3044A1E13PD] - 2025/10/07 0:17:09 CET [2025/10/06 18:17:09 ET]
Table 'Sirio' 6-max Seat #1 is the button
Seat 1: IKARO_3 (€8.72 in chips) 
Seat 2: 19kappa88 (€1.80 in chips) 
Seat 3: pistaKKio23 (€3.45 in chips) 
Seat 4: caduceus369 (€2.07 in chips) 
Seat 5: mashallahh (€5.86 in chips) 
Seat 6: Coffeebreak96 (€4.22 in chips) 
19kappa88: posts small blind €0.01
pistaKKio23: posts big blind €0.02
*** HOLE CARDS ***
Dealt to caduceus369 [Th 9d]
caduceus369: folds 
mashallahh: raises €0.04 to €0.06
Coffeebreak96: calls €0.06
IKARO_3: raises €0.22 to €0.28
19kappa88: folds 
pistaKKio23: folds 
mashallahh: raises €0.70 to €0.98
Coffeebreak96: folds 
IKARO_3: folds 
Uncalled bet (€0.70) returned to mashallahh
mashallahh collected €0.65 from pot
mashallahh: doesn't show hand 
*** SUMMARY ***
Total pot €0.65 | Rake €0 
Seat 1: IKARO_3 (button) folded before Flop
Seat 2: 19kappa88 (small blind) folded before Flop
Seat 3: pistaKKio23 (big blind) folded before Flop
Seat 4: caduceus369 folded before Flop (didn't bet)
Seat 5: mashallahh collected (€0.65)
Seat 6: Coffeebreak96 folded before Flop



PokerStars Zoom Hand #258027028876:  Hold'em No Limit (€0.01/€0.02) [ADM ID: M62BD3044A1E13PD] - 2025/10/07 0:17:16 CET [2025/10/06 18:17:16 ET]
Table 'Sirio' 6-max Seat #1 is the button
Seat 1: Wildag00 (€1.33 in chips) 
Seat 2: pistaKKio23 (€8.53 in chips) 
Seat 3: caduceus369 (€2.07 in chips) 
Seat 4: mashallahh (€3.35 in chips) 
Seat 5: 7chris5 (€3.33 in chips) 
Seat 6: Poetto65 (€1.26 in chips) 
pistaKKio23: posts small blind €0.01
caduceus369: posts big blind €0.02
*** HOLE CARDS ***
Dealt to caduceus369 [4c Tc]
mashallahh: folds 
7chris5: folds 
Poetto65: folds 
Wildag00: folds 
pistaKKio23: calls €0.01
caduceus369: checks 
*** FLOP *** [8d 3c Ts]
pistaKKio23: checks 
caduceus369: bets €0.02
pistaKKio23: folds 
Uncalled bet (€0.02) returned to caduceus369
caduceus369 collected €0.04 from pot
caduceus369: doesn't show hand 
*** SUMMARY ***
Total pot €0.04 | Rake €0 
Board [8d 3c Ts]
Seat 1: Wildag00 (button) folded before Flop (didn't bet)
Seat 2: pistaKKio23 (small blind) folded on the Flop
Seat 3: caduceus369 (big blind) collected (€0.04)
Seat 4: mashallahh folded before Flop (didn't bet)
Seat 5: 7chris5 folded before Flop (didn't bet)
Seat 6: Poetto65 folded before Flop (didn't bet)



PokerStars Zoom Hand #258027024667:  Hold'em No Limit (€0.01/€0.02) [ADM ID: M62BD3044A1E13PD] - 2025/10/07 0:16:56 CET [2025/10/06 18:16:56 ET]
Table 'Sirio' 6-max Seat #1 is the button
Seat 1: caduceus369 (€2.07 in chips) 
Seat 2: AlwaisToRun (€0.43 in chips) 
Seat 3: IKARO_3 (€2.13 in chips) 
Seat 4: pistaKKio23 (€3.45 in chips) 
Seat 5: cap e'bomb95 (€2.46 in chips) 
Seat 6: gigysk (€1.56 in chips) 
AlwaisToRun: posts small blind €0.01
IKARO_3: posts big blind €0.02
*** HOLE CARDS ***
Dealt to caduceus369 [Ac 5d]
pistaKKio23: folds 
cap e'bomb95: folds 
gigysk: calls €0.02
caduceus369: folds 
AlwaisToRun: folds 
IKARO_3: checks 
*** FLOP *** [Tc 6c 5s]
IKARO_3: checks 
gigysk: checks 
*** TURN *** [Tc 6c 5s] [As]
IKARO_3: checks 
gigysk: checks 
*** RIVER *** [Tc 6c 5s As] [9s]
IKARO_3: bets €0.06
gigysk: folds 
Uncalled bet (€0.06) returned to IKARO_3
IKARO_3 collected €0.05 from pot
IKARO_3: doesn't show hand 
*** SUMMARY ***
Total pot €0.05 | Rake €0 
Board [Tc 6c 5s As 9s]
Seat 1: caduceus369 (button) folded before Flop (didn't bet)
Seat 2: AlwaisToRun (small blind) folded before Flop
Seat 3: IKARO_3 (big blind) collected (€0.05)
Seat 4: pistaKKio23 folded before Flop (didn't bet)
Seat 5: cap e'bomb95 folded before Flop (didn't bet)
Seat 6: gigysk folded on the River



PokerStars Zoom Hand #258027034766:  Hold'em No Limit (€0.01/€0.02) [ADM ID: M62BD3044A1E13PD] - 2025/10/07 0:17:43 CET [2025/10/06 18:17:43 ET]
Table 'Sirio' 6-max Seat #1 is the button
Seat 1: IKARO_3 (€2.50 in chips) 
Seat 2: caduceus369 (€2.09 in chips) 
Seat 3: Poetto65 (€1.26 in chips) 
Seat 4: AlwaisToRun (€0.42 in chips) 
Seat 5: stfuplzudonk (€1.75 in chips) 
Seat 6: montemeru (€1.92 in chips) 
caduceus369: posts small blind €0.01
Poetto65: posts big blind €0.02
*** HOLE CARDS ***
Dealt to caduceus369 [2s Jh]
AlwaisToRun: folds 
stfuplzudonk: folds 
montemeru: raises €0.04 to €0.06
IKARO_3: folds 
caduceus369: folds 
Poetto65: folds 
Uncalled bet (€0.04) returned to montemeru
montemeru collected €0.05 from pot
montemeru: doesn't show hand 
*** SUMMARY ***
Total pot €0.05 | Rake €0 
Seat 1: IKARO_3 (button) folded before Flop (didn't bet)
Seat 2: caduceus369 (small blind) folded before Flop
Seat 3: Poetto65 (big blind) folded before Flop
Seat 4: AlwaisToRun folded before Flop (didn't bet)
Seat 5: stfuplzudonk folded before Flop (didn't bet)
Seat 6: montemeru collected (€0.05)



PokerStars Zoom Hand #258027036323:  Hold'em No Limit (€0.01/€0.02) [ADM ID: M62BD3044A1E13PD] - 2025/10/07 0:17:51 CET [2025/10/06 18:17:51 ET]
Table 'Sirio' 6-max Seat #1 is the button
Seat 1: caduceus369 (€2.08 in chips) 
Seat 2: pistaKKio23 (€8.18 in chips) 
Seat 3: Wildag00 (€2.35 in chips) 
Seat 4: IKARO_3 (€8.42 in chips) 
Seat 5: Agata1971 (€2.07 in chips) 
Seat 6: M@verick781 (€9.03 in chips) 
pistaKKio23: posts small blind €0.01
Wildag00: posts big blind €0.02
*** HOLE CARDS ***
Dealt to caduceus369 [7s Ts]
IKARO_3: folds 
Agata1971: folds 
M@verick781: folds 
caduceus369: raises €0.04 to €0.06
pistaKKio23: folds 
Wildag00: folds 
Uncalled bet (€0.04) returned to caduceus369
caduceus369 collected €0.05 from pot
caduceus369: doesn't show hand 
*** SUMMARY ***
Total pot €0.05 | Rake €0 
Seat 1: caduceus369 (button) collected (€0.05)
Seat 2: pistaKKio23 (small blind) folded before Flop
Seat 3: Wildag00 (big blind) folded before Flop
Seat 4: IKARO_3 folded before Flop (didn't bet)
Seat 5: Agata1971 folded before Flop (didn't bet)
Seat 6: M@verick781 folded before Flop (didn't bet)



PokerStars Zoom Hand #258027041841:  Hold'em No Limit (€0.01/€0.02) [ADM ID: M62BD3044A1E13PD] - 2025/10/07 0:18:17 CET [2025/10/06 18:18:17 ET]
Table 'Sirio' 6-max Seat #1 is the button
Seat 1: IKARO_3 (€4.23 in chips) 
Seat 2: Wildag00 (€2.33 in chips) 
Seat 3: montemeru (€1.89 in chips) 
Seat 4: caduceus369 (€2.11 in chips) 
Seat 5: mashallahh (€3.32 in chips) 
Seat 6: Agata1971 (€2.04 in chips) 
Wildag00: posts small blind €0.01
montemeru: posts big blind €0.02
*** HOLE CARDS ***
Dealt to caduceus369 [7s Tc]
caduceus369: folds 
mashallahh: folds 
Agata1971: folds 
IKARO_3: folds 
Wildag00: folds 
Uncalled bet (€0.01) returned to montemeru
montemeru collected €0.02 from pot
montemeru: doesn't show hand 
*** SUMMARY ***
Total pot €0.02 | Rake €0 
Seat 1: IKARO_3 (button) folded before Flop (didn't bet)
Seat 2: Wildag00 (small blind) folded before Flop
Seat 3: montemeru (big blind) collected (€0.02)
Seat 4: caduceus369 folded before Flop (didn't bet)
Seat 5: mashallahh folded before Flop (didn't bet)
Seat 6: Agata1971 folded before Flop (didn't bet)



PokerStars Zoom Hand #258027045412:  Hold'em No Limit (€0.01/€0.02) [ADM ID: M62BD3044A1E13PD] - 2025/10/07 0:18:34 CET [2025/10/06 18:18:34 ET]
Table 'Sirio' 6-max Seat #1 is the button
Seat 1: caduceus369 (€2.11 in chips) 
Seat 2: montemeru (€1.90 in chips) 
Seat 3: jhonnystecco8 (€1.76 in chips) 
Seat 4: cap e'bomb95 (€2.76 in chips) 
Seat 5: mashallahh (€3.32 in chips) 
Seat 6: 19kappa88 (€1.98 in chips) 
montemeru: posts small blind €0.01
jhonnystecco8: posts big blind €0.02
*** HOLE CARDS ***
Dealt to caduceus369 [3c Qs]
cap e'bomb95: folds 
mashallahh: folds 
19kappa88: folds 
caduceus369: folds 
montemeru: raises €0.04 to €0.06
jhonnystecco8: folds 
Uncalled bet (€0.04) returned to montemeru
montemeru collected €0.04 from pot
montemeru: doesn't show hand 
*** SUMMARY ***
Total pot €0.04 | Rake €0 
Seat 1: caduceus369 (button) folded before Flop (didn't bet)
Seat 2: montemeru (small blind) collected (€0.04)
Seat 3: jhonnystecco8 (big blind) folded before Flop
Seat 4: cap e'bomb95 folded before Flop (didn't bet)
Seat 5: mashallahh folded before Flop (didn't bet)
Seat 6: 19kappa88 folded before Flop (didn't bet)



PokerStars Zoom Hand #258027042630:  Hold'em No Limit (€0.01/€0.02) [ADM ID: M62BD3044A1E13PD] - 2025/10/07 0:18:20 CET [2025/10/06 18:18:20 ET]
Table 'Sirio' 6-max Seat #1 is the button
Seat 1: IKARO_3 (€2.15 in chips) 
Seat 2: mashallahh (€6.71 in chips) 
Seat 3: M@verick781 (€9.06 in chips) 
Seat 4: 7chris5 (€3.25 in chips) 
Seat 5: MammAnnAILovey (€2.31 in chips) 
Seat 6: caduceus369 (€2.11 in chips) 
mashallahh: posts small blind €0.01
M@verick781: posts big blind €0.02
*** HOLE CARDS ***
Dealt to caduceus369 [2s Tc]
7chris5: calls €0.02
MammAnnAILovey: folds 
caduceus369: folds 
IKARO_3: raises €0.09 to €0.11
mashallahh: folds 
M@verick781: folds 
7chris5: folds 
Uncalled bet (€0.09) returned to IKARO_3
IKARO_3 collected €0.07 from pot
IKARO_3: doesn't show hand 
*** SUMMARY ***
Total pot €0.07 | Rake €0 
Seat 1: IKARO_3 (button) collected (€0.07)
Seat 2: mashallahh (small blind) folded before Flop
Seat 3: M@verick781 (big blind) folded before Flop
Seat 4: 7chris5 folded before Flop
Seat 5: MammAnnAILovey folded before Flop (didn't bet)
Seat 6: caduceus369 folded before Flop (didn't bet)



PokerStars Zoom Hand #258027039336:  Hold'em No Limit (€0.01/€0.02) [ADM ID: M62BD3044A1E13PD] - 2025/10/07 0:18:05 CET [2025/10/06 18:18:05 ET]
Table 'Sirio' 6-max Seat #1 is the button
Seat 1: pistaKKio23 (€3.41 in chips) 
Seat 2: Paky6688988 (€0.66 in chips) 
Seat 3: dispershn (€1.50 in chips) 
Seat 4: J0HN-BR0WN (€5.93 in chips) 
Seat 5: caduceus369 (€2.11 in chips) 
Seat 6: Ohhhhyeahhh89 (€1.21 in chips) 
Paky6688988: posts small blind €0.01
dispershn: posts big blind €0.02
*** HOLE CARDS ***
Dealt to caduceus369 [Qs 5h]
J0HN-BR0WN: calls €0.02
caduceus369: folds 
Ohhhhyeahhh89: calls €0.02
pistaKKio23: folds 
Paky6688988: calls €0.01
dispershn: checks 
*** FLOP *** [Jh Ad Jc]
Paky6688988: checks 
dispershn: checks 
J0HN-BR0WN: checks 
Ohhhhyeahhh89: checks 
*** TURN *** [Jh Ad Jc] [Js]
Paky6688988: bets €0.02
dispershn: folds 
J0HN-BR0WN: calls €0.02
Ohhhhyeahhh89: folds 
*** RIVER *** [Jh Ad Jc Js] [4d]
Paky6688988: bets €0.04
J0HN-BR0WN: calls €0.04
*** SHOW DOWN ***
Paky6688988: shows [2c Kh] (three of a kind, Jacks)
J0HN-BR0WN: shows [9h Kc] (three of a kind, Jacks)
Paky6688988 collected €0.10 from pot
J0HN-BR0WN collected €0.09 from pot
*** SUMMARY ***
Total pot €0.20 | Rake €0.01 
Board [Jh Ad Jc Js 4d]
Seat 1: pistaKKio23 (button) folded before Flop (didn't bet)
Seat 2: Paky6688988 (small blind) showed [2c Kh] and won (€0.10) with three of a kind, Jacks
Seat 3: dispershn (big blind) folded on the Turn
Seat 4: J0HN-BR0WN showed [9h Kc] and won (€0.09) with three of a kind, Jacks
Seat 5: caduceus369 folded before Flop (didn't bet)
Seat 6: Ohhhhyeahhh89 folded on the Turn



PokerStars Zoom Hand #258027043687:  Hold'em No Limit (€0.01/€0.02) [ADM ID: M62BD3044A1E13PD] - 2025/10/07 0:18:25 CET [2025/10/06 18:18:25 ET]
Table 'Sirio' 6-max Seat #1 is the button
Seat 1: jhonnystecco8 (€1.76 in chips) 
Seat 2: 19kappa88 (€1.99 in chips) 
Seat 3: mashallahh (€6.70 in chips) 
Seat 4: Rorotitti (€3.06 in chips) 
Seat 5: cap e'bomb95 (€2.73 in chips) 
Seat 6: caduceus369 (€2.11 in chips) 
19kappa88: posts small blind €0.01
mashallahh: posts big blind €0.02
*** HOLE CARDS ***
Dealt to caduceus369 [As 6c]
Rorotitti: calls €0.02
cap e'bomb95: folds 
caduceus369: folds 
jhonnystecco8: folds 
19kappa88: folds 
mashallahh: checks 
*** FLOP *** [Jh 8d Kh]
mashallahh: checks 
Rorotitti: checks 
*** TURN *** [Jh 8d Kh] [7c]
mashallahh: checks 
Rorotitti: checks 
*** RIVER *** [Jh 8d Kh 7c] [Ks]
mashallahh: checks 
Rorotitti: bets €0.04
mashallahh: folds 
Uncalled bet (€0.04) returned to Rorotitti
Rorotitti collected €0.05 from pot
Rorotitti: doesn't show hand 
*** SUMMARY ***
Total pot €0.05 | Rake €0 
Board [Jh 8d Kh 7c Ks]
Seat 1: jhonnystecco8 (button) folded before Flop (didn't bet)
Seat 2: 19kappa88 (small blind) folded before Flop
Seat 3: mashallahh (big blind) folded on the River
Seat 4: Rorotitti collected (€0.05)
Seat 5: cap e'bomb95 folded before Flop (didn't bet)
Seat 6: caduceus369 folded before Flop (didn't bet)



PokerStars Zoom Hand #258027047230:  Hold'em No Limit (€0.01/€0.02) [ADM ID: M62BD3044A1E13PD] - 2025/10/07 0:18:42 CET [2025/10/06 18:18:42 ET]
Table 'Sirio' 6-max Seat #1 is the button
Seat 1: Wildag00 (€1.30 in chips) 
Seat 2: mashallahh (€3.32 in chips) 
Seat 3: caduceus369 (€2.11 in chips) 
Seat 4: cap e'bomb95 (€3.37 in chips) 
Seat 5: M@verick781 (€7.39 in chips) 
Seat 6: alekappe (€1.46 in chips) 
mashallahh: posts small blind €0.01
caduceus369: posts big blind €0.02
*** HOLE CARDS ***
Dealt to caduceus369 [Ks 6s]
cap e'bomb95: folds 
M@verick781: raises €0.05 to €0.07
alekappe: folds 
Wildag00: calls €0.07
mashallahh: calls €0.06
caduceus369: folds 
*** FLOP *** [As 3c Kc]
mashallahh: checks 
M@verick781: checks 
Wildag00: bets €0.11
mashallahh: calls €0.11
M@verick781: folds 
*** TURN *** [As 3c Kc] [Jd]
mashallahh: checks 
Wildag00: bets €0.22
mashallahh: folds 
Uncalled bet (€0.22) returned to Wildag00
Wildag00 collected €0.43 from pot
Wildag00: doesn't show hand 
*** SUMMARY ***
Total pot €0.45 | Rake €0.02 
Board [As 3c Kc Jd]
Seat 1: Wildag00 (button) collected (€0.43)
Seat 2: mashallahh (small blind) folded on the Turn
Seat 3: caduceus369 (big blind) folded before Flop
Seat 4: cap e'bomb95 folded before Flop (didn't bet)
Seat 5: M@verick781 folded on the Flop
Seat 6: alekappe folded before Flop (didn't bet)



PokerStars Zoom Hand #258027055404:  Hold'em No Limit (€0.01/€0.02) [ADM ID: M62BD3044A1E13PD] - 2025/10/07 0:19:21 CET [2025/10/06 18:19:21 ET]
Table 'Sirio' 6-max Seat #1 is the button
Seat 1: SebaRapy14 (€3.16 in chips) 
Seat 2: jhonnystecco8 (€1.74 in chips) 
Seat 3: Poetto65 (€1.18 in chips) 
Seat 4: caduceus369 (€2.08 in chips) 
Seat 5: IKARO_3 (€2.17 in chips) 
Seat 6: hedo2008 (€1.62 in chips) 
jhonnystecco8: posts small blind €0.01
Poetto65: posts big blind €0.02
*** HOLE CARDS ***
Dealt to caduceus369 [3s Qc]
caduceus369: folds 
IKARO_3: folds 
hedo2008: folds 
SebaRapy14: folds 
jhonnystecco8: folds 
Uncalled bet (€0.01) returned to Poetto65
Poetto65 collected €0.02 from pot
Poetto65: doesn't show hand 
*** SUMMARY ***
Total pot €0.02 | Rake €0 
Seat 1: SebaRapy14 (button) folded before Flop (didn't bet)
Seat 2: jhonnystecco8 (small blind) folded before Flop
Seat 3: Poetto65 (big blind) collected (€0.02)
Seat 4: caduceus369 folded before Flop (didn't bet)
Seat 5: IKARO_3 folded before Flop (didn't bet)
Seat 6: hedo2008 folded before Flop (didn't bet)



PokerStars Zoom Hand #258027058664:  Hold'em No Limit (€0.01/€0.02) [ADM ID: M62BD3044A1E13PD] - 2025/10/07 0:19:37 CET [2025/10/06 18:19:37 ET]
Table 'Sirio' 6-max Seat #1 is the button
Seat 1: alekappe (€1.55 in chips) 
Seat 2: caduceus369 (€2.08 in chips) 
Seat 3: mashallahh (€3.14 in chips) 
Seat 4: gigysk (€1.54 in chips) 
Seat 5: M@verick781 (€9.28 in chips) 
Seat 6: stfuplzudonk (€1.46 in chips) 
caduceus369: posts small blind €0.01
mashallahh: posts big blind €0.02
*** HOLE CARDS ***
Dealt to caduceus369 [Qd Js]
gigysk: calls €0.02
M@verick781: folds 
stfuplzudonk: folds 
alekappe: folds 
caduceus369: raises €0.12 to €0.14
mashallahh: folds 
gigysk: folds 
Uncalled bet (€0.12) returned to caduceus369
caduceus369 collected €0.06 from pot
caduceus369: doesn't show hand 
*** SUMMARY ***
Total pot €0.06 | Rake €0 
Seat 1: alekappe (button) folded before Flop (didn't bet)
Seat 2: caduceus369 (small blind) collected (€0.06)
Seat 3: mashallahh (big blind) folded before Flop
Seat 4: gigysk folded before Flop
Seat 5: M@verick781 folded before Flop (didn't bet)
Seat 6: stfuplzudonk folded before Flop (didn't bet)



PokerStars Zoom Hand #258027056974:  Hold'em No Limit (€0.01/€0.02) [ADM ID: M62BD3044A1E13PD] - 2025/10/07 0:19:29 CET [2025/10/06 18:19:29 ET]
Table 'Sirio' 6-max Seat #1 is the button
Seat 1: jhonnystecco8 (€1.73 in chips) 
Seat 2: TaranteIIa (€2.04 in chips) 
Seat 3: Ohhhhyeahhh89 (€1.11 in chips) 
Seat 4: M@verick781 (€7.32 in chips) 
Seat 5: caduceus369 (€2.08 in chips) 
Seat 6: Mr_Zlatan84 (€1.04 in chips) 
TaranteIIa: posts small blind €0.01
Ohhhhyeahhh89: posts big blind €0.02
*** HOLE CARDS ***
Dealt to caduceus369 [Qs 5d]
M@verick781: raises €0.04 to €0.06
caduceus369: folds 
Mr_Zlatan84: folds 
jhonnystecco8: folds 
TaranteIIa: folds 
Ohhhhyeahhh89: calls €0.04
*** FLOP *** [Ac Jc 4c]
Ohhhhyeahhh89: checks 
M@verick781: bets €0.04
Ohhhhyeahhh89: calls €0.04
*** TURN *** [Ac Jc 4c] [Td]
Ohhhhyeahhh89: checks 
M@verick781: bets €0.07
Ohhhhyeahhh89: calls €0.07
*** RIVER *** [Ac Jc 4c Td] [2c]
Ohhhhyeahhh89: checks 
M@verick781: bets €0.16
Ohhhhyeahhh89: folds 
Uncalled bet (€0.16) returned to M@verick781
M@verick781 collected €0.34 from pot
M@verick781: doesn't show hand 
*** SUMMARY ***
Total pot €0.35 | Rake €0.01 
Board [Ac Jc 4c Td 2c]
Seat 1: jhonnystecco8 (button) folded before Flop (didn't bet)
Seat 2: TaranteIIa (small blind) folded before Flop
Seat 3: Ohhhhyeahhh89 (big blind) folded on the River
Seat 4: M@verick781 collected (€0.34)
Seat 5: caduceus369 folded before Flop (didn't bet)
Seat 6: Mr_Zlatan84 folded before Flop (didn't bet)



PokerStars Zoom Hand #258027052844:  Hold'em No Limit (€0.01/€0.02) [ADM ID: M62BD3044A1E13PD] - 2025/10/07 0:19:09 CET [2025/10/06 18:19:09 ET]
Table 'Sirio' 6-max Seat #1 is the button
Seat 1: M@verick781 (€9.03 in chips) 
Seat 2: caduceus369 (€2.09 in chips) 
Seat 3: Rorotitti (€3.09 in chips) 
Seat 4: Wildag00 (€2.52 in chips) 
Seat 5: Coffeebreak96 (€3.79 in chips) 
Seat 6: alekappe (€1.45 in chips) 
caduceus369: posts small blind €0.01
Rorotitti: posts big blind €0.02
*** HOLE CARDS ***
Dealt to caduceus369 [9d Js]
Wildag00: raises €0.04 to €0.06
Coffeebreak96: folds 
alekappe: folds 
M@verick781: raises €0.12 to €0.18
caduceus369: folds 
Rorotitti: calls €0.16
Wildag00: raises €0.48 to €0.66
M@verick781: folds 
Rorotitti: raises €2.43 to €3.09 and is all-in
Wildag00: calls €1.86 and is all-in
Uncalled bet (€0.57) returned to Rorotitti
*** FLOP *** [3c Ks 7s]
*** TURN *** [3c Ks 7s] [Ac]
*** RIVER *** [3c Ks 7s Ac] [Jd]
*** SHOW DOWN ***
Rorotitti: shows [Kc Kd] (three of a kind, Kings)
Wildag00: shows [Kh Ad] (two pair, Aces and Kings)
Rorotitti collected €4.95 from pot
*** SUMMARY ***
Total pot €5.23 | Rake €0.28 
Board [3c Ks 7s Ac Jd]
Seat 1: M@verick781 (button) folded before Flop
Seat 2: caduceus369 (small blind) folded before Flop
Seat 3: Rorotitti (big blind) showed [Kc Kd] and won (€4.95) with three of a kind, Kings
Seat 4: Wildag00 showed [Kh Ad] and lost with two pair, Aces and Kings
Seat 5: Coffeebreak96 folded before Flop (didn't bet)
Seat 6: alekappe folded before Flop (didn't bet)



PokerStars Zoom Hand #258027054036:  Hold'em No Limit (€0.01/€0.02) [ADM ID: M62BD3044A1E13PD] - 2025/10/07 0:19:15 CET [2025/10/06 18:19:15 ET]
Table 'Sirio' 6-max Seat #1 is the button
Seat 1: stfuplzudonk (€4.92 in chips) 
Seat 2: cap e'bomb95 (€2.71 in chips) 
Seat 3: jhonnystecco8 (€1.76 in chips) 
Seat 4: mashallahh (€6.68 in chips) 
Seat 5: caduceus369 (€2.08 in chips) 
Seat 6: pistaKKio23 (€8.57 in chips) 
cap e'bomb95: posts small blind €0.01
jhonnystecco8: posts big blind €0.02
*** HOLE CARDS ***
Dealt to caduceus369 [Td 2c]
mashallahh: raises €0.04 to €0.06
caduceus369: folds 
pistaKKio23: folds 
stfuplzudonk: calls €0.06
cap e'bomb95: calls €0.05
jhonnystecco8: folds 
*** FLOP *** [Jh 5h 7c]
cap e'bomb95: checks 
mashallahh: checks 
stfuplzudonk: bets €0.14
cap e'bomb95: folds 
mashallahh: calls €0.14
*** TURN *** [Jh 5h 7c] [7s]
mashallahh: checks 
stfuplzudonk: checks 
*** RIVER *** [Jh 5h 7c 7s] [6d]
mashallahh: checks 
stfuplzudonk: checks 
*** SHOW DOWN ***
mashallahh: shows [8h 8s] (two pair, Eights and Sevens)
stfuplzudonk: shows [Qh Js] (two pair, Jacks and Sevens)
stfuplzudonk collected €0.46 from pot
*** SUMMARY ***
Total pot €0.48 | Rake €0.02 
Board [Jh 5h 7c 7s 6d]
Seat 1: stfuplzudonk (button) showed [Qh Js] and won (€0.46) with two pair, Jacks and Sevens
Seat 2: cap e'bomb95 (small blind) folded on the Flop
Seat 3: jhonnystecco8 (big blind) folded before Flop
Seat 4: mashallahh showed [8h 8s] and lost with two pair, Eights and Sevens
Seat 5: caduceus369 folded before Flop (didn't bet)
Seat 6: pistaKKio23 folded before Flop (didn't bet)



PokerStars Zoom Hand #258027064216:  Hold'em No Limit (€0.01/€0.02) [ADM ID: M62BD3044A1E13PD] - 2025/10/07 0:20:03 CET [2025/10/06 18:20:03 ET]
Table 'Sirio' 6-max Seat #1 is the button
Seat 1: cap e'bomb95 (€3.47 in chips) 
Seat 2: simona13890 (€1.05 in chips) 
Seat 3: caduceus369 (€2.12 in chips) 
Seat 4: Wildag00 (€1.55 in chips) 
Seat 5: mashallahh (€4.72 in chips) 
Seat 6: Ohhhhyeahhh89 (€0.94 in chips) 
simona13890: posts small blind €0.01
caduceus369: posts big blind €0.02
*** HOLE CARDS ***
Dealt to caduceus369 [Ac Ts]
Wildag00: calls €0.02
mashallahh: folds 
Ohhhhyeahhh89: folds 
cap e'bomb95: folds 
simona13890: calls €0.01
caduceus369: raises €0.08 to €0.10
Wildag00: calls €0.08
simona13890: calls €0.08
*** FLOP *** [Qc 9c 6d]
simona13890: checks 
caduceus369: checks 
Wildag00: bets €0.04
simona13890: calls €0.04
caduceus369: calls €0.04
*** TURN *** [Qc 9c 6d] [Js]
simona13890: checks 
caduceus369: checks 
Wildag00: checks 
*** RIVER *** [Qc 9c 6d Js] [Ah]
simona13890: checks 
caduceus369: bets €0.24
Wildag00: folds 
simona13890: calls €0.24
*** SHOW DOWN ***
caduceus369: shows [Ac Ts] (a pair of Aces)
simona13890: mucks hand 
caduceus369 collected €0.86 from pot
*** SUMMARY ***
Total pot €0.90 | Rake €0.04 
Board [Qc 9c 6d Js Ah]
Seat 1: cap e'bomb95 (button) folded before Flop (didn't bet)
Seat 2: simona13890 (small blind) mucked [Jd 8s]
Seat 3: caduceus369 (big blind) showed [Ac Ts] and won (€0.86) with a pair of Aces
Seat 4: Wildag00 folded on the River
Seat 5: mashallahh folded before Flop (didn't bet)
Seat 6: Ohhhhyeahhh89 folded before Flop (didn't bet)



PokerStars Zoom Hand #258027076583:  Hold'em No Limit (€0.01/€0.02) [ADM ID: M62BD3044A1E13PD] - 2025/10/07 0:21:01 CET [2025/10/06 18:21:01 ET]
Table 'Sirio' 6-max Seat #1 is the button
Seat 1: caduceus369 (€2.60 in chips) 
Seat 2: mashallahh (€4.70 in chips) 
Seat 3: IKARO_3 (€2.46 in chips) 
Seat 4: simona13890 (€0.67 in chips) 
Seat 5: M@verick781 (€3.95 in chips) 
Seat 6: cap e'bomb95 (€2.54 in chips) 
mashallahh: posts small blind €0.01
IKARO_3: posts big blind €0.02
*** HOLE CARDS ***
Dealt to caduceus369 [Jd Th]
simona13890: calls €0.02
M@verick781: folds 
cap e'bomb95: folds 
caduceus369: raises €0.04 to €0.06
mashallahh: folds 
IKARO_3: folds 
simona13890: calls €0.04
*** FLOP *** [Tc Ad 7s]
simona13890: checks 
caduceus369: bets €0.05
simona13890: calls €0.05
*** TURN *** [Tc Ad 7s] [7d]
simona13890: checks 
caduceus369: checks 
*** RIVER *** [Tc Ad 7s 7d] [Qs]
simona13890: checks 
caduceus369: checks 
*** SHOW DOWN ***
simona13890: shows [5d Kh] (a pair of Sevens)
caduceus369: shows [Jd Th] (two pair, Tens and Sevens)
caduceus369 collected €0.24 from pot
*** SUMMARY ***
Total pot €0.25 | Rake €0.01 
Board [Tc Ad 7s 7d Qs]
Seat 1: caduceus369 (button) showed [Jd Th] and won (€0.24) with two pair, Tens and Sevens
Seat 2: mashallahh (small blind) folded before Flop
Seat 3: IKARO_3 (big blind) folded before Flop
Seat 4: simona13890 showed [5d Kh] and lost with a pair of Sevens
Seat 5: M@verick781 folded before Flop (didn't bet)
Seat 6: cap e'bomb95 folded before Flop (didn't bet)



PokerStars Zoom Hand #258027086557:  Hold'em No Limit (€0.01/€0.02) [ADM ID: M62BD3044A1E13PD] - 2025/10/07 0:21:48 CET [2025/10/06 18:21:48 ET]
Table 'Sirio' 6-max Seat #1 is the button
Seat 1: 19kappa88 (€1.89 in chips) 
Seat 2: J0HN-BR0WN (€5.75 in chips) 
Seat 3: M@verick781 (€7.76 in chips) 
Seat 4: barmiencas (€1.33 in chips) 
Seat 5: pistaKKio23 (€3.37 in chips) 
Seat 6: caduceus369 (€2.73 in chips) 
J0HN-BR0WN: posts small blind €0.01
M@verick781: posts big blind €0.02
*** HOLE CARDS ***
Dealt to caduceus369 [Jh Ts]
barmiencas: folds 
pistaKKio23: folds 
caduceus369: folds 
19kappa88: folds 
J0HN-BR0WN: raises €0.02 to €0.04
M@verick781: raises €0.14 to €0.18
J0HN-BR0WN: calls €0.14
*** FLOP *** [5d 4c 6c]
J0HN-BR0WN: bets €0.35
M@verick781: raises €0.53 to €0.88
J0HN-BR0WN: folds 
Uncalled bet (€0.53) returned to M@verick781
M@verick781 collected €1.01 from pot
M@verick781: doesn't show hand 
*** SUMMARY ***
Total pot €1.06 | Rake €0.05 
Board [5d 4c 6c]
Seat 1: 19kappa88 (button) folded before Flop (didn't bet)
Seat 2: J0HN-BR0WN (small blind) folded on the Flop
Seat 3: M@verick781 (big blind) collected (€1.01)
Seat 4: barmiencas folded before Flop (didn't bet)
Seat 5: pistaKKio23 folded before Flop (didn't bet)
Seat 6: caduceus369 folded before Flop (didn't bet)



PokerStars Zoom Hand #258027090689:  Hold'em No Limit (€0.01/€0.02) [ADM ID: M62BD3044A1E13PD] - 2025/10/07 0:22:08 CET [2025/10/06 18:22:08 ET]
Table 'Sirio' 6-max Seat #1 is the button
Seat 1: caduceus369 (€2.73 in chips) 
Seat 2: alekappe (€0.92 in chips) 
Seat 3: IKARO_3 (€8.35 in chips) 
Seat 4: 19kappa88 (€1.87 in chips) 
Seat 5: hedo2008 (€0.86 in chips) 
Seat 6: pistaKKio23 (€3.37 in chips) 
alekappe: posts small blind €0.01
IKARO_3: posts big blind €0.02
*** HOLE CARDS ***
Dealt to caduceus369 [Qc Jd]
19kappa88: folds 
hedo2008: folds 
pistaKKio23: folds 
caduceus369: raises €0.04 to €0.06
alekappe: raises €0.86 to €0.92 and is all-in
IKARO_3: raises €7.43 to €8.35 and is all-in
caduceus369: folds 
Uncalled bet (€7.43) returned to IKARO_3
*** FLOP *** [6c 3c 6s]
*** TURN *** [6c 3c 6s] [2s]
*** RIVER *** [6c 3c 6s 2s] [Qs]
*** SHOW DOWN ***
alekappe: shows [4d 3d] (two pair, Sixes and Threes)
IKARO_3: shows [Kd Kh] (two pair, Kings and Sixes)
IKARO_3 collected €1.80 from pot
*** SUMMARY ***
Total pot €1.90 | Rake €0.10 
Board [6c 3c 6s 2s Qs]
Seat 1: caduceus369 (button) folded before Flop
Seat 2: alekappe (small blind) showed [4d 3d] and lost with two pair, Sixes and Threes
Seat 3: IKARO_3 (big blind) showed [Kd Kh] and won (€1.80) with two pair, Kings and Sixes
Seat 4: 19kappa88 folded before Flop (didn't bet)
Seat 5: hedo2008 folded before Flop (didn't bet)
Seat 6: pistaKKio23 folded before Flop (didn't bet)



PokerStars Zoom Hand #258027088415:  Hold'em No Limit (€0.01/€0.02) [ADM ID: M62BD3044A1E13PD] - 2025/10/07 0:21:57 CET [2025/10/06 18:21:57 ET]
Table 'Sirio' 6-max Seat #1 is the button
Seat 1: 7chris5 (€3.18 in chips) 
Seat 2: stfuplzudonk (€2.27 in chips) 
Seat 3: 19kappa88 (€1.89 in chips) 
Seat 4: Wildag00 (€4.39 in chips) 
Seat 5: caduceus369 (€2.73 in chips) 
Seat 6: pistaKKio23 (€1.91 in chips) 
stfuplzudonk: posts small blind €0.01
19kappa88: posts big blind €0.02
*** HOLE CARDS ***
Dealt to caduceus369 [4c 2h]
Wildag00: raises €0.04 to €0.06
caduceus369: folds 
pistaKKio23: folds 
7chris5 has timed out
7chris5: folds 
stfuplzudonk: calls €0.05
19kappa88: folds 
*** FLOP *** [4d Js Td]
stfuplzudonk: checks 
Wildag00: bets €0.07
stfuplzudonk: calls €0.07
*** TURN *** [4d Js Td] [3c]
stfuplzudonk: checks 
Wildag00: bets €0.20
stfuplzudonk: folds 
Uncalled bet (€0.20) returned to Wildag00
Wildag00 collected €0.27 from pot
Wildag00: doesn't show hand 
*** SUMMARY ***
Total pot €0.28 | Rake €0.01 
Board [4d Js Td 3c]
Seat 1: 7chris5 (button) folded before Flop (didn't bet)
Seat 2: stfuplzudonk (small blind) folded on the Turn
Seat 3: 19kappa88 (big blind) folded before Flop
Seat 4: Wildag00 collected (€0.27)
Seat 5: caduceus369 folded before Flop (didn't bet)
Seat 6: pistaKKio23 folded before Flop (didn't bet)



PokerStars Zoom Hand #258027095688:  Hold'em No Limit (€0.01/€0.02) [ADM ID: M62BD3044A1E13PD] - 2025/10/07 0:22:31 CET [2025/10/06 18:22:31 ET]
Table 'Sirio' 6-max Seat #1 is the button
Seat 1: Coffeebreak96 (€3.76 in chips) 
Seat 2: cap e'bomb95 (€3.29 in chips) 
Seat 3: caduceus369 (€2.67 in chips) 
Seat 4: J0HN-BR0WN (€5.22 in chips) 
Seat 5: stfuplzudonk (€2.05 in chips) 
Seat 6: pistaKKio23 (€8.22 in chips) 
cap e'bomb95: posts small blind €0.01
caduceus369: posts big blind €0.02
*** HOLE CARDS ***
Dealt to caduceus369 [3h 3d]
J0HN-BR0WN: calls €0.02
stfuplzudonk: folds 
pistaKKio23: folds 
Coffeebreak96: folds 
cap e'bomb95: folds 
caduceus369: checks 
*** FLOP *** [Kc 7h 4c]
caduceus369: checks 
J0HN-BR0WN: checks 
*** TURN *** [Kc 7h 4c] [9d]
caduceus369: checks 
J0HN-BR0WN: checks 
*** RIVER *** [Kc 7h 4c 9d] [2d]
caduceus369: checks 
J0HN-BR0WN: checks 
*** SHOW DOWN ***
caduceus369: shows [3h 3d] (a pair of Threes)
J0HN-BR0WN: mucks hand 
caduceus369 collected €0.05 from pot
*** SUMMARY ***
Total pot €0.05 | Rake €0 
Board [Kc 7h 4c 9d 2d]
Seat 1: Coffeebreak96 (button) folded before Flop (didn't bet)
Seat 2: cap e'bomb95 (small blind) folded before Flop
Seat 3: caduceus369 (big blind) showed [3h 3d] and won (€0.05) with a pair of Threes
Seat 4: J0HN-BR0WN mucked [Qd Tc]
Seat 5: stfuplzudonk folded before Flop (didn't bet)
Seat 6: pistaKKio23 folded before Flop (didn't bet)



PokerStars Zoom Hand #258027105204:  Hold'em No Limit (€0.01/€0.02) [ADM ID: M62BD3044A1E13PD] - 2025/10/07 0:23:17 CET [2025/10/06 18:23:17 ET]
Table 'Sirio' 6-max Seat #1 is the button
Seat 1: hedo2008 (€1.05 in chips) 
Seat 2: M@verick781 (€8.24 in chips) 
Seat 3: pistaKKio23 (€3.36 in chips) 
Seat 4: caduceus369 (€2.69 in chips) 
Seat 5: Curanto17 (€1.08 in chips) 
Seat 6: jackkk03 (€3.20 in chips) 
M@verick781: posts small blind €0.01
pistaKKio23: posts big blind €0.02
*** HOLE CARDS ***
Dealt to caduceus369 [Ts 6h]
caduceus369: folds 
Curanto17: folds 
jackkk03: folds 
hedo2008: folds 
M@verick781: raises €0.04 to €0.06
pistaKKio23: folds 
Uncalled bet (€0.04) returned to M@verick781
M@verick781 collected €0.04 from pot
M@verick781: doesn't show hand 
*** SUMMARY ***
Total pot €0.04 | Rake €0 
Seat 1: hedo2008 (button) folded before Flop (didn't bet)
Seat 2: M@verick781 (small blind) collected (€0.04)
Seat 3: pistaKKio23 (big blind) folded before Flop
Seat 4: caduceus369 folded before Flop (didn't bet)
Seat 5: Curanto17 folded before Flop (didn't bet)
Seat 6: jackkk03 folded before Flop (didn't bet)



PokerStars Zoom Hand #258027102812:  Hold'em No Limit (€0.01/€0.02) [ADM ID: M62BD3044A1E13PD] - 2025/10/07 0:23:05 CET [2025/10/06 18:23:05 ET]
Table 'Sirio' 6-max Seat #1 is the button
Seat 1: J0HN-BR0WN (€5.20 in chips) 
Seat 2: caduceus369 (€2.70 in chips) 
Seat 3: hedo2008 (€1.07 in chips) 
Seat 4: IKARO_3 (€4.67 in chips) 
Seat 5: 7chris5 (€3.17 in chips) 
Seat 6: mashallahh (€2.98 in chips) 
caduceus369: posts small blind €0.01
hedo2008: posts big blind €0.02
*** HOLE CARDS ***
Dealt to caduceus369 [Kh 6d]
IKARO_3: folds 
7chris5: calls €0.02
mashallahh: folds 
J0HN-BR0WN: raises €0.07 to €0.09
caduceus369: folds 
hedo2008: folds 
7chris5: calls €0.07
*** FLOP *** [5h 6c 4c]
7chris5: checks 
J0HN-BR0WN: bets €0.02
7chris5: calls €0.02
*** TURN *** [5h 6c 4c] [Ts]
7chris5: checks 
J0HN-BR0WN: bets €0.24
7chris5: calls €0.24
*** RIVER *** [5h 6c 4c Ts] [7c]
7chris5: checks 
J0HN-BR0WN: bets €0.69
7chris5: calls €0.69
*** SHOW DOWN ***
J0HN-BR0WN: shows [Js Tc] (a pair of Tens)
7chris5: shows [5c 5d] (three of a kind, Fives)
7chris5 collected €2 from pot
*** SUMMARY ***
Total pot €2.11 | Rake €0.11 
Board [5h 6c 4c Ts 7c]
Seat 1: J0HN-BR0WN (button) showed [Js Tc] and lost with a pair of Tens
Seat 2: caduceus369 (small blind) folded before Flop
Seat 3: hedo2008 (big blind) folded before Flop
Seat 4: IKARO_3 folded before Flop (didn't bet)
Seat 5: 7chris5 showed [5c 5d] and won (€2) with three of a kind, Fives
Seat 6: mashallahh folded before Flop (didn't bet)



PokerStars Zoom Hand #258027106545:  Hold'em No Limit (€0.01/€0.02) [ADM ID: M62BD3044A1E13PD] - 2025/10/07 0:23:23 CET [2025/10/06 18:23:23 ET]
Table 'Sirio' 6-max Seat #1 is the button
Seat 1: Wildag00 (€4.53 in chips) 
Seat 2: heitel (€3.33 in chips) 
Seat 3: MammAnnAILovey (€1.03 in chips) 
Seat 4: Curanto17 (€1.08 in chips) 
Seat 5: caduceus369 (€2.69 in chips) 
Seat 6: hedo2008 (€1.05 in chips) 
heitel: posts small blind €0.01
MammAnnAILovey: posts big blind €0.02
*** HOLE CARDS ***
Dealt to caduceus369 [6d 2s]
Curanto17: folds 
caduceus369: folds 
hedo2008: folds 
Wildag00: raises €0.02 to €0.04
heitel: folds 
MammAnnAILovey: calls €0.02
*** FLOP *** [Qc As 3s]
MammAnnAILovey: checks 
Wildag00: bets €0.05
MammAnnAILovey: folds 
Uncalled bet (€0.05) returned to Wildag00
Wildag00 collected €0.09 from pot
Wildag00: doesn't show hand 
*** SUMMARY ***
Total pot €0.09 | Rake €0 
Board [Qc As 3s]
Seat 1: Wildag00 (button) collected (€0.09)
Seat 2: heitel (small blind) folded before Flop
Seat 3: MammAnnAILovey (big blind) folded on the Flop
Seat 4: Curanto17 folded before Flop (didn't bet)
Seat 5: caduceus369 folded before Flop (didn't bet)
Seat 6: hedo2008 folded before Flop (didn't bet)



PokerStars Zoom Hand #258027104372:  Hold'em No Limit (€0.01/€0.02) [ADM ID: M62BD3044A1E13PD] - 2025/10/07 0:23:13 CET [2025/10/06 18:23:13 ET]
Table 'Sirio' 6-max Seat #1 is the button
Seat 1: IKARO_3 (€9.22 in chips) 
Seat 2: jackkk03 (€3.21 in chips) 
Seat 3: stfuplzudonk (€2.14 in chips) 
Seat 4: mashallahh (€2.98 in chips) 
Seat 5: cap e'bomb95 (€2.74 in chips) 
Seat 6: caduceus369 (€2.69 in chips) 
jackkk03: posts small blind €0.01
stfuplzudonk: posts big blind €0.02
*** HOLE CARDS ***
Dealt to caduceus369 [2c 7d]
mashallahh: folds 
cap e'bomb95: raises €0.03 to €0.05
caduceus369: folds 
IKARO_3: folds 
jackkk03: folds 
stfuplzudonk: calls €0.03
*** FLOP *** [5c Jh 6d]
stfuplzudonk: checks 
cap e'bomb95: checks 
*** TURN *** [5c Jh 6d] [Tc]
stfuplzudonk: checks 
cap e'bomb95: checks 
*** RIVER *** [5c Jh 6d Tc] [Ks]
stfuplzudonk: checks 
cap e'bomb95: bets €0.07
stfuplzudonk: folds 
Uncalled bet (€0.07) returned to cap e'bomb95
cap e'bomb95 collected €0.11 from pot
cap e'bomb95: doesn't show hand 
*** SUMMARY ***
Total pot €0.11 | Rake €0 
Board [5c Jh 6d Tc Ks]
Seat 1: IKARO_3 (button) folded before Flop (didn't bet)
Seat 2: jackkk03 (small blind) folded before Flop
Seat 3: stfuplzudonk (big blind) folded on the River
Seat 4: mashallahh folded before Flop (didn't bet)
Seat 5: cap e'bomb95 collected (€0.11)
Seat 6: caduceus369 folded before Flop (didn't bet)



PokerStars Zoom Hand #258027107988:  Hold'em No Limit (€0.01/€0.02) [ADM ID: M62BD3044A1E13PD] - 2025/10/07 0:23:30 CET [2025/10/06 18:23:30 ET]
Table 'Sirio' 6-max Seat #1 is the button
Seat 1: mashallahh (€2.98 in chips) 
Seat 2: barmiencas (€1.15 in chips) 
Seat 3: jackkk03 (€3.20 in chips) 
Seat 4: caduceus369 (€2.69 in chips) 
Seat 5: Agata1971 (€0.80 in chips) 
Seat 6: montemeru (€2.02 in chips) 
barmiencas: posts small blind €0.01
jackkk03: posts big blind €0.02
*** HOLE CARDS ***
Dealt to caduceus369 [Qs Qc]
caduceus369: raises €0.04 to €0.06
Agata1971: folds 
montemeru: folds 
mashallahh: folds 
barmiencas: folds 
jackkk03: calls €0.04
*** FLOP *** [7c Ks Tc]
jackkk03: checks 
caduceus369: bets €0.05
jackkk03: calls €0.05
*** TURN *** [7c Ks Tc] [7s]
jackkk03: checks 
caduceus369: checks 
*** RIVER *** [7c Ks Tc 7s] [2c]
jackkk03: bets €0.22
caduceus369: folds 
Uncalled bet (€0.22) returned to jackkk03
jackkk03 collected €0.22 from pot
jackkk03: doesn't show hand 
*** SUMMARY ***
Total pot €0.23 | Rake €0.01 
Board [7c Ks Tc 7s 2c]
Seat 1: mashallahh (button) folded before Flop (didn't bet)
Seat 2: barmiencas (small blind) folded before Flop
Seat 3: jackkk03 (big blind) collected (€0.22)
Seat 4: caduceus369 folded on the River
Seat 5: Agata1971 folded before Flop (didn't bet)
Seat 6: montemeru folded before Flop (didn't bet)



PokerStars Zoom Hand #258027115001:  Hold'em No Limit (€0.01/€0.02) [ADM ID: M62BD3044A1E13PD] - 2025/10/07 0:24:03 CET [2025/10/06 18:24:03 ET]
Table 'Sirio' 6-max Seat #1 is the button
Seat 1: Andre2697 (€2.29 in chips) 
Seat 2: ArtikWarrior (€0.99 in chips) 
Seat 3: caduceus369 (€2.58 in chips) 
Seat 4: IKARO_3 (€2.22 in chips) 
Seat 5: Paky6688988 (€2.13 in chips) 
Seat 6: pistaKKio23 (€8.69 in chips) 
ArtikWarrior: posts small blind €0.01
caduceus369: posts big blind €0.02
*** HOLE CARDS ***
Dealt to caduceus369 [5s Ah]
IKARO_3 has timed out
IKARO_3: folds 
Paky6688988: calls €0.02
pistaKKio23: folds 
Andre2697: folds 
ArtikWarrior: calls €0.01
caduceus369: checks 
*** FLOP *** [5d Ks 2s]
ArtikWarrior: checks 
caduceus369: checks 
Paky6688988: checks 
*** TURN *** [5d Ks 2s] [Js]
ArtikWarrior: checks 
caduceus369: bets €0.02
Paky6688988: calls €0.02
ArtikWarrior: calls €0.02
*** RIVER *** [5d Ks 2s Js] [2c]
ArtikWarrior: checks 
caduceus369: bets €0.02
Paky6688988: raises €0.18 to €0.20
ArtikWarrior: folds 
caduceus369: folds 
Uncalled bet (€0.18) returned to Paky6688988
Paky6688988 collected €0.16 from pot
Paky6688988: doesn't show hand 
*** SUMMARY ***
Total pot €0.16 | Rake €0 
Board [5d Ks 2s Js 2c]
Seat 1: Andre2697 (button) folded before Flop (didn't bet)
Seat 2: ArtikWarrior (small blind) folded on the River
Seat 3: caduceus369 (big blind) folded on the River
Seat 4: IKARO_3 folded before Flop (didn't bet)
Seat 5: Paky6688988 collected (€0.16)
Seat 6: pistaKKio23 folded before Flop (didn't bet)



PokerStars Zoom Hand #258027128645:  Hold'em No Limit (€0.01/€0.02) [ADM ID: M62BD3044A1E13PD] - 2025/10/07 0:25:08 CET [2025/10/06 18:25:08 ET]
Table 'Sirio' 6-max Seat #1 is the button
Seat 1: barmiencas (€1.12 in chips) 
Seat 2: pistaKKio23 (€8.35 in chips) 
Seat 3: M@verick781 (€8.54 in chips) 
Seat 4: caduceus369 (€2.52 in chips) 
Seat 5: cap e'bomb95 (€3.53 in chips) 
Seat 6: AlwaisToRun (€0.69 in chips) 
pistaKKio23: posts small blind €0.01
M@verick781: posts big blind €0.02
*** HOLE CARDS ***
Dealt to caduceus369 [Ac Ad]
caduceus369: raises €0.04 to €0.06
cap e'bomb95: folds 
AlwaisToRun: folds 
barmiencas: folds 
pistaKKio23: folds 
M@verick781: calls €0.04
*** FLOP *** [3s 4c 2d]
M@verick781: checks 
caduceus369: bets €0.05
M@verick781: calls €0.05
*** TURN *** [3s 4c 2d] [9c]
M@verick781: checks 
caduceus369: bets €0.02
M@verick781: calls €0.02
*** RIVER *** [3s 4c 2d 9c] [6c]
M@verick781: checks 
caduceus369: bets €0.15
M@verick781: calls €0.15
*** SHOW DOWN ***
caduceus369: shows [Ac Ad] (a pair of Aces)
M@verick781: mucks hand 
caduceus369 collected €0.54 from pot
*** SUMMARY ***
Total pot €0.57 | Rake €0.03 
Board [3s 4c 2d 9c 6c]
Seat 1: barmiencas (button) folded before Flop (didn't bet)
Seat 2: pistaKKio23 (small blind) folded before Flop
Seat 3: M@verick781 (big blind) mucked [8c 8h]
Seat 4: caduceus369 showed [Ac Ad] and won (€0.54) with a pair of Aces
Seat 5: cap e'bomb95 folded before Flop (didn't bet)
Seat 6: AlwaisToRun folded before Flop (didn't bet)



PokerStars Zoom Hand #258027141225:  Hold'em No Limit (€0.01/€0.02) [ADM ID: M62BD3044A1E13PD] - 2025/10/07 0:26:09 CET [2025/10/06 18:26:09 ET]
Table 'Sirio' 6-max Seat #1 is the button
Seat 1: cap e'bomb95 (€3.19 in chips) 
Seat 2: caduceus369 (€2.78 in chips) 
Seat 3: barmiencas (€1.03 in chips) 
Seat 4: stfuplzudonk (€1.93 in chips) 
Seat 5: pistaKKio23 (€8.66 in chips) 
Seat 6: IKARO_3 (€3.81 in chips) 
caduceus369: posts small blind €0.01
barmiencas: posts big blind €0.02
*** HOLE CARDS ***
Dealt to caduceus369 [8c Kd]
stfuplzudonk: folds 
pistaKKio23 has timed out
pistaKKio23: folds 
IKARO_3: folds 
cap e'bomb95: folds 
caduceus369: folds 
Uncalled bet (€0.01) returned to barmiencas
barmiencas collected €0.02 from pot
barmiencas: doesn't show hand 
*** SUMMARY ***
Total pot €0.02 | Rake €0 
Seat 1: cap e'bomb95 (button) folded before Flop (didn't bet)
Seat 2: caduceus369 (small blind) folded before Flop
Seat 3: barmiencas (big blind) collected (€0.02)
Seat 4: stfuplzudonk folded before Flop (didn't bet)
Seat 5: pistaKKio23 folded before Flop (didn't bet)
Seat 6: IKARO_3 folded before Flop (didn't bet)



PokerStars Zoom Hand #258027144208:  Hold'em No Limit (€0.01/€0.02) [ADM ID: M62BD3044A1E13PD] - 2025/10/07 0:26:23 CET [2025/10/06 18:26:23 ET]
Table 'Sirio' 6-max Seat #1 is the button
Seat 1: caduceus369 (€2.77 in chips) 
Seat 2: Poetto65 (€0.84 in chips) 
Seat 3: stfuplzudonk (€1.93 in chips) 
Seat 4: ArtikWarrior (€0.97 in chips) 
Seat 5: Curanto17 (€1.04 in chips) 
Seat 6: J0HN-BR0WN (€4.41 in chips) 
Poetto65: posts small blind €0.01
stfuplzudonk: posts big blind €0.02
*** HOLE CARDS ***
Dealt to caduceus369 [2h 4d]
ArtikWarrior: raises €0.02 to €0.04
Curanto17: calls €0.04
J0HN-BR0WN: folds 
caduceus369: folds 
Poetto65: folds 
stfuplzudonk: calls €0.02
*** FLOP *** [5c 9c 4c]
stfuplzudonk: checks 
ArtikWarrior: checks 
Curanto17: checks 
*** TURN *** [5c 9c 4c] [7h]
stfuplzudonk: checks 
ArtikWarrior: checks 
Curanto17: checks 
*** RIVER *** [5c 9c 4c 7h] [7s]
stfuplzudonk: bets €0.07
ArtikWarrior: folds 
Curanto17: folds 
Uncalled bet (€0.07) returned to stfuplzudonk
stfuplzudonk collected €0.13 from pot
stfuplzudonk: doesn't show hand 
*** SUMMARY ***
Total pot €0.13 | Rake €0 
Board [5c 9c 4c 7h 7s]
Seat 1: caduceus369 (button) folded before Flop (didn't bet)
Seat 2: Poetto65 (small blind) folded before Flop
Seat 3: stfuplzudonk (big blind) collected (€0.13)
Seat 4: ArtikWarrior folded on the River
Seat 5: Curanto17 folded on the River
Seat 6: J0HN-BR0WN folded before Flop (didn't bet)



PokerStars Zoom Hand #258027144980:  Hold'em No Limit (€0.01/€0.02) [ADM ID: M62BD3044A1E13PD] - 2025/10/07 0:26:27 CET [2025/10/06 18:26:27 ET]
Table 'Sirio' 6-max Seat #1 is the button
Seat 1: montemeru (€1.88 in chips) 
Seat 2: IKARO_3 (€7.94 in chips) 
Seat 3: cap e'bomb95 (€3.19 in chips) 
Seat 4: M@verick781 (€8.25 in chips) 
Seat 5: mashallahh (€3.36 in chips) 
Seat 6: caduceus369 (€2.77 in chips) 
IKARO_3: posts small blind €0.01
cap e'bomb95: posts big blind €0.02
*** HOLE CARDS ***
Dealt to caduceus369 [Ad 4d]
M@verick781: folds 
mashallahh: folds 
caduceus369: raises €0.04 to €0.06
montemeru: calls €0.06
IKARO_3: folds 
cap e'bomb95: folds 
*** FLOP *** [Jd 5h Qd]
caduceus369: checks 
montemeru: bets €0.08
caduceus369: calls €0.08
*** TURN *** [Jd 5h Qd] [5s]
caduceus369: checks 
montemeru: bets €0.15
caduceus369: calls €0.15
*** RIVER *** [Jd 5h Qd 5s] [Ac]
caduceus369: checks 
montemeru: checks 
*** SHOW DOWN ***
caduceus369: shows [Ad 4d] (two pair, Aces and Fives)
montemeru: mucks hand 
caduceus369 collected €0.58 from pot
*** SUMMARY ***
Total pot €0.61 | Rake €0.03 
Board [Jd 5h Qd 5s Ac]
Seat 1: montemeru (button) mucked [7h Qc]
Seat 2: IKARO_3 (small blind) folded before Flop
Seat 3: cap e'bomb95 (big blind) folded before Flop
Seat 4: M@verick781 folded before Flop (didn't bet)
Seat 5: mashallahh folded before Flop (didn't bet)
Seat 6: caduceus369 showed [Ad 4d] and won (€0.58) with two pair, Aces and Fives



PokerStars Zoom Hand #258027157680:  Hold'em No Limit (€0.01/€0.02) [ADM ID: M62BD3044A1E13PD] - 2025/10/07 0:27:28 CET [2025/10/06 18:27:28 ET]
Table 'Sirio' 6-max Seat #1 is the button
Seat 1: Poetto65 (€0.81 in chips) 
Seat 2: caduceus369 (€3.06 in chips) 
Seat 3: jackkk03 (€3.54 in chips) 
Seat 4: Wildag00 (€4.68 in chips) 
Seat 5: montemeru (€1.59 in chips) 
Seat 6: IKARO_3 (€7.91 in chips) 
caduceus369: posts small blind €0.01
jackkk03: posts big blind €0.02
*** HOLE CARDS ***
Dealt to caduceus369 [Ah 5s]
Wildag00: raises €0.04 to €0.06
montemeru: folds 
IKARO_3: raises €0.16 to €0.22
Poetto65: folds 
caduceus369: folds 
jackkk03: folds 
Wildag00: raises €4.46 to €4.68 and is all-in
IKARO_3: folds 
Uncalled bet (€4.46) returned to Wildag00
Wildag00 collected €0.47 from pot
Wildag00: doesn't show hand 
*** SUMMARY ***
Total pot €0.47 | Rake €0 
Seat 1: Poetto65 (button) folded before Flop (didn't bet)
Seat 2: caduceus369 (small blind) folded before Flop
Seat 3: jackkk03 (big blind) folded before Flop
Seat 4: Wildag00 collected (€0.47)
Seat 5: montemeru folded before Flop (didn't bet)
Seat 6: IKARO_3 folded before Flop



PokerStars Zoom Hand #258027159195:  Hold'em No Limit (€0.01/€0.02) [ADM ID: M62BD3044A1E13PD] - 2025/10/07 0:27:35 CET [2025/10/06 18:27:35 ET]
Table 'Sirio' 6-max Seat #1 is the button
Seat 1: DiaboliKuSSS85 (€2 in chips) 
Seat 2: jackkk03 (€3.52 in chips) 
Seat 3: caduceus369 (€3.05 in chips) 
Seat 4: mashallahh (€3.70 in chips) 
Seat 5: M@verick781 (€8.23 in chips) 
Seat 6: Poetto65 (€0.81 in chips) 
jackkk03: posts small blind €0.01
caduceus369: posts big blind €0.02
*** HOLE CARDS ***
Dealt to caduceus369 [4h 6s]
mashallahh: folds 
M@verick781: folds 
Poetto65: calls €0.02
DiaboliKuSSS85: folds 
jackkk03: calls €0.01
caduceus369: checks 
*** FLOP *** [Ks 4d Th]
jackkk03: checks 
caduceus369: checks 
Poetto65: bets €0.06
jackkk03: calls €0.06
caduceus369: folds 
*** TURN *** [Ks 4d Th] [5h]
jackkk03: checks 
Poetto65: bets €0.06
jackkk03: calls €0.06
*** RIVER *** [Ks 4d Th 5h] [3c]
jackkk03: checks 
Poetto65: bets €0.29
jackkk03: folds 
Uncalled bet (€0.29) returned to Poetto65
Poetto65 collected €0.29 from pot
Poetto65: doesn't show hand 
*** SUMMARY ***
Total pot €0.30 | Rake €0.01 
Board [Ks 4d Th 5h 3c]
Seat 1: DiaboliKuSSS85 (button) folded before Flop (didn't bet)
Seat 2: jackkk03 (small blind) folded on the River
Seat 3: caduceus369 (big blind) folded on the Flop
Seat 4: mashallahh folded before Flop (didn't bet)
Seat 5: M@verick781 folded before Flop (didn't bet)
Seat 6: Poetto65 collected (€0.29)



PokerStars Zoom Hand #258027167886:  Hold'em No Limit (€0.01/€0.02) [ADM ID: M62BD3044A1E13PD] - 2025/10/07 0:28:18 CET [2025/10/06 18:28:18 ET]
Table 'Sirio' 6-max Seat #1 is the button
Seat 1: cap e'bomb95 (€4.04 in chips) 
Seat 2: Paky6688988 (€1.97 in chips) 
Seat 3: gigysk (€1.51 in chips) 
Seat 4: mashallahh (€3.72 in chips) 
Seat 5: caduceus369 (€3.03 in chips) 
Paky6688988: posts small blind €0.01
gigysk: posts big blind €0.02
*** HOLE CARDS ***
Dealt to caduceus369 [Js 2d]
mashallahh: calls €0.02
caduceus369: folds 
cap e'bomb95: folds 
Paky6688988: folds 
gigysk: checks 
*** FLOP *** [Th 5d 2c]
gigysk: checks 
mashallahh: bets €0.05
gigysk: calls €0.05
*** TURN *** [Th 5d 2c] [Qh]
gigysk: checks 
mashallahh: checks 
*** RIVER *** [Th 5d 2c Qh] [5s]
gigysk: checks 
mashallahh: checks 
*** SHOW DOWN ***
gigysk: shows [Ac 3c] (a pair of Fives)
mashallahh: shows [4c 4h] (two pair, Fives and Fours)
mashallahh collected €0.15 from pot
*** SUMMARY ***
Total pot €0.15 | Rake €0 
Board [Th 5d 2c Qh 5s]
Seat 1: cap e'bomb95 (button) folded before Flop (didn't bet)
Seat 2: Paky6688988 (small blind) folded before Flop
Seat 3: gigysk (big blind) showed [Ac 3c] and lost with a pair of Fives
Seat 4: mashallahh showed [4c 4h] and won (€0.15) with two pair, Fives and Fours
Seat 5: caduceus369 folded before Flop (didn't bet)



PokerStars Zoom Hand #258027166419:  Hold'em No Limit (€0.01/€0.02) [ADM ID: M62BD3044A1E13PD] - 2025/10/07 0:28:11 CET [2025/10/06 18:28:11 ET]
Table 'Sirio' 6-max Seat #1 is the button
Seat 1: caduceus369 (€3.03 in chips) 
Seat 2: J0HN-BR0WN (€4.73 in chips) 
Seat 3: M@verick781 (€3.29 in chips) 
Seat 4: IKARO_3 (€7.69 in chips) 
Seat 5: Wildag00 (€4.93 in chips) 
Seat 6: pistaKKio23 (€3.67 in chips) 
J0HN-BR0WN: posts small blind €0.01
M@verick781: posts big blind €0.02
*** HOLE CARDS ***
Dealt to caduceus369 [4d 9h]
IKARO_3: folds 
Wildag00: raises €0.04 to €0.06
pistaKKio23: folds 
caduceus369: folds 
J0HN-BR0WN: calls €0.05
M@verick781: calls €0.04
*** FLOP *** [Js 5h 4s]
J0HN-BR0WN: bets €0.02
M@verick781: raises €0.08 to €0.10
Wildag00: calls €0.10
J0HN-BR0WN: calls €0.08
*** TURN *** [Js 5h 4s] [4c]
J0HN-BR0WN: bets €0.46
M@verick781: calls €0.46
Wildag00: folds 
*** RIVER *** [Js 5h 4s 4c] [Kh]
J0HN-BR0WN: bets €1.33
M@verick781: folds 
Uncalled bet (€1.33) returned to J0HN-BR0WN
J0HN-BR0WN collected €1.33 from pot
J0HN-BR0WN: doesn't show hand 
*** SUMMARY ***
Total pot €1.40 | Rake €0.07 
Board [Js 5h 4s 4c Kh]
Seat 1: caduceus369 (button) folded before Flop (didn't bet)
Seat 2: J0HN-BR0WN (small blind) collected (€1.33)
Seat 3: M@verick781 (big blind) folded on the River
Seat 4: IKARO_3 folded before Flop (didn't bet)
Seat 5: Wildag00 folded on the Turn
Seat 6: pistaKKio23 folded before Flop (didn't bet)



PokerStars Zoom Hand #258027172368:  Hold'em No Limit (€0.01/€0.02) [ADM ID: M62BD3044A1E13PD] - 2025/10/07 0:28:40 CET [2025/10/06 18:28:40 ET]
Table 'Sirio' 6-max Seat #1 is the button
Seat 1: jackkk03 (€3.38 in chips) 
Seat 2: Poetto65 (€0.96 in chips) 
Seat 3: caduceus369 (€3.03 in chips) 
Seat 4: cap e'bomb95 (€0.98 in chips) 
Seat 5: mashallahh (€3.75 in chips) 
Seat 6: stfuplzudonk (€3.26 in chips) 
Poetto65: posts small blind €0.01
caduceus369: posts big blind €0.02
*** HOLE CARDS ***
Dealt to caduceus369 [Kc Ad]
cap e'bomb95: folds 
mashallahh: folds 
stfuplzudonk: folds 
jackkk03: raises €0.04 to €0.06
Poetto65: folds 
caduceus369: raises €0.12 to €0.18
jackkk03: calls €0.12
*** FLOP *** [3c As 6d]
caduceus369: checks 
jackkk03: checks 
*** TURN *** [3c As 6d] [2c]
caduceus369: bets €0.16
jackkk03: calls €0.16
*** RIVER *** [3c As 6d 2c] [3d]
caduceus369: bets €0.70
jackkk03: folds 
Uncalled bet (€0.70) returned to caduceus369
caduceus369 collected €0.66 from pot
caduceus369: doesn't show hand 
*** SUMMARY ***
Total pot €0.69 | Rake €0.03 
Board [3c As 6d 2c 3d]
Seat 1: jackkk03 (button) folded on the River
Seat 2: Poetto65 (small blind) folded before Flop
Seat 3: caduceus369 (big blind) collected (€0.66)
Seat 4: cap e'bomb95 folded before Flop (didn't bet)
Seat 5: mashallahh folded before Flop (didn't bet)
Seat 6: stfuplzudonk folded before Flop (didn't bet)



PokerStars Zoom Hand #258027169165:  Hold'em No Limit (€0.01/€0.02) [ADM ID: M62BD3044A1E13PD] - 2025/10/07 0:28:24 CET [2025/10/06 18:28:24 ET]
Table 'Sirio' 6-max Seat #1 is the button
Seat 1: stfuplzudonk (€4.69 in chips) 
Seat 2: mashallahh (€3.76 in chips) 
Seat 3: IKARO_3 (€7.69 in chips) 
Seat 4: barmiencas (€1.01 in chips) 
Seat 5: AlwaisToRun (€0.51 in chips) 
Seat 6: caduceus369 (€3.03 in chips) 
mashallahh: posts small blind €0.01
IKARO_3: posts big blind €0.02
*** HOLE CARDS ***
Dealt to caduceus369 [5s 8d]
barmiencas: folds 
AlwaisToRun: calls €0.02
caduceus369: folds 
stfuplzudonk: raises €0.06 to €0.08
mashallahh: folds 
IKARO_3: raises €0.20 to €0.28
AlwaisToRun: folds 
stfuplzudonk: calls €0.20
*** FLOP *** [9s 6d Ad]
IKARO_3: bets €0.42
stfuplzudonk: calls €0.42
*** TURN *** [9s 6d Ad] [6h]
IKARO_3: bets €1.65
stfuplzudonk: calls €1.65
*** RIVER *** [9s 6d Ad 6h] [Qd]
IKARO_3: bets €5.34 and is all-in
stfuplzudonk: calls €2.34 and is all-in
Uncalled bet (€3) returned to IKARO_3
*** SHOW DOWN ***
IKARO_3: shows [Kc As] (two pair, Aces and Sixes)
stfuplzudonk: shows [Ac Ts] (two pair, Aces and Sixes - lower kicker)
IKARO_3 collected €8.90 from pot
*** SUMMARY ***
Total pot €9.41 | Rake €0.51 
Board [9s 6d Ad 6h Qd]
Seat 1: stfuplzudonk (button) showed [Ac Ts] and lost with two pair, Aces and Sixes
Seat 2: mashallahh (small blind) folded before Flop
Seat 3: IKARO_3 (big blind) showed [Kc As] and won (€8.90) with two pair, Aces and Sixes
Seat 4: barmiencas folded before Flop (didn't bet)
Seat 5: AlwaisToRun folded before Flop
Seat 6: caduceus369 folded before Flop (didn't bet)



PokerStars Zoom Hand #258027182042:  Hold'em No Limit (€0.01/€0.02) [ADM ID: M62BD3044A1E13PD] - 2025/10/07 0:29:26 CET [2025/10/06 18:29:26 ET]
Table 'Sirio' 6-max Seat #1 is the button
Seat 1: IKARO_3 (€11.90 in chips) 
Seat 2: caduceus369 (€3.35 in chips) 
Seat 3: cap e'bomb95 (€3.18 in chips) 
Seat 4: stfuplzudonk (€2 in chips) 
Seat 5: mashallahh (€3.74 in chips) 
caduceus369: posts small blind €0.01
cap e'bomb95: posts big blind €0.02
*** HOLE CARDS ***
Dealt to caduceus369 [3d Ah]
stfuplzudonk: folds 
mashallahh: folds 
IKARO_3: folds 
caduceus369: folds 
Uncalled bet (€0.01) returned to cap e'bomb95
cap e'bomb95 collected €0.02 from pot
cap e'bomb95: doesn't show hand 
*** SUMMARY ***
Total pot €0.02 | Rake €0 
Seat 1: IKARO_3 (button) folded before Flop (didn't bet)
Seat 2: caduceus369 (small blind) folded before Flop
Seat 3: cap e'bomb95 (big blind) collected (€0.02)
Seat 4: stfuplzudonk folded before Flop (didn't bet)
Seat 5: mashallahh folded before Flop (didn't bet)



PokerStars Zoom Hand #258027170843:  Hold'em No Limit (€0.01/€0.02) [ADM ID: M62BD3044A1E13PD] - 2025/10/07 0:28:32 CET [2025/10/06 18:28:32 ET]
Table 'Sirio' 6-max Seat #1 is the button
Seat 1: stfuplzudonk (€1.50 in chips) 
Seat 2: M@verick781 (€9.05 in chips) 
Seat 3: jhonnystecco8 (€1.88 in chips) 
Seat 4: caduceus369 (€3.03 in chips) 
Seat 5: franko4102 (€1.08 in chips) 
Seat 6: ArtikWarrior (€0.97 in chips) 
M@verick781: posts small blind €0.01
jhonnystecco8: posts big blind €0.02
*** HOLE CARDS ***
Dealt to caduceus369 [5c 8s]
caduceus369: folds 
franko4102: folds 
ArtikWarrior: calls €0.02
stfuplzudonk: folds 
M@verick781: calls €0.01
jhonnystecco8: raises €0.08 to €0.10
ArtikWarrior: folds 
M@verick781: calls €0.08
*** FLOP *** [Kh Jd 8h]
M@verick781: checks 
jhonnystecco8: checks 
*** TURN *** [Kh Jd 8h] [4c]
M@verick781: checks 
jhonnystecco8: bets €0.12
M@verick781: folds 
Uncalled bet (€0.12) returned to jhonnystecco8
jhonnystecco8 collected €0.21 from pot
jhonnystecco8: doesn't show hand 
*** SUMMARY ***
Total pot €0.22 | Rake €0.01 
Board [Kh Jd 8h 4c]
Seat 1: stfuplzudonk (button) folded before Flop (didn't bet)
Seat 2: M@verick781 (small blind) folded on the Turn
Seat 3: jhonnystecco8 (big blind) collected (€0.21)
Seat 4: caduceus369 folded before Flop (didn't bet)
Seat 5: franko4102 folded before Flop (didn't bet)
Seat 6: ArtikWarrior folded before Flop



PokerStars Zoom Hand #258027183736:  Hold'em No Limit (€0.01/€0.02) [ADM ID: M62BD3044A1E13PD] - 2025/10/07 0:29:34 CET [2025/10/06 18:29:34 ET]
Table 'Sirio' 6-max Seat #1 is the button
Seat 1: stfuplzudonk (€3.24 in chips) 
Seat 2: IKARO_3 (€11.90 in chips) 
Seat 3: mashallahh (€3.79 in chips) 
Seat 4: AlwaisToRun (€0.46 in chips) 
Seat 5: caduceus369 (€3.34 in chips) 
IKARO_3: posts small blind €0.01
mashallahh: posts big blind €0.02
*** HOLE CARDS ***
Dealt to caduceus369 [7h Kc]
AlwaisToRun: folds 
caduceus369: folds 
stfuplzudonk: folds 
IKARO_3: raises €0.05 to €0.07
mashallahh: folds 
Uncalled bet (€0.05) returned to IKARO_3
IKARO_3 collected €0.04 from pot
IKARO_3: doesn't show hand 
*** SUMMARY ***
Total pot €0.04 | Rake €0 
Seat 1: stfuplzudonk (button) folded before Flop (didn't bet)
Seat 2: IKARO_3 (small blind) collected (€0.04)
Seat 3: mashallahh (big blind) folded before Flop
Seat 4: AlwaisToRun folded before Flop (didn't bet)
Seat 5: caduceus369 folded before Flop (didn't bet)



PokerStars Zoom Hand #258027184551:  Hold'em No Limit (€0.01/€0.02) [ADM ID: M62BD3044A1E13PD] - 2025/10/07 0:29:38 CET [2025/10/06 18:29:38 ET]
Table 'Sirio' 6-max Seat #1 is the button
Seat 1: caduceus369 (€3.34 in chips) 
Seat 2: AlwaisToRun (€0.46 in chips) 
Seat 3: M@verick781 (€8.19 in chips) 
Seat 4: montemeru (€2.13 in chips) 
Seat 5: stfuplzudonk (€1.37 in chips) 
AlwaisToRun: posts small blind €0.01
M@verick781: posts big blind €0.02
*** HOLE CARDS ***
Dealt to caduceus369 [Jh Jc]
montemeru: raises €0.04 to €0.06
stfuplzudonk: calls €0.06
caduceus369: raises €0.24 to €0.30
AlwaisToRun: folds 
M@verick781: folds 
montemeru: folds 
stfuplzudonk: folds 
Uncalled bet (€0.24) returned to caduceus369
caduceus369 collected €0.21 from pot
caduceus369: doesn't show hand 
*** SUMMARY ***
Total pot €0.21 | Rake €0 
Seat 1: caduceus369 (button) collected (€0.21)
Seat 2: AlwaisToRun (small blind) folded before Flop
Seat 3: M@verick781 (big blind) folded before Flop
Seat 4: montemeru folded before Flop
Seat 5: stfuplzudonk folded before Flop



PokerStars Zoom Hand #258027190455:  Hold'em No Limit (€0.01/€0.02) [ADM ID: M62BD3044A1E13PD] - 2025/10/07 0:30:06 CET [2025/10/06 18:30:06 ET]
Table 'Sirio' 6-max Seat #1 is the button
Seat 1: Wildag00 (€4.74 in chips) 
Seat 2: M@verick781 (€13.19 in chips) 
Seat 3: stfuplzudonk (€1.31 in chips) 
Seat 4: IKARO_3 (€2.22 in chips) 
Seat 5: caduceus369 (€3.49 in chips) 
M@verick781: posts small blind €0.01
stfuplzudonk: posts big blind €0.02
*** HOLE CARDS ***
Dealt to caduceus369 [7s 2c]
IKARO_3: folds 
caduceus369: folds 
Wildag00: folds 
M@verick781: raises €0.04 to €0.06
stfuplzudonk: folds 
Uncalled bet (€0.04) returned to M@verick781
M@verick781 collected €0.04 from pot
M@verick781: doesn't show hand 
*** SUMMARY ***
Total pot €0.04 | Rake €0 
Seat 1: Wildag00 (button) folded before Flop (didn't bet)
Seat 2: M@verick781 (small blind) collected (€0.04)
Seat 3: stfuplzudonk (big blind) folded before Flop
Seat 4: IKARO_3 folded before Flop (didn't bet)
Seat 5: caduceus369 folded before Flop (didn't bet)



PokerStars Zoom Hand #258027191452:  Hold'em No Limit (€0.01/€0.02) [ADM ID: M62BD3044A1E13PD] - 2025/10/07 0:30:11 CET [2025/10/06 18:30:11 ET]
Table 'Sirio' 6-max Seat #1 is the button
Seat 1: gigysk (€1.91 in chips) 
Seat 2: Wildag00 (€4.74 in chips) 
Seat 3: J0HN-BR0WN (€5.61 in chips) 
Seat 4: caduceus369 (€3.49 in chips) 
Seat 5: Rorotitti (€5.39 in chips) 
Wildag00: posts small blind €0.01
J0HN-BR0WN: posts big blind €0.02
*** HOLE CARDS ***
Dealt to caduceus369 [3h Qs]
caduceus369: folds 
Rorotitti: folds 
gigysk: folds 
Wildag00: folds 
Uncalled bet (€0.01) returned to J0HN-BR0WN
J0HN-BR0WN collected €0.02 from pot
J0HN-BR0WN: doesn't show hand 
*** SUMMARY ***
Total pot €0.02 | Rake €0 
Seat 1: gigysk (button) folded before Flop (didn't bet)
Seat 2: Wildag00 (small blind) folded before Flop
Seat 3: J0HN-BR0WN (big blind) collected (€0.02)
Seat 4: caduceus369 folded before Flop (didn't bet)
Seat 5: Rorotitti folded before Flop (didn't bet)



PokerStars Zoom Hand #258027192275:  Hold'em No Limit (€0.01/€0.02) [ADM ID: M62BD3044A1E13PD] - 2025/10/07 0:30:15 CET [2025/10/06 18:30:15 ET]
Table 'Sirio' 6-max Seat #1 is the button
Seat 1: IKARO_3 (€3.13 in chips) 
Seat 2: pistaKKio23 (€3.62 in chips) 
Seat 3: caduceus369 (€3.49 in chips) 
Seat 4: Wildag00 (€4.73 in chips) 
Seat 5: M@verick781 (€8.96 in chips) 
pistaKKio23: posts small blind €0.01
caduceus369: posts big blind €0.02
*** HOLE CARDS ***
Dealt to caduceus369 [8h 3d]
Wildag00: folds 
M@verick781: folds 
IKARO_3: folds 
pistaKKio23: calls €0.01
caduceus369: checks 
*** FLOP *** [Js Ks 7h]
pistaKKio23: checks 
caduceus369: checks 
*** TURN *** [Js Ks 7h] [Kd]
pistaKKio23: checks 
caduceus369: checks 
*** RIVER *** [Js Ks 7h Kd] [3c]
pistaKKio23: checks 
caduceus369: checks 
*** SHOW DOWN ***
pistaKKio23: shows [5d 9h] (a pair of Kings)
caduceus369: shows [8h 3d] (two pair, Kings and Threes)
caduceus369 collected €0.04 from pot
*** SUMMARY ***
Total pot €0.04 | Rake €0 
Board [Js Ks 7h Kd 3c]
Seat 1: IKARO_3 (button) folded before Flop (didn't bet)
Seat 2: pistaKKio23 (small blind) showed [5d 9h] and lost with a pair of Kings
Seat 3: caduceus369 (big blind) showed [8h 3d] and won (€0.04) with two pair, Kings and Threes
Seat 4: Wildag00 folded before Flop (didn't bet)
Seat 5: M@verick781 folded before Flop (didn't bet)



PokerStars Zoom Hand #258027200354:  Hold'em No Limit (€0.01/€0.02) [ADM ID: M62BD3044A1E13PD] - 2025/10/07 0:30:55 CET [2025/10/06 18:30:55 ET]
Table 'Sirio' 6-max Seat #1 is the button
Seat 1: caduceus369 (€3.50 in chips) 
Seat 2: IKARO_3 (€2.83 in chips) 
Seat 3: jackkk03 (€2.37 in chips) 
Seat 4: M@verick781 (€13.21 in chips) 
Seat 5: Wildag00 (€0.81 in chips) 
IKARO_3: posts small blind €0.01
jackkk03: posts big blind €0.02
*** HOLE CARDS ***
Dealt to caduceus369 [8c Qh]
M@verick781: folds 
Wildag00: folds 
caduceus369: raises €0.04 to €0.06
IKARO_3: folds 
jackkk03: folds 
Uncalled bet (€0.04) returned to caduceus369
caduceus369 collected €0.05 from pot
caduceus369: doesn't show hand 
*** SUMMARY ***
Total pot €0.05 | Rake €0 
Seat 1: caduceus369 (button) collected (€0.05)
Seat 2: IKARO_3 (small blind) folded before Flop
Seat 3: jackkk03 (big blind) folded before Flop
Seat 4: M@verick781 folded before Flop (didn't bet)
Seat 5: Wildag00 folded before Flop (didn't bet)



PokerStars Zoom Hand #258027198226:  Hold'em No Limit (€0.01/€0.02) [ADM ID: M62BD3044A1E13PD] - 2025/10/07 0:30:44 CET [2025/10/06 18:30:44 ET]
Table 'Sirio' 6-max Seat #1 is the button
Seat 1: M@verick781 (€13.21 in chips) 
Seat 2: caduceus369 (€3.51 in chips) 
Seat 3: pistaKKio23 (€3.60 in chips) 
Seat 4: franko4102 (€0.72 in chips) 
Seat 5: montemeru (€1.91 in chips) 
Seat 6: stfuplzudonk (€1.29 in chips) 
caduceus369: posts small blind €0.01
pistaKKio23: posts big blind €0.02
*** HOLE CARDS ***
Dealt to caduceus369 [9c 6c]
franko4102: raises €0.02 to €0.04
montemeru: calls €0.04
stfuplzudonk: calls €0.04
M@verick781: folds 
caduceus369: folds 
pistaKKio23: calls €0.02
*** FLOP *** [9h 5d Jh]
pistaKKio23: bets €0.17
franko4102: raises €0.51 to €0.68 and is all-in
montemeru: folds 
stfuplzudonk: folds 
pistaKKio23: calls €0.51
*** TURN *** [9h 5d Jh] [Jd]
*** RIVER *** [9h 5d Jh Jd] [8d]
*** SHOW DOWN ***
pistaKKio23: shows [Jc Kh] (three of a kind, Jacks)
franko4102: shows [Ah Js] (three of a kind, Jacks - Ace kicker)
franko4102 collected €1.45 from pot
*** SUMMARY ***
Total pot €1.53 | Rake €0.08 
Board [9h 5d Jh Jd 8d]
Seat 1: M@verick781 (button) folded before Flop (didn't bet)
Seat 2: caduceus369 (small blind) folded before Flop
Seat 3: pistaKKio23 (big blind) showed [Jc Kh] and lost with three of a kind, Jacks
Seat 4: franko4102 showed [Ah Js] and won (€1.45) with three of a kind, Jacks
Seat 5: montemeru folded on the Flop
Seat 6: stfuplzudonk folded on the Flop



PokerStars Zoom Hand #258027203319:  Hold'em No Limit (€0.01/€0.02) [ADM ID: M62BD3044A1E13PD] - 2025/10/07 0:31:09 CET [2025/10/06 18:31:09 ET]
Table 'Sirio' 6-max Seat #1 is the button
Seat 1: Wildag00 (€4.71 in chips) 
Seat 2: jhonnystecco8 (€1.93 in chips) 
Seat 3: IKARO_3 (€2.19 in chips) 
Seat 4: caduceus369 (€3.53 in chips) 
Seat 5: stfuplzudonk (€2.57 in chips) 
jhonnystecco8: posts small blind €0.01
IKARO_3: posts big blind €0.02
*** HOLE CARDS ***
Dealt to caduceus369 [6s 9s]
caduceus369: folds 
stfuplzudonk: raises €0.02 to €0.04
Wildag00: folds 
jhonnystecco8: calls €0.03
IKARO_3: folds 
*** FLOP *** [9c Qc 3c]
jhonnystecco8: checks 
stfuplzudonk: checks 
*** TURN *** [9c Qc 3c] [7s]
jhonnystecco8: checks 
stfuplzudonk: checks 
*** RIVER *** [9c Qc 3c 7s] [2d]
jhonnystecco8: checks 
stfuplzudonk: checks 
*** SHOW DOWN ***
jhonnystecco8: shows [Jd Ad] (high card Ace)
stfuplzudonk: shows [As 2s] (a pair of Deuces)
stfuplzudonk collected €0.10 from pot
*** SUMMARY ***
Total pot €0.10 | Rake €0 
Board [9c Qc 3c 7s 2d]
Seat 1: Wildag00 (button) folded before Flop (didn't bet)
Seat 2: jhonnystecco8 (small blind) showed [Jd Ad] and lost with high card Ace
Seat 3: IKARO_3 (big blind) folded before Flop
Seat 4: caduceus369 folded before Flop (didn't bet)
Seat 5: stfuplzudonk showed [As 2s] and won (€0.10) with a pair of Deuces



PokerStars Zoom Hand #258027204394:  Hold'em No Limit (€0.01/€0.02) [ADM ID: M62BD3044A1E13PD] - 2025/10/07 0:31:14 CET [2025/10/06 18:31:14 ET]
Table 'Sirio' 6-max Seat #1 is the button
Seat 1: IKARO_3 (€2.80 in chips) 
Seat 2: jackkk03 (€2.35 in chips) 
Seat 3: Paky6688988 (€2.30 in chips) 
Seat 4: AlwaisToRun (€0.49 in chips) 
Seat 5: caduceus369 (€3.53 in chips) 
jackkk03: posts small blind €0.01
Paky6688988: posts big blind €0.02
*** HOLE CARDS ***
Dealt to caduceus369 [9d 8d]
AlwaisToRun: raises €0.04 to €0.06
caduceus369: folds 
IKARO_3: folds 
jackkk03: raises €0.14 to €0.20
Paky6688988: folds 
AlwaisToRun: raises €0.29 to €0.49 and is all-in
jackkk03: calls €0.29
*** FLOP *** [7h 7d Th]
*** TURN *** [7h 7d Th] [Qc]
*** RIVER *** [7h 7d Th Qc] [4s]
*** SHOW DOWN ***
jackkk03: shows [Kc Ac] (a pair of Sevens)
AlwaisToRun: shows [Ah Kd] (a pair of Sevens)
jackkk03 collected €0.48 from pot
AlwaisToRun collected €0.47 from pot
*** SUMMARY ***
Total pot €1 | Rake €0.05 
Board [7h 7d Th Qc 4s]
Seat 1: IKARO_3 (button) folded before Flop (didn't bet)
Seat 2: jackkk03 (small blind) showed [Kc Ac] and won (€0.48) with a pair of Sevens
Seat 3: Paky6688988 (big blind) folded before Flop
Seat 4: AlwaisToRun showed [Ah Kd] and won (€0.47) with a pair of Sevens
Seat 5: caduceus369 folded before Flop (didn't bet)



PokerStars Zoom Hand #258027205988:  Hold'em No Limit (€0.01/€0.02) [ADM ID: M62BD3044A1E13PD] - 2025/10/07 0:31:22 CET [2025/10/06 18:31:22 ET]
Table 'Sirio' 6-max Seat #1 is the button
Seat 1: IKARO_3 (€2.17 in chips) 
Seat 2: gigysk (€1.89 in chips) 
Seat 3: mashallahh (€3.79 in chips) 
Seat 4: caduceus369 (€3.53 in chips) 
Seat 5: stfuplzudonk (€4.49 in chips) 
gigysk: posts small blind €0.01
mashallahh: posts big blind €0.02
*** HOLE CARDS ***
Dealt to caduceus369 [Jh 7s]
caduceus369: folds 
stfuplzudonk: folds 
IKARO_3: raises €0.05 to €0.07
gigysk: folds 
mashallahh: folds 
Uncalled bet (€0.05) returned to IKARO_3
IKARO_3 collected €0.05 from pot
IKARO_3: doesn't show hand 
*** SUMMARY ***
Total pot €0.05 | Rake €0 
Seat 1: IKARO_3 (button) collected (€0.05)
Seat 2: gigysk (small blind) folded before Flop
Seat 3: mashallahh (big blind) folded before Flop
Seat 4: caduceus369 folded before Flop (didn't bet)
Seat 5: stfuplzudonk folded before Flop (didn't bet)



PokerStars Zoom Hand #258027214288:  Hold'em No Limit (€0.01/€0.02) [ADM ID: M62BD3044A1E13PD] - 2025/10/07 0:32:02 CET [2025/10/06 18:32:02 ET]
Table 'Sirio' 6-max Seat #1 is the button
Seat 1: GraviiTy10 (€2 in chips) 
Seat 2: pistaKKio23 (€8.17 in chips) 
Seat 3: RRgalp (€3.18 in chips) 
Seat 4: IKARO_3 (€3.10 in chips) 
Seat 5: caduceus369 (€3.50 in chips) 
pistaKKio23: posts small blind €0.01
RRgalp: posts big blind €0.02
*** HOLE CARDS ***
Dealt to caduceus369 [Qh 2d]
IKARO_3: folds 
caduceus369: folds 
GraviiTy10: folds 
pistaKKio23: calls €0.01
RRgalp: raises €0.04 to €0.06
pistaKKio23: folds 
Uncalled bet (€0.04) returned to RRgalp
RRgalp collected €0.04 from pot
RRgalp: doesn't show hand 
*** SUMMARY ***
Total pot €0.04 | Rake €0 
Seat 1: GraviiTy10 (button) folded before Flop (didn't bet)
Seat 2: pistaKKio23 (small blind) folded before Flop
Seat 3: RRgalp (big blind) collected (€0.04)
Seat 4: IKARO_3 folded before Flop (didn't bet)
Seat 5: caduceus369 folded before Flop (didn't bet)



PokerStars Zoom Hand #258027211679:  Hold'em No Limit (€0.01/€0.02) [ADM ID: M62BD3044A1E13PD] - 2025/10/07 0:31:49 CET [2025/10/06 18:31:49 ET]
Table 'Sirio' 6-max Seat #1 is the button
Seat 1: stfuplzudonk (€1.27 in chips) 
Seat 2: caduceus369 (€3.51 in chips) 
Seat 3: Wildag00 (€4.70 in chips) 
Seat 4: IKARO_3 (€2.20 in chips) 
Seat 5: RRgalp (€3.18 in chips) 
Seat 6: Poetto65 (€2.02 in chips) 
caduceus369: posts small blind €0.01
Wildag00: posts big blind €0.02
*** HOLE CARDS ***
Dealt to caduceus369 [Ah 2c]
IKARO_3: folds 
RRgalp: folds 
Poetto65: folds 
stfuplzudonk: raises €0.02 to €0.04
caduceus369: folds 
Wildag00: calls €0.02
*** FLOP *** [3c Kc Th]
Wildag00: checks 
stfuplzudonk: checks 
*** TURN *** [3c Kc Th] [Js]
Wildag00: bets €0.04
stfuplzudonk: calls €0.04
*** RIVER *** [3c Kc Th Js] [Jh]
Wildag00: bets €0.09
stfuplzudonk: calls €0.09
*** SHOW DOWN ***
Wildag00: shows [9d Qd] (a straight, Nine to King)
stfuplzudonk: mucks hand 
Wildag00 collected €0.34 from pot
*** SUMMARY ***
Total pot €0.35 | Rake €0.01 
Board [3c Kc Th Js Jh]
Seat 1: stfuplzudonk (button) mucked [Td 8h]
Seat 2: caduceus369 (small blind) folded before Flop
Seat 3: Wildag00 (big blind) showed [9d Qd] and won (€0.34) with a straight, Nine to King
Seat 4: IKARO_3 folded before Flop (didn't bet)
Seat 5: RRgalp folded before Flop (didn't bet)
Seat 6: Poetto65 folded before Flop (didn't bet)



PokerStars Zoom Hand #258027206800:  Hold'em No Limit (€0.01/€0.02) [ADM ID: M62BD3044A1E13PD] - 2025/10/07 0:31:26 CET [2025/10/06 18:31:26 ET]
Table 'Sirio' 6-max Seat #1 is the button
Seat 1: Poetto65 (€2.04 in chips) 
Seat 2: franko4102 (€1.45 in chips) 
Seat 3: caduceus369 (€3.53 in chips) 
Seat 4: Paky6688988 (€2.28 in chips) 
Seat 5: IKARO_3 (€2.80 in chips) 
Seat 6: Wildag00 (€4.71 in chips) 
franko4102: posts small blind €0.01
caduceus369: posts big blind €0.02
*** HOLE CARDS ***
Dealt to caduceus369 [5h Ts]
Paky6688988: calls €0.02
IKARO_3: folds 
Wildag00: folds 
Poetto65: calls €0.02
franko4102: calls €0.01
caduceus369: checks 
*** FLOP *** [9c 7d 4c]
franko4102: checks 
caduceus369: checks 
Paky6688988: bets €0.02
Poetto65: folds 
franko4102: raises €0.06 to €0.08
caduceus369: folds 
Paky6688988: calls €0.06
*** TURN *** [9c 7d 4c] [5d]
franko4102: bets €0.12
Paky6688988: calls €0.12
*** RIVER *** [9c 7d 4c 5d] [6d]
franko4102: bets €0.23
Paky6688988: calls €0.23
*** SHOW DOWN ***
franko4102: shows [9h Th] (a pair of Nines)
Paky6688988: mucks hand 
franko4102 collected €0.89 from pot
*** SUMMARY ***
Total pot €0.94 | Rake €0.05 
Board [9c 7d 4c 5d 6d]
Seat 1: Poetto65 (button) folded on the Flop
Seat 2: franko4102 (small blind) showed [9h Th] and won (€0.89) with a pair of Nines
Seat 3: caduceus369 (big blind) folded on the Flop
Seat 4: Paky6688988 mucked [Ah 7s]
Seat 5: IKARO_3 folded before Flop (didn't bet)
Seat 6: Wildag00 folded before Flop (didn't bet)



PokerStars Zoom Hand #258027215328:  Hold'em No Limit (€0.01/€0.02) [ADM ID: M62BD3044A1E13PD] - 2025/10/07 0:32:07 CET [2025/10/06 18:32:07 ET]
Table 'Sirio' 6-max Seat #1 is the button
Seat 1: caduceus369 (€3.50 in chips) 
Seat 2: stfuplzudonk (€1.98 in chips) 
Seat 3: IKARO_3 (€3.10 in chips) 
Seat 4: Parker853 (€0.40 in chips) 
Seat 5: GraviiTy10 (€2 in chips) 
Seat 6: Wildag00 (€0.77 in chips) 
stfuplzudonk: posts small blind €0.01
IKARO_3: posts big blind €0.02
*** HOLE CARDS ***
Dealt to caduceus369 [Tc 3d]
Parker853: raises €0.38 to €0.40 and is all-in
GraviiTy10: folds 
Wildag00: folds 
caduceus369: folds 
stfuplzudonk: folds 
IKARO_3: folds 
Uncalled bet (€0.38) returned to Parker853
Parker853 collected €0.05 from pot
Parker853: doesn't show hand 
*** SUMMARY ***
Total pot €0.05 | Rake €0 
Seat 1: caduceus369 (button) folded before Flop (didn't bet)
Seat 2: stfuplzudonk (small blind) folded before Flop
Seat 3: IKARO_3 (big blind) folded before Flop
Seat 4: Parker853 collected (€0.05)
Seat 5: GraviiTy10 folded before Flop (didn't bet)
Seat 6: Wildag00 folded before Flop (didn't bet)



PokerStars Zoom Hand #258027216391:  Hold'em No Limit (€0.01/€0.02) [ADM ID: M62BD3044A1E13PD] - 2025/10/07 0:32:12 CET [2025/10/06 18:32:12 ET]
Table 'Sirio' 6-max Seat #1 is the button
Seat 1: jhonnystecco8 (€1.86 in chips) 
Seat 2: mashallahh (€3.76 in chips) 
Seat 3: SebaRapy14 (€4.62 in chips) 
Seat 4: jackkk03 (€2.38 in chips) 
Seat 5: gigysk (€1.86 in chips) 
Seat 6: caduceus369 (€3.50 in chips) 
mashallahh: posts small blind €0.01
SebaRapy14: posts big blind €0.02
*** HOLE CARDS ***
Dealt to caduceus369 [6c Js]
jackkk03: folds 
gigysk: calls €0.02
caduceus369: folds 
jhonnystecco8: folds 
mashallahh: folds 
SebaRapy14: checks 
*** FLOP *** [4d 6s Kc]
SebaRapy14: checks 
gigysk: checks 
*** TURN *** [4d 6s Kc] [Tc]
SebaRapy14: checks 
gigysk: bets €0.03
SebaRapy14: folds 
Uncalled bet (€0.03) returned to gigysk
gigysk collected €0.05 from pot
gigysk: doesn't show hand 
*** SUMMARY ***
Total pot €0.05 | Rake €0 
Board [4d 6s Kc Tc]
Seat 1: jhonnystecco8 (button) folded before Flop (didn't bet)
Seat 2: mashallahh (small blind) folded before Flop
Seat 3: SebaRapy14 (big blind) folded on the Turn
Seat 4: jackkk03 folded before Flop (didn't bet)
Seat 5: gigysk collected (€0.05)
Seat 6: caduceus369 folded before Flop (didn't bet)



PokerStars Zoom Hand #258027218097:  Hold'em No Limit (€0.01/€0.02) [ADM ID: M62BD3044A1E13PD] - 2025/10/07 0:32:21 CET [2025/10/06 18:32:21 ET]
Table 'Sirio' 6-max Seat #1 is the button
Seat 1: IKARO_3 (€11.56 in chips) 
Seat 2: RRgalp (€3.20 in chips) 
Seat 3: caduceus369 (€3.50 in chips) 
Seat 4: mashallahh (€3.75 in chips) 
Seat 5: AlwaisToRun (€0.89 in chips) 
Seat 6: M@verick781 (€2.32 in chips) 
RRgalp: posts small blind €0.01
caduceus369: posts big blind €0.02
*** HOLE CARDS ***
Dealt to caduceus369 [3d Kh]
mashallahh: folds 
AlwaisToRun: folds 
M@verick781: folds 
IKARO_3: folds 
RRgalp: folds 
Uncalled bet (€0.01) returned to caduceus369
caduceus369 collected €0.02 from pot
caduceus369: doesn't show hand 
*** SUMMARY ***
Total pot €0.02 | Rake €0 
Seat 1: IKARO_3 (button) folded before Flop (didn't bet)
Seat 2: RRgalp (small blind) folded before Flop
Seat 3: caduceus369 (big blind) collected (€0.02)
Seat 4: mashallahh folded before Flop (didn't bet)
Seat 5: AlwaisToRun folded before Flop (didn't bet)
Seat 6: M@verick781 folded before Flop (didn't bet)



PokerStars Zoom Hand #258027217173:  Hold'em No Limit (€0.01/€0.02) [ADM ID: M62BD3044A1E13PD] - 2025/10/07 0:32:16 CET [2025/10/06 18:32:16 ET]
Table 'Sirio' 6-max Seat #1 is the button
Seat 1: Poetto65 (€2.03 in chips) 
Seat 2: IKARO_3 (€2.83 in chips) 
Seat 3: Rorotitti (€5.37 in chips) 
Seat 4: caduceus369 (€3.50 in chips) 
Seat 5: jackkk03 (€2.38 in chips) 
Seat 6: mashallahh (€3.75 in chips) 
IKARO_3: posts small blind €0.01
Rorotitti: posts big blind €0.02
*** HOLE CARDS ***
Dealt to caduceus369 [8c 9s]
caduceus369: folds 
jackkk03: calls €0.02
mashallahh: folds 
Poetto65: calls €0.02
IKARO_3: folds 
Rorotitti: raises €0.02 to €0.04
jackkk03: calls €0.02
Poetto65: calls €0.02
*** FLOP *** [2s Ac Qs]
Rorotitti: bets €0.02
jackkk03: calls €0.02
Poetto65: calls €0.02
*** TURN *** [2s Ac Qs] [6c]
Rorotitti: bets €0.06
jackkk03: folds 
Poetto65: folds 
Uncalled bet (€0.06) returned to Rorotitti
Rorotitti collected €0.18 from pot
Rorotitti: doesn't show hand 
*** SUMMARY ***
Total pot €0.19 | Rake €0.01 
Board [2s Ac Qs 6c]
Seat 1: Poetto65 (button) folded on the Turn
Seat 2: IKARO_3 (small blind) folded before Flop
Seat 3: Rorotitti (big blind) collected (€0.18)
Seat 4: caduceus369 folded before Flop (didn't bet)
Seat 5: jackkk03 folded on the Turn
Seat 6: mashallahh folded before Flop (didn't bet)



PokerStars Zoom Hand #258027223730:  Hold'em No Limit (€0.01/€0.02) [ADM ID: M62BD3044A1E13PD] - 2025/10/07 0:32:48 CET [2025/10/06 18:32:48 ET]
Table 'Sirio' 6-max Seat #1 is the button
Seat 1: jackkk03 (€2.32 in chips) 
Seat 2: caduceus369 (€3.51 in chips) 
Seat 3: gigysk (€1.89 in chips) 
Seat 4: SebaRapy14 (€3.46 in chips) 
Seat 5: mashallahh (€3.73 in chips) 
Seat 6: jhonnystecco8 (€1.86 in chips) 
caduceus369: posts small blind €0.01
gigysk: posts big blind €0.02
*** HOLE CARDS ***
Dealt to caduceus369 [Ts Ks]
SebaRapy14: folds 
mashallahh: folds 
jhonnystecco8: folds 
jackkk03: raises €0.04 to €0.06
caduceus369: raises €0.22 to €0.28
gigysk: folds 
jackkk03: folds 
Uncalled bet (€0.22) returned to caduceus369
caduceus369 collected €0.14 from pot
caduceus369: doesn't show hand 
*** SUMMARY ***
Total pot €0.14 | Rake €0 
Seat 1: jackkk03 (button) folded before Flop
Seat 2: caduceus369 (small blind) collected (€0.14)
Seat 3: gigysk (big blind) folded before Flop
Seat 4: SebaRapy14 folded before Flop (didn't bet)
Seat 5: mashallahh folded before Flop (didn't bet)
Seat 6: jhonnystecco8 folded before Flop (didn't bet)



PokerStars Zoom Hand #258027232845:  Hold'em No Limit (€0.01/€0.02) [ADM ID: M62BD3044A1E13PD] - 2025/10/07 0:33:33 CET [2025/10/06 18:33:33 ET]
Table 'Sirio' 6-max Seat #1 is the button
Seat 1: caduceus369 (€3.59 in chips) 
Seat 2: Poetto65 (€1.97 in chips) 
Seat 3: mashallahh (€4.45 in chips) 
Seat 4: RRgalp (€3.13 in chips) 
Seat 5: stfuplzudonk (€4.23 in chips) 
Seat 6: M@verick781 (€8.98 in chips) 
Poetto65: posts small blind €0.01
mashallahh: posts big blind €0.02
*** HOLE CARDS ***
Dealt to caduceus369 [9h 2d]
RRgalp: folds 
stfuplzudonk: folds 
M@verick781: folds 
caduceus369: folds 
Poetto65: folds 
Uncalled bet (€0.01) returned to mashallahh
mashallahh collected €0.02 from pot
mashallahh: doesn't show hand 
*** SUMMARY ***
Total pot €0.02 | Rake €0 
Seat 1: caduceus369 (button) folded before Flop (didn't bet)
Seat 2: Poetto65 (small blind) folded before Flop
Seat 3: mashallahh (big blind) collected (€0.02)
Seat 4: RRgalp folded before Flop (didn't bet)
Seat 5: stfuplzudonk folded before Flop (didn't bet)
Seat 6: M@verick781 folded before Flop (didn't bet)



PokerStars Zoom Hand #258027221879:  Hold'em No Limit (€0.01/€0.02) [ADM ID: M62BD3044A1E13PD] - 2025/10/07 0:32:39 CET [2025/10/06 18:32:39 ET]
Table 'Sirio' 6-max Seat #1 is the button
Seat 1: M@verick781 (€8.50 in chips) 
Seat 2: IKARO_3 (€3.08 in chips) 
Seat 3: mashallahh (€6.03 in chips) 
Seat 4: gigysk (€1.89 in chips) 
Seat 5: caduceus369 (€3.51 in chips) 
Seat 6: Mark Poke783 (€1.17 in chips) 
IKARO_3: posts small blind €0.01
mashallahh: posts big blind €0.02
*** HOLE CARDS ***
Dealt to caduceus369 [2c 6h]
gigysk: folds 
caduceus369: folds 
Mark Poke783: calls €0.02
M@verick781: folds 
IKARO_3: raises €0.07 to €0.09
mashallahh: folds 
Mark Poke783: calls €0.07
*** FLOP *** [6d Qd 3c]
IKARO_3: bets €0.08
Mark Poke783: calls €0.08
*** TURN *** [6d Qd 3c] [2d]
IKARO_3: bets €0.26
Mark Poke783: folds 
Uncalled bet (€0.26) returned to IKARO_3
IKARO_3 collected €0.35 from pot
IKARO_3: doesn't show hand 
*** SUMMARY ***
Total pot €0.36 | Rake €0.01 
Board [6d Qd 3c 2d]
Seat 1: M@verick781 (button) folded before Flop (didn't bet)
Seat 2: IKARO_3 (small blind) collected (€0.35)
Seat 3: mashallahh (big blind) folded before Flop
Seat 4: gigysk folded before Flop (didn't bet)
Seat 5: caduceus369 folded before Flop (didn't bet)
Seat 6: Mark Poke783 folded on the Turn



PokerStars Zoom Hand #258027235041:  Hold'em No Limit (€0.01/€0.02) [ADM ID: M62BD3044A1E13PD] - 2025/10/07 0:33:43 CET [2025/10/06 18:33:43 ET]
Table 'Sirio' 6-max Seat #1 is the button
Seat 1: stfuplzudonk (€4.23 in chips) 
Seat 2: M@verick781 (€8.98 in chips) 
Seat 3: RRgalp (€3.13 in chips) 
Seat 4: caduceus369 (€3.59 in chips) 
Seat 5: Poetto65 (€1.96 in chips) 
M@verick781: posts small blind €0.01
RRgalp: posts big blind €0.02
*** HOLE CARDS ***
Dealt to caduceus369 [2s 4h]
caduceus369: folds 
Poetto65: calls €0.02
stfuplzudonk: folds 
M@verick781: raises €0.06 to €0.08
RRgalp: folds 
Poetto65: folds 
Uncalled bet (€0.06) returned to M@verick781
M@verick781 collected €0.06 from pot
M@verick781: doesn't show hand 
*** SUMMARY ***
Total pot €0.06 | Rake €0 
Seat 1: stfuplzudonk (button) folded before Flop (didn't bet)
Seat 2: M@verick781 (small blind) collected (€0.06)
Seat 3: RRgalp (big blind) folded before Flop
Seat 4: caduceus369 folded before Flop (didn't bet)
Seat 5: Poetto65 folded before Flop



PokerStars Zoom Hand #258027247664:  Hold'em No Limit (€0.01/€0.02) [ADM ID: M62BD3044A1E13PD] - 2025/10/07 0:34:47 CET [2025/10/06 18:34:47 ET]
Table 'Sirio' 6-max Seat #1 is the button
Seat 1: mashallahh (€4.69 in chips) 
Seat 2: caduceus369 (€3.57 in chips) 
Seat 3: stfuplzudonk (€2.25 in chips) 
Seat 4: M@verick781 (€8.47 in chips) 
Seat 5: RRgalp (€3.10 in chips) 
caduceus369: posts small blind €0.01
stfuplzudonk: posts big blind €0.02
*** HOLE CARDS ***
Dealt to caduceus369 [Tc 7s]
M@verick781: raises €0.03 to €0.05
RRgalp: folds 
mashallahh: folds 
caduceus369: folds 
stfuplzudonk: folds 
Uncalled bet (€0.03) returned to M@verick781
M@verick781 collected €0.05 from pot
M@verick781: doesn't show hand 
*** SUMMARY ***
Total pot €0.05 | Rake €0 
Seat 1: mashallahh (button) folded before Flop (didn't bet)
Seat 2: caduceus369 (small blind) folded before Flop
Seat 3: stfuplzudonk (big blind) folded before Flop
Seat 4: M@verick781 collected (€0.05)
Seat 5: RRgalp folded before Flop (didn't bet)



PokerStars Zoom Hand #258027246104:  Hold'em No Limit (€0.01/€0.02) [ADM ID: M62BD3044A1E13PD] - 2025/10/07 0:34:39 CET [2025/10/06 18:34:39 ET]
Table 'Sirio' 6-max Seat #1 is the button
Seat 1: jackkk03 (€2 in chips) 
Seat 2: TGolda (€1.18 in chips) 
Seat 3: Poetto65 (€1.94 in chips) 
Seat 4: stfuplzudonk (€3.23 in chips) 
Seat 5: RRgalp (€3.10 in chips) 
Seat 6: caduceus369 (€3.57 in chips) 
TGolda: posts small blind €0.01
Poetto65: posts big blind €0.02
*** HOLE CARDS ***
Dealt to caduceus369 [7d Kc]
stfuplzudonk: raises €0.04 to €0.06
RRgalp: folds 
caduceus369: folds 
jackkk03: calls €0.06
TGolda: folds 
Poetto65: folds 
*** FLOP *** [8c 6c Qh]
stfuplzudonk: bets €0.15
jackkk03: folds 
Uncalled bet (€0.15) returned to stfuplzudonk
stfuplzudonk collected €0.15 from pot
stfuplzudonk: doesn't show hand 
*** SUMMARY ***
Total pot €0.15 | Rake €0 
Board [8c 6c Qh]
Seat 1: jackkk03 (button) folded on the Flop
Seat 2: TGolda (small blind) folded before Flop
Seat 3: Poetto65 (big blind) folded before Flop
Seat 4: stfuplzudonk collected (€0.15)
Seat 5: RRgalp folded before Flop (didn't bet)
Seat 6: caduceus369 folded before Flop (didn't bet)



PokerStars Zoom Hand #258027235909:  Hold'em No Limit (€0.01/€0.02) [ADM ID: M62BD3044A1E13PD] - 2025/10/07 0:33:48 CET [2025/10/06 18:33:48 ET]
Table 'Sirio' 6-max Seat #1 is the button
Seat 1: stfuplzudonk (€2.26 in chips) 
Seat 2: pistaKKio23 (€5.94 in chips) 
Seat 3: caduceus369 (€3.59 in chips) 
Seat 4: M@verick781 (€2.08 in chips) 
Seat 5: jhonnystecco8 (€1.82 in chips) 
Seat 6: J0HN-BR0WN (€6.21 in chips) 
pistaKKio23: posts small blind €0.01
caduceus369: posts big blind €0.02
*** HOLE CARDS ***
Dealt to caduceus369 [3h 2h]
M@verick781: raises €0.03 to €0.05
jhonnystecco8: folds 
J0HN-BR0WN: calls €0.05
stfuplzudonk: folds 
pistaKKio23 has timed out
pistaKKio23: folds 
caduceus369: folds 
*** FLOP *** [4h Qh 5c]
M@verick781: checks 
J0HN-BR0WN: checks 
*** TURN *** [4h Qh 5c] [5h]
M@verick781: checks 
J0HN-BR0WN: checks 
*** RIVER *** [4h Qh 5c 5h] [7h]
M@verick781: checks 
J0HN-BR0WN: checks 
*** SHOW DOWN ***
M@verick781: shows [6d 4d] (two pair, Fives and Fours)
J0HN-BR0WN: shows [Kh 8d] (a flush, King high)
J0HN-BR0WN collected €0.13 from pot
*** SUMMARY ***
Total pot €0.13 | Rake €0 
Board [4h Qh 5c 5h 7h]
Seat 1: stfuplzudonk (button) folded before Flop (didn't bet)
Seat 2: pistaKKio23 (small blind) folded before Flop
Seat 3: caduceus369 (big blind) folded before Flop
Seat 4: M@verick781 showed [6d 4d] and lost with two pair, Fives and Fours
Seat 5: jhonnystecco8 folded before Flop (didn't bet)
Seat 6: J0HN-BR0WN showed [Kh 8d] and won (€0.13) with a flush, King high



PokerStars Zoom Hand #258027248740:  Hold'em No Limit (€0.01/€0.02) [ADM ID: M62BD3044A1E13PD] - 2025/10/07 0:34:52 CET [2025/10/06 18:34:52 ET]
Table 'Sirio' 6-max Seat #1 is the button
Seat 1: TGolda (€1.17 in chips) 
Seat 2: mashallahh (€4.40 in chips) 
Seat 3: caduceus369 (€3.56 in chips) 
Seat 4: IKARO_3 (€3.24 in chips) 
Seat 5: Wildag00 (€2 in chips) 
Seat 6: M@verick781 (€16.96 in chips) 
mashallahh: posts small blind €0.01
caduceus369: posts big blind €0.02
*** HOLE CARDS ***
Dealt to caduceus369 [Ad 4h]
IKARO_3: raises €0.03 to €0.05
Wildag00: folds 
M@verick781: folds 
TGolda: folds 
mashallahh: folds 
caduceus369: calls €0.03
*** FLOP *** [7s 3s 7c]
caduceus369: checks 
IKARO_3: bets €0.08
caduceus369: folds 
Uncalled bet (€0.08) returned to IKARO_3
IKARO_3 collected €0.11 from pot
IKARO_3: doesn't show hand 
*** SUMMARY ***
Total pot €0.11 | Rake €0 
Board [7s 3s 7c]
Seat 1: TGolda (button) folded before Flop (didn't bet)
Seat 2: mashallahh (small blind) folded before Flop
Seat 3: caduceus369 (big blind) folded on the Flop
Seat 4: IKARO_3 collected (€0.11)
Seat 5: Wildag00 folded before Flop (didn't bet)
Seat 6: M@verick781 folded before Flop (didn't bet)



PokerStars Zoom Hand #258027261990:  Hold'em No Limit (€0.01/€0.02) [ADM ID: M62BD3044A1E13PD] - 2025/10/07 0:35:59 CET [2025/10/06 18:35:59 ET]
Table 'Sirio' 6-max Seat #1 is the button
Seat 1: jackkk03 (€1.93 in chips) 
Seat 2: stfuplzudonk (€3.33 in chips) 
Seat 3: IKARO_3 (€4.18 in chips) 
Seat 4: pistaKKio23 (€2.67 in chips) 
Seat 5: caduceus369 (€3.45 in chips) 
stfuplzudonk: posts small blind €0.01
IKARO_3: posts big blind €0.02
*** HOLE CARDS ***
Dealt to caduceus369 [5d Qh]
pistaKKio23: folds 
caduceus369: folds 
jackkk03: folds 
stfuplzudonk: folds 
Uncalled bet (€0.01) returned to IKARO_3
IKARO_3 collected €0.02 from pot
IKARO_3: doesn't show hand 
*** SUMMARY ***
Total pot €0.02 | Rake €0 
Seat 1: jackkk03 (button) folded before Flop (didn't bet)
Seat 2: stfuplzudonk (small blind) folded before Flop
Seat 3: IKARO_3 (big blind) collected (€0.02)
Seat 4: pistaKKio23 folded before Flop (didn't bet)
Seat 5: caduceus369 folded before Flop (didn't bet)



PokerStars Zoom Hand #258027265450:  Hold'em No Limit (€0.01/€0.02) [ADM ID: M62BD3044A1E13PD] - 2025/10/07 0:36:16 CET [2025/10/06 18:36:16 ET]
Table 'Sirio' 6-max Seat #1 is the button
Seat 1: pistaKKio23 (€2.67 in chips) 
Seat 2: caduceus369 (€3.45 in chips) 
Seat 3: IKARO_3 (€12.56 in chips) 
Seat 4: Poetto65 (€1.86 in chips) 
Seat 5: gigysk (€1.79 in chips) 
caduceus369: posts small blind €0.01
IKARO_3: posts big blind €0.02
*** HOLE CARDS ***
Dealt to caduceus369 [2d 9c]
Poetto65: folds 
gigysk: folds 
pistaKKio23: folds 
caduceus369: folds 
Uncalled bet (€0.01) returned to IKARO_3
IKARO_3 collected €0.02 from pot
IKARO_3: doesn't show hand 
*** SUMMARY ***
Total pot €0.02 | Rake €0 
Seat 1: pistaKKio23 (button) folded before Flop (didn't bet)
Seat 2: caduceus369 (small blind) folded before Flop
Seat 3: IKARO_3 (big blind) collected (€0.02)
Seat 4: Poetto65 folded before Flop (didn't bet)
Seat 5: gigysk folded before Flop (didn't bet)



PokerStars Zoom Hand #258027264037:  Hold'em No Limit (€0.01/€0.02) [ADM ID: M62BD3044A1E13PD] - 2025/10/07 0:36:09 CET [2025/10/06 18:36:09 ET]
Table 'Sirio' 6-max Seat #1 is the button
Seat 1: stfuplzudonk (€3.32 in chips) 
Seat 2: GraviiTy10 (€1.96 in chips) 
Seat 3: mashallahh (€4.68 in chips) 
Seat 4: caduceus369 (€3.45 in chips) 
Seat 5: Poetto65 (€1.86 in chips) 
GraviiTy10: posts small blind €0.01
mashallahh: posts big blind €0.02
*** HOLE CARDS ***
Dealt to caduceus369 [Td Jc]
caduceus369: folds 
Poetto65: folds 
stfuplzudonk: raises €0.02 to €0.04
GraviiTy10: calls €0.03
mashallahh: folds 
*** FLOP *** [As Ts 6d]
GraviiTy10: bets €0.03
stfuplzudonk: folds 
Uncalled bet (€0.03) returned to GraviiTy10
GraviiTy10 collected €0.10 from pot
GraviiTy10: doesn't show hand 
*** SUMMARY ***
Total pot €0.10 | Rake €0 
Board [As Ts 6d]
Seat 1: stfuplzudonk (button) folded on the Flop
Seat 2: GraviiTy10 (small blind) collected (€0.10)
Seat 3: mashallahh (big blind) folded before Flop
Seat 4: caduceus369 folded before Flop (didn't bet)
Seat 5: Poetto65 folded before Flop (didn't bet)



PokerStars Zoom Hand #258027254201:  Hold'em No Limit (€0.01/€0.02) [ADM ID: M62BD3044A1E13PD] - 2025/10/07 0:35:20 CET [2025/10/06 18:35:20 ET]
Table 'Sirio' 6-max Seat #1 is the button
Seat 1: caduceus369 (€3.51 in chips) 
Seat 2: Wildag00 (€4.80 in chips) 
Seat 3: IKARO_3 (€4.20 in chips) 
Seat 4: mashallahh (€6.01 in chips) 
Seat 5: M@verick781 (€9 in chips) 
Wildag00: posts small blind €0.01
IKARO_3: posts big blind €0.02
*** HOLE CARDS ***
Dealt to caduceus369 [Ac 7s]
mashallahh: calls €0.02
M@verick781: folds 
caduceus369: raises €0.04 to €0.06
Wildag00: calls €0.05
IKARO_3: folds 
mashallahh: calls €0.04
*** FLOP *** [3s 6c 6h]
Wildag00: bets €0.10
mashallahh: raises €0.20 to €0.30
caduceus369: folds 
Wildag00: calls €0.20
*** TURN *** [3s 6c 6h] [Td]
Wildag00: checks 
mashallahh: checks 
*** RIVER *** [3s 6c 6h Td] [7h]
Wildag00: checks 
mashallahh: checks 
*** SHOW DOWN ***
Wildag00: shows [5d 5c] (two pair, Sixes and Fives)
mashallahh: mucks hand 
Wildag00 collected €0.76 from pot
*** SUMMARY ***
Total pot €0.80 | Rake €0.04 
Board [3s 6c 6h Td 7h]
Seat 1: caduceus369 (button) folded on the Flop
Seat 2: Wildag00 (small blind) showed [5d 5c] and won (€0.76) with two pair, Sixes and Fives
Seat 3: IKARO_3 (big blind) folded before Flop
Seat 4: mashallahh mucked [4s 4h]
Seat 5: M@verick781 folded before Flop (didn't bet)



PokerStars Zoom Hand #258027262898:  Hold'em No Limit (€0.01/€0.02) [ADM ID: M62BD3044A1E13PD] - 2025/10/07 0:36:03 CET [2025/10/06 18:36:03 ET]
Table 'Sirio' 6-max Seat #1 is the button
Seat 1: mashallahh (€4.37 in chips) 
Seat 2: stfuplzudonk (€2.29 in chips) 
Seat 3: M@verick781 (€16.98 in chips) 
Seat 4: caduceus369 (€3.45 in chips) 
Seat 5: pistaKKio23 (€2.67 in chips) 
Seat 6: RRgalp (€3.01 in chips) 
stfuplzudonk: posts small blind €0.01
M@verick781: posts big blind €0.02
*** HOLE CARDS ***
Dealt to caduceus369 [Js 2s]
caduceus369: folds 
pistaKKio23: folds 
RRgalp: raises €0.04 to €0.06
mashallahh: folds 
stfuplzudonk: calls €0.05
M@verick781: folds 
*** FLOP *** [2d Jd 8s]
stfuplzudonk: checks 
RRgalp: bets €0.14
stfuplzudonk: folds 
Uncalled bet (€0.14) returned to RRgalp
RRgalp collected €0.14 from pot
RRgalp: doesn't show hand 
*** SUMMARY ***
Total pot €0.14 | Rake €0 
Board [2d Jd 8s]
Seat 1: mashallahh (button) folded before Flop (didn't bet)
Seat 2: stfuplzudonk (small blind) folded on the Flop
Seat 3: M@verick781 (big blind) folded before Flop
Seat 4: caduceus369 folded before Flop (didn't bet)
Seat 5: pistaKKio23 folded before Flop (didn't bet)
Seat 6: RRgalp collected (€0.14)



PokerStars Zoom Hand #258027266900:  Hold'em No Limit (€0.01/€0.02) [ADM ID: M62BD3044A1E13PD] - 2025/10/07 0:36:23 CET [2025/10/06 18:36:23 ET]
Table 'Sirio' 6-max Seat #1 is the button
Seat 1: stfuplzudonk (€4.14 in chips) 
Seat 2: gigysk (€1.79 in chips) 
Seat 3: caduceus369 (€3.44 in chips) 
Seat 4: M@verick781 (€16.96 in chips) 
Seat 5: mashallahh (€4.37 in chips) 
gigysk: posts small blind €0.01
caduceus369: posts big blind €0.02
*** HOLE CARDS ***
Dealt to caduceus369 [4d 2s]
M@verick781: folds 
mashallahh: raises €0.04 to €0.06
stfuplzudonk: calls €0.06
gigysk: folds 
caduceus369: folds 
*** FLOP *** [7h 4c Kh]
mashallahh: checks 
stfuplzudonk: checks 
*** TURN *** [7h 4c Kh] [7s]
mashallahh: bets €0.11
stfuplzudonk: folds 
Uncalled bet (€0.11) returned to mashallahh
mashallahh collected €0.15 from pot
mashallahh: doesn't show hand 
*** SUMMARY ***
Total pot €0.15 | Rake €0 
Board [7h 4c Kh 7s]
Seat 1: stfuplzudonk (button) folded on the Turn
Seat 2: gigysk (small blind) folded before Flop
Seat 3: caduceus369 (big blind) folded before Flop
Seat 4: M@verick781 folded before Flop (didn't bet)
Seat 5: mashallahh collected (€0.15)



PokerStars Zoom Hand #258027269705:  Hold'em No Limit (€0.01/€0.02) [ADM ID: M62BD3044A1E13PD] - 2025/10/07 0:36:37 CET [2025/10/06 18:36:37 ET]
Table 'Sirio' 6-max Seat #1 is the button
Seat 1: caduceus369 (€3.42 in chips) 
Seat 2: mashallahh (€5.65 in chips) 
Seat 3: stfuplzudonk (€2.23 in chips) 
Seat 4: GraviiTy10 (€2.02 in chips) 
Seat 5: Parker853 (€1.62 in chips) 
mashallahh: posts small blind €0.01
stfuplzudonk: posts big blind €0.02
*** HOLE CARDS ***
Dealt to caduceus369 [9s Ac]
GraviiTy10: raises €0.02 to €0.04
Parker853: calls €0.04
caduceus369: folds 
mashallahh: folds 
stfuplzudonk: calls €0.02
*** FLOP *** [6d 2h 6s]
stfuplzudonk: checks 
GraviiTy10: checks 
Parker853: bets €0.02
stfuplzudonk: calls €0.02
GraviiTy10: calls €0.02
*** TURN *** [6d 2h 6s] [Qh]
stfuplzudonk: checks 
GraviiTy10: checks 
Parker853: bets €0.02
stfuplzudonk: calls €0.02
GraviiTy10: calls €0.02
*** RIVER *** [6d 2h 6s Qh] [Jh]
stfuplzudonk: checks 
GraviiTy10: checks 
Parker853: checks 
*** SHOW DOWN ***
stfuplzudonk: shows [3s 3h] (two pair, Sixes and Threes)
GraviiTy10: mucks hand 
Parker853: mucks hand 
stfuplzudonk collected €0.24 from pot
*** SUMMARY ***
Total pot €0.25 | Rake €0.01 
Board [6d 2h 6s Qh Jh]
Seat 1: caduceus369 (button) folded before Flop (didn't bet)
Seat 2: mashallahh (small blind) folded before Flop
Seat 3: stfuplzudonk (big blind) showed [3s 3h] and won (€0.24) with two pair, Sixes and Threes
Seat 4: GraviiTy10 mucked [Ah Tc]
Seat 5: Parker853 mucked [5d Kd]



PokerStars Zoom Hand #258027271271:  Hold'em No Limit (€0.01/€0.02) [ADM ID: M62BD3044A1E13PD] - 2025/10/07 0:36:45 CET [2025/10/06 18:36:45 ET]
Table 'Sirio' 6-max Seat #1 is the button
Seat 1: gigysk (€1.78 in chips) 
Seat 2: jackkk03 (€2.32 in chips) 
Seat 3: montemeru (€1.87 in chips) 
Seat 4: jhonnystecco8 (€2.50 in chips) 
Seat 5: caduceus369 (€3.42 in chips) 
jackkk03: posts small blind €0.01
montemeru: posts big blind €0.02
*** HOLE CARDS ***
Dealt to caduceus369 [9s Js]
jhonnystecco8: folds 
caduceus369: raises €0.04 to €0.06
gigysk: calls €0.06
jackkk03: folds 
montemeru: calls €0.04
*** FLOP *** [8d 7d Kh]
montemeru: checks 
caduceus369: checks 
gigysk: checks 
*** TURN *** [8d 7d Kh] [Qc]
montemeru: checks 
caduceus369: checks 
gigysk: checks 
*** RIVER *** [8d 7d Kh Qc] [5d]
montemeru: checks 
caduceus369: bets €0.11
gigysk: folds 
montemeru: folds 
Uncalled bet (€0.11) returned to caduceus369
caduceus369 collected €0.18 from pot
caduceus369: doesn't show hand 
*** SUMMARY ***
Total pot €0.19 | Rake €0.01 
Board [8d 7d Kh Qc 5d]
Seat 1: gigysk (button) folded on the River
Seat 2: jackkk03 (small blind) folded before Flop
Seat 3: montemeru (big blind) folded on the River
Seat 4: jhonnystecco8 folded before Flop (didn't bet)
Seat 5: caduceus369 collected (€0.18)



PokerStars Zoom Hand #258027284154:  Hold'em No Limit (€0.01/€0.02) [ADM ID: M62BD3044A1E13PD] - 2025/10/07 0:37:49 CET [2025/10/06 18:37:49 ET]
Table 'Sirio' 6-max Seat #1 is the button
Seat 1: M@verick781 (€9.58 in chips) 
Seat 2: gigysk (€1.73 in chips) 
Seat 3: caduceus369 (€3.53 in chips) 
Seat 4: RRgalp (€3.02 in chips) 
Seat 5: IKARO_3 (€2.83 in chips) 
Seat 6: jackkk03 (€2.31 in chips) 
gigysk: posts small blind €0.01
caduceus369: posts big blind €0.02
*** HOLE CARDS ***
Dealt to caduceus369 [Kh 9s]
RRgalp: folds 
IKARO_3: folds 
jackkk03: folds 
M@verick781: folds 
gigysk: folds 
Uncalled bet (€0.01) returned to caduceus369
caduceus369 collected €0.02 from pot
caduceus369: doesn't show hand 
*** SUMMARY ***
Total pot €0.02 | Rake €0 
Seat 1: M@verick781 (button) folded before Flop (didn't bet)
Seat 2: gigysk (small blind) folded before Flop
Seat 3: caduceus369 (big blind) collected (€0.02)
Seat 4: RRgalp folded before Flop (didn't bet)
Seat 5: IKARO_3 folded before Flop (didn't bet)
Seat 6: jackkk03 folded before Flop (didn't bet)



PokerStars Zoom Hand #258027280936:  Hold'em No Limit (€0.01/€0.02) [ADM ID: M62BD3044A1E13PD] - 2025/10/07 0:37:33 CET [2025/10/06 18:37:33 ET]
Table 'Sirio' 6-max Seat #1 is the button
Seat 1: Parker853 (€1.54 in chips) 
Seat 2: caduceus369 (€3.54 in chips) 
Seat 3: montemeru (€2 in chips) 
Seat 4: pistaKKio23 (€2.64 in chips) 
Seat 5: GraviiTy10 (€1.94 in chips) 
Seat 6: stfuplzudonk (€2.39 in chips) 
caduceus369: posts small blind €0.01
montemeru: posts big blind €0.02
*** HOLE CARDS ***
Dealt to caduceus369 [2s 6s]
pistaKKio23: folds 
GraviiTy10: folds 
stfuplzudonk: raises €0.02 to €0.04
Parker853: folds 
caduceus369: folds 
montemeru: calls €0.02
*** FLOP *** [9s 4s 5h]
montemeru: checks 
stfuplzudonk: checks 
*** TURN *** [9s 4s 5h] [5c]
montemeru: checks 
stfuplzudonk: checks 
*** RIVER *** [9s 4s 5h 5c] [9d]
montemeru: checks 
stfuplzudonk: checks 
*** SHOW DOWN ***
montemeru: shows [Qd 7c] (two pair, Nines and Fives)
stfuplzudonk: shows [2h Kh] (two pair, Nines and Fives - King kicker)
stfuplzudonk collected €0.09 from pot
*** SUMMARY ***
Total pot €0.09 | Rake €0 
Board [9s 4s 5h 5c 9d]
Seat 1: Parker853 (button) folded before Flop (didn't bet)
Seat 2: caduceus369 (small blind) folded before Flop
Seat 3: montemeru (big blind) showed [Qd 7c] and lost with two pair, Nines and Fives
Seat 4: pistaKKio23 folded before Flop (didn't bet)
Seat 5: GraviiTy10 folded before Flop (didn't bet)
Seat 6: stfuplzudonk showed [2h Kh] and won (€0.09) with two pair, Nines and Fives



PokerStars Zoom Hand #258027283053:  Hold'em No Limit (€0.01/€0.02) [ADM ID: M62BD3044A1E13PD] - 2025/10/07 0:37:44 CET [2025/10/06 18:37:44 ET]
Table 'Sirio' 6-max Seat #1 is the button
Seat 1: M@verick781 (€9.09 in chips) 
Seat 2: pistaKKio23 (€2.64 in chips) 
Seat 3: Parker853 (€1.54 in chips) 
Seat 4: caduceus369 (€3.53 in chips) 
Seat 5: RRgalp (€3.02 in chips) 
pistaKKio23: posts small blind €0.01
Parker853: posts big blind €0.02
*** HOLE CARDS ***
Dealt to caduceus369 [7c 4h]
caduceus369: folds 
RRgalp: folds 
M@verick781: folds 
pistaKKio23: raises €0.04 to €0.06
Parker853: calls €0.04
*** FLOP *** [2s 3d 9s]
pistaKKio23: checks 
Parker853: bets €0.04
pistaKKio23: folds 
Uncalled bet (€0.04) returned to Parker853
Parker853 collected €0.12 from pot
Parker853: doesn't show hand 
*** SUMMARY ***
Total pot €0.12 | Rake €0 
Board [2s 3d 9s]
Seat 1: M@verick781 (button) folded before Flop (didn't bet)
Seat 2: pistaKKio23 (small blind) folded on the Flop
Seat 3: Parker853 (big blind) collected (€0.12)
Seat 4: caduceus369 folded before Flop (didn't bet)
Seat 5: RRgalp folded before Flop (didn't bet)



PokerStars Zoom Hand #258027282246:  Hold'em No Limit (€0.01/€0.02) [ADM ID: M62BD3044A1E13PD] - 2025/10/07 0:37:40 CET [2025/10/06 18:37:40 ET]
Table 'Sirio' 6-max Seat #1 is the button
Seat 1: caduceus369 (€3.53 in chips) 
Seat 2: 9AIC1 (€1.81 in chips) 
Seat 3: GraviiTy10 (€1.94 in chips) 
Seat 4: Parker853 (€1.54 in chips) 
Seat 5: mashallahh (€4.63 in chips) 
9AIC1: posts small blind €0.01
GraviiTy10: posts big blind €0.02
*** HOLE CARDS ***
Dealt to caduceus369 [5h 9d]
Parker853: folds 
mashallahh: raises €0.04 to €0.06
caduceus369: folds 
9AIC1: folds 
GraviiTy10: calls €0.04
*** FLOP *** [2d Ac 2s]
GraviiTy10: checks 
mashallahh: bets €0.09
GraviiTy10: folds 
Uncalled bet (€0.09) returned to mashallahh
mashallahh collected €0.13 from pot
mashallahh: doesn't show hand 
*** SUMMARY ***
Total pot €0.13 | Rake €0 
Board [2d Ac 2s]
Seat 1: caduceus369 (button) folded before Flop (didn't bet)
Seat 2: 9AIC1 (small blind) folded before Flop
Seat 3: GraviiTy10 (big blind) folded on the Flop
Seat 4: Parker853 folded before Flop (didn't bet)
Seat 5: mashallahh collected (€0.13)



PokerStars Zoom Hand #258027287869:  Hold'em No Limit (€0.01/€0.02) [ADM ID: M62BD3044A1E13PD] - 2025/10/07 0:38:08 CET [2025/10/06 18:38:08 ET]
Table 'Sirio' 6-max Seat #1 is the button
Seat 1: montemeru (€1.74 in chips) 
Seat 2: M@verick781 (€9.58 in chips) 
Seat 3: gigysk (€1.72 in chips) 
Seat 4: IKARO_3 (€11.76 in chips) 
Seat 5: caduceus369 (€3.54 in chips) 
M@verick781: posts small blind €0.01
gigysk: posts big blind €0.02
*** HOLE CARDS ***
Dealt to caduceus369 [9s Qd]
IKARO_3: raises €0.03 to €0.05
caduceus369: folds 
montemeru: folds 
M@verick781: calls €0.04
gigysk: folds 
*** FLOP *** [As 3s Ah]
M@verick781: checks 
IKARO_3: bets €0.09
M@verick781: folds 
Uncalled bet (€0.09) returned to IKARO_3
IKARO_3 collected €0.12 from pot
IKARO_3: doesn't show hand 
*** SUMMARY ***
Total pot €0.12 | Rake €0 
Board [As 3s Ah]
Seat 1: montemeru (button) folded before Flop (didn't bet)
Seat 2: M@verick781 (small blind) folded on the Flop
Seat 3: gigysk (big blind) folded before Flop
Seat 4: IKARO_3 collected (€0.12)
Seat 5: caduceus369 folded before Flop (didn't bet)



PokerStars Zoom Hand #258027289161:  Hold'em No Limit (€0.01/€0.02) [ADM ID: M62BD3044A1E13PD] - 2025/10/07 0:38:14 CET [2025/10/06 18:38:14 ET]
Table 'Sirio' 6-max Seat #1 is the button
Seat 1: Parker853 (€1.60 in chips) 
Seat 2: GraviiTy10 (€1.88 in chips) 
Seat 3: jackkk03 (€2.31 in chips) 
Seat 4: IKARO_3 (€2.81 in chips) 
Seat 5: M@verick781 (€16.72 in chips) 
Seat 6: caduceus369 (€3.54 in chips) 
GraviiTy10: posts small blind €0.01
jackkk03: posts big blind €0.02
*** HOLE CARDS ***
Dealt to caduceus369 [Ac 5h]
IKARO_3: folds 
M@verick781: folds 
caduceus369: raises €0.04 to €0.06
Parker853: calls €0.06
GraviiTy10: folds 
jackkk03: calls €0.04
*** FLOP *** [2d 5s Ad]
jackkk03: checks 
caduceus369: bets €0.12
Parker853: folds 
jackkk03: folds 
Uncalled bet (€0.12) returned to caduceus369
caduceus369 collected €0.18 from pot
caduceus369: doesn't show hand 
*** SUMMARY ***
Total pot €0.19 | Rake €0.01 
Board [2d 5s Ad]
Seat 1: Parker853 (button) folded on the Flop
Seat 2: GraviiTy10 (small blind) folded before Flop
Seat 3: jackkk03 (big blind) folded on the Flop
Seat 4: IKARO_3 folded before Flop (didn't bet)
Seat 5: M@verick781 folded before Flop (didn't bet)
Seat 6: caduceus369 collected (€0.18)



PokerStars Zoom Hand #258027297688:  Hold'em No Limit (€0.01/€0.02) [ADM ID: M62BD3044A1E13PD] - 2025/10/07 0:38:57 CET [2025/10/06 18:38:57 ET]
Table 'Sirio' 6-max Seat #1 is the button
Seat 1: M@verick781 (€9.20 in chips) 
Seat 2: caduceus369 (€3.66 in chips) 
Seat 3: jhonnystecco8 (€3.37 in chips) 
Seat 4: SebaRapy14 (€2.55 in chips) 
Seat 5: stfuplzudonk (€3.34 in chips) 
Seat 6: mashallahh (€4.38 in chips) 
caduceus369: posts small blind €0.01
jhonnystecco8: posts big blind €0.02
*** HOLE CARDS ***
Dealt to caduceus369 [7s 6s]
SebaRapy14: raises €0.04 to €0.06
stfuplzudonk: folds 
mashallahh: folds 
M@verick781: raises €0.12 to €0.18
caduceus369: folds 
jhonnystecco8: folds 
SebaRapy14: folds 
Uncalled bet (€0.12) returned to M@verick781
M@verick781 collected €0.15 from pot
M@verick781: doesn't show hand 
*** SUMMARY ***
Total pot €0.15 | Rake €0 
Seat 1: M@verick781 (button) collected (€0.15)
Seat 2: caduceus369 (small blind) folded before Flop
Seat 3: jhonnystecco8 (big blind) folded before Flop
Seat 4: SebaRapy14 folded before Flop
Seat 5: stfuplzudonk folded before Flop (didn't bet)
Seat 6: mashallahh folded before Flop (didn't bet)



PokerStars Zoom Hand #258027299719:  Hold'em No Limit (€0.01/€0.02) [ADM ID: M62BD3044A1E13PD] - 2025/10/07 0:39:07 CET [2025/10/06 18:39:07 ET]
Table 'Sirio' 6-max Seat #1 is the button
Seat 1: caduceus369 (€3.65 in chips) 
Seat 2: jhonnystecco8 (€3.35 in chips) 
Seat 3: montemeru (€2.42 in chips) 
Seat 4: Parker853 (€1.56 in chips) 
Seat 5: Wildag00 (€1.59 in chips) 
jhonnystecco8: posts small blind €0.01
montemeru: posts big blind €0.02
*** HOLE CARDS ***
Dealt to caduceus369 [Kd Jh]
Parker853: folds 
Wildag00: folds 
caduceus369: raises €0.04 to €0.06
jhonnystecco8: folds 
montemeru: calls €0.04
*** FLOP *** [Qc 3d 7h]
montemeru: checks 
caduceus369: checks 
*** TURN *** [Qc 3d 7h] [Tc]
montemeru: bets €0.07
caduceus369: calls €0.07
*** RIVER *** [Qc 3d 7h Tc] [Ad]
montemeru: checks 
caduceus369: bets €0.34
montemeru: folds 
Uncalled bet (€0.34) returned to caduceus369
caduceus369 collected €0.26 from pot
caduceus369: doesn't show hand 
*** SUMMARY ***
Total pot €0.27 | Rake €0.01 
Board [Qc 3d 7h Tc Ad]
Seat 1: caduceus369 (button) collected (€0.26)
Seat 2: jhonnystecco8 (small blind) folded before Flop
Seat 3: montemeru (big blind) folded on the River
Seat 4: Parker853 folded before Flop (didn't bet)
Seat 5: Wildag00 folded before Flop (didn't bet)



PokerStars Zoom Hand #258027310144:  Hold'em No Limit (€0.01/€0.02) [ADM ID: M62BD3044A1E13PD] - 2025/10/07 0:39:58 CET [2025/10/06 18:39:58 ET]
Table 'Sirio' 6-max Seat #1 is the button
Seat 1: M@verick781 (€9.03 in chips) 
Seat 2: SebaRapy14 (€4.65 in chips) 
Seat 3: IKARO_3 (€12.13 in chips) 
Seat 4: jhonnystecco8 (€3.14 in chips) 
Seat 5: caduceus369 (€3.78 in chips) 
Seat 6: Wildag00 (€1.56 in chips) 
SebaRapy14: posts small blind €0.01
IKARO_3: posts big blind €0.02
*** HOLE CARDS ***
Dealt to caduceus369 [Td Ad]
jhonnystecco8: folds 
caduceus369: raises €0.04 to €0.06
Wildag00: calls €0.06
M@verick781: folds 
SebaRapy14: raises €0.24 to €0.30
IKARO_3: folds 
caduceus369: folds 
Wildag00: folds 
Uncalled bet (€0.24) returned to SebaRapy14
SebaRapy14 collected €0.20 from pot
SebaRapy14: doesn't show hand 
*** SUMMARY ***
Total pot €0.20 | Rake €0 
Seat 1: M@verick781 (button) folded before Flop (didn't bet)
Seat 2: SebaRapy14 (small blind) collected (€0.20)
Seat 3: IKARO_3 (big blind) folded before Flop
Seat 4: jhonnystecco8 folded before Flop (didn't bet)
Seat 5: caduceus369 folded before Flop
Seat 6: Wildag00 folded before Flop



PokerStars Zoom Hand #258027319455:  Hold'em No Limit (€0.01/€0.02) [ADM ID: M62BD3044A1E13PD] - 2025/10/07 0:40:44 CET [2025/10/06 18:40:44 ET]
Table 'Sirio' 6-max Seat #1 is the button
Seat 1: Parker853 (€1.71 in chips) 
Seat 2: Wildag00 (€5.15 in chips) 
Seat 3: caduceus369 (€3.72 in chips) 
Seat 4: M@verick781 (€9.11 in chips) 
Seat 5: mashallahh (€5.15 in chips) 
Seat 6: SebaRapy14 (€4.79 in chips) 
Wildag00: posts small blind €0.01
caduceus369: posts big blind €0.02
*** HOLE CARDS ***
Dealt to caduceus369 [Js 5h]
M@verick781: folds 
mashallahh: raises €0.04 to €0.06
SebaRapy14: folds 
Parker853: folds 
Wildag00: folds 
caduceus369: folds 
Uncalled bet (€0.04) returned to mashallahh
mashallahh collected €0.05 from pot
mashallahh: doesn't show hand 
*** SUMMARY ***
Total pot €0.05 | Rake €0 
Seat 1: Parker853 (button) folded before Flop (didn't bet)
Seat 2: Wildag00 (small blind) folded before Flop
Seat 3: caduceus369 (big blind) folded before Flop
Seat 4: M@verick781 folded before Flop (didn't bet)
Seat 5: mashallahh collected (€0.05)
Seat 6: SebaRapy14 folded before Flop (didn't bet)



PokerStars Zoom Hand #258027321661:  Hold'em No Limit (€0.01/€0.02) [ADM ID: M62BD3044A1E13PD] - 2025/10/07 0:40:55 CET [2025/10/06 18:40:55 ET]
Table 'Sirio' 6-max Seat #1 is the button
Seat 1: IKARO_3 (€2.46 in chips) 
Seat 2: montemeru (€2.24 in chips) 
Seat 3: M@verick781 (€2.10 in chips) 
Seat 4: caduceus369 (€3.70 in chips) 
Seat 5: jhonnystecco8 (€3.11 in chips) 
Seat 6: gigysk (€1.90 in chips) 
montemeru: posts small blind €0.01
M@verick781: posts big blind €0.02
*** HOLE CARDS ***
Dealt to caduceus369 [Js 4d]
caduceus369: folds 
jhonnystecco8: folds 
gigysk has timed out
gigysk: folds 
IKARO_3: folds 
montemeru: folds 
Uncalled bet (€0.01) returned to M@verick781
M@verick781 collected €0.02 from pot
M@verick781: doesn't show hand 
*** SUMMARY ***
Total pot €0.02 | Rake €0 
Seat 1: IKARO_3 (button) folded before Flop (didn't bet)
Seat 2: montemeru (small blind) folded before Flop
Seat 3: M@verick781 (big blind) collected (€0.02)
Seat 4: caduceus369 folded before Flop (didn't bet)
Seat 5: jhonnystecco8 folded before Flop (didn't bet)
Seat 6: gigysk folded before Flop (didn't bet)



PokerStars Zoom Hand #258027322663:  Hold'em No Limit (€0.01/€0.02) [ADM ID: M62BD3044A1E13PD] - 2025/10/07 0:41:00 CET [2025/10/06 18:41:00 ET]
Table 'Sirio' 6-max Seat #1 is the button
Seat 1: montemeru (€1.75 in chips) 
Seat 2: caduceus369 (€3.70 in chips) 
Seat 3: jhonnystecco8 (€3.11 in chips) 
Seat 4: mashallahh (€7.32 in chips) 
Seat 5: stfuplzudonk (€3.19 in chips) 
caduceus369: posts small blind €0.01
jhonnystecco8: posts big blind €0.02
*** HOLE CARDS ***
Dealt to caduceus369 [8d 8s]
mashallahh: folds 
stfuplzudonk: folds 
montemeru: folds 
caduceus369: raises €0.04 to €0.06
jhonnystecco8: raises €0.12 to €0.18
caduceus369: calls €0.12
*** FLOP *** [5c Ah Jd]
caduceus369: checks 
jhonnystecco8: bets €0.14
caduceus369: calls €0.14
*** TURN *** [5c Ah Jd] [8c]
caduceus369: checks 
jhonnystecco8: bets €0.37
caduceus369: calls €0.37
*** RIVER *** [5c Ah Jd 8c] [6s]
caduceus369: bets €0.32
jhonnystecco8 has timed out
jhonnystecco8: folds 
Uncalled bet (€0.32) returned to caduceus369
caduceus369 collected €1.31 from pot
caduceus369: doesn't show hand 
*** SUMMARY ***
Total pot €1.38 | Rake €0.07 
Board [5c Ah Jd 8c 6s]
Seat 1: montemeru (button) folded before Flop (didn't bet)
Seat 2: caduceus369 (small blind) collected (€1.31)
Seat 3: jhonnystecco8 (big blind) folded on the River
Seat 4: mashallahh folded before Flop (didn't bet)
Seat 5: stfuplzudonk folded before Flop (didn't bet)



PokerStars Zoom Hand #258027360106:  Hold'em No Limit (€0.01/€0.02) [ADM ID: M62BD3044A1E13PD] - 2025/10/07 0:44:08 CET [2025/10/06 18:44:08 ET]
Table 'Sirio' 6-max Seat #1 is the button
Seat 1: caduceus369 (€4.32 in chips) 
Seat 2: jhonnystecco8 (€2.42 in chips) 
Seat 3: RRgalp (€3.28 in chips) 
Seat 4: Poetto65 (€1.65 in chips) 
Seat 5: Wildag00 (€5.46 in chips) 
Seat 6: montemeru (€1.81 in chips) 
jhonnystecco8: posts small blind €0.01
RRgalp: posts big blind €0.02
*** HOLE CARDS ***
Dealt to caduceus369 [5s 6d]
Poetto65: folds 
Wildag00: folds 
montemeru: raises €0.04 to €0.06
caduceus369: folds 
jhonnystecco8: folds 
RRgalp: folds 
Uncalled bet (€0.04) returned to montemeru
montemeru collected €0.05 from pot
montemeru: doesn't show hand 
*** SUMMARY ***
Total pot €0.05 | Rake €0 
Seat 1: caduceus369 (button) folded before Flop (didn't bet)
Seat 2: jhonnystecco8 (small blind) folded before Flop
Seat 3: RRgalp (big blind) folded before Flop
Seat 4: Poetto65 folded before Flop (didn't bet)
Seat 5: Wildag00 folded before Flop (didn't bet)
Seat 6: montemeru collected (€0.05)



PokerStars Zoom Hand #258027363519:  Hold'em No Limit (€0.01/€0.02) [ADM ID: M62BD3044A1E13PD] - 2025/10/07 0:44:26 CET [2025/10/06 18:44:26 ET]
Table 'Sirio' 6-max Seat #1 is the button
Seat 1: gigysk (€1.88 in chips) 
Seat 2: ermajico84 (€0.42 in chips) 
Seat 3: Wildag00 (€2.28 in chips) 
Seat 4: stfuplzudonk (€3.12 in chips) 
Seat 5: caduceus369 (€4.32 in chips) 
ermajico84: posts small blind €0.01
Wildag00: posts big blind €0.02
*** HOLE CARDS ***
Dealt to caduceus369 [4d 7s]
stfuplzudonk: raises €0.02 to €0.04
caduceus369: folds 
gigysk: folds 
ermajico84: calls €0.03
Wildag00: calls €0.02
*** FLOP *** [Ad Kh 8d]
ermajico84: checks 
Wildag00: checks 
stfuplzudonk: checks 
*** TURN *** [Ad Kh 8d] [5d]
ermajico84: bets €0.02
Wildag00: calls €0.02
stfuplzudonk: calls €0.02
*** RIVER *** [Ad Kh 8d 5d] [Qc]
ermajico84: bets €0.02
Wildag00: folds 
stfuplzudonk: calls €0.02
*** SHOW DOWN ***
ermajico84: shows [Kd Th] (a pair of Kings)
stfuplzudonk: shows [2c Ac] (a pair of Aces)
stfuplzudonk collected €0.21 from pot
*** SUMMARY ***
Total pot €0.22 | Rake €0.01 
Board [Ad Kh 8d 5d Qc]
Seat 1: gigysk (button) folded before Flop (didn't bet)
Seat 2: ermajico84 (small blind) showed [Kd Th] and lost with a pair of Kings
Seat 3: Wildag00 (big blind) folded on the River
Seat 4: stfuplzudonk showed [2c Ac] and won (€0.21) with a pair of Aces
Seat 5: caduceus369 folded before Flop (didn't bet)



PokerStars Zoom Hand #258027370204:  Hold'em No Limit (€0.01/€0.02) [ADM ID: M62BD3044A1E13PD] - 2025/10/07 0:45:00 CET [2025/10/06 18:45:00 ET]
Table 'Sirio' 6-max Seat #1 is the button
Seat 1: IKARO_3 (€21.65 in chips) 
Seat 2: andrea73b16 (€2.16 in chips) 
Seat 3: caduceus369 (€4.32 in chips) 
Seat 4: M@verick781 (€0.83 in chips) 
Seat 5: stfuplzudonk (€4.52 in chips) 
andrea73b16: posts small blind €0.01
caduceus369: posts big blind €0.02
*** HOLE CARDS ***
Dealt to caduceus369 [Ac 9c]
M@verick781: raises €0.81 to €0.83 and is all-in
stfuplzudonk: folds 
IKARO_3: folds 
andrea73b16: folds 
caduceus369: folds 
Uncalled bet (€0.81) returned to M@verick781
M@verick781 collected €0.05 from pot
M@verick781: doesn't show hand 
*** SUMMARY ***
Total pot €0.05 | Rake €0 
Seat 1: IKARO_3 (button) folded before Flop (didn't bet)
Seat 2: andrea73b16 (small blind) folded before Flop
Seat 3: caduceus369 (big blind) folded before Flop
Seat 4: M@verick781 collected (€0.05)
Seat 5: stfuplzudonk folded before Flop (didn't bet)



PokerStars Zoom Hand #258027373660:  Hold'em No Limit (€0.01/€0.02) [ADM ID: M62BD3044A1E13PD] - 2025/10/07 0:45:18 CET [2025/10/06 18:45:18 ET]
Table 'Sirio' 6-max Seat #1 is the button
Seat 1: J0HN-BR0WN (€7.37 in chips) 
Seat 2: stfuplzudonk (€3.81 in chips) 
Seat 3: GraviiTy10 (€4.89 in chips) 
Seat 4: caduceus369 (€4.30 in chips) 
Seat 5: M@verick781 (€0.86 in chips) 
stfuplzudonk: posts small blind €0.01
GraviiTy10: posts big blind €0.02
*** HOLE CARDS ***
Dealt to caduceus369 [5c 4c]
caduceus369: folds 
M@verick781: raises €0.82 to €0.84
J0HN-BR0WN: calls €0.84
stfuplzudonk: folds 
GraviiTy10: folds 
*** FLOP *** [3h Ts 2s]
M@verick781: bets €0.02 and is all-in
J0HN-BR0WN: calls €0.02
*** TURN *** [3h Ts 2s] [Kc]
*** RIVER *** [3h Ts 2s Kc] [Th]
*** SHOW DOWN ***
M@verick781: shows [Ac 9c] (a pair of Tens)
J0HN-BR0WN: shows [Qs As] (a pair of Tens - Ace+King+Queen kicker)
J0HN-BR0WN collected €1.66 from pot
*** SUMMARY ***
Total pot €1.75 | Rake €0.09 
Board [3h Ts 2s Kc Th]
Seat 1: J0HN-BR0WN (button) showed [Qs As] and won (€1.66) with a pair of Tens
Seat 2: stfuplzudonk (small blind) folded before Flop
Seat 3: GraviiTy10 (big blind) folded before Flop
Seat 4: caduceus369 folded before Flop (didn't bet)
Seat 5: M@verick781 showed [Ac 9c] and lost with a pair of Tens



PokerStars Zoom Hand #258027365459:  Hold'em No Limit (€0.01/€0.02) [ADM ID: M62BD3044A1E13PD] - 2025/10/07 0:44:36 CET [2025/10/06 18:44:36 ET]
Table 'Sirio' 6-max Seat #1 is the button
Seat 1: RRgalp (€3.26 in chips) 
Seat 2: IKARO_3 (€21.66 in chips) 
Seat 3: montemeru (€1.73 in chips) 
Seat 4: caduceus369 (€4.32 in chips) 
Seat 5: mashallahh (€5.04 in chips) 
IKARO_3: posts small blind €0.01
montemeru: posts big blind €0.02
*** HOLE CARDS ***
Dealt to caduceus369 [9s Ts]
caduceus369: folds 
mashallahh: raises €0.04 to €0.06
montemeru is disconnected 
RRgalp: raises €0.12 to €0.18
IKARO_3: folds 
montemeru has timed out while disconnected
montemeru: folds 
mashallahh: folds 
Uncalled bet (€0.12) returned to RRgalp
RRgalp collected €0.15 from pot
RRgalp: doesn't show hand 
*** SUMMARY ***
Total pot €0.15 | Rake €0 
Seat 1: RRgalp (button) collected (€0.15)
Seat 2: IKARO_3 (small blind) folded before Flop
Seat 3: montemeru (big blind) folded before Flop
Seat 4: caduceus369 folded before Flop (didn't bet)
Seat 5: mashallahh folded before Flop



PokerStars Zoom Hand #258027374423:  Hold'em No Limit (€0.01/€0.02) [ADM ID: M62BD3044A1E13PD] - 2025/10/07 0:45:22 CET [2025/10/06 18:45:22 ET]
Table 'Sirio' 6-max Seat #1 is the button
Seat 1: Wildag00 (€7.65 in chips) 
Seat 2: caduceus369 (€4.30 in chips) 
Seat 3: mashallahh (€4.98 in chips) 
Seat 4: gigysk (€1.83 in chips) 
Seat 5: stfuplzudonk (€4.52 in chips) 
caduceus369: posts small blind €0.01
mashallahh: posts big blind €0.02
*** HOLE CARDS ***
Dealt to caduceus369 [2s 3c]
gigysk: calls €0.02
stfuplzudonk: folds 
Wildag00: folds 
caduceus369: folds 
mashallahh: checks 
*** FLOP *** [9s Jh Td]
mashallahh: bets €0.02
gigysk: calls €0.02
*** TURN *** [9s Jh Td] [4d]
mashallahh: checks 
gigysk: checks 
*** RIVER *** [9s Jh Td 4d] [Ac]
mashallahh: checks 
gigysk: checks 
*** SHOW DOWN ***
mashallahh: shows [Qs 4c] (a pair of Fours)
gigysk: shows [Ad 8s] (a pair of Aces)
gigysk collected €0.09 from pot
*** SUMMARY ***
Total pot €0.09 | Rake €0 
Board [9s Jh Td 4d Ac]
Seat 1: Wildag00 (button) folded before Flop (didn't bet)
Seat 2: caduceus369 (small blind) folded before Flop
Seat 3: mashallahh (big blind) showed [Qs 4c] and lost with a pair of Fours
Seat 4: gigysk showed [Ad 8s] and won (€0.09) with a pair of Aces
Seat 5: stfuplzudonk folded before Flop (didn't bet)



PokerStars Zoom Hand #258027376884:  Hold'em No Limit (€0.01/€0.02) [ADM ID: M62BD3044A1E13PD] - 2025/10/07 0:45:35 CET [2025/10/06 18:45:35 ET]
Table 'Sirio' 6-max Seat #1 is the button
Seat 1: caduceus369 (€4.29 in chips) 
Seat 2: stfuplzudonk (€2.41 in chips) 
Seat 3: M@verick781 (€2.28 in chips) 
Seat 4: SebaRapy14 (€5.14 in chips) 
Seat 5: Wildag00 (€7.65 in chips) 
Seat 6: mashallahh (€4.41 in chips) 
stfuplzudonk: posts small blind €0.01
M@verick781: posts big blind €0.02
*** HOLE CARDS ***
Dealt to caduceus369 [2h As]
SebaRapy14: folds 
Wildag00: folds 
mashallahh: raises €0.04 to €0.06
caduceus369: folds 
stfuplzudonk: folds 
M@verick781: raises €0.20 to €0.26
mashallahh: raises €0.60 to €0.86
M@verick781: calls €0.60
*** FLOP *** [Qd 2d 6c]
M@verick781: checks 
mashallahh: bets €1.64
M@verick781: folds 
Uncalled bet (€1.64) returned to mashallahh
mashallahh collected €1.64 from pot
mashallahh: doesn't show hand 
*** SUMMARY ***
Total pot €1.73 | Rake €0.09 
Board [Qd 2d 6c]
Seat 1: caduceus369 (button) folded before Flop (didn't bet)
Seat 2: stfuplzudonk (small blind) folded before Flop
Seat 3: M@verick781 (big blind) folded on the Flop
Seat 4: SebaRapy14 folded before Flop (didn't bet)
Seat 5: Wildag00 folded before Flop (didn't bet)
Seat 6: mashallahh collected (€1.64)



PokerStars Zoom Hand #258027377826:  Hold'em No Limit (€0.01/€0.02) [ADM ID: M62BD3044A1E13PD] - 2025/10/07 0:45:40 CET [2025/10/06 18:45:40 ET]
Table 'Sirio' 6-max Seat #1 is the button
Seat 1: xTheBulldogx (€0.66 in chips) 
Seat 2: SebaRapy14 (€5.14 in chips) 
Seat 3: Wildag00 (€7.65 in chips) 
Seat 4: caduceus369 (€4.29 in chips) 
Seat 5: IKARO_3 (€2 in chips) 
SebaRapy14: posts small blind €0.01
Wildag00: posts big blind €0.02
*** HOLE CARDS ***
Dealt to caduceus369 [Ah Qc]
caduceus369: raises €0.04 to €0.06
IKARO_3: folds 
xTheBulldogx: calls €0.06
SebaRapy14: calls €0.05
Wildag00: calls €0.04
*** FLOP *** [Jc 8h 4d]
SebaRapy14: checks 
Wildag00: checks 
caduceus369: checks 
xTheBulldogx: checks 
*** TURN *** [Jc 8h 4d] [3h]
SebaRapy14: checks 
Wildag00: checks 
caduceus369: checks 
xTheBulldogx: checks 
*** RIVER *** [Jc 8h 4d 3h] [2d]
SebaRapy14: bets €0.11
Wildag00: folds 
caduceus369: folds 
xTheBulldogx: folds 
Uncalled bet (€0.11) returned to SebaRapy14
SebaRapy14 collected €0.23 from pot
SebaRapy14: doesn't show hand 
*** SUMMARY ***
Total pot €0.24 | Rake €0.01 
Board [Jc 8h 4d 3h 2d]
Seat 1: xTheBulldogx (button) folded on the River
Seat 2: SebaRapy14 (small blind) collected (€0.23)
Seat 3: Wildag00 (big blind) folded on the River
Seat 4: caduceus369 folded on the River
Seat 5: IKARO_3 folded before Flop (didn't bet)



PokerStars Zoom Hand #258027395206:  Hold'em No Limit (€0.01/€0.02) [ADM ID: M62BD3044A1E13PD] - 2025/10/07 0:47:09 CET [2025/10/06 18:47:09 ET]
Table 'Sirio' 6-max Seat #1 is the button
Seat 1: Giampon78 (€1.86 in chips) 
Seat 2: M@verick781 (€17.47 in chips) 
Seat 3: mashallahh (€5.22 in chips) 
Seat 4: heitel (€2.84 in chips) 
Seat 5: caduceus369 (€4.21 in chips) 
M@verick781: posts small blind €0.01
mashallahh: posts big blind €0.02
*** HOLE CARDS ***
Dealt to caduceus369 [Ks 6c]
heitel: folds 
caduceus369: folds 
Giampon78: folds 
M@verick781: raises €0.04 to €0.06
mashallahh: folds 
Uncalled bet (€0.04) returned to M@verick781
M@verick781 collected €0.04 from pot
M@verick781: doesn't show hand 
*** SUMMARY ***
Total pot €0.04 | Rake €0 
Seat 1: Giampon78 (button) folded before Flop (didn't bet)
Seat 2: M@verick781 (small blind) collected (€0.04)
Seat 3: mashallahh (big blind) folded before Flop
Seat 4: heitel folded before Flop (didn't bet)
Seat 5: caduceus369 folded before Flop (didn't bet)



PokerStars Zoom Hand #258027395872:  Hold'em No Limit (€0.01/€0.02) [ADM ID: M62BD3044A1E13PD] - 2025/10/07 0:47:12 CET [2025/10/06 18:47:12 ET]
Table 'Sirio' 6-max Seat #1 is the button
Seat 1: heitel (€2.84 in chips) 
Seat 2: caduceus369 (€4.21 in chips) 
Seat 3: QUATTRODAME (€1.52 in chips) 
Seat 4: mashallahh (€4.31 in chips) 
Seat 5: Giampon78 (€1.86 in chips) 
Seat 6: J0HN-BR0WN (€8.32 in chips) 
caduceus369: posts small blind €0.01
QUATTRODAME: posts big blind €0.02
*** HOLE CARDS ***
Dealt to caduceus369 [3h 3s]
mashallahh: folds 
Giampon78: folds 
J0HN-BR0WN: raises €0.04 to €0.06
heitel: folds 
caduceus369: folds 
QUATTRODAME is disconnected 
QUATTRODAME has timed out while disconnected
QUATTRODAME: folds 
Uncalled bet (€0.04) returned to J0HN-BR0WN
J0HN-BR0WN collected €0.05 from pot
J0HN-BR0WN: doesn't show hand 
*** SUMMARY ***
Total pot €0.05 | Rake €0 
Seat 1: heitel (button) folded before Flop (didn't bet)
Seat 2: caduceus369 (small blind) folded before Flop
Seat 3: QUATTRODAME (big blind) folded before Flop
Seat 4: mashallahh folded before Flop (didn't bet)
Seat 5: Giampon78 folded before Flop (didn't bet)
Seat 6: J0HN-BR0WN collected (€0.05)



PokerStars Zoom Hand #258027390943:  Hold'em No Limit (€0.01/€0.02) [ADM ID: M62BD3044A1E13PD] - 2025/10/07 0:46:47 CET [2025/10/06 18:46:47 ET]
Table 'Sirio' 6-max Seat #1 is the button
Seat 1: IKARO_3 (€1.97 in chips) 
Seat 2: stfuplzudonk (€4.39 in chips) 
Seat 3: caduceus369 (€4.23 in chips) 
Seat 4: mashallahh (€4.93 in chips) 
Seat 5: Wildag00 (€7.59 in chips) 
Seat 6: Clajito17 (€2.01 in chips) 
stfuplzudonk: posts small blind €0.01
caduceus369: posts big blind €0.02
*** HOLE CARDS ***
Dealt to caduceus369 [2h Ts]
mashallahh: folds 
Wildag00: raises €0.03 to €0.05
Clajito17: folds 
IKARO_3: raises €0.13 to €0.18
stfuplzudonk: folds 
caduceus369: folds 
Wildag00: calls €0.13
*** FLOP *** [Jd Ac Kh]
Wildag00: checks 
IKARO_3: checks 
*** TURN *** [Jd Ac Kh] [Kc]
Wildag00: bets €0.12
IKARO_3: calls €0.12
*** RIVER *** [Jd Ac Kh Kc] [Td]
Wildag00: checks 
IKARO_3: checks 
*** SHOW DOWN ***
Wildag00: shows [6d Ad] (two pair, Aces and Kings)
IKARO_3: shows [4h Ah] (two pair, Aces and Kings)
Wildag00 collected €0.30 from pot
IKARO_3 collected €0.30 from pot
*** SUMMARY ***
Total pot €0.63 | Rake €0.03 
Board [Jd Ac Kh Kc Td]
Seat 1: IKARO_3 (button) showed [4h Ah] and won (€0.30) with two pair, Aces and Kings
Seat 2: stfuplzudonk (small blind) folded before Flop
Seat 3: caduceus369 (big blind) folded before Flop
Seat 4: mashallahh folded before Flop (didn't bet)
Seat 5: Wildag00 showed [6d Ad] and won (€0.30) with two pair, Aces and Kings
Seat 6: Clajito17 folded before Flop (didn't bet)



PokerStars Zoom Hand #258027396802:  Hold'em No Limit (€0.01/€0.02) [ADM ID: M62BD3044A1E13PD] - 2025/10/07 0:47:17 CET [2025/10/06 18:47:17 ET]
Table 'Sirio' 6-max Seat #1 is the button
Seat 1: caduceus369 (€4.20 in chips) 
Seat 2: Kapiushon25 (€1.08 in chips) 
Seat 3: mashallahh (€4.93 in chips) 
Seat 4: heitel (€2.84 in chips) 
Seat 5: stfuplzudonk (€3.77 in chips) 
Seat 6: IKARO_3 (€2.39 in chips) 
Kapiushon25: posts small blind €0.01
mashallahh: posts big blind €0.02
*** HOLE CARDS ***
Dealt to caduceus369 [6s 5s]
heitel: raises €0.04 to €0.06
stfuplzudonk: calls €0.06
IKARO_3 has timed out
IKARO_3: folds 
caduceus369: folds 
Kapiushon25: folds 
mashallahh: folds 
*** FLOP *** [Ks 7d 5c]
heitel: bets €0.15
stfuplzudonk: folds 
Uncalled bet (€0.15) returned to heitel
heitel collected €0.15 from pot
heitel: doesn't show hand 
*** SUMMARY ***
Total pot €0.15 | Rake €0 
Board [Ks 7d 5c]
Seat 1: caduceus369 (button) folded before Flop (didn't bet)
Seat 2: Kapiushon25 (small blind) folded before Flop
Seat 3: mashallahh (big blind) folded before Flop
Seat 4: heitel collected (€0.15)
Seat 5: stfuplzudonk folded on the Flop
Seat 6: IKARO_3 folded before Flop (didn't bet)



PokerStars Zoom Hand #258027407339:  Hold'em No Limit (€0.01/€0.02) [ADM ID: M62BD3044A1E13PD] - 2025/10/07 0:48:11 CET [2025/10/06 18:48:11 ET]
Table 'Sirio' 6-max Seat #1 is the button
Seat 1: M@verick781 (€2 in chips) 
Seat 2: ermajico84 (€0.76 in chips) 
Seat 3: QUATTRODAME (€1.50 in chips) 
Seat 4: mashallahh (€7.59 in chips) 
Seat 5: caduceus369 (€4.02 in chips) 
Seat 6: IKARO_3 (€1.97 in chips) 
ermajico84: posts small blind €0.01
QUATTRODAME: posts big blind €0.02
*** HOLE CARDS ***
Dealt to caduceus369 [7c Ac]
mashallahh: folds 
caduceus369: raises €0.04 to €0.06
IKARO_3: folds 
M@verick781: raises €0.12 to €0.18
ermajico84: folds 
QUATTRODAME: folds 
caduceus369: calls €0.12
*** FLOP *** [Jc Kh Kc]
caduceus369: checks 
M@verick781: checks 
*** TURN *** [Jc Kh Kc] [Jh]
caduceus369: bets €0.15
M@verick781: raises €0.15 to €0.30
caduceus369: calls €0.15
*** RIVER *** [Jc Kh Kc Jh] [Ad]
caduceus369: checks 
M@verick781: bets €0.71
caduceus369: folds 
Uncalled bet (€0.71) returned to M@verick781
M@verick781 collected €0.94 from pot
M@verick781: doesn't show hand 
*** SUMMARY ***
Total pot €0.99 | Rake €0.05 
Board [Jc Kh Kc Jh Ad]
Seat 1: M@verick781 (button) collected (€0.94)
Seat 2: ermajico84 (small blind) folded before Flop
Seat 3: QUATTRODAME (big blind) folded before Flop
Seat 4: mashallahh folded before Flop (didn't bet)
Seat 5: caduceus369 folded on the River
Seat 6: IKARO_3 folded before Flop (didn't bet)



PokerStars Zoom Hand #258027425707:  Hold'em No Limit (€0.01/€0.02) [ADM ID: M62BD3044A1E13PD] - 2025/10/07 0:49:46 CET [2025/10/06 18:49:46 ET]
Table 'Sirio' 6-max Seat #1 is the button
Seat 1: QUATTRODAME (€1.43 in chips) 
Seat 2: jhonnystecco8 (€1.88 in chips) 
Seat 3: KindRonin (€1.36 in chips) 
Seat 4: andrea73b16 (€2 in chips) 
Seat 5: J0HN-BR0WN (€8.18 in chips) 
Seat 6: caduceus369 (€3.54 in chips) 
jhonnystecco8: posts small blind €0.01
KindRonin: posts big blind €0.02
*** HOLE CARDS ***
Dealt to caduceus369 [9s Kc]
andrea73b16: raises €0.04 to €0.06
J0HN-BR0WN: folds 
caduceus369: folds 
QUATTRODAME: folds 
jhonnystecco8: folds 
KindRonin: folds 
Uncalled bet (€0.04) returned to andrea73b16
andrea73b16 collected €0.05 from pot
andrea73b16: doesn't show hand 
*** SUMMARY ***
Total pot €0.05 | Rake €0 
Seat 1: QUATTRODAME (button) folded before Flop (didn't bet)
Seat 2: jhonnystecco8 (small blind) folded before Flop
Seat 3: KindRonin (big blind) folded before Flop
Seat 4: andrea73b16 collected (€0.05)
Seat 5: J0HN-BR0WN folded before Flop (didn't bet)
Seat 6: caduceus369 folded before Flop (didn't bet)



PokerStars Zoom Hand #258027426724:  Hold'em No Limit (€0.01/€0.02) [ADM ID: M62BD3044A1E13PD] - 2025/10/07 0:49:51 CET [2025/10/06 18:49:51 ET]
Table 'Sirio' 6-max Seat #1 is the button
Seat 1: Wildag00 (€7.55 in chips) 
Seat 2: KindRonin (€1.34 in chips) 
Seat 3: caduceus369 (€3.54 in chips) 
Seat 4: QUATTRODAME (€1.43 in chips) 
Seat 5: mashallahh (€5.13 in chips) 
Seat 6: jhonnystecco8 (€1.87 in chips) 
KindRonin: posts small blind €0.01
caduceus369: posts big blind €0.02
*** HOLE CARDS ***
Dealt to caduceus369 [Jd Qc]
QUATTRODAME: folds 
mashallahh: folds 
jhonnystecco8: folds 
Wildag00: folds 
KindRonin: raises €0.02 to €0.04
caduceus369: calls €0.02
*** FLOP *** [Qd Jc 8h]
KindRonin: bets €0.04
caduceus369: calls €0.04
*** TURN *** [Qd Jc 8h] [5s]
KindRonin: bets €0.08
caduceus369: calls €0.08
*** RIVER *** [Qd Jc 8h 5s] [9d]
KindRonin: checks 
caduceus369: checks 
*** SHOW DOWN ***
KindRonin: shows [Jh Kc] (a pair of Jacks)
caduceus369: shows [Jd Qc] (two pair, Queens and Jacks)
caduceus369 collected €0.31 from pot
*** SUMMARY ***
Total pot €0.32 | Rake €0.01 
Board [Qd Jc 8h 5s 9d]
Seat 1: Wildag00 (button) folded before Flop (didn't bet)
Seat 2: KindRonin (small blind) showed [Jh Kc] and lost with a pair of Jacks
Seat 3: caduceus369 (big blind) showed [Jd Qc] and won (€0.31) with two pair, Queens and Jacks
Seat 4: QUATTRODAME folded before Flop (didn't bet)
Seat 5: mashallahh folded before Flop (didn't bet)
Seat 6: jhonnystecco8 folded before Flop (didn't bet)



PokerStars Zoom Hand #258027439380:  Hold'em No Limit (€0.01/€0.02) [ADM ID: M62BD3044A1E13PD] - 2025/10/07 0:50:57 CET [2025/10/06 18:50:57 ET]
Table 'Sirio' 6-max Seat #1 is the button
Seat 1: stfuplzudonk (€4.31 in chips) 
Seat 2: jackkk03 (€2.57 in chips) 
Seat 3: TGolda (€3.25 in chips) 
Seat 4: caduceus369 (€3.69 in chips) 
Seat 5: heitel (€2.79 in chips) 
Seat 6: KindRonin (€1.18 in chips) 
jackkk03: posts small blind €0.01
TGolda: posts big blind €0.02
*** HOLE CARDS ***
Dealt to caduceus369 [Qs 3s]
caduceus369: folds 
heitel: folds 
KindRonin: folds 
stfuplzudonk: raises €0.02 to €0.04
jackkk03: folds 
TGolda: calls €0.02
*** FLOP *** [Ah Kc 9d]
TGolda: checks 
stfuplzudonk: checks 
*** TURN *** [Ah Kc 9d] [4d]
TGolda: bets €0.02
stfuplzudonk: calls €0.02
*** RIVER *** [Ah Kc 9d 4d] [5s]
TGolda: checks 
stfuplzudonk: checks 
*** SHOW DOWN ***
TGolda: shows [8d Ks] (a pair of Kings)
stfuplzudonk: shows [6s Ad] (a pair of Aces)
stfuplzudonk collected €0.13 from pot
*** SUMMARY ***
Total pot €0.13 | Rake €0 
Board [Ah Kc 9d 4d 5s]
Seat 1: stfuplzudonk (button) showed [6s Ad] and won (€0.13) with a pair of Aces
Seat 2: jackkk03 (small blind) folded before Flop
Seat 3: TGolda (big blind) showed [8d Ks] and lost with a pair of Kings
Seat 4: caduceus369 folded before Flop (didn't bet)
Seat 5: heitel folded before Flop (didn't bet)
Seat 6: KindRonin folded before Flop (didn't bet)



PokerStars Zoom Hand #258027440367:  Hold'em No Limit (€0.01/€0.02) [ADM ID: M62BD3044A1E13PD] - 2025/10/07 0:51:02 CET [2025/10/06 18:51:02 ET]
Table 'Sirio' 6-max Seat #1 is the button
Seat 1: Clajito17 (€1.88 in chips) 
Seat 2: caduceus369 (€3.69 in chips) 
Seat 3: dalailami (€0.80 in chips) 
Seat 4: mashallahh (€6.28 in chips) 
Seat 5: KindRonin (€1.18 in chips) 
Seat 6: Wildag00 (€3.65 in chips) 
caduceus369: posts small blind €0.01
dalailami: posts big blind €0.02
*** HOLE CARDS ***
Dealt to caduceus369 [Qc Ac]
mashallahh: folds 
KindRonin: folds 
Wildag00: folds 
Clajito17: calls €0.02
caduceus369: raises €0.08 to €0.10
dalailami: calls €0.08
Clajito17: folds 
*** FLOP *** [Jh 5c 7d]
caduceus369: checks 
dalailami: bets €0.12
caduceus369: folds 
Uncalled bet (€0.12) returned to dalailami
dalailami collected €0.21 from pot
dalailami: doesn't show hand 
*** SUMMARY ***
Total pot €0.22 | Rake €0.01 
Board [Jh 5c 7d]
Seat 1: Clajito17 (button) folded before Flop
Seat 2: caduceus369 (small blind) folded on the Flop
Seat 3: dalailami (big blind) collected (€0.21)
Seat 4: mashallahh folded before Flop (didn't bet)
Seat 5: KindRonin folded before Flop (didn't bet)
Seat 6: Wildag00 folded before Flop (didn't bet)



PokerStars Zoom Hand #258027438058:  Hold'em No Limit (€0.01/€0.02) [ADM ID: M62BD3044A1E13PD] - 2025/10/07 0:50:50 CET [2025/10/06 18:50:50 ET]
Table 'Sirio' 6-max Seat #1 is the button
Seat 1: KindRonin (€1.18 in chips) 
Seat 2: M@verick781 (€2.19 in chips) 
Seat 3: IKARO_3 (€2.29 in chips) 
Seat 4: caduceus369 (€3.69 in chips) 
Seat 5: jackkk03 (€2.57 in chips) 
Seat 6: mashallahh (€3.73 in chips) 
M@verick781: posts small blind €0.01
IKARO_3: posts big blind €0.02
*** HOLE CARDS ***
Dealt to caduceus369 [4h Tc]
caduceus369: folds 
jackkk03: folds 
mashallahh: raises €0.04 to €0.06
KindRonin: folds 
M@verick781: raises €0.20 to €0.26
IKARO_3: folds 
mashallahh: calls €0.20
*** FLOP *** [Ac 6s 5c]
M@verick781: checks 
mashallahh: bets €0.38
M@verick781: raises €0.38 to €0.76
mashallahh: raises €2.71 to €3.47 and is all-in
M@verick781: calls €1.17 and is all-in
Uncalled bet (€1.54) returned to mashallahh
*** TURN *** [Ac 6s 5c] [Ad]
*** RIVER *** [Ac 6s 5c Ad] [9h]
*** SHOW DOWN ***
M@verick781: shows [4c As] (three of a kind, Aces)
mashallahh: shows [8c 9c] (two pair, Aces and Nines)
M@verick781 collected €4.16 from pot
*** SUMMARY ***
Total pot €4.40 | Rake €0.24 
Board [Ac 6s 5c Ad 9h]
Seat 1: KindRonin (button) folded before Flop (didn't bet)
Seat 2: M@verick781 (small blind) showed [4c As] and won (€4.16) with three of a kind, Aces
Seat 3: IKARO_3 (big blind) folded before Flop
Seat 4: caduceus369 folded before Flop (didn't bet)
Seat 5: jackkk03 folded before Flop (didn't bet)
Seat 6: mashallahh showed [8c 9c] and lost with two pair, Aces and Nines



PokerStars Zoom Hand #258027449487:  Hold'em No Limit (€0.01/€0.02) [ADM ID: M62BD3044A1E13PD] - 2025/10/07 0:51:51 CET [2025/10/06 18:51:51 ET]
Table 'Sirio' 6-max Seat #1 is the button
Seat 1: montemeru (€2.18 in chips) 
Seat 2: QUATTRODAME (€1.35 in chips) 
Seat 3: caduceus369 (€3.59 in chips) 
Seat 4: SebaRapy14 (€9.51 in chips) 
Seat 5: M@verick781 (€4.16 in chips) 
Seat 6: IKARO_3 (€2.32 in chips) 
QUATTRODAME: posts small blind €0.01
caduceus369: posts big blind €0.02
*** HOLE CARDS ***
Dealt to caduceus369 [Kc 8c]
SebaRapy14: folds 
M@verick781: folds 
IKARO_3: folds 
montemeru: folds 
QUATTRODAME: folds 
Uncalled bet (€0.01) returned to caduceus369
caduceus369 collected €0.02 from pot
caduceus369: doesn't show hand 
*** SUMMARY ***
Total pot €0.02 | Rake €0 
Seat 1: montemeru (button) folded before Flop (didn't bet)
Seat 2: QUATTRODAME (small blind) folded before Flop
Seat 3: caduceus369 (big blind) collected (€0.02)
Seat 4: SebaRapy14 folded before Flop (didn't bet)
Seat 5: M@verick781 folded before Flop (didn't bet)
Seat 6: IKARO_3 folded before Flop (didn't bet)



PokerStars Zoom Hand #258027446694:  Hold'em No Limit (€0.01/€0.02) [ADM ID: M62BD3044A1E13PD] - 2025/10/07 0:51:36 CET [2025/10/06 18:51:36 ET]
Table 'Sirio' 6-max Seat #1 is the button
Seat 1: caduceus369 (€3.59 in chips) 
Seat 2: IKARO_3 (€2.33 in chips) 
Seat 3: mashallahh (€6.28 in chips) 
Seat 4: jhonnystecco8 (€1.97 in chips) 
Seat 5: QUATTRODAME (€1.35 in chips) 
Seat 6: Clajito17 (€1.85 in chips) 
IKARO_3: posts small blind €0.01
mashallahh: posts big blind €0.02
*** HOLE CARDS ***
Dealt to caduceus369 [5h 4c]
jhonnystecco8: folds 
QUATTRODAME: folds 
Clajito17: calls €0.02
caduceus369: folds 
IKARO_3: folds 
mashallahh: checks 
*** FLOP *** [9h 6h 3h]
mashallahh: checks 
Clajito17: checks 
*** TURN *** [9h 6h 3h] [Jh]
mashallahh: checks 
Clajito17: checks 
*** RIVER *** [9h 6h 3h Jh] [2h]
mashallahh: checks 
Clajito17: checks 
*** SHOW DOWN ***
mashallahh: shows [3d 5c] (a flush, Jack high)
Clajito17: shows [Kc Tc] (a flush, Jack high)
mashallahh collected €0.03 from pot
Clajito17 collected €0.02 from pot
*** SUMMARY ***
Total pot €0.05 | Rake €0 
Board [9h 6h 3h Jh 2h]
Seat 1: caduceus369 (button) folded before Flop (didn't bet)
Seat 2: IKARO_3 (small blind) folded before Flop
Seat 3: mashallahh (big blind) showed [3d 5c] and won (€0.03) with a flush, Jack high
Seat 4: jhonnystecco8 folded before Flop (didn't bet)
Seat 5: QUATTRODAME folded before Flop (didn't bet)
Seat 6: Clajito17 showed [Kc Tc] and won (€0.02) with a flush, Jack high



PokerStars Zoom Hand #258027448148:  Hold'em No Limit (€0.01/€0.02) [ADM ID: M62BD3044A1E13PD] - 2025/10/07 0:51:43 CET [2025/10/06 18:51:43 ET]
Table 'Sirio' 6-max Seat #1 is the button
Seat 1: KindRonin (€1.15 in chips) 
Seat 2: Kapiushon25 (€0.65 in chips) 
Seat 3: RRgalp (€6 in chips) 
Seat 4: jackkk03 (€2.53 in chips) 
Seat 5: caduceus369 (€3.59 in chips) 
Seat 6: SebaRapy14 (€9.51 in chips) 
Kapiushon25: posts small blind €0.01
RRgalp: posts big blind €0.02
*** HOLE CARDS ***
Dealt to caduceus369 [2s Jd]
jackkk03: calls €0.02
caduceus369: folds 
SebaRapy14: folds 
KindRonin: calls €0.02
Kapiushon25: calls €0.01
RRgalp: checks 
*** FLOP *** [5d 4h Qh]
Kapiushon25: bets €0.02
RRgalp: folds 
jackkk03: calls €0.02
KindRonin: calls €0.02
*** TURN *** [5d 4h Qh] [4c]
Kapiushon25: bets €0.02
jackkk03: calls €0.02
KindRonin: calls €0.02
*** RIVER *** [5d 4h Qh 4c] [Tc]
Kapiushon25: bets €0.02
jackkk03: calls €0.02
KindRonin: folds 
*** SHOW DOWN ***
Kapiushon25: shows [8h Ad] (a pair of Fours)
jackkk03: shows [Qs Jh] (two pair, Queens and Fours)
jackkk03 collected €0.23 from pot
*** SUMMARY ***
Total pot €0.24 | Rake €0.01 
Board [5d 4h Qh 4c Tc]
Seat 1: KindRonin (button) folded on the River
Seat 2: Kapiushon25 (small blind) showed [8h Ad] and lost with a pair of Fours
Seat 3: RRgalp (big blind) folded on the Flop
Seat 4: jackkk03 showed [Qs Jh] and won (€0.23) with two pair, Queens and Fours
Seat 5: caduceus369 folded before Flop (didn't bet)
Seat 6: SebaRapy14 folded before Flop (didn't bet)



PokerStars Zoom Hand #258027402625:  Hold'em No Limit (€0.01/€0.02) [ADM ID: M62BD3044A1E13PD] - 2025/10/07 0:47:47 CET [2025/10/06 18:47:47 ET]
Table 'Sirio' 6-max Seat #1 is the button
Seat 1: Kapiushon25 (€1.07 in chips) 
Seat 2: mashallahh (€4.91 in chips) 
Seat 3: Giampon78 (€1.81 in chips) 
Seat 4: M@verick781 (€17.64 in chips) 
Seat 5: xTheBulldogx (€0.58 in chips) 
Seat 6: caduceus369 (€4.20 in chips) 
mashallahh: posts small blind €0.01
Giampon78: posts big blind €0.02
*** HOLE CARDS ***
Dealt to caduceus369 [Ac Qh]
M@verick781: raises €0.04 to €0.06
xTheBulldogx: folds 
caduceus369: raises €0.12 to €0.18
Kapiushon25: folds 
mashallahh: folds 
Giampon78: calls €0.16
M@verick781: raises €0.55 to €0.73
caduceus369: folds 
Giampon78: calls €0.55
*** FLOP *** [6d 3h Qd]
Giampon78: checks 
M@verick781: bets €1.56
Giampon78 is disconnected 
Kapiushon25 is disconnected 
Giampon78 has timed out while disconnected
Giampon78: folds 
Uncalled bet (€1.56) returned to M@verick781
M@verick781 collected €1.56 from pot
M@verick781: doesn't show hand 
*** SUMMARY ***
Total pot €1.65 | Rake €0.09 
Board [6d 3h Qd]
Seat 1: Kapiushon25 (button) folded before Flop (didn't bet)
Seat 2: mashallahh (small blind) folded before Flop
Seat 3: Giampon78 (big blind) folded on the Flop
Seat 4: M@verick781 collected (€1.56)
Seat 5: xTheBulldogx folded before Flop (didn't bet)
Seat 6: caduceus369 folded before Flop



PokerStars Zoom Hand #258027454041:  Hold'em No Limit (€0.01/€0.02) [ADM ID: M62BD3044A1E13PD] - 2025/10/07 0:52:15 CET [2025/10/06 18:52:15 ET]
Table 'Sirio' 6-max Seat #1 is the button
Seat 1: caduceus369 (€3.59 in chips) 
Seat 2: mashallahh (€5.03 in chips) 
Seat 3: stfuplzudonk (€2.93 in chips) 
Seat 4: Clajito17 (€1.85 in chips) 
Seat 5: IKARO_3 (€2.32 in chips) 
Seat 6: ermajico84 (€0.43 in chips) 
mashallahh: posts small blind €0.01
stfuplzudonk: posts big blind €0.02
*** HOLE CARDS ***
Dealt to caduceus369 [2h 3s]
Clajito17: raises €1.83 to €1.85 and is all-in
IKARO_3: folds 
ermajico84: folds 
caduceus369: folds 
mashallahh: folds 
stfuplzudonk: folds 
Uncalled bet (€1.83) returned to Clajito17
Clajito17 collected €0.05 from pot
Clajito17: doesn't show hand 
*** SUMMARY ***
Total pot €0.05 | Rake €0 
Seat 1: caduceus369 (button) folded before Flop (didn't bet)
Seat 2: mashallahh (small blind) folded before Flop
Seat 3: stfuplzudonk (big blind) folded before Flop
Seat 4: Clajito17 collected (€0.05)
Seat 5: IKARO_3 folded before Flop (didn't bet)
Seat 6: ermajico84 folded before Flop (didn't bet)



PokerStars Zoom Hand #258027455619:  Hold'em No Limit (€0.01/€0.02) [ADM ID: M62BD3044A1E13PD] - 2025/10/07 0:52:24 CET [2025/10/06 18:52:24 ET]
Table 'Sirio' 6-max Seat #1 is the button
Seat 1: mashallahh (€5.58 in chips) 
Seat 2: gigysk (€0.75 in chips) 
Seat 3: jackkk03 (€2.68 in chips) 
Seat 4: ermajico84 (€0.43 in chips) 
Seat 5: IKARO_3 (€3.36 in chips) 
Seat 6: caduceus369 (€3.59 in chips) 
gigysk: posts small blind €0.01
jackkk03: posts big blind €0.02
*** HOLE CARDS ***
Dealt to caduceus369 [Qd 8d]
ermajico84: folds 
IKARO_3: folds 
caduceus369: raises €0.04 to €0.06
mashallahh: raises €0.18 to €0.24
gigysk: folds 
jackkk03: folds 
caduceus369: folds 
Uncalled bet (€0.18) returned to mashallahh
mashallahh collected €0.15 from pot
mashallahh: doesn't show hand 
*** SUMMARY ***
Total pot €0.15 | Rake €0 
Seat 1: mashallahh (button) collected (€0.15)
Seat 2: gigysk (small blind) folded before Flop
Seat 3: jackkk03 (big blind) folded before Flop
Seat 4: ermajico84 folded before Flop (didn't bet)
Seat 5: IKARO_3 folded before Flop (didn't bet)
Seat 6: caduceus369 folded before Flop



PokerStars Zoom Hand #258027452044:  Hold'em No Limit (€0.01/€0.02) [ADM ID: M62BD3044A1E13PD] - 2025/10/07 0:52:04 CET [2025/10/06 18:52:04 ET]
Table 'Sirio' 6-max Seat #1 is the button
Seat 1: RRgalp (€5.98 in chips) 
Seat 2: caduceus369 (€3.60 in chips) 
Seat 3: gigysk (€0.77 in chips) 
Seat 4: mashallahh (€2 in chips) 
Seat 5: stfuplzudonk (€2.93 in chips) 
Seat 6: IKARO_3 (€3.36 in chips) 
caduceus369: posts small blind €0.01
gigysk: posts big blind €0.02
*** HOLE CARDS ***
Dealt to caduceus369 [Js 6h]
mashallahh: calls €0.02
stfuplzudonk: folds 
IKARO_3: folds 
RRgalp: raises €0.04 to €0.06
caduceus369: folds 
gigysk: folds 
mashallahh: calls €0.04
*** FLOP *** [Kd 5s 5c]
mashallahh: checks 
RRgalp: checks 
*** TURN *** [Kd 5s 5c] [Tc]
mashallahh: checks 
RRgalp: bets €0.15
mashallahh: calls €0.15
*** RIVER *** [Kd 5s 5c Tc] [Ks]
mashallahh: checks 
RRgalp: checks 
*** SHOW DOWN ***
mashallahh: shows [7d 7s] (two pair, Kings and Sevens)
RRgalp: mucks hand 
mashallahh collected €0.43 from pot
*** SUMMARY ***
Total pot €0.45 | Rake €0.02 
Board [Kd 5s 5c Tc Ks]
Seat 1: RRgalp (button) mucked [Jc Qc]
Seat 2: caduceus369 (small blind) folded before Flop
Seat 3: gigysk (big blind) folded before Flop
Seat 4: mashallahh showed [7d 7s] and won (€0.43) with two pair, Kings and Sevens
Seat 5: stfuplzudonk folded before Flop (didn't bet)
Seat 6: IKARO_3 folded before Flop (didn't bet)



PokerStars Zoom Hand #258027459315:  Hold'em No Limit (€0.01/€0.02) [ADM ID: M62BD3044A1E13PD] - 2025/10/07 0:52:43 CET [2025/10/06 18:52:43 ET]
Table 'Sirio' 6-max Seat #1 is the button
Seat 1: jhonnystecco8 (€1.94 in chips) 
Seat 2: QUATTRODAME (€1.35 in chips) 
Seat 3: IKARO_3 (€3.36 in chips) 
Seat 4: caduceus369 (€3.53 in chips) 
Seat 5: mashallahh (€5.67 in chips) 
QUATTRODAME: posts small blind €0.01
IKARO_3: posts big blind €0.02
*** HOLE CARDS ***
Dealt to caduceus369 [4d 2s]
caduceus369: folds 
mashallahh: folds 
jhonnystecco8: raises €0.04 to €0.06
QUATTRODAME: calls €0.05
IKARO_3: folds 
*** FLOP *** [Tc Ac 8d]
QUATTRODAME: checks 
jhonnystecco8: bets €0.09
QUATTRODAME: calls €0.09
*** TURN *** [Tc Ac 8d] [3h]
QUATTRODAME: checks 
jhonnystecco8: checks 
*** RIVER *** [Tc Ac 8d 3h] [5d]
QUATTRODAME: bets €0.31
jhonnystecco8: calls €0.31
*** SHOW DOWN ***
QUATTRODAME: shows [Th Td] (three of a kind, Tens)
jhonnystecco8: mucks hand 
QUATTRODAME collected €0.89 from pot
*** SUMMARY ***
Total pot €0.94 | Rake €0.05 
Board [Tc Ac 8d 3h 5d]
Seat 1: jhonnystecco8 (button) mucked [As Js]
Seat 2: QUATTRODAME (small blind) showed [Th Td] and won (€0.89) with three of a kind, Tens
Seat 3: IKARO_3 (big blind) folded before Flop
Seat 4: caduceus369 folded before Flop (didn't bet)
Seat 5: mashallahh folded before Flop (didn't bet)



PokerStars Zoom Hand #258027460109:  Hold'em No Limit (€0.01/€0.02) [ADM ID: M62BD3044A1E13PD] - 2025/10/07 0:52:48 CET [2025/10/06 18:52:48 ET]
Table 'Sirio' 6-max Seat #1 is the button
Seat 1: caduceus369 (€3.53 in chips) 
Seat 2: Wildag00 (€8.50 in chips) 
Seat 3: Kapiushon25 (€1.11 in chips) 
Seat 4: mashallahh (€5.67 in chips) 
Seat 5: IKARO_3 (€2.29 in chips) 
Seat 6: Clint934 (€1.45 in chips) 
Wildag00: posts small blind €0.01
Kapiushon25: posts big blind €0.02
*** HOLE CARDS ***
Dealt to caduceus369 [Ah 7d]
mashallahh: folds 
IKARO_3: folds 
Clint934: calls €0.02
caduceus369: calls €0.02
Wildag00: folds 
Kapiushon25: checks 
*** FLOP *** [4c As 2h]
Kapiushon25: checks 
Clint934: bets €0.10
caduceus369: calls €0.10
Kapiushon25: calls €0.10
*** TURN *** [4c As 2h] [Jd]
Kapiushon25: checks 
Clint934: checks 
caduceus369: checks 
*** RIVER *** [4c As 2h Jd] [5s]
Kapiushon25: checks 
Clint934: checks 
caduceus369: checks 
*** SHOW DOWN ***
Kapiushon25: shows [7s 2d] (a pair of Deuces)
Clint934: mucks hand 
caduceus369: shows [Ah 7d] (a pair of Aces)
caduceus369 collected €0.35 from pot
*** SUMMARY ***
Total pot €0.37 | Rake €0.02 
Board [4c As 2h Jd 5s]
Seat 1: caduceus369 (button) showed [Ah 7d] and won (€0.35) with a pair of Aces
Seat 2: Wildag00 (small blind) folded before Flop
Seat 3: Kapiushon25 (big blind) showed [7s 2d] and lost with a pair of Deuces
Seat 4: mashallahh folded before Flop (didn't bet)
Seat 5: IKARO_3 folded before Flop (didn't bet)
Seat 6: Clint934 mucked [7h 9d]



PokerStars Zoom Hand #258027470719:  Hold'em No Limit (€0.01/€0.02) [ADM ID: M62BD3044A1E13PD] - 2025/10/07 0:53:44 CET [2025/10/06 18:53:44 ET]
Table 'Sirio' 6-max Seat #1 is the button
Seat 1: jackkk03 (€2.57 in chips) 
Seat 2: jhonnystecco8 (€1.48 in chips) 
Seat 3: caduceus369 (€3.76 in chips) 
Seat 4: QUATTRODAME (€1.78 in chips) 
Seat 5: Clint934 (€1.33 in chips) 
Seat 6: andrea73b16 (€2.08 in chips) 
jhonnystecco8: posts small blind €0.01
caduceus369: posts big blind €0.02
*** HOLE CARDS ***
Dealt to caduceus369 [7c 2h]
QUATTRODAME: folds 
Clint934: calls €0.02
andrea73b16: folds 
jackkk03: calls €0.02
jhonnystecco8: folds 
caduceus369: checks 
*** FLOP *** [5c 6h Js]
caduceus369: checks 
Clint934: bets €0.04
jackkk03: folds 
caduceus369: folds 
Uncalled bet (€0.04) returned to Clint934
Clint934 collected €0.07 from pot
Clint934: doesn't show hand 
*** SUMMARY ***
Total pot €0.07 | Rake €0 
Board [5c 6h Js]
Seat 1: jackkk03 (button) folded on the Flop
Seat 2: jhonnystecco8 (small blind) folded before Flop
Seat 3: caduceus369 (big blind) folded on the Flop
Seat 4: QUATTRODAME folded before Flop (didn't bet)
Seat 5: Clint934 collected (€0.07)
Seat 6: andrea73b16 folded before Flop (didn't bet)



PokerStars Zoom Hand #258027473844:  Hold'em No Limit (€0.01/€0.02) [ADM ID: M62BD3044A1E13PD] - 2025/10/07 0:54:01 CET [2025/10/06 18:54:01 ET]
Table 'Sirio' 6-max Seat #1 is the button
Seat 1: jackkk03 (€2.55 in chips) 
Seat 2: mashallahh (€4.82 in chips) 
Seat 3: stfuplzudonk (€2.89 in chips) 
Seat 4: heitel (€2.80 in chips) 
Seat 5: IKARO_3 (€1.25 in chips) 
Seat 6: caduceus369 (€3.74 in chips) 
mashallahh: posts small blind €0.01
stfuplzudonk: posts big blind €0.02
*** HOLE CARDS ***
Dealt to caduceus369 [6s 6d]
heitel: folds 
IKARO_3: folds 
caduceus369: raises €0.04 to €0.06
jackkk03: calls €0.06
mashallahh: folds 
stfuplzudonk: calls €0.04
*** FLOP *** [4c 8h 3s]
stfuplzudonk: checks 
caduceus369: checks 
jackkk03: checks 
*** TURN *** [4c 8h 3s] [Qh]
stfuplzudonk: checks 
caduceus369: checks 
jackkk03: checks 
*** RIVER *** [4c 8h 3s Qh] [Qd]
stfuplzudonk: checks 
caduceus369: bets €0.02
jackkk03: folds 
stfuplzudonk: folds 
Uncalled bet (€0.02) returned to caduceus369
caduceus369 collected €0.18 from pot
caduceus369: doesn't show hand 
*** SUMMARY ***
Total pot €0.19 | Rake €0.01 
Board [4c 8h 3s Qh Qd]
Seat 1: jackkk03 (button) folded on the River
Seat 2: mashallahh (small blind) folded before Flop
Seat 3: stfuplzudonk (big blind) folded on the River
Seat 4: heitel folded before Flop (didn't bet)
Seat 5: IKARO_3 folded before Flop (didn't bet)
Seat 6: caduceus369 collected (€0.18)



PokerStars Zoom Hand #258027481106:  Hold'em No Limit (€0.01/€0.02) [ADM ID: M62BD3044A1E13PD] - 2025/10/07 0:54:40 CET [2025/10/06 18:54:40 ET]
Table 'Sirio' 6-max Seat #1 is the button
Seat 1: Wildag00 (€8.45 in chips) 
Seat 2: mashallahh (€6.26 in chips) 
Seat 3: jackkk03 (€2.49 in chips) 
Seat 4: caduceus369 (€3.86 in chips) 
Seat 5: jhonnystecco8 (€1.39 in chips) 
Seat 6: M@verick781 (€19.45 in chips) 
mashallahh: posts small blind €0.01
jackkk03: posts big blind €0.02
*** HOLE CARDS ***
Dealt to caduceus369 [3h Qs]
caduceus369: folds 
jhonnystecco8: folds 
M@verick781: folds 
Wildag00: folds 
mashallahh: folds 
Uncalled bet (€0.01) returned to jackkk03
jackkk03 collected €0.02 from pot
jackkk03: doesn't show hand 
*** SUMMARY ***
Total pot €0.02 | Rake €0 
Seat 1: Wildag00 (button) folded before Flop (didn't bet)
Seat 2: mashallahh (small blind) folded before Flop
Seat 3: jackkk03 (big blind) collected (€0.02)
Seat 4: caduceus369 folded before Flop (didn't bet)
Seat 5: jhonnystecco8 folded before Flop (didn't bet)
Seat 6: M@verick781 folded before Flop (didn't bet)



PokerStars Zoom Hand #258027487044:  Hold'em No Limit (€0.01/€0.02) [ADM ID: M62BD3044A1E13PD] - 2025/10/07 0:55:16 CET [2025/10/06 18:55:16 ET]
Table 'Sirio' 6-max Seat #1 is the button
Seat 1: mashallahh (€2.17 in chips) 
Seat 2: caduceus369 (€3.86 in chips) 
Seat 3: M@verick781 (€19.48 in chips) 
Seat 4: jhonnystecco8 (€1.40 in chips) 
Seat 5: Clajito17 (€1.06 in chips) 
caduceus369: posts small blind €0.01
M@verick781: posts big blind €0.02
*** HOLE CARDS ***
Dealt to caduceus369 [2c 5c]
jhonnystecco8: folds 
Clajito17: raises €1.04 to €1.06 and is all-in
mashallahh: folds 
caduceus369: folds 
M@verick781: folds 
Uncalled bet (€1.04) returned to Clajito17
Clajito17 collected €0.05 from pot
Clajito17: doesn't show hand 
*** SUMMARY ***
Total pot €0.05 | Rake €0 
Seat 1: mashallahh (button) folded before Flop (didn't bet)
Seat 2: caduceus369 (small blind) folded before Flop
Seat 3: M@verick781 (big blind) folded before Flop
Seat 4: jhonnystecco8 folded before Flop (didn't bet)
Seat 5: Clajito17 collected (€0.05)



PokerStars Zoom Hand #258027487901:  Hold'em No Limit (€0.01/€0.02) [ADM ID: M62BD3044A1E13PD] - 2025/10/07 0:55:22 CET [2025/10/06 18:55:22 ET]
Table 'Sirio' 6-max Seat #1 is the button
Seat 1: stfuplzudonk (€1.73 in chips) 
Seat 2: jhonnystecco8 (€1.40 in chips) 
Seat 3: caduceus369 (€3.85 in chips) 
Seat 4: jackkk03 (€2.50 in chips) 
Seat 5: Giampon78 (€2.15 in chips) 
Seat 6: heitel (€3.10 in chips) 
jhonnystecco8: posts small blind €0.01
caduceus369: posts big blind €0.02
*** HOLE CARDS ***
Dealt to caduceus369 [4s 5s]
jackkk03: calls €0.02
Giampon78: raises €0.07 to €0.09
heitel: calls €0.09
stfuplzudonk: calls €0.09
jhonnystecco8: folds 
caduceus369: folds 
jackkk03: calls €0.07
*** FLOP *** [Qd Qs 9c]
jackkk03: checks 
Giampon78: checks 
heitel: checks 
stfuplzudonk: checks 
*** TURN *** [Qd Qs 9c] [6c]
jackkk03: checks 
Giampon78: bets €0.19
heitel: folds 
stfuplzudonk: calls €0.19
jackkk03: folds 
*** RIVER *** [Qd Qs 9c 6c] [6d]
Giampon78: bets €0.37
stfuplzudonk: folds 
Uncalled bet (€0.37) returned to Giampon78
Giampon78 collected €0.73 from pot
Giampon78: doesn't show hand 
*** SUMMARY ***
Total pot €0.77 | Rake €0.04 
Board [Qd Qs 9c 6c 6d]
Seat 1: stfuplzudonk (button) folded on the River
Seat 2: jhonnystecco8 (small blind) folded before Flop
Seat 3: caduceus369 (big blind) folded before Flop
Seat 4: jackkk03 folded on the Turn
Seat 5: Giampon78 collected (€0.73)
Seat 6: heitel folded on the Turn



PokerStars Zoom Hand #258027485305:  Hold'em No Limit (€0.01/€0.02) [ADM ID: M62BD3044A1E13PD] - 2025/10/07 0:55:03 CET [2025/10/06 18:55:03 ET]
Table 'Sirio' 6-max Seat #1 is the button
Seat 1: KindRonin (€1.11 in chips) 
Seat 2: gigysk (€0.70 in chips) 
Seat 3: SebaRapy14 (€5.76 in chips) 
Seat 4: stfuplzudonk (€6.31 in chips) 
Seat 5: caduceus369 (€3.86 in chips) 
Seat 6: Kapiushon25 (€0.99 in chips) 
gigysk: posts small blind €0.01
SebaRapy14: posts big blind €0.02
*** HOLE CARDS ***
Dealt to caduceus369 [9h Qc]
stfuplzudonk: folds 
caduceus369: folds 
Kapiushon25: folds 
KindRonin: folds 
gigysk: calls €0.01
SebaRapy14: checks 
*** FLOP *** [5s 4c 2s]
gigysk: checks 
SebaRapy14: checks 
*** TURN *** [5s 4c 2s] [8c]
gigysk: checks 
SebaRapy14: checks 
*** RIVER *** [5s 4c 2s 8c] [6d]
gigysk: checks 
SebaRapy14: checks 
*** SHOW DOWN ***
gigysk: shows [Qs Ts] (high card Queen)
SebaRapy14: mucks hand 
gigysk collected €0.04 from pot
*** SUMMARY ***
Total pot €0.04 | Rake €0 
Board [5s 4c 2s 8c 6d]
Seat 1: KindRonin (button) folded before Flop (didn't bet)
Seat 2: gigysk (small blind) showed [Qs Ts] and won (€0.04) with high card Queen
Seat 3: SebaRapy14 (big blind) mucked [9d Qh]
Seat 4: stfuplzudonk folded before Flop (didn't bet)
Seat 5: caduceus369 folded before Flop (didn't bet)
Seat 6: Kapiushon25 folded before Flop (didn't bet)



PokerStars Zoom Hand #258027490247:  Hold'em No Limit (€0.01/€0.02) [ADM ID: M62BD3044A1E13PD] - 2025/10/07 0:55:39 CET [2025/10/06 18:55:39 ET]
Table 'Sirio' 6-max Seat #1 is the button
Seat 1: caduceus369 (€3.83 in chips) 
Seat 2: mashallahh (€2.17 in chips) 
Seat 3: IKARO_3 (€2.99 in chips) 
Seat 4: KindRonin (€1.09 in chips) 
Seat 5: Clint934 (€1.15 in chips) 
mashallahh: posts small blind €0.01
IKARO_3: posts big blind €0.02
*** HOLE CARDS ***
Dealt to caduceus369 [Qd 5h]
KindRonin: folds 
Clint934: raises €0.08 to €0.10
caduceus369: folds 
mashallahh: folds 
IKARO_3: folds 
Uncalled bet (€0.08) returned to Clint934
Clint934 collected €0.05 from pot
Clint934: doesn't show hand 
*** SUMMARY ***
Total pot €0.05 | Rake €0 
Seat 1: caduceus369 (button) folded before Flop (didn't bet)
Seat 2: mashallahh (small blind) folded before Flop
Seat 3: IKARO_3 (big blind) folded before Flop
Seat 4: KindRonin folded before Flop (didn't bet)
Seat 5: Clint934 collected (€0.05)



PokerStars Zoom Hand #258027493667:  Hold'em No Limit (€0.01/€0.02) [ADM ID: M62BD3044A1E13PD] - 2025/10/07 0:56:04 CET [2025/10/06 18:56:04 ET]
Table 'Sirio' 6-max Seat #1 is the button
Seat 1: heitel (€3.02 in chips) 
Seat 2: mashallahh (€4.79 in chips) 
Seat 3: stfuplzudonk (€4.27 in chips) 
Seat 4: IKARO_3 (€1.57 in chips) 
Seat 5: caduceus369 (€3.83 in chips) 
mashallahh: posts small blind €0.01
stfuplzudonk: posts big blind €0.02
*** HOLE CARDS ***
Dealt to caduceus369 [Td As]
IKARO_3: folds 
caduceus369: raises €0.04 to €0.06
heitel: raises €0.12 to €0.18
mashallahh: folds 
stfuplzudonk: folds 
caduceus369: calls €0.12
*** FLOP *** [Tc Js 4s]
caduceus369: checks 
heitel: bets €0.25
caduceus369: calls €0.25
*** TURN *** [Tc Js 4s] [9s]
caduceus369: bets €0.27
heitel: calls €0.27
*** RIVER *** [Tc Js 4s 9s] [Kh]
caduceus369: bets €1.52
heitel: folds 
Uncalled bet (€1.52) returned to caduceus369
caduceus369 collected €1.36 from pot
caduceus369: doesn't show hand 
*** SUMMARY ***
Total pot €1.43 | Rake €0.07 
Board [Tc Js 4s 9s Kh]
Seat 1: heitel (button) folded on the River
Seat 2: mashallahh (small blind) folded before Flop
Seat 3: stfuplzudonk (big blind) folded before Flop
Seat 4: IKARO_3 folded before Flop (didn't bet)
Seat 5: caduceus369 collected (€1.36)



PokerStars Zoom Hand #258027505283:  Hold'em No Limit (€0.01/€0.02) [ADM ID: M62BD3044A1E13PD] - 2025/10/07 0:57:28 CET [2025/10/06 18:57:28 ET]
Table 'Sirio' 6-max Seat #1 is the button
Seat 1: QUATTRODAME (€2.83 in chips) 
Seat 2: caduceus369 (€4.49 in chips) 
Seat 3: bravo1270 (€0.81 in chips) 
Seat 4: stfuplzudonk (€1.34 in chips) 
Seat 5: Wildag00 (€6.87 in chips) 
Seat 6: IKARO_3 (€1.57 in chips) 
caduceus369: posts small blind €0.01
bravo1270: posts big blind €0.02
*** HOLE CARDS ***
Dealt to caduceus369 [Ts 3s]
stfuplzudonk: folds 
Wildag00: folds 
IKARO_3: folds 
QUATTRODAME: folds 
caduceus369: folds 
Uncalled bet (€0.01) returned to bravo1270
bravo1270 collected €0.02 from pot
bravo1270: doesn't show hand 
*** SUMMARY ***
Total pot €0.02 | Rake €0 
Seat 1: QUATTRODAME (button) folded before Flop (didn't bet)
Seat 2: caduceus369 (small blind) folded before Flop
Seat 3: bravo1270 (big blind) collected (€0.02)
Seat 4: stfuplzudonk folded before Flop (didn't bet)
Seat 5: Wildag00 folded before Flop (didn't bet)
Seat 6: IKARO_3 folded before Flop (didn't bet)



PokerStars Zoom Hand #258027506650:  Hold'em No Limit (€0.01/€0.02) [ADM ID: M62BD3044A1E13PD] - 2025/10/07 0:57:38 CET [2025/10/06 18:57:38 ET]
Table 'Sirio' 6-max Seat #1 is the button
Seat 1: KindRonin (€1.36 in chips) 
Seat 2: Wildag00 (€4.62 in chips) 
Seat 3: mashallahh (€2.22 in chips) 
Seat 4: Clajito17 (€1.74 in chips) 
Seat 5: caduceus369 (€4.48 in chips) 
Seat 6: stfuplzudonk (€7.04 in chips) 
Wildag00: posts small blind €0.01
mashallahh: posts big blind €0.02
*** HOLE CARDS ***
Dealt to caduceus369 [Ah 8s]
Clajito17: folds 
caduceus369: folds 
stfuplzudonk: folds 
KindRonin: folds 
Wildag00: folds 
Uncalled bet (€0.01) returned to mashallahh
mashallahh collected €0.02 from pot
mashallahh: doesn't show hand 
*** SUMMARY ***
Total pot €0.02 | Rake €0 
Seat 1: KindRonin (button) folded before Flop (didn't bet)
Seat 2: Wildag00 (small blind) folded before Flop
Seat 3: mashallahh (big blind) collected (€0.02)
Seat 4: Clajito17 folded before Flop (didn't bet)
Seat 5: caduceus369 folded before Flop (didn't bet)
Seat 6: stfuplzudonk folded before Flop (didn't bet)



PokerStars Zoom Hand #258027507338:  Hold'em No Limit (€0.01/€0.02) [ADM ID: M62BD3044A1E13PD] - 2025/10/07 0:57:43 CET [2025/10/06 18:57:43 ET]
Table 'Sirio' 6-max Seat #1 is the button
Seat 1: dalailami (€0.50 in chips) 
Seat 2: IKARO_3 (€24.08 in chips) 
Seat 3: KindRonin (€1.36 in chips) 
Seat 4: caduceus369 (€4.48 in chips) 
Seat 5: heitel (€2.34 in chips) 
Seat 6: Wildag00 (€4.61 in chips) 
IKARO_3: posts small blind €0.01
KindRonin: posts big blind €0.02
*** HOLE CARDS ***
Dealt to caduceus369 [3d Jc]
caduceus369: folds 
heitel: raises €0.04 to €0.06
Wildag00: folds 
dalailami: folds 
IKARO_3: folds 
KindRonin: folds 
Uncalled bet (€0.04) returned to heitel
heitel collected €0.05 from pot
heitel: doesn't show hand 
*** SUMMARY ***
Total pot €0.05 | Rake €0 
Seat 1: dalailami (button) folded before Flop (didn't bet)
Seat 2: IKARO_3 (small blind) folded before Flop
Seat 3: KindRonin (big blind) folded before Flop
Seat 4: caduceus369 folded before Flop (didn't bet)
Seat 5: heitel collected (€0.05)
Seat 6: Wildag00 folded before Flop (didn't bet)



PokerStars Zoom Hand #258027509097:  Hold'em No Limit (€0.01/€0.02) [ADM ID: M62BD3044A1E13PD] - 2025/10/07 0:57:56 CET [2025/10/06 18:57:56 ET]
Table 'Sirio' 6-max Seat #1 is the button
Seat 1: jhonnystecco8 (€1.20 in chips) 
Seat 2: IKARO_3 (€3.90 in chips) 
Seat 3: caduceus369 (€4.48 in chips) 
Seat 4: mashallahh (€2.23 in chips) 
Seat 5: M@verick781 (€19.55 in chips) 
IKARO_3: posts small blind €0.01
caduceus369: posts big blind €0.02
*** HOLE CARDS ***
Dealt to caduceus369 [8d Jd]
mashallahh: folds 
M@verick781: folds 
jhonnystecco8: folds 
IKARO_3: folds 
Uncalled bet (€0.01) returned to caduceus369
caduceus369 collected €0.02 from pot
caduceus369: doesn't show hand 
*** SUMMARY ***
Total pot €0.02 | Rake €0 
Seat 1: jhonnystecco8 (button) folded before Flop (didn't bet)
Seat 2: IKARO_3 (small blind) folded before Flop
Seat 3: caduceus369 (big blind) collected (€0.02)
Seat 4: mashallahh folded before Flop (didn't bet)
Seat 5: M@verick781 folded before Flop (didn't bet)



PokerStars Zoom Hand #258027510329:  Hold'em No Limit (€0.01/€0.02) [ADM ID: M62BD3044A1E13PD] - 2025/10/07 0:58:05 CET [2025/10/06 18:58:05 ET]
Table 'Sirio' 6-max Seat #1 is the button
Seat 1: RRgalp (€5.37 in chips) 
Seat 2: caduceus369 (€4.49 in chips) 
Seat 3: mashallahh (€5.57 in chips) 
Seat 4: heitel (€2.37 in chips) 
Seat 5: IKARO_3 (€3.89 in chips) 
caduceus369: posts small blind €0.01
mashallahh: posts big blind €0.02
*** HOLE CARDS ***
Dealt to caduceus369 [4d Qs]
heitel: folds 
IKARO_3: raises €0.05 to €0.07
RRgalp: folds 
caduceus369: folds 
mashallahh: folds 
Uncalled bet (€0.05) returned to IKARO_3
IKARO_3 collected €0.05 from pot
IKARO_3: doesn't show hand 
*** SUMMARY ***
Total pot €0.05 | Rake €0 
Seat 1: RRgalp (button) folded before Flop (didn't bet)
Seat 2: caduceus369 (small blind) folded before Flop
Seat 3: mashallahh (big blind) folded before Flop
Seat 4: heitel folded before Flop (didn't bet)
Seat 5: IKARO_3 collected (€0.05)



PokerStars Zoom Hand #258027511754:  Hold'em No Limit (€0.01/€0.02) [ADM ID: M62BD3044A1E13PD] - 2025/10/07 0:58:15 CET [2025/10/06 18:58:15 ET]
Table 'Sirio' 6-max Seat #1 is the button
Seat 1: caduceus369 (€4.48 in chips) 
Seat 2: SebaRapy14 (€11.88 in chips) 
Seat 3: KindRonin (€1.33 in chips) 
Seat 4: RRgalp (€5.37 in chips) 
Seat 5: mashallahh (€2.22 in chips) 
SebaRapy14: posts small blind €0.01
KindRonin: posts big blind €0.02
*** HOLE CARDS ***
Dealt to caduceus369 [9h 9d]
RRgalp: folds 
mashallahh: folds 
caduceus369: raises €0.04 to €0.06
SebaRapy14: raises €0.16 to €0.22
KindRonin: folds 
caduceus369: calls €0.16
*** FLOP *** [6c 4h Kh]
SebaRapy14: bets €0.20
caduceus369: calls €0.20
*** TURN *** [6c 4h Kh] [2d]
SebaRapy14: bets €0.56
caduceus369: folds 
Uncalled bet (€0.56) returned to SebaRapy14
SebaRapy14 collected €0.82 from pot
SebaRapy14: doesn't show hand 
*** SUMMARY ***
Total pot €0.86 | Rake €0.04 
Board [6c 4h Kh 2d]
Seat 1: caduceus369 (button) folded on the Turn
Seat 2: SebaRapy14 (small blind) collected (€0.82)
Seat 3: KindRonin (big blind) folded before Flop
Seat 4: RRgalp folded before Flop (didn't bet)
Seat 5: mashallahh folded before Flop (didn't bet)



PokerStars Zoom Hand #258027523736:  Hold'em No Limit (€0.01/€0.02) [ADM ID: M62BD3044A1E13PD] - 2025/10/07 0:59:41 CET [2025/10/06 18:59:41 ET]
Table 'Sirio' 6-max Seat #1 is the button
Seat 1: KindRonin (€1.43 in chips) 
Seat 2: QUATTRODAME (€2.70 in chips) 
Seat 3: Giampon78 (€2.97 in chips) 
Seat 4: caduceus369 (€4.04 in chips) 
Seat 5: jhonnystecco8 (€1.11 in chips) 
QUATTRODAME: posts small blind €0.01
Giampon78: posts big blind €0.02
*** HOLE CARDS ***
Dealt to caduceus369 [Qs 2h]
caduceus369: folds 
jhonnystecco8: folds 
KindRonin: raises €0.02 to €0.04
QUATTRODAME: calls €0.03
Giampon78: calls €0.02
*** FLOP *** [8d 3c Kc]
QUATTRODAME: checks 
Giampon78: checks 
KindRonin: bets €0.04
QUATTRODAME: folds 
Giampon78: folds 
Uncalled bet (€0.04) returned to KindRonin
KindRonin collected €0.12 from pot
KindRonin: doesn't show hand 
*** SUMMARY ***
Total pot €0.12 | Rake €0 
Board [8d 3c Kc]
Seat 1: KindRonin (button) collected (€0.12)
Seat 2: QUATTRODAME (small blind) folded on the Flop
Seat 3: Giampon78 (big blind) folded on the Flop
Seat 4: caduceus369 folded before Flop (didn't bet)
Seat 5: jhonnystecco8 folded before Flop (didn't bet)



PokerStars Zoom Hand #258027525886:  Hold'em No Limit (€0.01/€0.02) [ADM ID: M62BD3044A1E13PD] - 2025/10/07 0:59:57 CET [2025/10/06 18:59:57 ET]
Table 'Sirio' 6-max Seat #1 is the button
Seat 1: andrea73b16 (€2.01 in chips) 
Seat 2: caduceus369 (€4.04 in chips) 
Seat 3: stfuplzudonk (€4.45 in chips) 
Seat 4: SebaRapy14 (€12.28 in chips) 
Seat 5: jackkk03 (€2.10 in chips) 
Seat 6: Clajito17 (€1.21 in chips) 
caduceus369: posts small blind €0.01
stfuplzudonk: posts big blind €0.02
*** HOLE CARDS ***
Dealt to caduceus369 [Td 5h]
SebaRapy14: folds 
jackkk03: folds 
Clajito17: folds 
andrea73b16: raises €0.04 to €0.06
caduceus369: folds 
stfuplzudonk: folds 
Uncalled bet (€0.04) returned to andrea73b16
andrea73b16 collected €0.05 from pot
andrea73b16: doesn't show hand 
*** SUMMARY ***
Total pot €0.05 | Rake €0 
Seat 1: andrea73b16 (button) collected (€0.05)
Seat 2: caduceus369 (small blind) folded before Flop
Seat 3: stfuplzudonk (big blind) folded before Flop
Seat 4: SebaRapy14 folded before Flop (didn't bet)
Seat 5: jackkk03 folded before Flop (didn't bet)
Seat 6: Clajito17 folded before Flop (didn't bet)



PokerStars Zoom Hand #258027521474:  Hold'em No Limit (€0.01/€0.02) [ADM ID: M62BD3044A1E13PD] - 2025/10/07 0:59:25 CET [2025/10/06 18:59:25 ET]
Table 'Sirio' 6-max Seat #1 is the button
Seat 1: Wildag00 (€7.22 in chips) 
Seat 2: RRgalp (€5.32 in chips) 
Seat 3: mashallahh (€5.10 in chips) 
Seat 4: caduceus369 (€4.06 in chips) 
Seat 5: IKARO_3 (€24.07 in chips) 
RRgalp: posts small blind €0.01
mashallahh: posts big blind €0.02
*** HOLE CARDS ***
Dealt to caduceus369 [3s Th]
caduceus369: folds 
IKARO_3: folds 
Wildag00: raises €0.02 to €0.04
RRgalp: calls €0.03
mashallahh: calls €0.02
*** FLOP *** [Jd 6s 5h]
RRgalp: checks 
mashallahh: checks 
Wildag00: checks 
*** TURN *** [Jd 6s 5h] [Qs]
RRgalp: checks 
mashallahh: bets €0.10
Wildag00: folds 
RRgalp: folds 
Uncalled bet (€0.10) returned to mashallahh
mashallahh collected €0.12 from pot
mashallahh: doesn't show hand 
*** SUMMARY ***
Total pot €0.12 | Rake €0 
Board [Jd 6s 5h Qs]
Seat 1: Wildag00 (button) folded on the Turn
Seat 2: RRgalp (small blind) folded on the Turn
Seat 3: mashallahh (big blind) collected (€0.12)
Seat 4: caduceus369 folded before Flop (didn't bet)
Seat 5: IKARO_3 folded before Flop (didn't bet)



PokerStars Zoom Hand #258027526655:  Hold'em No Limit (€0.01/€0.02) [ADM ID: M62BD3044A1E13PD] - 2025/10/07 1:00:02 CET [2025/10/06 19:00:02 ET]
Table 'Sirio' 6-max Seat #1 is the button
Seat 1: Clajito17 (€1.21 in chips) 
Seat 2: Wildag00 (€4.72 in chips) 
Seat 3: jackkk03 (€2.10 in chips) 
Seat 4: SebaRapy14 (€12.28 in chips) 
Seat 5: heitel (€3.26 in chips) 
Seat 6: caduceus369 (€4.03 in chips) 
Wildag00: posts small blind €0.01
jackkk03: posts big blind €0.02
*** HOLE CARDS ***
Dealt to caduceus369 [4h Th]
SebaRapy14: folds 
heitel: folds 
caduceus369: folds 
Clajito17: folds 
Wildag00: raises €0.02 to €0.04
jackkk03: folds 
Uncalled bet (€0.02) returned to Wildag00
Wildag00 collected €0.04 from pot
Wildag00: doesn't show hand 
*** SUMMARY ***
Total pot €0.04 | Rake €0 
Seat 1: Clajito17 (button) folded before Flop (didn't bet)
Seat 2: Wildag00 (small blind) collected (€0.04)
Seat 3: jackkk03 (big blind) folded before Flop
Seat 4: SebaRapy14 folded before Flop (didn't bet)
Seat 5: heitel folded before Flop (didn't bet)
Seat 6: caduceus369 folded before Flop (didn't bet)



PokerStars Zoom Hand #258027525132:  Hold'em No Limit (€0.01/€0.02) [ADM ID: M62BD3044A1E13PD] - 2025/10/07 0:59:51 CET [2025/10/06 18:59:51 ET]
Table 'Sirio' 6-max Seat #1 is the button
Seat 1: caduceus369 (€4.04 in chips) 
Seat 2: heitel (€3.27 in chips) 
Seat 3: mashallahh (€4.44 in chips) 
Seat 4: IKARO_3 (€3.89 in chips) 
Seat 5: stfuplzudonk (€1.35 in chips) 
heitel: posts small blind €0.01
mashallahh: posts big blind €0.02
*** HOLE CARDS ***
Dealt to caduceus369 [Kh 6s]
IKARO_3: raises €0.03 to €0.05
stfuplzudonk: folds 
caduceus369: folds 
heitel: folds 
mashallahh: folds 
Uncalled bet (€0.03) returned to IKARO_3
IKARO_3 collected €0.05 from pot
IKARO_3: doesn't show hand 
*** SUMMARY ***
Total pot €0.05 | Rake €0 
Seat 1: caduceus369 (button) folded before Flop (didn't bet)
Seat 2: heitel (small blind) folded before Flop
Seat 3: mashallahh (big blind) folded before Flop
Seat 4: IKARO_3 collected (€0.05)
Seat 5: stfuplzudonk folded before Flop (didn't bet)



PokerStars Zoom Hand #258027522151:  Hold'em No Limit (€0.01/€0.02) [ADM ID: M62BD3044A1E13PD] - 2025/10/07 0:59:30 CET [2025/10/06 18:59:30 ET]
Table 'Sirio' 6-max Seat #1 is the button
Seat 1: stfuplzudonk (€1.35 in chips) 
Seat 2: dalailami (€0.89 in chips) 
Seat 3: caduceus369 (€4.06 in chips) 
Seat 4: mashallahh (€5.28 in chips) 
Seat 5: IKARO_3 (€24.07 in chips) 
dalailami: posts small blind €0.01
caduceus369: posts big blind €0.02
*** HOLE CARDS ***
Dealt to caduceus369 [7c 2d]
mashallahh: folds 
IKARO_3: raises €0.05 to €0.07
stfuplzudonk: folds 
dalailami: calls €0.06
caduceus369: folds 
*** FLOP *** [2h 3h 9s]
dalailami: bets €0.06
IKARO_3: raises €0.13 to €0.19
dalailami: calls €0.13
*** TURN *** [2h 3h 9s] [Ac]
dalailami: bets €0.63 and is all-in
IKARO_3: folds 
Uncalled bet (€0.63) returned to dalailami
dalailami collected €0.52 from pot
dalailami: doesn't show hand 
*** SUMMARY ***
Total pot €0.54 | Rake €0.02 
Board [2h 3h 9s Ac]
Seat 1: stfuplzudonk (button) folded before Flop (didn't bet)
Seat 2: dalailami (small blind) collected (€0.52)
Seat 3: caduceus369 (big blind) folded before Flop
Seat 4: mashallahh folded before Flop (didn't bet)
Seat 5: IKARO_3 folded on the Turn



PokerStars Zoom Hand #258027527425:  Hold'em No Limit (€0.01/€0.02) [ADM ID: M62BD3044A1E13PD] - 2025/10/07 1:00:08 CET [2025/10/06 19:00:08 ET]
Table 'Sirio' 6-max Seat #1 is the button
Seat 1: IKARO_3 (€1.55 in chips) 
Seat 2: stfuplzudonk (€6.86 in chips) 
Seat 3: caduceus369 (€4.03 in chips) 
Seat 4: QUATTRODAME (€2.66 in chips) 
Seat 5: SebaRapy14 (€6.28 in chips) 
stfuplzudonk: posts small blind €0.01
caduceus369: posts big blind €0.02
*** HOLE CARDS ***
Dealt to caduceus369 [5d 7d]
QUATTRODAME: folds 
SebaRapy14: folds 
IKARO_3: folds 
stfuplzudonk: raises €0.04 to €0.06
caduceus369: calls €0.04
*** FLOP *** [As Qc 2c]
stfuplzudonk: checks 
caduceus369: checks 
*** TURN *** [As Qc 2c] [9d]
stfuplzudonk: checks 
caduceus369: checks 
*** RIVER *** [As Qc 2c 9d] [5s]
stfuplzudonk: checks 
caduceus369: checks 
*** SHOW DOWN ***
stfuplzudonk: shows [Ts 9s] (a pair of Nines)
caduceus369: mucks hand 
stfuplzudonk collected €0.12 from pot
*** SUMMARY ***
Total pot €0.12 | Rake €0 
Board [As Qc 2c 9d 5s]
Seat 1: IKARO_3 (button) folded before Flop (didn't bet)
Seat 2: stfuplzudonk (small blind) showed [Ts 9s] and won (€0.12) with a pair of Nines
Seat 3: caduceus369 (big blind) mucked [5d 7d]
Seat 4: QUATTRODAME folded before Flop (didn't bet)
Seat 5: SebaRapy14 folded before Flop (didn't bet)



PokerStars Zoom Hand #258027532665:  Hold'em No Limit (€0.01/€0.02) [ADM ID: M62BD3044A1E13PD] - 2025/10/07 1:00:42 CET [2025/10/06 19:00:42 ET]
Table 'Sirio' 6-max Seat #1 is the button
Seat 1: RRgalp (€5.26 in chips) 
Seat 2: IKARO_3 (€3.90 in chips) 
Seat 3: stfuplzudonk (€6.92 in chips) 
Seat 4: QUATTRODAME (€2.63 in chips) 
Seat 5: caduceus369 (€3.97 in chips) 
IKARO_3: posts small blind €0.01
stfuplzudonk: posts big blind €0.02
*** HOLE CARDS ***
Dealt to caduceus369 [6d 9d]
QUATTRODAME: folds 
caduceus369: folds 
RRgalp: folds 
IKARO_3: folds 
Uncalled bet (€0.01) returned to stfuplzudonk
stfuplzudonk collected €0.02 from pot
stfuplzudonk: doesn't show hand 
*** SUMMARY ***
Total pot €0.02 | Rake €0 
Seat 1: RRgalp (button) folded before Flop (didn't bet)
Seat 2: IKARO_3 (small blind) folded before Flop
Seat 3: stfuplzudonk (big blind) collected (€0.02)
Seat 4: QUATTRODAME folded before Flop (didn't bet)
Seat 5: caduceus369 folded before Flop (didn't bet)



PokerStars Zoom Hand #258027533478:  Hold'em No Limit (€0.01/€0.02) [ADM ID: M62BD3044A1E13PD] - 2025/10/07 1:00:47 CET [2025/10/06 19:00:47 ET]
Table 'Sirio' 6-max Seat #1 is the button
Seat 1: Wildag00 (€4.75 in chips) 
Seat 2: caduceus369 (€3.97 in chips) 
Seat 3: andrea73b16 (€2 in chips) 
Seat 4: IKARO_3 (€2.81 in chips) 
Seat 5: QUATTRODAME (€2.63 in chips) 
caduceus369: posts small blind €0.01
andrea73b16: posts big blind €0.02
*** HOLE CARDS ***
Dealt to caduceus369 [4s Jh]
IKARO_3: folds 
QUATTRODAME: folds 
Wildag00: raises €0.04 to €0.06
caduceus369: folds 
andrea73b16: calls €0.04
*** FLOP *** [7c 2d Th]
andrea73b16: checks 
Wildag00: bets €0.07
andrea73b16: folds 
Uncalled bet (€0.07) returned to Wildag00
Wildag00 collected €0.13 from pot
Wildag00: doesn't show hand 
*** SUMMARY ***
Total pot €0.13 | Rake €0 
Board [7c 2d Th]
Seat 1: Wildag00 (button) collected (€0.13)
Seat 2: caduceus369 (small blind) folded before Flop
Seat 3: andrea73b16 (big blind) folded on the Flop
Seat 4: IKARO_3 folded before Flop (didn't bet)
Seat 5: QUATTRODAME folded before Flop (didn't bet)



PokerStars Zoom Hand #258027534376:  Hold'em No Limit (€0.01/€0.02) [ADM ID: M62BD3044A1E13PD] - 2025/10/07 1:00:52 CET [2025/10/06 19:00:52 ET]
Table 'Sirio' 6-max Seat #1 is the button
Seat 1: IKARO_3 (€3.89 in chips) 
Seat 2: SebaRapy14 (€6.29 in chips) 
Seat 3: QUATTRODAME (€2.63 in chips) 
Seat 4: mashallahh (€5.17 in chips) 
Seat 5: caduceus369 (€3.96 in chips) 
SebaRapy14: posts small blind €0.01
QUATTRODAME: posts big blind €0.02
*** HOLE CARDS ***
Dealt to caduceus369 [9h Th]
mashallahh: folds 
caduceus369: raises €0.04 to €0.06
IKARO_3: folds 
SebaRapy14: folds 
QUATTRODAME: folds 
Uncalled bet (€0.04) returned to caduceus369
caduceus369 collected €0.05 from pot
caduceus369: doesn't show hand 
*** SUMMARY ***
Total pot €0.05 | Rake €0 
Seat 1: IKARO_3 (button) folded before Flop (didn't bet)
Seat 2: SebaRapy14 (small blind) folded before Flop
Seat 3: QUATTRODAME (big blind) folded before Flop
Seat 4: mashallahh folded before Flop (didn't bet)
Seat 5: caduceus369 collected (€0.05)



PokerStars Zoom Hand #258027539553:  Hold'em No Limit (€0.01/€0.02) [ADM ID: M62BD3044A1E13PD] - 2025/10/07 1:01:21 CET [2025/10/06 19:01:21 ET]
Table 'Sirio' 6-max Seat #1 is the button
Seat 1: caduceus369 (€3.99 in chips) 
Seat 2: jhonnystecco8 (€1.13 in chips) 
Seat 3: Clajito17 (€1.70 in chips) 
Seat 4: IKARO_3 (€24.18 in chips) 
Seat 5: QUATTRODAME (€2.61 in chips) 
jhonnystecco8: posts small blind €0.01
Clajito17: posts big blind €0.02
*** HOLE CARDS ***
Dealt to caduceus369 [Ts 2c]
IKARO_3: folds 
QUATTRODAME: folds 
caduceus369: folds 
jhonnystecco8: calls €0.01
Clajito17: checks 
*** FLOP *** [Kc 4s Ah]
jhonnystecco8: bets €0.02
Clajito17: folds 
Uncalled bet (€0.02) returned to jhonnystecco8
jhonnystecco8 collected €0.04 from pot
jhonnystecco8: doesn't show hand 
*** SUMMARY ***
Total pot €0.04 | Rake €0 
Board [Kc 4s Ah]
Seat 1: caduceus369 (button) folded before Flop (didn't bet)
Seat 2: jhonnystecco8 (small blind) collected (€0.04)
Seat 3: Clajito17 (big blind) folded on the Flop
Seat 4: IKARO_3 folded before Flop (didn't bet)
Seat 5: QUATTRODAME folded before Flop (didn't bet)



PokerStars Zoom Hand #258027538807:  Hold'em No Limit (€0.01/€0.02) [ADM ID: M62BD3044A1E13PD] - 2025/10/07 1:01:17 CET [2025/10/06 19:01:17 ET]
Table 'Sirio' 6-max Seat #1 is the button
Seat 1: SebaRapy14 (€12.20 in chips) 
Seat 2: Wildag00 (€4.82 in chips) 
Seat 3: IKARO_3 (€2.80 in chips) 
Seat 4: caduceus369 (€3.99 in chips) 
Seat 5: Clajito17 (€1.70 in chips) 
Wildag00: posts small blind €0.01
IKARO_3: posts big blind €0.02
*** HOLE CARDS ***
Dealt to caduceus369 [As 4h]
caduceus369: folds 
Clajito17: folds 
SebaRapy14: raises €0.04 to €0.06
Wildag00: calls €0.05
IKARO_3: folds 
*** FLOP *** [8d 5h 5s]
Wildag00: checks 
SebaRapy14: checks 
*** TURN *** [8d 5h 5s] [Jh]
Wildag00: bets €0.05
SebaRapy14: raises €0.11 to €0.16
Wildag00: folds 
Uncalled bet (€0.11) returned to SebaRapy14
SebaRapy14 collected €0.23 from pot
SebaRapy14: doesn't show hand 
*** SUMMARY ***
Total pot €0.24 | Rake €0.01 
Board [8d 5h 5s Jh]
Seat 1: SebaRapy14 (button) collected (€0.23)
Seat 2: Wildag00 (small blind) folded on the Turn
Seat 3: IKARO_3 (big blind) folded before Flop
Seat 4: caduceus369 folded before Flop (didn't bet)
Seat 5: Clajito17 folded before Flop (didn't bet)



PokerStars Zoom Hand #258027541507:  Hold'em No Limit (€0.01/€0.02) [ADM ID: M62BD3044A1E13PD] - 2025/10/07 1:01:32 CET [2025/10/06 19:01:32 ET]
Table 'Sirio' 6-max Seat #1 is the button
Seat 1: Clajito17 (€1.68 in chips) 
Seat 2: jackkk03 (€2.15 in chips) 
Seat 3: caduceus369 (€3.99 in chips) 
Seat 4: mashallahh (€5.17 in chips) 
Seat 5: SebaRapy14 (€6.33 in chips) 
Seat 6: IKARO_3 (€24.18 in chips) 
jackkk03: posts small blind €0.01
caduceus369: posts big blind €0.02
*** HOLE CARDS ***
Dealt to caduceus369 [4c Kd]
mashallahh: raises €0.04 to €0.06
SebaRapy14: folds 
IKARO_3: folds 
Clajito17: folds 
jackkk03: folds 
caduceus369: folds 
Uncalled bet (€0.04) returned to mashallahh
mashallahh collected €0.05 from pot
mashallahh: doesn't show hand 
*** SUMMARY ***
Total pot €0.05 | Rake €0 
Seat 1: Clajito17 (button) folded before Flop (didn't bet)
Seat 2: jackkk03 (small blind) folded before Flop
Seat 3: caduceus369 (big blind) folded before Flop
Seat 4: mashallahh collected (€0.05)
Seat 5: SebaRapy14 folded before Flop (didn't bet)
Seat 6: IKARO_3 folded before Flop (didn't bet)



PokerStars Zoom Hand #258027540251:  Hold'em No Limit (€0.01/€0.02) [ADM ID: M62BD3044A1E13PD] - 2025/10/07 1:01:25 CET [2025/10/06 19:01:25 ET]
Table 'Sirio' 6-max Seat #1 is the button
Seat 1: KindRonin (€1.44 in chips) 
Seat 2: QUATTRODAME (€2.61 in chips) 
Seat 3: stfuplzudonk (€4.32 in chips) 
Seat 4: caduceus369 (€3.99 in chips) 
Seat 5: IKARO_3 (€1.51 in chips) 
Seat 6: bravo1270 (€0.30 in chips) 
QUATTRODAME: posts small blind €0.01
stfuplzudonk: posts big blind €0.02
*** HOLE CARDS ***
Dealt to caduceus369 [9c Qh]
caduceus369: folds 
IKARO_3: raises €0.03 to €0.05
bravo1270: folds 
KindRonin: folds 
QUATTRODAME: folds 
stfuplzudonk: calls €0.03
*** FLOP *** [Td 4c 5h]
stfuplzudonk: checks 
IKARO_3: bets €0.06
stfuplzudonk: folds 
Uncalled bet (€0.06) returned to IKARO_3
IKARO_3 collected €0.11 from pot
IKARO_3: doesn't show hand 
*** SUMMARY ***
Total pot €0.11 | Rake €0 
Board [Td 4c 5h]
Seat 1: KindRonin (button) folded before Flop (didn't bet)
Seat 2: QUATTRODAME (small blind) folded before Flop
Seat 3: stfuplzudonk (big blind) folded on the Flop
Seat 4: caduceus369 folded before Flop (didn't bet)
Seat 5: IKARO_3 collected (€0.11)
Seat 6: bravo1270 folded before Flop (didn't bet)



PokerStars Zoom Hand #258027546962:  Hold'em No Limit (€0.01/€0.02) [ADM ID: M62BD3044A1E13PD] - 2025/10/07 1:02:03 CET [2025/10/06 19:02:03 ET]
Table 'Sirio' 6-max Seat #1 is the button
Seat 1: caduceus369 (€3.96 in chips) 
Seat 2: mashallahh (€5.67 in chips) 
Seat 3: IKARO_3 (€1.57 in chips) 
Seat 4: SebaRapy14 (€6.33 in chips) 
Seat 5: stfuplzudonk (€6.89 in chips) 
mashallahh: posts small blind €0.01
IKARO_3: posts big blind €0.02
*** HOLE CARDS ***
Dealt to caduceus369 [7h Kd]
SebaRapy14: raises €0.04 to €0.06
stfuplzudonk: folds 
caduceus369: folds 
mashallahh: folds 
IKARO_3: folds 
Uncalled bet (€0.04) returned to SebaRapy14
SebaRapy14 collected €0.05 from pot
SebaRapy14: doesn't show hand 
*** SUMMARY ***
Total pot €0.05 | Rake €0 
Seat 1: caduceus369 (button) folded before Flop (didn't bet)
Seat 2: mashallahh (small blind) folded before Flop
Seat 3: IKARO_3 (big blind) folded before Flop
Seat 4: SebaRapy14 collected (€0.05)
Seat 5: stfuplzudonk folded before Flop (didn't bet)



PokerStars Zoom Hand #258027544531:  Hold'em No Limit (€0.01/€0.02) [ADM ID: M62BD3044A1E13PD] - 2025/10/07 1:01:49 CET [2025/10/06 19:01:49 ET]
Table 'Sirio' 6-max Seat #1 is the button
Seat 1: SebaRapy14 (€6.33 in chips) 
Seat 2: gigysk (€0.76 in chips) 
Seat 3: jhonnystecco8 (€1.15 in chips) 
Seat 4: heitel (€3.20 in chips) 
Seat 5: caduceus369 (€3.97 in chips) 
gigysk: posts small blind €0.01
jhonnystecco8: posts big blind €0.02
*** HOLE CARDS ***
Dealt to caduceus369 [Jh 5s]
heitel: folds 
caduceus369: folds 
SebaRapy14: folds 
gigysk: calls €0.01
jhonnystecco8: checks 
*** FLOP *** [6c 3h 8c]
gigysk: checks 
jhonnystecco8: bets €0.02
gigysk: calls €0.02
*** TURN *** [6c 3h 8c] [Jc]
gigysk: checks 
jhonnystecco8: checks 
*** RIVER *** [6c 3h 8c Jc] [Tc]
gigysk: checks 
jhonnystecco8: checks 
*** SHOW DOWN ***
gigysk: shows [9s Ts] (a pair of Tens)
jhonnystecco8: mucks hand 
gigysk collected €0.08 from pot
*** SUMMARY ***
Total pot €0.08 | Rake €0 
Board [6c 3h 8c Jc Tc]
Seat 1: SebaRapy14 (button) folded before Flop (didn't bet)
Seat 2: gigysk (small blind) showed [9s Ts] and won (€0.08) with a pair of Tens
Seat 3: jhonnystecco8 (big blind) mucked [3s 4d]
Seat 4: heitel folded before Flop (didn't bet)
Seat 5: caduceus369 folded before Flop (didn't bet)



PokerStars Zoom Hand #258027545062:  Hold'em No Limit (€0.01/€0.02) [ADM ID: M62BD3044A1E13PD] - 2025/10/07 1:01:52 CET [2025/10/06 19:01:52 ET]
Table 'Sirio' 6-max Seat #1 is the button
Seat 1: mashallahh (€5.67 in chips) 
Seat 2: caduceus369 (€3.97 in chips) 
Seat 3: heitel (€3.20 in chips) 
Seat 4: Wildag00 (€7.65 in chips) 
Seat 5: stfuplzudonk (€1.16 in chips) 
Seat 6: SebaRapy14 (€12.32 in chips) 
caduceus369: posts small blind €0.01
heitel: posts big blind €0.02
*** HOLE CARDS ***
Dealt to caduceus369 [6c Ah]
Wildag00: raises €0.03 to €0.05
stfuplzudonk: calls €0.05
SebaRapy14: folds 
mashallahh: folds 
caduceus369: folds 
heitel: raises €0.19 to €0.24
Wildag00: folds 
stfuplzudonk: folds 
Uncalled bet (€0.19) returned to heitel
heitel collected €0.16 from pot
heitel: doesn't show hand 
*** SUMMARY ***
Total pot €0.16 | Rake €0 
Seat 1: mashallahh (button) folded before Flop (didn't bet)
Seat 2: caduceus369 (small blind) folded before Flop
Seat 3: heitel (big blind) collected (€0.16)
Seat 4: Wildag00 folded before Flop
Seat 5: stfuplzudonk folded before Flop
Seat 6: SebaRapy14 folded before Flop (didn't bet)



PokerStars Zoom Hand #258027548071:  Hold'em No Limit (€0.01/€0.02) [ADM ID: M62BD3044A1E13PD] - 2025/10/07 1:02:09 CET [2025/10/06 19:02:09 ET]
Table 'Sirio' 6-max Seat #1 is the button
Seat 1: IKARO_3 (€1.55 in chips) 
Seat 2: KindRonin (€1.51 in chips) 
Seat 3: Aledybala93 (€1.32 in chips) 
Seat 4: caduceus369 (€3.96 in chips) 
Seat 5: mashallahh (€3 in chips) 
KindRonin: posts small blind €0.01
Aledybala93: posts big blind €0.02
*** HOLE CARDS ***
Dealt to caduceus369 [8d 8c]
caduceus369: raises €0.04 to €0.06
mashallahh: folds 
IKARO_3: folds 
KindRonin: folds 
Aledybala93: calls €0.04
*** FLOP *** [Ah 3s 4c]
Aledybala93: checks 
caduceus369: bets €0.05
Aledybala93: calls €0.05
*** TURN *** [Ah 3s 4c] [3d]
Aledybala93: checks 
caduceus369: checks 
*** RIVER *** [Ah 3s 4c 3d] [6h]
Aledybala93: bets €1.21 and is all-in
caduceus369: folds 
Uncalled bet (€1.21) returned to Aledybala93
Aledybala93 collected €0.22 from pot
Aledybala93: doesn't show hand 
*** SUMMARY ***
Total pot €0.23 | Rake €0.01 
Board [Ah 3s 4c 3d 6h]
Seat 1: IKARO_3 (button) folded before Flop (didn't bet)
Seat 2: KindRonin (small blind) folded before Flop
Seat 3: Aledybala93 (big blind) collected (€0.22)
Seat 4: caduceus369 folded on the River
Seat 5: mashallahh folded before Flop (didn't bet)



PokerStars Zoom Hand #258027553172:  Hold'em No Limit (€0.01/€0.02) [ADM ID: M62BD3044A1E13PD] - 2025/10/07 1:02:37 CET [2025/10/06 19:02:37 ET]
Table 'Sirio' 6-max Seat #1 is the button
Seat 1: Wildag00 (€4.79 in chips) 
Seat 2: caduceus369 (€3.85 in chips) 
Seat 3: gigysk (€0.80 in chips) 
Seat 4: stfuplzudonk (€4.26 in chips) 
Seat 5: IKARO_3 (€3.29 in chips) 
Seat 6: mashallahh (€2.98 in chips) 
caduceus369: posts small blind €0.01
gigysk: posts big blind €0.02
*** HOLE CARDS ***
Dealt to caduceus369 [Qs 3d]
stfuplzudonk: raises €0.02 to €0.04
IKARO_3: folds 
mashallahh: folds 
Wildag00: folds 
caduceus369: folds 
gigysk: folds 
Uncalled bet (€0.02) returned to stfuplzudonk
stfuplzudonk collected €0.05 from pot
stfuplzudonk: doesn't show hand 
*** SUMMARY ***
Total pot €0.05 | Rake €0 
Seat 1: Wildag00 (button) folded before Flop (didn't bet)
Seat 2: caduceus369 (small blind) folded before Flop
Seat 3: gigysk (big blind) folded before Flop
Seat 4: stfuplzudonk collected (€0.05)
Seat 5: IKARO_3 folded before Flop (didn't bet)
Seat 6: mashallahh folded before Flop (didn't bet)



PokerStars Zoom Hand #258027554051:  Hold'em No Limit (€0.01/€0.02) [ADM ID: M62BD3044A1E13PD] - 2025/10/07 1:02:42 CET [2025/10/06 19:02:42 ET]
Table 'Sirio' 6-max Seat #1 is the button
Seat 1: Clajito17 (€1.57 in chips) 
Seat 2: mashallahh (€2.98 in chips) 
Seat 3: caduceus369 (€3.84 in chips) 
Seat 4: IKARO_3 (€3.29 in chips) 
Seat 5: Wildag00 (€4.79 in chips) 
mashallahh: posts small blind €0.01
caduceus369: posts big blind €0.02
*** HOLE CARDS ***
Dealt to caduceus369 [Jd Qd]
IKARO_3: folds 
Wildag00: raises €0.04 to €0.06
Clajito17: calls €0.06
mashallahh: folds 
caduceus369: calls €0.04
*** FLOP *** [Ks Ah Js]
caduceus369: checks 
Wildag00: bets €0.06
Clajito17: calls €0.06
caduceus369: calls €0.06
*** TURN *** [Ks Ah Js] [3c]
caduceus369: checks 
Wildag00: checks 
Clajito17: checks 
*** RIVER *** [Ks Ah Js 3c] [3d]
caduceus369: checks 
Wildag00: checks 
Clajito17: bets €0.10
caduceus369: folds 
Wildag00: folds 
Uncalled bet (€0.10) returned to Clajito17
Clajito17 collected €0.35 from pot
Clajito17: doesn't show hand 
*** SUMMARY ***
Total pot €0.37 | Rake €0.02 
Board [Ks Ah Js 3c 3d]
Seat 1: Clajito17 (button) collected (€0.35)
Seat 2: mashallahh (small blind) folded before Flop
Seat 3: caduceus369 (big blind) folded on the River
Seat 4: IKARO_3 folded before Flop (didn't bet)
Seat 5: Wildag00 folded on the River



PokerStars Zoom Hand #258027565408:  Hold'em No Limit (€0.01/€0.02) [ADM ID: M62BD3044A1E13PD] - 2025/10/07 1:03:45 CET [2025/10/06 19:03:45 ET]
Table 'Sirio' 6-max Seat #1 is the button
Seat 1: mashallahh (€5.34 in chips) 
Seat 2: bravo1270 (€0.57 in chips) 
Seat 3: dalailami (€0.55 in chips) 
Seat 4: Wildag00 (€7.60 in chips) 
Seat 5: jhonnystecco8 (€0.98 in chips) 
Seat 6: caduceus369 (€3.72 in chips) 
bravo1270: posts small blind €0.01
dalailami: posts big blind €0.02
*** HOLE CARDS ***
Dealt to caduceus369 [9d Kd]
Wildag00: calls €0.02
jhonnystecco8: folds 
caduceus369: raises €0.08 to €0.10
mashallahh: raises €0.20 to €0.30
bravo1270: folds 
dalailami: folds 
Wildag00: folds 
caduceus369: folds 
Uncalled bet (€0.20) returned to mashallahh
mashallahh collected €0.25 from pot
mashallahh: doesn't show hand 
*** SUMMARY ***
Total pot €0.25 | Rake €0 
Seat 1: mashallahh (button) collected (€0.25)
Seat 2: bravo1270 (small blind) folded before Flop
Seat 3: dalailami (big blind) folded before Flop
Seat 4: Wildag00 folded before Flop
Seat 5: jhonnystecco8 folded before Flop (didn't bet)
Seat 6: caduceus369 folded before Flop



PokerStars Zoom Hand #258027570148:  Hold'em No Limit (€0.01/€0.02) [ADM ID: M62BD3044A1E13PD] - 2025/10/07 1:04:11 CET [2025/10/06 19:04:11 ET]
Table 'Sirio' 6-max Seat #1 is the button
Seat 1: caduceus369 (€3.62 in chips) 
Seat 2: dalailami (€0.53 in chips) 
Seat 3: SebaRapy14 (€6.47 in chips) 
Seat 4: IKARO_3 (€1.52 in chips) 
Seat 5: jhonnystecco8 (€0.95 in chips) 
Seat 6: stfuplzudonk (€3.17 in chips) 
dalailami: posts small blind €0.01
SebaRapy14: posts big blind €0.02
*** HOLE CARDS ***
Dealt to caduceus369 [3d Ks]
IKARO_3: folds 
jhonnystecco8: folds 
stfuplzudonk: raises €0.02 to €0.04
caduceus369: folds 
dalailami: calls €0.03
SebaRapy14: folds 
*** FLOP *** [5d 2s 6c]
dalailami: bets €0.10
stfuplzudonk: folds 
Uncalled bet (€0.10) returned to dalailami
dalailami collected €0.10 from pot
dalailami: doesn't show hand 
*** SUMMARY ***
Total pot €0.10 | Rake €0 
Board [5d 2s 6c]
Seat 1: caduceus369 (button) folded before Flop (didn't bet)
Seat 2: dalailami (small blind) collected (€0.10)
Seat 3: SebaRapy14 (big blind) folded before Flop
Seat 4: IKARO_3 folded before Flop (didn't bet)
Seat 5: jhonnystecco8 folded before Flop (didn't bet)
Seat 6: stfuplzudonk folded on the Flop



PokerStars Zoom Hand #258027571407:  Hold'em No Limit (€0.01/€0.02) [ADM ID: M62BD3044A1E13PD] - 2025/10/07 1:04:18 CET [2025/10/06 19:04:18 ET]
Table 'Sirio' 6-max Seat #1 is the button
Seat 1: IKARO_3 (€3.70 in chips) 
Seat 2: RRgalp (€6.29 in chips) 
Seat 3: Wildag00 (€7.58 in chips) 
Seat 4: caduceus369 (€3.62 in chips) 
Seat 5: Giampon78 (€3.29 in chips) 
RRgalp: posts small blind €0.01
Wildag00: posts big blind €0.02
*** HOLE CARDS ***
Dealt to caduceus369 [Kh Td]
caduceus369: raises €0.04 to €0.06
Giampon78: folds 
IKARO_3: folds 
RRgalp: folds 
Wildag00: folds 
Uncalled bet (€0.04) returned to caduceus369
caduceus369 collected €0.05 from pot
caduceus369: doesn't show hand 
*** SUMMARY ***
Total pot €0.05 | Rake €0 
Seat 1: IKARO_3 (button) folded before Flop (didn't bet)
Seat 2: RRgalp (small blind) folded before Flop
Seat 3: Wildag00 (big blind) folded before Flop
Seat 4: caduceus369 collected (€0.05)
Seat 5: Giampon78 folded before Flop (didn't bet)



PokerStars Zoom Hand #258027569044:  Hold'em No Limit (€0.01/€0.02) [ADM ID: M62BD3044A1E13PD] - 2025/10/07 1:04:05 CET [2025/10/06 19:04:05 ET]
Table 'Sirio' 6-max Seat #1 is the button
Seat 1: heitel (€2.99 in chips) 
Seat 2: IKARO_3 (€3.71 in chips) 
Seat 3: Giampon78 (€3.31 in chips) 
Seat 4: Aledybala93 (€1.48 in chips) 
Seat 5: caduceus369 (€3.62 in chips) 
Seat 6: dalailami (€0.53 in chips) 
IKARO_3: posts small blind €0.01
Giampon78: posts big blind €0.02
*** HOLE CARDS ***
Dealt to caduceus369 [4d Ts]
Aledybala93: calls €0.02
caduceus369: folds 
dalailami: folds 
heitel: raises €0.06 to €0.08
IKARO_3: folds 
Giampon78: folds 
Aledybala93: calls €0.06
*** FLOP *** [7s 9d 2d]
Aledybala93: checks 
heitel: bets €0.09
Aledybala93: calls €0.09
*** TURN *** [7s 9d 2d] [9s]
Aledybala93: checks 
heitel: bets €0.18
Aledybala93: calls €0.18
*** RIVER *** [7s 9d 2d 9s] [8h]
Aledybala93: bets €0.71
heitel: folds 
Uncalled bet (€0.71) returned to Aledybala93
Aledybala93 collected €0.69 from pot
Aledybala93: doesn't show hand 
*** SUMMARY ***
Total pot €0.73 | Rake €0.04 
Board [7s 9d 2d 9s 8h]
Seat 1: heitel (button) folded on the River
Seat 2: IKARO_3 (small blind) folded before Flop
Seat 3: Giampon78 (big blind) folded before Flop
Seat 4: Aledybala93 collected (€0.69)
Seat 5: caduceus369 folded before Flop (didn't bet)
Seat 6: dalailami folded before Flop (didn't bet)



PokerStars Zoom Hand #258027580905:  Hold'em No Limit (€0.01/€0.02) [ADM ID: M62BD3044A1E13PD] - 2025/10/07 1:05:10 CET [2025/10/06 19:05:10 ET]
Table 'Sirio' 6-max Seat #1 is the button
Seat 1: QUATTRODAME (€2.39 in chips) 
Seat 2: gigysk (€0.69 in chips) 
Seat 3: stfuplzudonk (€3.13 in chips) 
Seat 4: caduceus369 (€3.62 in chips) 
Seat 5: Wildag00 (€4.43 in chips) 
gigysk: posts small blind €0.01
stfuplzudonk: posts big blind €0.02
*** HOLE CARDS ***
Dealt to caduceus369 [3c Jh]
caduceus369: folds 
Wildag00: folds 
QUATTRODAME: folds 
gigysk: folds 
Uncalled bet (€0.01) returned to stfuplzudonk
stfuplzudonk collected €0.02 from pot
stfuplzudonk: doesn't show hand 
*** SUMMARY ***
Total pot €0.02 | Rake €0 
Seat 1: QUATTRODAME (button) folded before Flop (didn't bet)
Seat 2: gigysk (small blind) folded before Flop
Seat 3: stfuplzudonk (big blind) collected (€0.02)
Seat 4: caduceus369 folded before Flop (didn't bet)
Seat 5: Wildag00 folded before Flop (didn't bet)



PokerStars Zoom Hand #258027580031:  Hold'em No Limit (€0.01/€0.02) [ADM ID: M62BD3044A1E13PD] - 2025/10/07 1:05:05 CET [2025/10/06 19:05:05 ET]
Table 'Sirio' 6-max Seat #1 is the button
Seat 1: Wildag00 (€4.43 in chips) 
Seat 2: caduceus369 (€3.63 in chips) 
Seat 3: jhonnystecco8 (€0.92 in chips) 
Seat 4: stfuplzudonk (€3.13 in chips) 
Seat 5: mashallahh (€4.09 in chips) 
caduceus369: posts small blind €0.01
jhonnystecco8: posts big blind €0.02
*** HOLE CARDS ***
Dealt to caduceus369 [3s 8c]
stfuplzudonk: folds 
mashallahh: folds 
Wildag00: folds 
caduceus369: folds 
Uncalled bet (€0.01) returned to jhonnystecco8
jhonnystecco8 collected €0.02 from pot
jhonnystecco8: doesn't show hand 
*** SUMMARY ***
Total pot €0.02 | Rake €0 
Seat 1: Wildag00 (button) folded before Flop (didn't bet)
Seat 2: caduceus369 (small blind) folded before Flop
Seat 3: jhonnystecco8 (big blind) collected (€0.02)
Seat 4: stfuplzudonk folded before Flop (didn't bet)
Seat 5: mashallahh folded before Flop (didn't bet)



PokerStars Zoom Hand #258027583295:  Hold'em No Limit (€0.01/€0.02) [ADM ID: M62BD3044A1E13PD] - 2025/10/07 1:05:23 CET [2025/10/06 19:05:23 ET]
Table 'Sirio' 6-max Seat #1 is the button
Seat 1: mashallahh (€5.59 in chips) 
Seat 2: jhonnystecco8 (€0.93 in chips) 
Seat 3: kdirokko (€0.80 in chips) 
Seat 4: IKARO_3 (€23.76 in chips) 
Seat 5: caduceus369 (€3.62 in chips) 
jhonnystecco8: posts small blind €0.01
kdirokko: posts big blind €0.02
*** HOLE CARDS ***
Dealt to caduceus369 [Kd 7h]
IKARO_3: folds 
caduceus369: folds 
mashallahh: folds 
jhonnystecco8: folds 
Uncalled bet (€0.01) returned to kdirokko
kdirokko collected €0.02 from pot
kdirokko: doesn't show hand 
*** SUMMARY ***
Total pot €0.02 | Rake €0 
Seat 1: mashallahh (button) folded before Flop (didn't bet)
Seat 2: jhonnystecco8 (small blind) folded before Flop
Seat 3: kdirokko (big blind) collected (€0.02)
Seat 4: IKARO_3 folded before Flop (didn't bet)
Seat 5: caduceus369 folded before Flop (didn't bet)



PokerStars Zoom Hand #258027581742:  Hold'em No Limit (€0.01/€0.02) [ADM ID: M62BD3044A1E13PD] - 2025/10/07 1:05:14 CET [2025/10/06 19:05:14 ET]
Table 'Sirio' 6-max Seat #1 is the button
Seat 1: caduceus369 (€3.62 in chips) 
Seat 2: QUATTRODAME (€2.39 in chips) 
Seat 3: kdirokko (€0.80 in chips) 
Seat 4: RRgalp (€6.29 in chips) 
Seat 5: gigysk (€0.68 in chips) 
Seat 6: Wildag00 (€4.43 in chips) 
QUATTRODAME: posts small blind €0.01
kdirokko: posts big blind €0.02
*** HOLE CARDS ***
Dealt to caduceus369 [6h 8s]
RRgalp: folds 
gigysk: folds 
Wildag00: raises €0.04 to €0.06
caduceus369: folds 
QUATTRODAME: folds 
kdirokko: calls €0.04
*** FLOP *** [3c 3s 5c]
kdirokko: checks 
Wildag00: bets €0.12
kdirokko: calls €0.12
*** TURN *** [3c 3s 5c] [Kd]
kdirokko: checks 
Wildag00: checks 
*** RIVER *** [3c 3s 5c Kd] [Qc]
kdirokko: bets €0.35
Wildag00: folds 
Uncalled bet (€0.35) returned to kdirokko
kdirokko collected €0.35 from pot
kdirokko: doesn't show hand 
*** SUMMARY ***
Total pot €0.37 | Rake €0.02 
Board [3c 3s 5c Kd Qc]
Seat 1: caduceus369 (button) folded before Flop (didn't bet)
Seat 2: QUATTRODAME (small blind) folded before Flop
Seat 3: kdirokko (big blind) collected (€0.35)
Seat 4: RRgalp folded before Flop (didn't bet)
Seat 5: gigysk folded before Flop (didn't bet)
Seat 6: Wildag00 folded on the River



PokerStars Zoom Hand #258027575822:  Hold'em No Limit (€0.01/€0.02) [ADM ID: M62BD3044A1E13PD] - 2025/10/07 1:04:42 CET [2025/10/06 19:04:42 ET]
Table 'Sirio' 6-max Seat #1 is the button
Seat 1: stfuplzudonk (€4.55 in chips) 
Seat 2: IKARO_3 (€3.29 in chips) 
Seat 3: caduceus369 (€3.65 in chips) 
Seat 4: Wildag00 (€4.46 in chips) 
Seat 5: mashallahh (€2.71 in chips) 
Seat 6: Clajito17 (€1.72 in chips) 
IKARO_3: posts small blind €0.01
caduceus369: posts big blind €0.02
*** HOLE CARDS ***
Dealt to caduceus369 [7s Kd]
Wildag00: folds 
mashallahh: folds 
Clajito17: folds 
stfuplzudonk: raises €0.02 to €0.04
IKARO_3: raises €0.14 to €0.18
caduceus369: folds 
stfuplzudonk: calls €0.14
*** FLOP *** [3c 6s Tc]
IKARO_3: checks 
stfuplzudonk: checks 
*** TURN *** [3c 6s Tc] [9h]
IKARO_3: bets €0.27
stfuplzudonk: calls €0.27
*** RIVER *** [3c 6s Tc 9h] [8s]
IKARO_3: checks 
stfuplzudonk: checks 
*** SHOW DOWN ***
IKARO_3: shows [Qh Ks] (high card King)
stfuplzudonk: shows [2h 2c] (a pair of Deuces)
stfuplzudonk collected €0.87 from pot
*** SUMMARY ***
Total pot €0.92 | Rake €0.05 
Board [3c 6s Tc 9h 8s]
Seat 1: stfuplzudonk (button) showed [2h 2c] and won (€0.87) with a pair of Deuces
Seat 2: IKARO_3 (small blind) showed [Qh Ks] and lost with high card King
Seat 3: caduceus369 (big blind) folded before Flop
Seat 4: Wildag00 folded before Flop (didn't bet)
Seat 5: mashallahh folded before Flop (didn't bet)
Seat 6: Clajito17 folded before Flop (didn't bet)



PokerStars Zoom Hand #258027585650:  Hold'em No Limit (€0.01/€0.02) [ADM ID: M62BD3044A1E13PD] - 2025/10/07 1:05:36 CET [2025/10/06 19:05:36 ET]
Table 'Sirio' 6-max Seat #1 is the button
Seat 1: andrea73b16 (€2.21 in chips) 
Seat 2: kdirokko (€0.81 in chips) 
Seat 3: caduceus369 (€3.62 in chips) 
Seat 4: stfuplzudonk (€8.02 in chips) 
Seat 5: Giampon78 (€3.22 in chips) 
kdirokko: posts small blind €0.01
caduceus369: posts big blind €0.02
*** HOLE CARDS ***
Dealt to caduceus369 [3h 4s]
stfuplzudonk: folds 
Giampon78: folds 
andrea73b16: folds 
kdirokko: calls €0.01
caduceus369: checks 
*** FLOP *** [8d Qs 7d]
kdirokko: checks 
caduceus369: checks 
*** TURN *** [8d Qs 7d] [4h]
kdirokko: bets €0.02
caduceus369: calls €0.02
*** RIVER *** [8d Qs 7d 4h] [6d]
kdirokko: checks 
caduceus369: checks 
*** SHOW DOWN ***
kdirokko: shows [Ks 6h] (a pair of Sixes)
caduceus369: mucks hand 
kdirokko collected €0.08 from pot
*** SUMMARY ***
Total pot €0.08 | Rake €0 
Board [8d Qs 7d 4h 6d]
Seat 1: andrea73b16 (button) folded before Flop (didn't bet)
Seat 2: kdirokko (small blind) showed [Ks 6h] and won (€0.08) with a pair of Sixes
Seat 3: caduceus369 (big blind) mucked [3h 4s]
Seat 4: stfuplzudonk folded before Flop (didn't bet)
Seat 5: Giampon78 folded before Flop (didn't bet)



PokerStars Zoom Hand #258027584530:  Hold'em No Limit (€0.01/€0.02) [ADM ID: M62BD3044A1E13PD] - 2025/10/07 1:05:30 CET [2025/10/06 19:05:30 ET]
Table 'Sirio' 6-max Seat #1 is the button
Seat 1: mashallahh (€4.27 in chips) 
Seat 2: jackkk03 (€1.77 in chips) 
Seat 3: QUATTRODAME (€2.38 in chips) 
Seat 4: caduceus369 (€3.62 in chips) 
Seat 5: andrea73b16 (€2.21 in chips) 
jackkk03: posts small blind €0.01
QUATTRODAME: posts big blind €0.02
*** HOLE CARDS ***
Dealt to caduceus369 [Qs Td]
caduceus369: folds 
andrea73b16: folds 
mashallahh: folds 
jackkk03: calls €0.01
QUATTRODAME: checks 
*** FLOP *** [3d 5s 9c]
jackkk03: bets €0.04
QUATTRODAME: calls €0.04
*** TURN *** [3d 5s 9c] [6c]
jackkk03: bets €0.12
QUATTRODAME: calls €0.12
*** RIVER *** [3d 5s 9c 6c] [Ks]
jackkk03: bets €0.18
QUATTRODAME: folds 
Uncalled bet (€0.18) returned to jackkk03
jackkk03 collected €0.35 from pot
jackkk03: doesn't show hand 
*** SUMMARY ***
Total pot €0.36 | Rake €0.01 
Board [3d 5s 9c 6c Ks]
Seat 1: mashallahh (button) folded before Flop (didn't bet)
Seat 2: jackkk03 (small blind) collected (€0.35)
Seat 3: QUATTRODAME (big blind) folded on the River
Seat 4: caduceus369 folded before Flop (didn't bet)
Seat 5: andrea73b16 folded before Flop (didn't bet)



PokerStars Zoom Hand #258027593259:  Hold'em No Limit (€0.01/€0.02) [ADM ID: M62BD3044A1E13PD] - 2025/10/07 1:06:18 CET [2025/10/06 19:06:18 ET]
Table 'Sirio' 6-max Seat #1 is the button
Seat 1: QUATTRODAME (€2.20 in chips) 
Seat 2: Wildag00 (€4.23 in chips) 
Seat 3: dalailami (€0.78 in chips) 
Seat 4: Aledybala93 (€2.04 in chips) 
Seat 5: mashallahh (€10.02 in chips) 
Seat 6: caduceus369 (€3.58 in chips) 
Wildag00: posts small blind €0.01
dalailami: posts big blind €0.02
*** HOLE CARDS ***
Dealt to caduceus369 [As 2c]
Aledybala93: calls €0.02
mashallahh: folds 
caduceus369: folds 
QUATTRODAME: folds 
Wildag00: raises €0.03 to €0.05
dalailami: raises €0.73 to €0.78 and is all-in
Aledybala93: folds 
Wildag00: folds 
Uncalled bet (€0.73) returned to dalailami
dalailami collected €0.12 from pot
dalailami: doesn't show hand 
*** SUMMARY ***
Total pot €0.12 | Rake €0 
Seat 1: QUATTRODAME (button) folded before Flop (didn't bet)
Seat 2: Wildag00 (small blind) folded before Flop
Seat 3: dalailami (big blind) collected (€0.12)
Seat 4: Aledybala93 folded before Flop
Seat 5: mashallahh folded before Flop (didn't bet)
Seat 6: caduceus369 folded before Flop (didn't bet)



PokerStars Zoom Hand #258027594671:  Hold'em No Limit (€0.01/€0.02) [ADM ID: M62BD3044A1E13PD] - 2025/10/07 1:06:26 CET [2025/10/06 19:06:26 ET]
Table 'Sirio' 6-max Seat #1 is the button
Seat 1: bravo1270 (€0.54 in chips) 
Seat 2: CallMeYzmael (€2.01 in chips) 
Seat 3: Wildag00 (€7.42 in chips) 
Seat 4: QUATTRODAME (€2.20 in chips) 
Seat 5: caduceus369 (€3.58 in chips) 
Seat 6: mashallahh (€10.02 in chips) 
CallMeYzmael: posts small blind €0.01
Wildag00: posts big blind €0.02
*** HOLE CARDS ***
Dealt to caduceus369 [7c 7d]
QUATTRODAME: folds 
caduceus369: raises €0.04 to €0.06
mashallahh: folds 
bravo1270: raises €0.48 to €0.54 and is all-in
CallMeYzmael: folds 
Wildag00: calls €0.52
caduceus369: folds 
*** FLOP *** [7s 8c 8h]
*** TURN *** [7s 8c 8h] [3h]
*** RIVER *** [7s 8c 8h 3h] [4h]
*** SHOW DOWN ***
Wildag00: shows [Kc 9s] (a pair of Eights)
bravo1270: shows [Ks Kh] (two pair, Kings and Eights)
bravo1270 collected €1.09 from pot
*** SUMMARY ***
Total pot €1.15 | Rake €0.06 
Board [7s 8c 8h 3h 4h]
Seat 1: bravo1270 (button) showed [Ks Kh] and won (€1.09) with two pair, Kings and Eights
Seat 2: CallMeYzmael (small blind) folded before Flop
Seat 3: Wildag00 (big blind) showed [Kc 9s] and lost with a pair of Eights
Seat 4: QUATTRODAME folded before Flop (didn't bet)
Seat 5: caduceus369 folded before Flop
Seat 6: mashallahh folded before Flop (didn't bet)



PokerStars Zoom Hand #258027599595:  Hold'em No Limit (€0.01/€0.02) [ADM ID: M62BD3044A1E13PD] - 2025/10/07 1:06:54 CET [2025/10/06 19:06:54 ET]
Table 'Sirio' 6-max Seat #1 is the button
Seat 1: Micmex23 (€1.67 in chips) 
Seat 2: caduceus369 (€3.52 in chips) 
Seat 3: IKARO_3 (€22.96 in chips) 
Seat 4: stfuplzudonk (€7.72 in chips) 
Seat 5: mashallahh (€10.02 in chips) 
caduceus369: posts small blind €0.01
IKARO_3: posts big blind €0.02
*** HOLE CARDS ***
Dealt to caduceus369 [7d 6s]
stfuplzudonk: raises €0.04 to €0.06
mashallahh: folds 
Micmex23: folds 
caduceus369: folds 
IKARO_3: folds 
Uncalled bet (€0.04) returned to stfuplzudonk
stfuplzudonk collected €0.05 from pot
stfuplzudonk: doesn't show hand 
*** SUMMARY ***
Total pot €0.05 | Rake €0 
Seat 1: Micmex23 (button) folded before Flop (didn't bet)
Seat 2: caduceus369 (small blind) folded before Flop
Seat 3: IKARO_3 (big blind) folded before Flop
Seat 4: stfuplzudonk collected (€0.05)
Seat 5: mashallahh folded before Flop (didn't bet)



PokerStars Zoom Hand #258027602842:  Hold'em No Limit (€0.01/€0.02) [ADM ID: M62BD3044A1E13PD] - 2025/10/07 1:07:12 CET [2025/10/06 19:07:12 ET]
Table 'Sirio' 6-max Seat #1 is the button
Seat 1: jackkk03 (€2.13 in chips) 
Seat 2: stfuplzudonk (€7.75 in chips) 
Seat 3: caduceus369 (€3.51 in chips) 
Seat 4: QUATTRODAME (€2.04 in chips) 
Seat 5: andrea73b16 (€3.10 in chips) 
stfuplzudonk: posts small blind €0.01
caduceus369: posts big blind €0.02
*** HOLE CARDS ***
Dealt to caduceus369 [6h 4s]
QUATTRODAME: folds 
andrea73b16: folds 
jackkk03: folds 
stfuplzudonk: folds 
Uncalled bet (€0.01) returned to caduceus369
caduceus369 collected €0.02 from pot
caduceus369: doesn't show hand 
*** SUMMARY ***
Total pot €0.02 | Rake €0 
Seat 1: jackkk03 (button) folded before Flop (didn't bet)
Seat 2: stfuplzudonk (small blind) folded before Flop
Seat 3: caduceus369 (big blind) collected (€0.02)
Seat 4: QUATTRODAME folded before Flop (didn't bet)
Seat 5: andrea73b16 folded before Flop (didn't bet)



PokerStars Zoom Hand #258027602135:  Hold'em No Limit (€0.01/€0.02) [ADM ID: M62BD3044A1E13PD] - 2025/10/07 1:07:08 CET [2025/10/06 19:07:08 ET]
Table 'Sirio' 6-max Seat #1 is the button
Seat 1: QUATTRODAME (€2.04 in chips) 
Seat 2: Giampon78 (€3.68 in chips) 
Seat 3: bravo1270 (€1.09 in chips) 
Seat 4: caduceus369 (€3.51 in chips) 
Seat 5: IKARO_3 (€22.94 in chips) 
Giampon78: posts small blind €0.01
bravo1270: posts big blind €0.02
*** HOLE CARDS ***
Dealt to caduceus369 [2c 8s]
caduceus369: folds 
IKARO_3: folds 
QUATTRODAME: folds 
Giampon78: calls €0.01
bravo1270: checks 
*** FLOP *** [3s 5s Kh]
Giampon78: checks 
bravo1270: bets €0.02
Giampon78: calls €0.02
*** TURN *** [3s 5s Kh] [9s]
Giampon78: checks 
bravo1270: checks 
*** RIVER *** [3s 5s Kh 9s] [8c]
Giampon78: checks 
bravo1270: checks 
*** SHOW DOWN ***
Giampon78: shows [2d 2s] (a pair of Deuces)
bravo1270: shows [7h 7c] (a pair of Sevens)
bravo1270 collected €0.08 from pot
*** SUMMARY ***
Total pot €0.08 | Rake €0 
Board [3s 5s Kh 9s 8c]
Seat 1: QUATTRODAME (button) folded before Flop (didn't bet)
Seat 2: Giampon78 (small blind) showed [2d 2s] and lost with a pair of Deuces
Seat 3: bravo1270 (big blind) showed [7h 7c] and won (€0.08) with a pair of Sevens
Seat 4: caduceus369 folded before Flop (didn't bet)
Seat 5: IKARO_3 folded before Flop (didn't bet)



PokerStars Zoom Hand #258027606078:  Hold'em No Limit (€0.01/€0.02) [ADM ID: M62BD3044A1E13PD] - 2025/10/07 1:07:30 CET [2025/10/06 19:07:30 ET]
Table 'Sirio' 6-max Seat #1 is the button
Seat 1: RRgalp (€11.86 in chips) 
Seat 2: caduceus369 (€3.52 in chips) 
Seat 3: CallMeYzmael (€2.10 in chips) 
Seat 4: mashallahh (€4.20 in chips) 
Seat 5: bravo1270 (€1.12 in chips) 
Seat 6: IKARO_3 (€1.68 in chips) 
caduceus369: posts small blind €0.01
CallMeYzmael: posts big blind €0.02
*** HOLE CARDS ***
Dealt to caduceus369 [Td 9c]
mashallahh: folds 
bravo1270: folds 
IKARO_3: folds 
RRgalp: folds 
caduceus369: raises €0.04 to €0.06
CallMeYzmael: folds 
Uncalled bet (€0.04) returned to caduceus369
caduceus369 collected €0.04 from pot
caduceus369: doesn't show hand 
*** SUMMARY ***
Total pot €0.04 | Rake €0 
Seat 1: RRgalp (button) folded before Flop (didn't bet)
Seat 2: caduceus369 (small blind) collected (€0.04)
Seat 3: CallMeYzmael (big blind) folded before Flop
Seat 4: mashallahh folded before Flop (didn't bet)
Seat 5: bravo1270 folded before Flop (didn't bet)
Seat 6: IKARO_3 folded before Flop (didn't bet)



PokerStars Zoom Hand #258027609437:  Hold'em No Limit (€0.01/€0.02) [ADM ID: M62BD3044A1E13PD] - 2025/10/07 1:07:49 CET [2025/10/06 19:07:49 ET]
Table 'Sirio' 6-max Seat #1 is the button
Seat 1: mashallahh (€9.99 in chips) 
Seat 2: IKARO_3 (€1.68 in chips) 
Seat 3: stev@nin (€2 in chips) 
Seat 4: Wildag00 (€4.15 in chips) 
Seat 5: caduceus369 (€3.54 in chips) 
IKARO_3: posts small blind €0.01
stev@nin: posts big blind €0.02
*** HOLE CARDS ***
Dealt to caduceus369 [Kh 9h]
Wildag00: folds 
caduceus369: raises €0.04 to €0.06
mashallahh: folds 
IKARO_3: folds 
stev@nin: calls €0.04
*** FLOP *** [5h Jh 6c]
stev@nin: checks 
caduceus369: bets €0.08
stev@nin: folds 
Uncalled bet (€0.08) returned to caduceus369
caduceus369 collected €0.13 from pot
caduceus369: doesn't show hand 
*** SUMMARY ***
Total pot €0.13 | Rake €0 
Board [5h Jh 6c]
Seat 1: mashallahh (button) folded before Flop (didn't bet)
Seat 2: IKARO_3 (small blind) folded before Flop
Seat 3: stev@nin (big blind) folded on the Flop
Seat 4: Wildag00 folded before Flop (didn't bet)
Seat 5: caduceus369 collected (€0.13)



PokerStars Zoom Hand #258027600371:  Hold'em No Limit (€0.01/€0.02) [ADM ID: M62BD3044A1E13PD] - 2025/10/07 1:06:58 CET [2025/10/06 19:06:58 ET]
Table 'Sirio' 6-max Seat #1 is the button
Seat 1: caduceus369 (€3.51 in chips) 
Seat 2: Nottegiorno1 (€1.18 in chips) 
Seat 3: kdirokko (€0.89 in chips) 
Seat 4: SebaRapy14 (€13.35 in chips) 
Seat 5: Wildag00 (€6.88 in chips) 
Seat 6: bravo1270 (€1.09 in chips) 
Nottegiorno1: posts small blind €0.01
kdirokko: posts big blind €0.02
*** HOLE CARDS ***
Dealt to caduceus369 [Kc 3h]
SebaRapy14: raises €0.04 to €0.06
Wildag00: calls €0.06
bravo1270: folds 
caduceus369: folds 
Nottegiorno1: calls €0.05
kdirokko: calls €0.04
*** FLOP *** [2s 3c 5h]
Nottegiorno1: bets €0.32
kdirokko: folds 
SebaRapy14: calls €0.32
Wildag00: calls €0.32
*** TURN *** [2s 3c 5h] [Js]
Nottegiorno1: checks 
SebaRapy14: checks 
Wildag00: checks 
*** RIVER *** [2s 3c 5h Js] [Jd]
Nottegiorno1: checks 
SebaRapy14: checks 
Wildag00: checks 
*** SHOW DOWN ***
Nottegiorno1: shows [As 5s] (two pair, Jacks and Fives)
SebaRapy14: mucks hand 
Wildag00: mucks hand 
Nottegiorno1 collected €1.14 from pot
*** SUMMARY ***
Total pot €1.20 | Rake €0.06 
Board [2s 3c 5h Js Jd]
Seat 1: caduceus369 (button) folded before Flop (didn't bet)
Seat 2: Nottegiorno1 (small blind) showed [As 5s] and won (€1.14) with two pair, Jacks and Fives
Seat 3: kdirokko (big blind) folded on the Flop
Seat 4: SebaRapy14 mucked [Qd Ah]
Seat 5: Wildag00 mucked [8h 6h]
Seat 6: bravo1270 folded before Flop (didn't bet)



PokerStars Zoom Hand #258027615129:  Hold'em No Limit (€0.01/€0.02) [ADM ID: M62BD3044A1E13PD] - 2025/10/07 1:08:21 CET [2025/10/06 19:08:21 ET]
Table 'Sirio' 6-max Seat #1 is the button
Seat 1: jhonnystecco8 (€0.96 in chips) 
Seat 2: stev@nin (€2 in chips) 
Seat 3: mashallahh (€9.99 in chips) 
Seat 4: caduceus369 (€3.61 in chips) 
Seat 5: IKARO_3 (€3.33 in chips) 
stev@nin: posts small blind €0.01
mashallahh: posts big blind €0.02
*** HOLE CARDS ***
Dealt to caduceus369 [5h 6h]
caduceus369: folds 
IKARO_3: folds 
jhonnystecco8: raises €0.94 to €0.96 and is all-in
stev@nin: folds 
mashallahh: folds 
Uncalled bet (€0.94) returned to jhonnystecco8
jhonnystecco8 collected €0.05 from pot
jhonnystecco8: doesn't show hand 
*** SUMMARY ***
Total pot €0.05 | Rake €0 
Seat 1: jhonnystecco8 (button) collected (€0.05)
Seat 2: stev@nin (small blind) folded before Flop
Seat 3: mashallahh (big blind) folded before Flop
Seat 4: caduceus369 folded before Flop (didn't bet)
Seat 5: IKARO_3 folded before Flop (didn't bet)



PokerStars Zoom Hand #258027615903:  Hold'em No Limit (€0.01/€0.02) [ADM ID: M62BD3044A1E13PD] - 2025/10/07 1:08:26 CET [2025/10/06 19:08:26 ET]
Table 'Sirio' 6-max Seat #1 is the button
Seat 1: caduceus369 (€3.61 in chips) 
Seat 2: mashallahh (€4.84 in chips) 
Seat 3: RRgalp (€11.82 in chips) 
Seat 4: CallMeYzmael (€2 in chips) 
Seat 5: stev@nin (€2 in chips) 
Seat 6: stfuplzudonk (€5.17 in chips) 
mashallahh: posts small blind €0.01
RRgalp: posts big blind €0.02
*** HOLE CARDS ***
Dealt to caduceus369 [7c Qh]
CallMeYzmael: raises €0.03 to €0.05
stev@nin: folds 
stfuplzudonk: calls €0.05
caduceus369: folds 
mashallahh: folds 
RRgalp: folds 
*** FLOP *** [6c 2c Ad]
CallMeYzmael: bets €0.03
stfuplzudonk: folds 
Uncalled bet (€0.03) returned to CallMeYzmael
CallMeYzmael collected €0.13 from pot
CallMeYzmael: doesn't show hand 
*** SUMMARY ***
Total pot €0.13 | Rake €0 
Board [6c 2c Ad]
Seat 1: caduceus369 (button) folded before Flop (didn't bet)
Seat 2: mashallahh (small blind) folded before Flop
Seat 3: RRgalp (big blind) folded before Flop
Seat 4: CallMeYzmael collected (€0.13)
Seat 5: stev@nin folded before Flop (didn't bet)
Seat 6: stfuplzudonk folded on the Flop



PokerStars Zoom Hand #258027617330:  Hold'em No Limit (€0.01/€0.02) [ADM ID: M62BD3044A1E13PD] - 2025/10/07 1:08:34 CET [2025/10/06 19:08:34 ET]
Table 'Sirio' 6-max Seat #1 is the button
Seat 1: bravo1270 (€1.07 in chips) 
Seat 2: kdirokko (€0.90 in chips) 
Seat 3: stfuplzudonk (€7.94 in chips) 
Seat 4: mashallahh (€9.97 in chips) 
Seat 5: caduceus369 (€3.61 in chips) 
Seat 6: RRgalp (€11.80 in chips) 
kdirokko: posts small blind €0.01
stfuplzudonk: posts big blind €0.02
*** HOLE CARDS ***
Dealt to caduceus369 [8d 2s]
mashallahh: folds 
caduceus369: folds 
RRgalp: folds 
bravo1270: calls €0.02
kdirokko: raises €0.02 to €0.04
stfuplzudonk: calls €0.02
bravo1270: calls €0.02
*** FLOP *** [Ad 8s 9s]
kdirokko: bets €0.08
stfuplzudonk: folds 
bravo1270: folds 
Uncalled bet (€0.08) returned to kdirokko
kdirokko collected €0.12 from pot
kdirokko: doesn't show hand 
*** SUMMARY ***
Total pot €0.12 | Rake €0 
Board [Ad 8s 9s]
Seat 1: bravo1270 (button) folded on the Flop
Seat 2: kdirokko (small blind) collected (€0.12)
Seat 3: stfuplzudonk (big blind) folded on the Flop
Seat 4: mashallahh folded before Flop (didn't bet)
Seat 5: caduceus369 folded before Flop (didn't bet)
Seat 6: RRgalp folded before Flop (didn't bet)



PokerStars Zoom Hand #258027619383:  Hold'em No Limit (€0.01/€0.02) [ADM ID: M62BD3044A1E13PD] - 2025/10/07 1:08:46 CET [2025/10/06 19:08:46 ET]
Table 'Sirio' 6-max Seat #1 is the button
Seat 1: CallMeYzmael (€2.08 in chips) 
Seat 2: RRgalp (€11.80 in chips) 
Seat 3: caduceus369 (€3.61 in chips) 
Seat 4: Wildag00 (€6.50 in chips) 
Seat 5: SebaRapy14 (€12.96 in chips) 
RRgalp: posts small blind €0.01
caduceus369: posts big blind €0.02
*** HOLE CARDS ***
Dealt to caduceus369 [Kd 5h]
Wildag00: folds 
SebaRapy14: raises €0.04 to €0.06
CallMeYzmael: folds 
RRgalp: folds 
caduceus369: folds 
Uncalled bet (€0.04) returned to SebaRapy14
SebaRapy14 collected €0.05 from pot
SebaRapy14: doesn't show hand 
*** SUMMARY ***
Total pot €0.05 | Rake €0 
Seat 1: CallMeYzmael (button) folded before Flop (didn't bet)
Seat 2: RRgalp (small blind) folded before Flop
Seat 3: caduceus369 (big blind) folded before Flop
Seat 4: Wildag00 folded before Flop (didn't bet)
Seat 5: SebaRapy14 collected (€0.05)



PokerStars Zoom Hand #258027622266:  Hold'em No Limit (€0.01/€0.02) [ADM ID: M62BD3044A1E13PD] - 2025/10/07 1:09:02 CET [2025/10/06 19:09:02 ET]
Table 'Sirio' 6-max Seat #1 is the button
Seat 1: andrea73b16 (€3.79 in chips) 
Seat 2: caduceus369 (€3.59 in chips) 
Seat 3: CallMeYzmael (€2.08 in chips) 
Seat 4: IKARO_3 (€3.32 in chips) 
Seat 5: bravo1270 (€1.03 in chips) 
Seat 6: kdirokko (€1.01 in chips) 
caduceus369: posts small blind €0.01
CallMeYzmael: posts big blind €0.02
*** HOLE CARDS ***
Dealt to caduceus369 [4s 8s]
IKARO_3: folds 
bravo1270: folds 
kdirokko: folds 
andrea73b16: raises €0.04 to €0.06
caduceus369: folds 
CallMeYzmael: calls €0.04
*** FLOP *** [Qh 8c Ts]
CallMeYzmael: checks 
andrea73b16: checks 
*** TURN *** [Qh 8c Ts] [Qd]
CallMeYzmael: checks 
andrea73b16: checks 
*** RIVER *** [Qh 8c Ts Qd] [Kd]
CallMeYzmael: checks 
andrea73b16: checks 
*** SHOW DOWN ***
CallMeYzmael: shows [As 7s] (a pair of Queens)
andrea73b16: shows [2d Td] (two pair, Queens and Tens)
andrea73b16 collected €0.13 from pot
*** SUMMARY ***
Total pot €0.13 | Rake €0 
Board [Qh 8c Ts Qd Kd]
Seat 1: andrea73b16 (button) showed [2d Td] and won (€0.13) with two pair, Queens and Tens
Seat 2: caduceus369 (small blind) folded before Flop
Seat 3: CallMeYzmael (big blind) showed [As 7s] and lost with a pair of Queens
Seat 4: IKARO_3 folded before Flop (didn't bet)
Seat 5: bravo1270 folded before Flop (didn't bet)
Seat 6: kdirokko folded before Flop (didn't bet)



PokerStars Zoom Hand #258027623409:  Hold'em No Limit (€0.01/€0.02) [ADM ID: M62BD3044A1E13PD] - 2025/10/07 1:09:09 CET [2025/10/06 19:09:09 ET]
Table 'Sirio' 6-max Seat #1 is the button
Seat 1: caduceus369 (€3.58 in chips) 
Seat 2: mashallahh (€4.28 in chips) 
Seat 3: SebaRapy14 (€12.99 in chips) 
Seat 4: kdirokko (€1.01 in chips) 
Seat 5: stfuplzudonk (€2.93 in chips) 
mashallahh: posts small blind €0.01
SebaRapy14: posts big blind €0.02
*** HOLE CARDS ***
Dealt to caduceus369 [Ad Jd]
kdirokko: folds 
stfuplzudonk: raises €0.04 to €0.06
caduceus369: raises €0.14 to €0.20
mashallahh: folds 
SebaRapy14: folds 
stfuplzudonk: calls €0.14
*** FLOP *** [4s Jh 4c]
stfuplzudonk: checks 
caduceus369: bets €0.23
stfuplzudonk: calls €0.23
*** TURN *** [4s Jh 4c] [Qh]
stfuplzudonk: checks 
caduceus369: checks 
*** RIVER *** [4s Jh 4c Qh] [4d]
stfuplzudonk: checks 
caduceus369: checks 
*** SHOW DOWN ***
stfuplzudonk: shows [Kd Jc] (a full house, Fours full of Jacks)
caduceus369: shows [Ad Jd] (a full house, Fours full of Jacks)
stfuplzudonk collected €0.43 from pot
caduceus369 collected €0.42 from pot
*** SUMMARY ***
Total pot €0.89 | Rake €0.04 
Board [4s Jh 4c Qh 4d]
Seat 1: caduceus369 (button) showed [Ad Jd] and won (€0.42) with a full house, Fours full of Jacks
Seat 2: mashallahh (small blind) folded before Flop
Seat 3: SebaRapy14 (big blind) folded before Flop
Seat 4: kdirokko folded before Flop (didn't bet)
Seat 5: stfuplzudonk showed [Kd Jc] and won (€0.43) with a full house, Fours full of Jacks



PokerStars Zoom Hand #258027639021:  Hold'em No Limit (€0.01/€0.02) [ADM ID: M62BD3044A1E13PD] - 2025/10/07 1:10:37 CET [2025/10/06 19:10:37 ET]
Table 'Sirio' 6-max Seat #1 is the button
Seat 1: gigysk (€0.92 in chips) 
Seat 2: caduceus369 (€3.57 in chips) 
Seat 3: Wildag00 (€4.07 in chips) 
Seat 4: dalailami (€0.89 in chips) 
Seat 5: mashallahh (€9.93 in chips) 
Seat 6: andrea73b16 (€2 in chips) 
caduceus369: posts small blind €0.01
Wildag00: posts big blind €0.02
*** HOLE CARDS ***
Dealt to caduceus369 [9h 7s]
dalailami: folds 
mashallahh: folds 
andrea73b16: raises €0.04 to €0.06
gigysk: folds 
caduceus369: folds 
Wildag00: folds 
Uncalled bet (€0.04) returned to andrea73b16
andrea73b16 collected €0.05 from pot
andrea73b16: doesn't show hand 
*** SUMMARY ***
Total pot €0.05 | Rake €0 
Seat 1: gigysk (button) folded before Flop (didn't bet)
Seat 2: caduceus369 (small blind) folded before Flop
Seat 3: Wildag00 (big blind) folded before Flop
Seat 4: dalailami folded before Flop (didn't bet)
Seat 5: mashallahh folded before Flop (didn't bet)
Seat 6: andrea73b16 collected (€0.05)



PokerStars Zoom Hand #258027636747:  Hold'em No Limit (€0.01/€0.02) [ADM ID: M62BD3044A1E13PD] - 2025/10/07 1:10:24 CET [2025/10/06 19:10:24 ET]
Table 'Sirio' 6-max Seat #1 is the button
Seat 1: Wildag00 (€4.07 in chips) 
Seat 2: RRgalp (€11.89 in chips) 
Seat 3: mashallahh (€5.07 in chips) 
Seat 4: IKARO_3 (€21.94 in chips) 
Seat 5: kdirokko (€0.88 in chips) 
Seat 6: caduceus369 (€3.57 in chips) 
RRgalp: posts small blind €0.01
mashallahh: posts big blind €0.02
*** HOLE CARDS ***
Dealt to caduceus369 [3s 8s]
IKARO_3: folds 
kdirokko: raises €0.02 to €0.04
caduceus369: folds 
Wildag00: folds 
RRgalp: raises €0.08 to €0.12
mashallahh: folds 
kdirokko: calls €0.08
*** FLOP *** [Kh Kd 9d]
RRgalp: checks 
kdirokko: bets €0.13
RRgalp: folds 
Uncalled bet (€0.13) returned to kdirokko
kdirokko collected €0.25 from pot
kdirokko: doesn't show hand 
*** SUMMARY ***
Total pot €0.26 | Rake €0.01 
Board [Kh Kd 9d]
Seat 1: Wildag00 (button) folded before Flop (didn't bet)
Seat 2: RRgalp (small blind) folded on the Flop
Seat 3: mashallahh (big blind) folded before Flop
Seat 4: IKARO_3 folded before Flop (didn't bet)
Seat 5: kdirokko collected (€0.25)
Seat 6: caduceus369 folded before Flop (didn't bet)



PokerStars Zoom Hand #258027635463:  Hold'em No Limit (€0.01/€0.02) [ADM ID: M62BD3044A1E13PD] - 2025/10/07 1:10:17 CET [2025/10/06 19:10:17 ET]
Table 'Sirio' 6-max Seat #1 is the button
Seat 1: mashallahh (€5.07 in chips) 
Seat 2: stev@nin (€2.04 in chips) 
Seat 3: stfuplzudonk (€2.93 in chips) 
Seat 4: Aledybala93 (€1.34 in chips) 
Seat 5: caduceus369 (€3.57 in chips) 
stev@nin: posts small blind €0.01
stfuplzudonk: posts big blind €0.02
*** HOLE CARDS ***
Dealt to caduceus369 [8d Th]
Aledybala93: folds 
caduceus369: folds 
mashallahh: folds 
stev@nin: raises €0.04 to €0.06
stfuplzudonk: calls €0.04
*** FLOP *** [5s Kh Jh]
stev@nin: bets €0.12
stfuplzudonk: calls €0.12
*** TURN *** [5s Kh Jh] [8h]
stev@nin: bets €0.36
stfuplzudonk: folds 
Uncalled bet (€0.36) returned to stev@nin
stev@nin collected €0.35 from pot
stev@nin: doesn't show hand 
*** SUMMARY ***
Total pot €0.36 | Rake €0.01 
Board [5s Kh Jh 8h]
Seat 1: mashallahh (button) folded before Flop (didn't bet)
Seat 2: stev@nin (small blind) collected (€0.35)
Seat 3: stfuplzudonk (big blind) folded on the Turn
Seat 4: Aledybala93 folded before Flop (didn't bet)
Seat 5: caduceus369 folded before Flop (didn't bet)



PokerStars Zoom Hand #258027641253:  Hold'em No Limit (€0.01/€0.02) [ADM ID: M62BD3044A1E13PD] - 2025/10/07 1:10:50 CET [2025/10/06 19:10:50 ET]
Table 'Sirio' 6-max Seat #1 is the button
Seat 1: QUATTRODAME (€3.79 in chips) 
Seat 2: mashallahh (€6.36 in chips) 
Seat 3: caduceus369 (€3.56 in chips) 
Seat 4: kdirokko (€0.97 in chips) 
Seat 5: Wildag00 (€4.05 in chips) 
mashallahh: posts small blind €0.01
caduceus369: posts big blind €0.02
*** HOLE CARDS ***
Dealt to caduceus369 [Ad 4s]
kdirokko: raises €0.04 to €0.06
Wildag00: folds 
QUATTRODAME: folds 
mashallahh: folds 
caduceus369: folds 
Uncalled bet (€0.04) returned to kdirokko
kdirokko collected €0.05 from pot
kdirokko: doesn't show hand 
*** SUMMARY ***
Total pot €0.05 | Rake €0 
Seat 1: QUATTRODAME (button) folded before Flop (didn't bet)
Seat 2: mashallahh (small blind) folded before Flop
Seat 3: caduceus369 (big blind) folded before Flop
Seat 4: kdirokko collected (€0.05)
Seat 5: Wildag00 folded before Flop (didn't bet)



PokerStars Zoom Hand #258027648351:  Hold'em No Limit (€0.01/€0.02) [ADM ID: M62BD3044A1E13PD] - 2025/10/07 1:11:31 CET [2025/10/06 19:11:31 ET]
Table 'Sirio' 6-max Seat #1 is the button
Seat 1: gigysk (€0.89 in chips) 
Seat 2: IKARO_3 (€21.94 in chips) 
Seat 3: mashallahh (€3.80 in chips) 
Seat 4: caduceus369 (€3.54 in chips) 
Seat 5: andrea73b16 (€2 in chips) 
IKARO_3: posts small blind €0.01
mashallahh: posts big blind €0.02
*** HOLE CARDS ***
Dealt to caduceus369 [As 2c]
caduceus369: folds 
andrea73b16: folds 
gigysk: folds 
IKARO_3: folds 
Uncalled bet (€0.01) returned to mashallahh
mashallahh collected €0.02 from pot
mashallahh: doesn't show hand 
*** SUMMARY ***
Total pot €0.02 | Rake €0 
Seat 1: gigysk (button) folded before Flop (didn't bet)
Seat 2: IKARO_3 (small blind) folded before Flop
Seat 3: mashallahh (big blind) collected (€0.02)
Seat 4: caduceus369 folded before Flop (didn't bet)
Seat 5: andrea73b16 folded before Flop (didn't bet)



PokerStars Zoom Hand #258027649738:  Hold'em No Limit (€0.01/€0.02) [ADM ID: M62BD3044A1E13PD] - 2025/10/07 1:11:39 CET [2025/10/06 19:11:39 ET]
Table 'Sirio' 6-max Seat #1 is the button
Seat 1: andrea73b16 (€2 in chips) 
Seat 2: caduceus369 (€3.54 in chips) 
Seat 3: Wildag00 (€3.97 in chips) 
Seat 4: mashallahh (€5.04 in chips) 
Seat 5: gigysk (€0.89 in chips) 
Seat 6: dispershn (€1.16 in chips) 
caduceus369: posts small blind €0.01
Wildag00: posts big blind €0.02
*** HOLE CARDS ***
Dealt to caduceus369 [Qh 8s]
mashallahh: folds 
gigysk: folds 
dispershn: folds 
andrea73b16: folds 
caduceus369: raises €0.04 to €0.06
Wildag00: folds 
Uncalled bet (€0.04) returned to caduceus369
caduceus369 collected €0.04 from pot
caduceus369: doesn't show hand 
*** SUMMARY ***
Total pot €0.04 | Rake €0 
Seat 1: andrea73b16 (button) folded before Flop (didn't bet)
Seat 2: caduceus369 (small blind) collected (€0.04)
Seat 3: Wildag00 (big blind) folded before Flop
Seat 4: mashallahh folded before Flop (didn't bet)
Seat 5: gigysk folded before Flop (didn't bet)
Seat 6: dispershn folded before Flop (didn't bet)



PokerStars Zoom Hand #258027646097:  Hold'em No Limit (€0.01/€0.02) [ADM ID: M62BD3044A1E13PD] - 2025/10/07 1:11:18 CET [2025/10/06 19:11:18 ET]
Table 'Sirio' 6-max Seat #1 is the button
Seat 1: caduceus369 (€3.54 in chips) 
Seat 2: andrea73b16 (€2.01 in chips) 
Seat 3: gigysk (€0.91 in chips) 
Seat 4: mashallahh (€9.91 in chips) 
Seat 5: stfuplzudonk (€2.75 in chips) 
andrea73b16: posts small blind €0.01
gigysk: posts big blind €0.02
*** HOLE CARDS ***
Dealt to caduceus369 [7h As]
mashallahh: raises €0.04 to €0.06
stfuplzudonk: calls €0.06
caduceus369: folds 
andrea73b16: folds 
gigysk: folds 
*** FLOP *** [9h Td 8h]
mashallahh: bets €0.13
stfuplzudonk: calls €0.13
*** TURN *** [9h Td 8h] [8c]
mashallahh: bets €0.29
stfuplzudonk: calls €0.29
*** RIVER *** [9h Td 8h 8c] [5h]
mashallahh: checks 
stfuplzudonk: bets €0.56
mashallahh: calls €0.56
*** SHOW DOWN ***
stfuplzudonk: shows [8s 7d] (three of a kind, Eights)
mashallahh: mucks hand 
stfuplzudonk collected €2 from pot
*** SUMMARY ***
Total pot €2.11 | Rake €0.11 
Board [9h Td 8h 8c 5h]
Seat 1: caduceus369 (button) folded before Flop (didn't bet)
Seat 2: andrea73b16 (small blind) folded before Flop
Seat 3: gigysk (big blind) folded before Flop
Seat 4: mashallahh mucked [Kd Ks]
Seat 5: stfuplzudonk showed [8s 7d] and won (€2) with three of a kind, Eights



PokerStars Zoom Hand #258027653958:  Hold'em No Limit (€0.01/€0.02) [ADM ID: M62BD3044A1E13PD] - 2025/10/07 1:12:04 CET [2025/10/06 19:12:04 ET]
Table 'Sirio' 6-max Seat #1 is the button
Seat 1: Wildag00 (€3.94 in chips) 
Seat 2: stfuplzudonk (€3.71 in chips) 
Seat 3: gigysk (€0.88 in chips) 
Seat 4: mashallahh (€8.87 in chips) 
Seat 5: caduceus369 (€3.56 in chips) 
stfuplzudonk: posts small blind €0.01
gigysk: posts big blind €0.02
*** HOLE CARDS ***
Dealt to caduceus369 [6d Kc]
mashallahh: folds 
caduceus369: folds 
Wildag00: raises €0.04 to €0.06
stfuplzudonk: folds 
gigysk: folds 
Uncalled bet (€0.04) returned to Wildag00
Wildag00 collected €0.05 from pot
Wildag00: doesn't show hand 
*** SUMMARY ***
Total pot €0.05 | Rake €0 
Seat 1: Wildag00 (button) collected (€0.05)
Seat 2: stfuplzudonk (small blind) folded before Flop
Seat 3: gigysk (big blind) folded before Flop
Seat 4: mashallahh folded before Flop (didn't bet)
Seat 5: caduceus369 folded before Flop (didn't bet)



PokerStars Zoom Hand #258027652476:  Hold'em No Limit (€0.01/€0.02) [ADM ID: M62BD3044A1E13PD] - 2025/10/07 1:11:55 CET [2025/10/06 19:11:55 ET]
Table 'Sirio' 6-max Seat #1 is the button
Seat 1: gigysk (€0.88 in chips) 
Seat 2: QUATTRODAME (€3.76 in chips) 
Seat 3: stfuplzudonk (€9.69 in chips) 
Seat 4: Wildag00 (€3.95 in chips) 
Seat 5: caduceus369 (€3.56 in chips) 
Seat 6: IKARO_3 (€2.90 in chips) 
QUATTRODAME: posts small blind €0.01
stfuplzudonk: posts big blind €0.02
*** HOLE CARDS ***
Dealt to caduceus369 [6c 3s]
Wildag00: folds 
caduceus369: folds 
IKARO_3: raises €0.05 to €0.07
gigysk: folds 
QUATTRODAME: folds 
stfuplzudonk: calls €0.05
*** FLOP *** [6h Jc Qd]
stfuplzudonk: checks 
IKARO_3: bets €0.07
stfuplzudonk: calls €0.07
*** TURN *** [6h Jc Qd] [Tc]
stfuplzudonk: checks 
IKARO_3: bets €0.34
stfuplzudonk: folds 
Uncalled bet (€0.34) returned to IKARO_3
IKARO_3 collected €0.28 from pot
IKARO_3: doesn't show hand 
*** SUMMARY ***
Total pot €0.29 | Rake €0.01 
Board [6h Jc Qd Tc]
Seat 1: gigysk (button) folded before Flop (didn't bet)
Seat 2: QUATTRODAME (small blind) folded before Flop
Seat 3: stfuplzudonk (big blind) folded on the Turn
Seat 4: Wildag00 folded before Flop (didn't bet)
Seat 5: caduceus369 folded before Flop (didn't bet)
Seat 6: IKARO_3 collected (€0.28)



PokerStars Zoom Hand #258027654521:  Hold'em No Limit (€0.01/€0.02) [ADM ID: M62BD3044A1E13PD] - 2025/10/07 1:12:07 CET [2025/10/06 19:12:07 ET]
Table 'Sirio' 6-max Seat #1 is the button
Seat 1: Fenigold (€3.39 in chips) 
Seat 2: stev@nin (€2 in chips) 
Seat 3: caduceus369 (€3.56 in chips) 
Seat 4: dalailami (€0.63 in chips) 
Seat 5: IKARO_3 (€21.91 in chips) 
Seat 6: mashallahh (€3.81 in chips) 
stev@nin: posts small blind €0.01
caduceus369: posts big blind €0.02
*** HOLE CARDS ***
Dealt to caduceus369 [Kh Kd]
dalailami: raises €0.06 to €0.08
IKARO_3: folds 
mashallahh: raises €0.18 to €0.26
Fenigold: folds 
stev@nin: folds 
caduceus369: raises €0.54 to €0.80
dalailami: folds 
mashallahh: calls €0.54
*** FLOP *** [Tc Jd 8c]
caduceus369: bets €0.80
mashallahh: raises €2.21 to €3.01 and is all-in
caduceus369: calls €1.96 and is all-in
Uncalled bet (€0.25) returned to mashallahh
*** TURN *** [Tc Jd 8c] [7d]
*** RIVER *** [Tc Jd 8c 7d] [9c]
*** SHOW DOWN ***
caduceus369: shows [Kh Kd] (a straight, Seven to Jack)
mashallahh: shows [Ac Kc] (a flush, Ace high)
mashallahh collected €6.82 from pot
*** SUMMARY ***
Total pot €7.21 | Rake €0.39 
Board [Tc Jd 8c 7d 9c]
Seat 1: Fenigold (button) folded before Flop (didn't bet)
Seat 2: stev@nin (small blind) folded before Flop
Seat 3: caduceus369 (big blind) showed [Kh Kd] and lost with a straight, Seven to Jack
Seat 4: dalailami folded before Flop
Seat 5: IKARO_3 folded before Flop (didn't bet)
Seat 6: mashallahh showed [Ac Kc] and won (€6.82) with a flush, Ace high



PokerStars Zoom Hand #258027666191:  Hold'em No Limit (€0.01/€0.02) [ADM ID: M62BD3044A1E13PD] - 2025/10/07 1:13:15 CET [2025/10/06 19:13:15 ET]
Table 'Sirio' 6-max Seat #1 is the button
Seat 1: caduceus369 (€2 in chips) 
Seat 2: dalailami (€0.53 in chips) 
Seat 3: mashallahh (€7.07 in chips) 
Seat 4: stfuplzudonk (€1.62 in chips) 
Seat 5: RRgalp (€11.76 in chips) 
dalailami: posts small blind €0.01
mashallahh: posts big blind €0.02
*** HOLE CARDS ***
Dealt to caduceus369 [7d Kh]
stfuplzudonk: folds 
RRgalp: folds 
caduceus369: folds 
dalailami: raises €0.02 to €0.04
mashallahh: folds 
Uncalled bet (€0.02) returned to dalailami
dalailami collected €0.04 from pot
dalailami: doesn't show hand 
*** SUMMARY ***
Total pot €0.04 | Rake €0 
Seat 1: caduceus369 (button) folded before Flop (didn't bet)
Seat 2: dalailami (small blind) collected (€0.04)
Seat 3: mashallahh (big blind) folded before Flop
Seat 4: stfuplzudonk folded before Flop (didn't bet)
Seat 5: RRgalp folded before Flop (didn't bet)



PokerStars Zoom Hand #258027681180:  Hold'em No Limit (€0.01/€0.02) [ADM ID: M62BD3044A1E13PD] - 2025/10/07 1:14:44 CET [2025/10/06 19:14:44 ET]
Table 'Sirio' 6-max Seat #1 is the button
Seat 1: RRgalp (€11.49 in chips) 
Seat 2: stfuplzudonk (€3.69 in chips) 
Seat 3: dalailami (€0.47 in chips) 
Seat 4: caduceus369 (€2 in chips) 
Seat 5: IKARO_3 (€22.11 in chips) 
stfuplzudonk: posts small blind €0.01
dalailami: posts big blind €0.02
*** HOLE CARDS ***
Dealt to caduceus369 [4d Js]
caduceus369: folds 
IKARO_3: folds 
RRgalp: folds 
stfuplzudonk: folds 
Uncalled bet (€0.01) returned to dalailami
dalailami collected €0.02 from pot
dalailami: doesn't show hand 
*** SUMMARY ***
Total pot €0.02 | Rake €0 
Seat 1: RRgalp (button) folded before Flop (didn't bet)
Seat 2: stfuplzudonk (small blind) folded before Flop
Seat 3: dalailami (big blind) collected (€0.02)
Seat 4: caduceus369 folded before Flop (didn't bet)
Seat 5: IKARO_3 folded before Flop (didn't bet)



PokerStars Zoom Hand #258027682053:  Hold'em No Limit (€0.01/€0.02) [ADM ID: M62BD3044A1E13PD] - 2025/10/07 1:14:50 CET [2025/10/06 19:14:50 ET]
Table 'Sirio' 6-max Seat #1 is the button
Seat 1: Delta1896 (€0.78 in chips) 
Seat 2: stfuplzudonk (€9.08 in chips) 
Seat 3: mashallahh (€7.03 in chips) 
Seat 4: IKARO_3 (€3.61 in chips) 
Seat 5: caduceus369 (€2 in chips) 
Seat 6: RRgalp (€11.49 in chips) 
stfuplzudonk: posts small blind €0.01
mashallahh: posts big blind €0.02
*** HOLE CARDS ***
Dealt to caduceus369 [3c Qc]
IKARO_3: raises €0.03 to €0.05
caduceus369: folds 
RRgalp: calls €0.05
Delta1896: raises €0.18 to €0.23
stfuplzudonk: folds 
mashallahh: folds 
IKARO_3: folds 
RRgalp: calls €0.18
*** FLOP *** [2s 5s Ks]
RRgalp: checks 
Delta1896: bets €0.52
RRgalp: folds 
Uncalled bet (€0.52) returned to Delta1896
Delta1896 collected €0.52 from pot
Delta1896: doesn't show hand 
*** SUMMARY ***
Total pot €0.54 | Rake €0.02 
Board [2s 5s Ks]
Seat 1: Delta1896 (button) collected (€0.52)
Seat 2: stfuplzudonk (small blind) folded before Flop
Seat 3: mashallahh (big blind) folded before Flop
Seat 4: IKARO_3 folded before Flop
Seat 5: caduceus369 folded before Flop (didn't bet)
Seat 6: RRgalp folded on the Flop



