PokerStars Zoom Hand #257983834798:  Hold'em No Limit (€0.01/€0.02) [ADM ID: M62BA304494E32ST] - 2025/10/03 18:03:36 CET [2025/10/03 12:03:36 ET]
Table 'Sirio' 6-max Seat #1 is the button
Seat 1: TurboMuletto (€1.23 in chips) 
Seat 2: HIGHLANDER1976 (€0.73 in chips) 
Seat 3: caduceus369 (€2 in chips) 
Seat 4: stfuplzudonk (€3.70 in chips) 
Seat 5: ZefirDevil (€0.98 in chips) 
Seat 6: OMGWOLFX (€10.77 in chips) 
HIGHLANDER1976: posts small blind €0.01
caduceus369: posts big blind €0.02
*** HOLE CARDS ***
Dealt to caduceus369 [6c 7s]
stfuplzudonk: folds 
ZefirDevil: folds 
OMGWOLFX: folds 
TurboMuletto: folds 
HIGHLANDER1976: folds 
Uncalled bet (€0.01) returned to caduceus369
caduceus369 collected €0.02 from pot
caduceus369: doesn't show hand 
*** SUMMARY ***
Total pot €0.02 | Rake €0 
Seat 1: TurboMuletto (button) folded before Flop (didn't bet)
Seat 2: HIGHLANDER1976 (small blind) folded before Flop
Seat 3: caduceus369 (big blind) collected (€0.02)
Seat 4: stfuplzudonk folded before Flop (didn't bet)
Seat 5: ZefirDevil folded before Flop (didn't bet)
Seat 6: OMGWOLFX folded before Flop (didn't bet)



PokerStars Zoom Hand #257983838593:  Hold'em No Limit (€0.01/€0.02) [ADM ID: M62BA304494E32ST] - 2025/10/03 18:03:57 CET [2025/10/03 12:03:57 ET]
Table 'Sirio' 6-max Seat #1 is the button
Seat 1: Zaptio10 (€0.72 in chips) 
Seat 2: caduceus369 (€2.01 in chips) 
Seat 3: ValenTom25 (€0.84 in chips) 
Seat 4: SidneyPrescott (€2 in chips) 
Seat 5: trillycata (€1.35 in chips) 
Seat 6: TripInter (€0.96 in chips) 
caduceus369: posts small blind €0.01
ValenTom25: posts big blind €0.02
*** HOLE CARDS ***
Dealt to caduceus369 [Qs 3h]
SidneyPrescott: folds 
trillycata: folds 
TripInter: calls €0.02
Zaptio10: folds 
caduceus369: folds 
ValenTom25: checks 
*** FLOP *** [7s Js Ks]
ValenTom25: bets €0.02
TripInter: folds 
Uncalled bet (€0.02) returned to ValenTom25
ValenTom25 collected €0.05 from pot
ValenTom25: doesn't show hand 
*** SUMMARY ***
Total pot €0.05 | Rake €0 
Board [7s Js Ks]
Seat 1: Zaptio10 (button) folded before Flop (didn't bet)
Seat 2: caduceus369 (small blind) folded before Flop
Seat 3: ValenTom25 (big blind) collected (€0.05)
Seat 4: SidneyPrescott folded before Flop (didn't bet)
Seat 5: trillycata folded before Flop (didn't bet)
Seat 6: TripInter folded on the Flop



PokerStars Zoom Hand #257983840773:  Hold'em No Limit (€0.01/€0.02) [ADM ID: M62BA304494E32ST] - 2025/10/03 18:04:09 CET [2025/10/03 12:04:09 ET]
Table 'Sirio' 6-max Seat #1 is the button
Seat 1: zicky78.r (€3.16 in chips) 
Seat 2: cap e'bomb95 (€1.60 in chips) 
Seat 3: GIacius (€2 in chips) 
Seat 4: jeeslike (€8.22 in chips) 
Seat 5: stfuplzudonk (€3.68 in chips) 
Seat 6: caduceus369 (€2 in chips) 
cap e'bomb95: posts small blind €0.01
GIacius: posts big blind €0.02
*** HOLE CARDS ***
Dealt to caduceus369 [Kc 7c]
jeeslike: folds 
stfuplzudonk: folds 
caduceus369: folds 
zicky78.r: folds 
cap e'bomb95: folds 
Uncalled bet (€0.01) returned to GIacius
GIacius collected €0.02 from pot
GIacius: doesn't show hand 
*** SUMMARY ***
Total pot €0.02 | Rake €0 
Seat 1: zicky78.r (button) folded before Flop (didn't bet)
Seat 2: cap e'bomb95 (small blind) folded before Flop
Seat 3: GIacius (big blind) collected (€0.02)
Seat 4: jeeslike folded before Flop (didn't bet)
Seat 5: stfuplzudonk folded before Flop (didn't bet)
Seat 6: caduceus369 folded before Flop (didn't bet)



PokerStars Zoom Hand #257983842977:  Hold'em No Limit (€0.01/€0.02) [ADM ID: M62BA304494E32ST] - 2025/10/03 18:04:22 CET [2025/10/03 12:04:22 ET]
Table 'Sirio' 6-max Seat #1 is the button
Seat 1: OMGWOLFX (€10.78 in chips) 
Seat 2: Dono881 (€1.27 in chips) 
Seat 3: caduceus369 (€2 in chips) 
Seat 4: kekkolucio32 (€2.33 in chips) 
Seat 5: QUATTRODAME (€2.18 in chips) 
Seat 6: pistaKKio23 (€2.31 in chips) 
Dono881: posts small blind €0.01
caduceus369: posts big blind €0.02
*** HOLE CARDS ***
Dealt to caduceus369 [4h 8h]
kekkolucio32: folds 
QUATTRODAME: folds 
pistaKKio23: raises €0.04 to €0.06
OMGWOLFX: folds 
Dono881: folds 
caduceus369: folds 
Uncalled bet (€0.04) returned to pistaKKio23
pistaKKio23 collected €0.05 from pot
pistaKKio23: doesn't show hand 
*** SUMMARY ***
Total pot €0.05 | Rake €0 
Seat 1: OMGWOLFX (button) folded before Flop (didn't bet)
Seat 2: Dono881 (small blind) folded before Flop
Seat 3: caduceus369 (big blind) folded before Flop
Seat 4: kekkolucio32 folded before Flop (didn't bet)
Seat 5: QUATTRODAME folded before Flop (didn't bet)
Seat 6: pistaKKio23 collected (€0.05)



PokerStars Zoom Hand #257983839629:  Hold'em No Limit (€0.01/€0.02) [ADM ID: M62BA304494E32ST] - 2025/10/03 18:04:03 CET [2025/10/03 12:04:03 ET]
Table 'Sirio' 6-max Seat #1 is the button
Seat 1: caduceus369 (€2 in chips) 
Seat 2: Cruelplace84 (€2.07 in chips) 
Seat 3: KilometroZer0 (€5.19 in chips) 
Seat 4: puerperos (€4.16 in chips) 
Seat 5: GIacius (€2 in chips) 
Seat 6: stfuplzudonk (€3.68 in chips) 
Cruelplace84: posts small blind €0.01
KilometroZer0: posts big blind €0.02
*** HOLE CARDS ***
Dealt to caduceus369 [Ts 6h]
puerperos: calls €0.02
GIacius: folds 
stfuplzudonk: folds 
caduceus369: folds 
Cruelplace84: calls €0.01
KilometroZer0: checks 
*** FLOP *** [4h 7s 8d]
Cruelplace84: checks 
KilometroZer0: checks 
puerperos: checks 
*** TURN *** [4h 7s 8d] [Kh]
Cruelplace84: checks 
KilometroZer0: checks 
puerperos: bets €0.06
Cruelplace84: folds 
KilometroZer0: folds 
Uncalled bet (€0.06) returned to puerperos
puerperos collected €0.06 from pot
puerperos: doesn't show hand 
*** SUMMARY ***
Total pot €0.06 | Rake €0 
Board [4h 7s 8d Kh]
Seat 1: caduceus369 (button) folded before Flop (didn't bet)
Seat 2: Cruelplace84 (small blind) folded on the Turn
Seat 3: KilometroZer0 (big blind) folded on the Turn
Seat 4: puerperos collected (€0.06)
Seat 5: GIacius folded before Flop (didn't bet)
Seat 6: stfuplzudonk folded before Flop (didn't bet)



PokerStars Zoom Hand #257983846010:  Hold'em No Limit (€0.01/€0.02) [ADM ID: M62BA304494E32ST] - 2025/10/03 18:04:40 CET [2025/10/03 12:04:40 ET]
Table 'Sirio' 6-max Seat #1 is the button
Seat 1: caduceus369 (€1.98 in chips) 
Seat 2: QUATTRODAME (€2.18 in chips) 
Seat 3: ZefirDevil (€1.06 in chips) 
Seat 4: pistaKKio23 (€1.74 in chips) 
Seat 5: Zaptio10 (€0.68 in chips) 
Seat 6: trillycata (€1.32 in chips) 
QUATTRODAME: posts small blind €0.01
ZefirDevil: posts big blind €0.02
*** HOLE CARDS ***
Dealt to caduceus369 [Ad 5c]
pistaKKio23 has timed out
pistaKKio23: folds 
Zaptio10: folds 
trillycata: folds 
caduceus369: raises €0.02 to €0.04
QUATTRODAME: folds 
ZefirDevil: calls €0.02
*** FLOP *** [9h 6c Jd]
ZefirDevil: bets €0.02
caduceus369: calls €0.02
*** TURN *** [9h 6c Jd] [7c]
ZefirDevil: checks 
caduceus369: checks 
*** RIVER *** [9h 6c Jd 7c] [8s]
ZefirDevil: checks 
caduceus369: bets €0.06
ZefirDevil: folds 
Uncalled bet (€0.06) returned to caduceus369
caduceus369 collected €0.13 from pot
caduceus369: doesn't show hand 
*** SUMMARY ***
Total pot €0.13 | Rake €0 
Board [9h 6c Jd 7c 8s]
Seat 1: caduceus369 (button) collected (€0.13)
Seat 2: QUATTRODAME (small blind) folded before Flop
Seat 3: ZefirDevil (big blind) folded on the River
Seat 4: pistaKKio23 folded before Flop (didn't bet)
Seat 5: Zaptio10 folded before Flop (didn't bet)
Seat 6: trillycata folded before Flop (didn't bet)



PokerStars Zoom Hand #257983857199:  Hold'em No Limit (€0.01/€0.02) [ADM ID: M62BA304494E32ST] - 2025/10/03 18:05:43 CET [2025/10/03 12:05:43 ET]
Table 'Sirio' 6-max Seat #1 is the button
Seat 1: HIGHLANDER1976 (€1.82 in chips) 
Seat 2: stfuplzudonk (€2.33 in chips) 
Seat 3: SidneyPrescott (€2 in chips) 
Seat 4: GIacius (€2 in chips) 
Seat 5: caduceus369 (€2.05 in chips) 
Seat 6: cap e'bomb95 (€1.69 in chips) 
stfuplzudonk: posts small blind €0.01
SidneyPrescott: posts big blind €0.02
*** HOLE CARDS ***
Dealt to caduceus369 [4h Jh]
GIacius: folds 
caduceus369: folds 
cap e'bomb95: folds 
HIGHLANDER1976: raises €0.05 to €0.07
stfuplzudonk: folds 
SidneyPrescott: folds 
Uncalled bet (€0.05) returned to HIGHLANDER1976
HIGHLANDER1976 collected €0.05 from pot
HIGHLANDER1976: doesn't show hand 
*** SUMMARY ***
Total pot €0.05 | Rake €0 
Seat 1: HIGHLANDER1976 (button) collected (€0.05)
Seat 2: stfuplzudonk (small blind) folded before Flop
Seat 3: SidneyPrescott (big blind) folded before Flop
Seat 4: GIacius folded before Flop (didn't bet)
Seat 5: caduceus369 folded before Flop (didn't bet)
Seat 6: cap e'bomb95 folded before Flop (didn't bet)



PokerStars Zoom Hand #257983860585:  Hold'em No Limit (€0.01/€0.02) [ADM ID: M62BA304494E32ST] - 2025/10/03 18:06:02 CET [2025/10/03 12:06:02 ET]
Table 'Sirio' 6-max Seat #1 is the button
Seat 1: KilometroZer0 (€8.34 in chips) 
Seat 2: caduceus369 (€2.05 in chips) 
Seat 3: cap e'bomb95 (€1.69 in chips) 
Seat 4: OMGWOLFX (€2 in chips) 
Seat 5: puerperos (€4.28 in chips) 
Seat 6: SidneyPrescott (€2.31 in chips) 
caduceus369: posts small blind €0.01
cap e'bomb95: posts big blind €0.02
*** HOLE CARDS ***
Dealt to caduceus369 [6s Qc]
OMGWOLFX: raises €0.04 to €0.06
puerperos: folds 
SidneyPrescott: folds 
KilometroZer0: folds 
caduceus369: folds 
cap e'bomb95: folds 
Uncalled bet (€0.04) returned to OMGWOLFX
OMGWOLFX collected €0.05 from pot
OMGWOLFX: doesn't show hand 
*** SUMMARY ***
Total pot €0.05 | Rake €0 
Seat 1: KilometroZer0 (button) folded before Flop (didn't bet)
Seat 2: caduceus369 (small blind) folded before Flop
Seat 3: cap e'bomb95 (big blind) folded before Flop
Seat 4: OMGWOLFX collected (€0.05)
Seat 5: puerperos folded before Flop (didn't bet)
Seat 6: SidneyPrescott folded before Flop (didn't bet)



PokerStars Zoom Hand #257983861514:  Hold'em No Limit (€0.01/€0.02) [ADM ID: M62BA304494E32ST] - 2025/10/03 18:06:07 CET [2025/10/03 12:06:07 ET]
Table 'Sirio' 6-max Seat #1 is the button
Seat 1: puerperos (€4.28 in chips) 
Seat 2: SidneyPrescott (€2.34 in chips) 
Seat 3: SaTheNuts_77 (€4.97 in chips) 
Seat 4: Gabrielefante (€2.83 in chips) 
Seat 5: TurboMuletto (€1.10 in chips) 
Seat 6: caduceus369 (€2.04 in chips) 
SidneyPrescott: posts small blind €0.01
SaTheNuts_77: posts big blind €0.02
*** HOLE CARDS ***
Dealt to caduceus369 [3s Ks]
Gabrielefante: folds 
TurboMuletto: folds 
caduceus369: folds 
puerperos: folds 
SidneyPrescott: raises €0.04 to €0.06
SaTheNuts_77: folds 
Uncalled bet (€0.04) returned to SidneyPrescott
SidneyPrescott collected €0.04 from pot
SidneyPrescott: doesn't show hand 
*** SUMMARY ***
Total pot €0.04 | Rake €0 
Seat 1: puerperos (button) folded before Flop (didn't bet)
Seat 2: SidneyPrescott (small blind) collected (€0.04)
Seat 3: SaTheNuts_77 (big blind) folded before Flop
Seat 4: Gabrielefante folded before Flop (didn't bet)
Seat 5: TurboMuletto folded before Flop (didn't bet)
Seat 6: caduceus369 folded before Flop (didn't bet)



PokerStars Zoom Hand #257983859212:  Hold'em No Limit (€0.01/€0.02) [ADM ID: M62BA304494E32ST] - 2025/10/03 18:05:54 CET [2025/10/03 12:05:54 ET]
Table 'Sirio' 6-max Seat #1 is the button
Seat 1: jeeslike (€8.26 in chips) 
Seat 2: Cruelplace84 (€2 in chips) 
Seat 3: Gabrielefante (€2.85 in chips) 
Seat 4: KilometroZer0 (€3.77 in chips) 
Seat 5: caduceus369 (€2.05 in chips) 
Seat 6: Cash_river8 (€0.92 in chips) 
Cruelplace84: posts small blind €0.01
Gabrielefante: posts big blind €0.02
*** HOLE CARDS ***
Dealt to caduceus369 [9c 8c]
KilometroZer0: raises €0.05 to €0.07
caduceus369: folds 
Cash_river8: calls €0.07
jeeslike: raises €0.07 to €0.14
Cruelplace84: folds 
Gabrielefante: folds 
KilometroZer0: folds 
Cash_river8: calls €0.07
*** FLOP *** [7d 9h Ah]
Cash_river8: checks 
jeeslike: bets €0.18
Cash_river8: folds 
Uncalled bet (€0.18) returned to jeeslike
jeeslike collected €0.36 from pot
jeeslike: doesn't show hand 
*** SUMMARY ***
Total pot €0.38 | Rake €0.02 
Board [7d 9h Ah]
Seat 1: jeeslike (button) collected (€0.36)
Seat 2: Cruelplace84 (small blind) folded before Flop
Seat 3: Gabrielefante (big blind) folded before Flop
Seat 4: KilometroZer0 folded before Flop
Seat 5: caduceus369 folded before Flop (didn't bet)
Seat 6: Cash_river8 folded on the Flop



PokerStars Zoom Hand #257983865482:  Hold'em No Limit (€0.01/€0.02) [ADM ID: M62BA304494E32ST] - 2025/10/03 18:06:30 CET [2025/10/03 12:06:30 ET]
Table 'Sirio' 6-max Seat #1 is the button
Seat 1: SidneyPrescott (€2 in chips) 
Seat 2: jeeslike (€8.48 in chips) 
Seat 3: caduceus369 (€2.04 in chips) 
Seat 4: ZefirDevil (€0.88 in chips) 
Seat 5: lilluz46424 (€3.16 in chips) 
Seat 6: TheBigFlash (€1.90 in chips) 
jeeslike: posts small blind €0.01
caduceus369: posts big blind €0.02
*** HOLE CARDS ***
Dealt to caduceus369 [8h 5c]
ZefirDevil: folds 
lilluz46424: folds 
TheBigFlash: folds 
SidneyPrescott: raises €0.04 to €0.06
jeeslike: folds 
caduceus369: folds 
Uncalled bet (€0.04) returned to SidneyPrescott
SidneyPrescott collected €0.05 from pot
SidneyPrescott: doesn't show hand 
*** SUMMARY ***
Total pot €0.05 | Rake €0 
Seat 1: SidneyPrescott (button) collected (€0.05)
Seat 2: jeeslike (small blind) folded before Flop
Seat 3: caduceus369 (big blind) folded before Flop
Seat 4: ZefirDevil folded before Flop (didn't bet)
Seat 5: lilluz46424 folded before Flop (didn't bet)
Seat 6: TheBigFlash folded before Flop (didn't bet)



PokerStars Zoom Hand #257983862314:  Hold'em No Limit (€0.01/€0.02) [ADM ID: M62BA304494E32ST] - 2025/10/03 18:06:12 CET [2025/10/03 12:06:12 ET]
Table 'Sirio' 6-max Seat #1 is the button
Seat 1: cap e'bomb95 (€1.67 in chips) 
Seat 2: Gabrielefante (€2.83 in chips) 
Seat 3: puerperos (€4.28 in chips) 
Seat 4: pistaKKio23 (€2.36 in chips) 
Seat 5: QUATTRODAME (€2.15 in chips) 
Seat 6: caduceus369 (€2.04 in chips) 
Gabrielefante: posts small blind €0.01
puerperos: posts big blind €0.02
*** HOLE CARDS ***
Dealt to caduceus369 [6h 8s]
pistaKKio23: raises €0.04 to €0.06
QUATTRODAME: raises €0.23 to €0.29
caduceus369: folds 
cap e'bomb95: folds 
Gabrielefante: folds 
puerperos: calls €0.27
pistaKKio23: folds 
*** FLOP *** [2s 6d 9h]
puerperos: bets €0.62
QUATTRODAME: raises €1.24 to €1.86 and is all-in
puerperos: calls €1.24
*** TURN *** [2s 6d 9h] [Jd]
*** RIVER *** [2s 6d 9h Jd] [4c]
*** SHOW DOWN ***
puerperos: shows [Td Th] (a pair of Tens)
QUATTRODAME: shows [Kh Kd] (a pair of Kings)
QUATTRODAME collected €4.13 from pot
*** SUMMARY ***
Total pot €4.37 | Rake €0.24 
Board [2s 6d 9h Jd 4c]
Seat 1: cap e'bomb95 (button) folded before Flop (didn't bet)
Seat 2: Gabrielefante (small blind) folded before Flop
Seat 3: puerperos (big blind) showed [Td Th] and lost with a pair of Tens
Seat 4: pistaKKio23 folded before Flop
Seat 5: QUATTRODAME showed [Kh Kd] and won (€4.13) with a pair of Kings
Seat 6: caduceus369 folded before Flop (didn't bet)



PokerStars Zoom Hand #257983863843:  Hold'em No Limit (€0.01/€0.02) [ADM ID: M62BA304494E32ST] - 2025/10/03 18:06:21 CET [2025/10/03 12:06:21 ET]
Table 'Sirio' 6-max Seat #1 is the button
Seat 1: caduceus369 (€2.04 in chips) 
Seat 2: ZefirDevil (€1.62 in chips) 
Seat 3: SidneyPrescott (€2.36 in chips) 
Seat 4: KilometroZer0 (€2.15 in chips) 
Seat 5: Cash_river8 (€0.78 in chips) 
Seat 6: Catania838 (€1.51 in chips) 
ZefirDevil: posts small blind €0.01
SidneyPrescott: posts big blind €0.02
*** HOLE CARDS ***
Dealt to caduceus369 [Qc 7s]
KilometroZer0: raises €0.05 to €0.07
Cash_river8: folds 
Catania838: calls €0.07
caduceus369: folds 
ZefirDevil: folds 
SidneyPrescott: folds 
*** FLOP *** [7c Jc 6h]
KilometroZer0: bets €0.09
Catania838: calls €0.09
*** TURN *** [7c Jc 6h] [Th]
KilometroZer0: bets €0.17
Catania838: raises €0.34 to €0.51
KilometroZer0: folds 
Uncalled bet (€0.34) returned to Catania838
Catania838 collected €0.66 from pot
Catania838: doesn't show hand 
*** SUMMARY ***
Total pot €0.69 | Rake €0.03 
Board [7c Jc 6h Th]
Seat 1: caduceus369 (button) folded before Flop (didn't bet)
Seat 2: ZefirDevil (small blind) folded before Flop
Seat 3: SidneyPrescott (big blind) folded before Flop
Seat 4: KilometroZer0 folded on the Turn
Seat 5: Cash_river8 folded before Flop (didn't bet)
Seat 6: Catania838 collected (€0.66)



PokerStars Zoom Hand #257983868529:  Hold'em No Limit (€0.01/€0.02) [ADM ID: M62BA304494E32ST] - 2025/10/03 18:06:47 CET [2025/10/03 12:06:47 ET]
Table 'Sirio' 6-max Seat #1 is the button
Seat 1: SalahUbeen (€1.43 in chips) 
Seat 2: caduceus369 (€2.02 in chips) 
Seat 3: kolain17 (€0.82 in chips) 
Seat 4: Grifo546 (€2.12 in chips) 
Seat 5: pistaKKio23 (€2.30 in chips) 
Seat 6: S'dj83 (€3.50 in chips) 
caduceus369: posts small blind €0.01
kolain17: posts big blind €0.02
*** HOLE CARDS ***
Dealt to caduceus369 [3d Ad]
Grifo546: raises €0.05 to €0.07
pistaKKio23: folds 
S'dj83: folds 
SalahUbeen: folds 
caduceus369: folds 
kolain17: calls €0.05
*** FLOP *** [2c 2h 7c]
kolain17: checks 
Grifo546: bets €0.15
kolain17: folds 
Uncalled bet (€0.15) returned to Grifo546
Grifo546 collected €0.15 from pot
Grifo546: doesn't show hand 
*** SUMMARY ***
Total pot €0.15 | Rake €0 
Board [2c 2h 7c]
Seat 1: SalahUbeen (button) folded before Flop (didn't bet)
Seat 2: caduceus369 (small blind) folded before Flop
Seat 3: kolain17 (big blind) folded on the Flop
Seat 4: Grifo546 collected (€0.15)
Seat 5: pistaKKio23 folded before Flop (didn't bet)
Seat 6: S'dj83 folded before Flop (didn't bet)



PokerStars Zoom Hand #257983871779:  Hold'em No Limit (€0.01/€0.02) [ADM ID: M62BA304494E32ST] - 2025/10/03 18:07:06 CET [2025/10/03 12:07:06 ET]
Table 'Sirio' 6-max Seat #1 is the button
Seat 1: OMGWOLFX (€2 in chips) 
Seat 2: QUATTRODAME (€4.11 in chips) 
Seat 3: pistaKKio23 (€2.30 in chips) 
Seat 4: Cash_river8 (€0.85 in chips) 
Seat 5: caduceus369 (€2.01 in chips) 
Seat 6: stfuplzudonk (€3.86 in chips) 
QUATTRODAME: posts small blind €0.01
pistaKKio23: posts big blind €0.02
*** HOLE CARDS ***
Dealt to caduceus369 [4s 9c]
Cash_river8: folds 
caduceus369: folds 
stfuplzudonk: folds 
OMGWOLFX: raises €0.04 to €0.06
QUATTRODAME: folds 
pistaKKio23: folds 
Uncalled bet (€0.04) returned to OMGWOLFX
OMGWOLFX collected €0.05 from pot
OMGWOLFX: doesn't show hand 
*** SUMMARY ***
Total pot €0.05 | Rake €0 
Seat 1: OMGWOLFX (button) collected (€0.05)
Seat 2: QUATTRODAME (small blind) folded before Flop
Seat 3: pistaKKio23 (big blind) folded before Flop
Seat 4: Cash_river8 folded before Flop (didn't bet)
Seat 5: caduceus369 folded before Flop (didn't bet)
Seat 6: stfuplzudonk folded before Flop (didn't bet)



PokerStars Zoom Hand #257983873668:  Hold'em No Limit (€0.01/€0.02) [ADM ID: M62BA304494E32ST] - 2025/10/03 18:07:16 CET [2025/10/03 12:07:16 ET]
Table 'Sirio' 6-max Seat #1 is the button
Seat 1: Grifo546 (€2.20 in chips) 
Seat 2: stfuplzudonk (€3.86 in chips) 
Seat 3: SalahUbeen (€1.43 in chips) 
Seat 4: pistaKKio23 (€2.28 in chips) 
Seat 5: Catania838 (€1.84 in chips) 
Seat 6: caduceus369 (€2.01 in chips) 
stfuplzudonk: posts small blind €0.01
SalahUbeen: posts big blind €0.02
*** HOLE CARDS ***
Dealt to caduceus369 [Kc 5s]
pistaKKio23: folds 
Catania838: folds 
caduceus369: folds 
Grifo546: folds 
stfuplzudonk: raises €0.04 to €0.06
SalahUbeen: folds 
Uncalled bet (€0.04) returned to stfuplzudonk
stfuplzudonk collected €0.04 from pot
stfuplzudonk: doesn't show hand 
*** SUMMARY ***
Total pot €0.04 | Rake €0 
Seat 1: Grifo546 (button) folded before Flop (didn't bet)
Seat 2: stfuplzudonk (small blind) collected (€0.04)
Seat 3: SalahUbeen (big blind) folded before Flop
Seat 4: pistaKKio23 folded before Flop (didn't bet)
Seat 5: Catania838 folded before Flop (didn't bet)
Seat 6: caduceus369 folded before Flop (didn't bet)



PokerStars Zoom Hand #257983872304:  Hold'em No Limit (€0.01/€0.02) [ADM ID: M62BA304494E32ST] - 2025/10/03 18:07:09 CET [2025/10/03 12:07:09 ET]
Table 'Sirio' 6-max Seat #1 is the button
Seat 1: SidneyPrescott (€2.43 in chips) 
Seat 2: Cash_river8 (€0.85 in chips) 
Seat 3: jeeslike (€8.41 in chips) 
Seat 4: caduceus369 (€2.01 in chips) 
Seat 5: S'dj83 (€3.50 in chips) 
Seat 6: KilometroZer0 (€1.82 in chips) 
Cash_river8: posts small blind €0.01
jeeslike: posts big blind €0.02
*** HOLE CARDS ***
Dealt to caduceus369 [2d 9d]
caduceus369: folds 
S'dj83: folds 
KilometroZer0 has timed out
KilometroZer0: folds 
SidneyPrescott: raises €0.04 to €0.06
Cash_river8: calls €0.05
jeeslike: folds 
*** FLOP *** [3s 3c Ad]
Cash_river8: checks 
SidneyPrescott: bets €0.06
Cash_river8: folds 
Uncalled bet (€0.06) returned to SidneyPrescott
SidneyPrescott collected €0.14 from pot
SidneyPrescott: doesn't show hand 
*** SUMMARY ***
Total pot €0.14 | Rake €0 
Board [3s 3c Ad]
Seat 1: SidneyPrescott (button) collected (€0.14)
Seat 2: Cash_river8 (small blind) folded on the Flop
Seat 3: jeeslike (big blind) folded before Flop
Seat 4: caduceus369 folded before Flop (didn't bet)
Seat 5: S'dj83 folded before Flop (didn't bet)
Seat 6: KilometroZer0 folded before Flop (didn't bet)



PokerStars Zoom Hand #257983874801:  Hold'em No Limit (€0.01/€0.02) [ADM ID: M62BA304494E32ST] - 2025/10/03 18:07:23 CET [2025/10/03 12:07:23 ET]
Table 'Sirio' 6-max Seat #1 is the button
Seat 1: GIacius (€2 in chips) 
Seat 2: pistaKKio23 (€2.28 in chips) 
Seat 3: caduceus369 (€2.01 in chips) 
Seat 4: Kamiros01 (€1.64 in chips) 
Seat 5: HIGHLANDER1976 (€1.87 in chips) 
Seat 6: Grifo546 (€2.20 in chips) 
pistaKKio23: posts small blind €0.01
caduceus369: posts big blind €0.02
*** HOLE CARDS ***
Dealt to caduceus369 [Js 4c]
Kamiros01: folds 
HIGHLANDER1976: folds 
Grifo546: folds 
GIacius: folds 
pistaKKio23: folds 
Uncalled bet (€0.01) returned to caduceus369
caduceus369 collected €0.02 from pot
caduceus369: doesn't show hand 
*** SUMMARY ***
Total pot €0.02 | Rake €0 
Seat 1: GIacius (button) folded before Flop (didn't bet)
Seat 2: pistaKKio23 (small blind) folded before Flop
Seat 3: caduceus369 (big blind) collected (€0.02)
Seat 4: Kamiros01 folded before Flop (didn't bet)
Seat 5: HIGHLANDER1976 folded before Flop (didn't bet)
Seat 6: Grifo546 folded before Flop (didn't bet)



PokerStars Zoom Hand #257983872967:  Hold'em No Limit (€0.01/€0.02) [ADM ID: M62BA304494E32ST] - 2025/10/03 18:07:12 CET [2025/10/03 12:07:12 ET]
Table 'Sirio' 6-max Seat #1 is the button
Seat 1: QUATTRODAME (€4.10 in chips) 
Seat 2: GIacius (€2.04 in chips) 
Seat 3: SalahUbeen (€1.43 in chips) 
Seat 4: Catania838 (€2.54 in chips) 
Seat 5: caduceus369 (€2.01 in chips) 
Seat 6: HIGHLANDER1976 (€0.58 in chips) 
GIacius: posts small blind €0.01
SalahUbeen: posts big blind €0.02
*** HOLE CARDS ***
Dealt to caduceus369 [8d 4s]
Catania838: folds 
caduceus369: folds 
HIGHLANDER1976: folds 
QUATTRODAME: folds 
GIacius: raises €0.04 to €0.06
SalahUbeen: calls €0.04
*** FLOP *** [Jh 3s Kd]
GIacius: checks 
SalahUbeen: checks 
*** TURN *** [Jh 3s Kd] [8h]
GIacius: bets €0.06
SalahUbeen: calls €0.06
*** RIVER *** [Jh 3s Kd 8h] [5h]
GIacius: checks 
SalahUbeen: checks 
*** SHOW DOWN ***
GIacius: shows [9h Qs] (high card King)
SalahUbeen: shows [9d 8s] (a pair of Eights)
SalahUbeen collected €0.23 from pot
*** SUMMARY ***
Total pot €0.24 | Rake €0.01 
Board [Jh 3s Kd 8h 5h]
Seat 1: QUATTRODAME (button) folded before Flop (didn't bet)
Seat 2: GIacius (small blind) showed [9h Qs] and lost with high card King
Seat 3: SalahUbeen (big blind) showed [9d 8s] and won (€0.23) with a pair of Eights
Seat 4: Catania838 folded before Flop (didn't bet)
Seat 5: caduceus369 folded before Flop (didn't bet)
Seat 6: HIGHLANDER1976 folded before Flop (didn't bet)



PokerStars Zoom Hand #257983880263:  Hold'em No Limit (€0.01/€0.02) [ADM ID: M62BA304494E32ST] - 2025/10/03 18:07:53 CET [2025/10/03 12:07:53 ET]
Table 'Sirio' 6-max Seat #1 is the button
Seat 1: OSPREYSTORM (€1.97 in chips) 
Seat 2: caduceus369 (€2.02 in chips) 
Seat 3: panzapelata (€1.95 in chips) 
Seat 4: Poker_Pidal88 (€1.15 in chips) 
Seat 5: Gabrielefante (€2.03 in chips) 
Seat 6: KilometroZer0 (€3.15 in chips) 
caduceus369: posts small blind €0.01
panzapelata: posts big blind €0.02
*** HOLE CARDS ***
Dealt to caduceus369 [2d 6c]
Poker_Pidal88: folds 
Gabrielefante: folds 
KilometroZer0: folds 
OSPREYSTORM: folds 
caduceus369: folds 
Uncalled bet (€0.01) returned to panzapelata
panzapelata collected €0.02 from pot
panzapelata: doesn't show hand 
*** SUMMARY ***
Total pot €0.02 | Rake €0 
Seat 1: OSPREYSTORM (button) folded before Flop (didn't bet)
Seat 2: caduceus369 (small blind) folded before Flop
Seat 3: panzapelata (big blind) collected (€0.02)
Seat 4: Poker_Pidal88 folded before Flop (didn't bet)
Seat 5: Gabrielefante folded before Flop (didn't bet)
Seat 6: KilometroZer0 folded before Flop (didn't bet)



PokerStars Zoom Hand #257983881077:  Hold'em No Limit (€0.01/€0.02) [ADM ID: M62BA304494E32ST] - 2025/10/03 18:07:57 CET [2025/10/03 12:07:57 ET]
Table 'Sirio' 6-max Seat #1 is the button
Seat 1: SalahUbeen (€2.96 in chips) 
Seat 2: winsper79 (€0.91 in chips) 
Seat 3: GIacius (€2 in chips) 
Seat 4: caduceus369 (€2.01 in chips) 
Seat 5: Cruelplace84 (€2.51 in chips) 
Seat 6: Gabrielefante (€2.03 in chips) 
winsper79: posts small blind €0.01
GIacius: posts big blind €0.02
*** HOLE CARDS ***
Dealt to caduceus369 [2c 9c]
caduceus369: folds 
Cruelplace84: folds 
Gabrielefante: folds 
SalahUbeen: folds 
winsper79: raises €0.04 to €0.06
GIacius: folds 
Uncalled bet (€0.04) returned to winsper79
winsper79 collected €0.04 from pot
winsper79: doesn't show hand 
*** SUMMARY ***
Total pot €0.04 | Rake €0 
Seat 1: SalahUbeen (button) folded before Flop (didn't bet)
Seat 2: winsper79 (small blind) collected (€0.04)
Seat 3: GIacius (big blind) folded before Flop
Seat 4: caduceus369 folded before Flop (didn't bet)
Seat 5: Cruelplace84 folded before Flop (didn't bet)
Seat 6: Gabrielefante folded before Flop (didn't bet)



PokerStars Zoom Hand #257983883169:  Hold'em No Limit (€0.01/€0.02) [ADM ID: M62BA304494E32ST] - 2025/10/03 18:08:09 CET [2025/10/03 12:08:09 ET]
Table 'Sirio' 6-max Seat #1 is the button
Seat 1: TheBigFlash (€1.78 in chips) 
Seat 2: Catania838 (€1.88 in chips) 
Seat 3: panzapelata (€1.90 in chips) 
Seat 4: caduceus369 (€2.01 in chips) 
Seat 5: Cash_river8 (€0.77 in chips) 
Seat 6: Cruelplace84 (€2 in chips) 
Catania838: posts small blind €0.01
panzapelata: posts big blind €0.02
*** HOLE CARDS ***
Dealt to caduceus369 [6c 5s]
caduceus369: folds 
Cash_river8: raises €0.06 to €0.08
Cruelplace84: folds 
TheBigFlash: folds 
Catania838: folds 
panzapelata: folds 
Uncalled bet (€0.06) returned to Cash_river8
Cash_river8 collected €0.05 from pot
Cash_river8: doesn't show hand 
*** SUMMARY ***
Total pot €0.05 | Rake €0 
Seat 1: TheBigFlash (button) folded before Flop (didn't bet)
Seat 2: Catania838 (small blind) folded before Flop
Seat 3: panzapelata (big blind) folded before Flop
Seat 4: caduceus369 folded before Flop (didn't bet)
Seat 5: Cash_river8 collected (€0.05)
Seat 6: Cruelplace84 folded before Flop (didn't bet)



PokerStars Zoom Hand #257983881850:  Hold'em No Limit (€0.01/€0.02) [ADM ID: M62BA304494E32ST] - 2025/10/03 18:08:02 CET [2025/10/03 12:08:02 ET]
Table 'Sirio' 6-max Seat #1 is the button
Seat 1: caduceus369 (€2.01 in chips) 
Seat 2: CiroFireFist (€1.14 in chips) 
Seat 3: Poker_Pidal88 (€1.15 in chips) 
Seat 4: ZefirDevil (€0.98 in chips) 
Seat 5: KilometroZer0 (€3.15 in chips) 
Seat 6: pistaKKio23 (€1.60 in chips) 
CiroFireFist: posts small blind €0.01
Poker_Pidal88: posts big blind €0.02
*** HOLE CARDS ***
Dealt to caduceus369 [Ks 3h]
ZefirDevil: calls €0.02
KilometroZer0: folds 
pistaKKio23: folds 
caduceus369: folds 
CiroFireFist: calls €0.01
Poker_Pidal88: checks 
*** FLOP *** [Kc 8h 7d]
CiroFireFist: checks 
Poker_Pidal88: bets €0.05
ZefirDevil: calls €0.05
CiroFireFist: calls €0.05
*** TURN *** [Kc 8h 7d] [8c]
CiroFireFist: checks 
Poker_Pidal88: checks 
ZefirDevil: checks 
*** RIVER *** [Kc 8h 7d 8c] [2h]
CiroFireFist: checks 
Poker_Pidal88: bets €1.08 and is all-in
ZefirDevil: folds 
CiroFireFist: folds 
Uncalled bet (€1.08) returned to Poker_Pidal88
Poker_Pidal88 collected €0.20 from pot
Poker_Pidal88: doesn't show hand 
*** SUMMARY ***
Total pot €0.21 | Rake €0.01 
Board [Kc 8h 7d 8c 2h]
Seat 1: caduceus369 (button) folded before Flop (didn't bet)
Seat 2: CiroFireFist (small blind) folded on the River
Seat 3: Poker_Pidal88 (big blind) collected (€0.20)
Seat 4: ZefirDevil folded on the River
Seat 5: KilometroZer0 folded before Flop (didn't bet)
Seat 6: pistaKKio23 folded before Flop (didn't bet)



PokerStars Zoom Hand #257983878780:  Hold'em No Limit (€0.01/€0.02) [ADM ID: M62BA304494E32ST] - 2025/10/03 18:07:45 CET [2025/10/03 12:07:45 ET]
Table 'Sirio' 6-max Seat #1 is the button
Seat 1: caduceus369 (€2.02 in chips) 
Seat 2: cap e'bomb95 (€1.68 in chips) 
Seat 3: QUATTRODAME (€4.10 in chips) 
Seat 4: panzapelata (€1.95 in chips) 
Seat 5: Cruelplace84 (€2.52 in chips) 
Seat 6: kolain17 (€0.87 in chips) 
cap e'bomb95: posts small blind €0.01
QUATTRODAME: posts big blind €0.02
*** HOLE CARDS ***
Dealt to caduceus369 [Jc 8s]
panzapelata: folds 
Cruelplace84: folds 
kolain17: calls €0.02
caduceus369: folds 
cap e'bomb95: calls €0.01
QUATTRODAME: checks 
*** FLOP *** [2c 4h Jd]
cap e'bomb95: checks 
QUATTRODAME: checks 
kolain17: checks 
*** TURN *** [2c 4h Jd] [5d]
cap e'bomb95: bets €0.04
QUATTRODAME: calls €0.04
kolain17: calls €0.04
*** RIVER *** [2c 4h Jd 5d] [Qs]
cap e'bomb95: checks 
QUATTRODAME: checks 
kolain17: checks 
*** SHOW DOWN ***
cap e'bomb95: shows [Ac 3c] (a straight, Ace to Five)
QUATTRODAME: mucks hand 
kolain17: mucks hand 
cap e'bomb95 collected €0.18 from pot
*** SUMMARY ***
Total pot €0.18 | Rake €0 
Board [2c 4h Jd 5d Qs]
Seat 1: caduceus369 (button) folded before Flop (didn't bet)
Seat 2: cap e'bomb95 (small blind) showed [Ac 3c] and won (€0.18) with a straight, Ace to Five
Seat 3: QUATTRODAME (big blind) mucked [8c Jh]
Seat 4: panzapelata folded before Flop (didn't bet)
Seat 5: Cruelplace84 folded before Flop (didn't bet)
Seat 6: kolain17 mucked [3h 5h]



PokerStars Zoom Hand #257983884235:  Hold'em No Limit (€0.01/€0.02) [ADM ID: M62BA304494E32ST] - 2025/10/03 18:08:15 CET [2025/10/03 12:08:15 ET]
Table 'Sirio' 6-max Seat #1 is the button
Seat 1: heitel (€1.54 in chips) 
Seat 2: pylonstrip (€2 in chips) 
Seat 3: caduceus369 (€2.01 in chips) 
Seat 4: GIacius (€2.12 in chips) 
Seat 5: Cruelplace84 (€2.87 in chips) 
Seat 6: SidneyPrescott (€2.31 in chips) 
pylonstrip: posts small blind €0.01
caduceus369: posts big blind €0.02
*** HOLE CARDS ***
Dealt to caduceus369 [8d Ad]
GIacius: folds 
Cruelplace84: folds 
SidneyPrescott: folds 
heitel: raises €0.04 to €0.06
pylonstrip: folds 
caduceus369: calls €0.04
*** FLOP *** [6d 7s Ts]
caduceus369: checks 
heitel: bets €0.13
caduceus369: calls €0.13
*** TURN *** [6d 7s Ts] [7h]
caduceus369: checks 
heitel: bets €0.23
caduceus369: folds 
Uncalled bet (€0.23) returned to heitel
heitel collected €0.37 from pot
heitel: doesn't show hand 
*** SUMMARY ***
Total pot €0.39 | Rake €0.02 
Board [6d 7s Ts 7h]
Seat 1: heitel (button) collected (€0.37)
Seat 2: pylonstrip (small blind) folded before Flop
Seat 3: caduceus369 (big blind) folded on the Turn
Seat 4: GIacius folded before Flop (didn't bet)
Seat 5: Cruelplace84 folded before Flop (didn't bet)
Seat 6: SidneyPrescott folded before Flop (didn't bet)



PokerStars Zoom Hand #257983898635:  Hold'em No Limit (€0.01/€0.02) [ADM ID: M62BA304494E32ST] - 2025/10/03 18:09:35 CET [2025/10/03 12:09:35 ET]
Table 'Sirio' 6-max Seat #1 is the button
Seat 1: SaTheNuts_77 (€4.93 in chips) 
Seat 2: pistaKKio23 (€2.22 in chips) 
Seat 3: caduceus369 (€1.81 in chips) 
Seat 4: KilometroZer0 (€3.28 in chips) 
Seat 5: Catania838 (€2.01 in chips) 
Seat 6: andresette (€2 in chips) 
pistaKKio23: posts small blind €0.01
caduceus369: posts big blind €0.02
*** HOLE CARDS ***
Dealt to caduceus369 [2c Ah]
KilometroZer0: folds 
Catania838: folds 
andresette: folds 
SaTheNuts_77: folds 
pistaKKio23: folds 
Uncalled bet (€0.01) returned to caduceus369
caduceus369 collected €0.02 from pot
caduceus369: doesn't show hand 
*** SUMMARY ***
Total pot €0.02 | Rake €0 
Seat 1: SaTheNuts_77 (button) folded before Flop (didn't bet)
Seat 2: pistaKKio23 (small blind) folded before Flop
Seat 3: caduceus369 (big blind) collected (€0.02)
Seat 4: KilometroZer0 folded before Flop (didn't bet)
Seat 5: Catania838 folded before Flop (didn't bet)
Seat 6: andresette folded before Flop (didn't bet)



PokerStars Zoom Hand #257983896050:  Hold'em No Limit (€0.01/€0.02) [ADM ID: M62BA304494E32ST] - 2025/10/03 18:09:21 CET [2025/10/03 12:09:21 ET]
Table 'Sirio' 6-max Seat #1 is the button
Seat 1: ValenTom25 (€2.16 in chips) 
Seat 2: TurboMuletto (€0.99 in chips) 
Seat 3: pistaKKio23 (€3.92 in chips) 
Seat 4: Cruelplace84 (€2.39 in chips) 
Seat 5: panzapelata (€1.85 in chips) 
Seat 6: caduceus369 (€1.81 in chips) 
TurboMuletto: posts small blind €0.01
pistaKKio23: posts big blind €0.02
*** HOLE CARDS ***
Dealt to caduceus369 [Jd 6h]
Cruelplace84: folds 
panzapelata: raises €0.02 to €0.04
caduceus369: folds 
ValenTom25: calls €0.04
TurboMuletto: folds 
pistaKKio23: folds 
*** FLOP *** [Kc 8h 7h]
panzapelata: checks 
ValenTom25: bets €0.11
panzapelata: folds 
Uncalled bet (€0.11) returned to ValenTom25
ValenTom25 collected €0.11 from pot
ValenTom25: doesn't show hand 
*** SUMMARY ***
Total pot €0.11 | Rake €0 
Board [Kc 8h 7h]
Seat 1: ValenTom25 (button) collected (€0.11)
Seat 2: TurboMuletto (small blind) folded before Flop
Seat 3: pistaKKio23 (big blind) folded before Flop
Seat 4: Cruelplace84 folded before Flop (didn't bet)
Seat 5: panzapelata folded on the Flop
Seat 6: caduceus369 folded before Flop (didn't bet)



PokerStars Zoom Hand #257983894024:  Hold'em No Limit (€0.01/€0.02) [ADM ID: M62BA304494E32ST] - 2025/10/03 18:09:09 CET [2025/10/03 12:09:09 ET]
Table 'Sirio' 6-max Seat #1 is the button
Seat 1: Poker_Pidal88 (€1.22 in chips) 
Seat 2: caduceus369 (€1.82 in chips) 
Seat 3: SalahUbeen (€2.88 in chips) 
Seat 4: GIacius (€2.10 in chips) 
Seat 5: SidneyPrescott (€2 in chips) 
Seat 6: jeeslike (€6.73 in chips) 
caduceus369: posts small blind €0.01
SalahUbeen: posts big blind €0.02
*** HOLE CARDS ***
Dealt to caduceus369 [4d 9d]
GIacius: raises €0.02 to €0.04
SidneyPrescott: calls €0.04
jeeslike: folds 
Poker_Pidal88: folds 
caduceus369: folds 
SalahUbeen: calls €0.02
*** FLOP *** [Th Ts Kh]
SalahUbeen: checks 
GIacius: bets €0.07
SidneyPrescott: calls €0.07
SalahUbeen: folds 
*** TURN *** [Th Ts Kh] [6h]
GIacius: checks 
SidneyPrescott: bets €0.16
GIacius: folds 
Uncalled bet (€0.16) returned to SidneyPrescott
SidneyPrescott collected €0.26 from pot
SidneyPrescott: doesn't show hand 
*** SUMMARY ***
Total pot €0.27 | Rake €0.01 
Board [Th Ts Kh 6h]
Seat 1: Poker_Pidal88 (button) folded before Flop (didn't bet)
Seat 2: caduceus369 (small blind) folded before Flop
Seat 3: SalahUbeen (big blind) folded on the Flop
Seat 4: GIacius folded on the Turn
Seat 5: SidneyPrescott collected (€0.26)
Seat 6: jeeslike folded before Flop (didn't bet)



PokerStars Zoom Hand #257983897211:  Hold'em No Limit (€0.01/€0.02) [ADM ID: M62BA304494E32ST] - 2025/10/03 18:09:27 CET [2025/10/03 12:09:27 ET]
Table 'Sirio' 6-max Seat #1 is the button
Seat 1: mariokart137 (€3.13 in chips) 
Seat 2: KilometroZer0 (€9.88 in chips) 
Seat 3: Allulimoni (€2.03 in chips) 
Seat 4: caduceus369 (€1.81 in chips) 
Seat 5: TurboMuletto (€0.98 in chips) 
Seat 6: winsper79 (€0.99 in chips) 
KilometroZer0: posts small blind €0.01
Allulimoni: posts big blind €0.02
*** HOLE CARDS ***
Dealt to caduceus369 [3h 2c]
caduceus369: folds 
TurboMuletto: folds 
winsper79: raises €0.02 to €0.04
mariokart137: folds 
KilometroZer0: folds 
Allulimoni: raises €0.09 to €0.13
winsper79: calls €0.09
*** FLOP *** [Ks Ad Ah]
Allulimoni: checks 
winsper79: checks 
*** TURN *** [Ks Ad Ah] [6s]
Allulimoni: checks 
winsper79: bets €0.14
Allulimoni: calls €0.14
*** RIVER *** [Ks Ad Ah 6s] [9s]
Allulimoni: checks 
winsper79: checks 
*** SHOW DOWN ***
Allulimoni: shows [Kc 8s] (two pair, Aces and Kings)
winsper79: mucks hand 
Allulimoni collected €0.52 from pot
*** SUMMARY ***
Total pot €0.55 | Rake €0.03 
Board [Ks Ad Ah 6s 9s]
Seat 1: mariokart137 (button) folded before Flop (didn't bet)
Seat 2: KilometroZer0 (small blind) folded before Flop
Seat 3: Allulimoni (big blind) showed [Kc 8s] and won (€0.52) with two pair, Aces and Kings
Seat 4: caduceus369 folded before Flop (didn't bet)
Seat 5: TurboMuletto folded before Flop (didn't bet)
Seat 6: winsper79 mucked [7d Qd]



PokerStars Zoom Hand #257983897931:  Hold'em No Limit (€0.01/€0.02) [ADM ID: M62BA304494E32ST] - 2025/10/03 18:09:31 CET [2025/10/03 12:09:31 ET]
Table 'Sirio' 6-max Seat #1 is the button
Seat 1: caduceus369 (€1.81 in chips) 
Seat 2: stfuplzudonk (€2.20 in chips) 
Seat 3: OSPREYSTORM (€2 in chips) 
Seat 4: Pupu300 (€4.63 in chips) 
Seat 5: mariokart137 (€3.13 in chips) 
Seat 6: TurboMuletto (€0.98 in chips) 
stfuplzudonk: posts small blind €0.01
OSPREYSTORM: posts big blind €0.02
*** HOLE CARDS ***
Dealt to caduceus369 [Ts 4s]
Pupu300 has timed out
Pupu300: folds 
mariokart137: folds 
TurboMuletto: folds 
caduceus369: folds 
stfuplzudonk: calls €0.01
OSPREYSTORM: checks 
*** FLOP *** [9c 3s 9d]
stfuplzudonk: checks 
OSPREYSTORM: checks 
*** TURN *** [9c 3s 9d] [7h]
stfuplzudonk: checks 
OSPREYSTORM: checks 
*** RIVER *** [9c 3s 9d 7h] [6s]
stfuplzudonk: checks 
OSPREYSTORM: checks 
*** SHOW DOWN ***
stfuplzudonk: shows [8d Kc] (a pair of Nines)
OSPREYSTORM: shows [3c Js] (two pair, Nines and Threes)
OSPREYSTORM collected €0.04 from pot
*** SUMMARY ***
Total pot €0.04 | Rake €0 
Board [9c 3s 9d 7h 6s]
Seat 1: caduceus369 (button) folded before Flop (didn't bet)
Seat 2: stfuplzudonk (small blind) showed [8d Kc] and lost with a pair of Nines
Seat 3: OSPREYSTORM (big blind) showed [3c Js] and won (€0.04) with two pair, Nines and Threes
Seat 4: Pupu300 folded before Flop (didn't bet)
Seat 5: mariokart137 folded before Flop (didn't bet)
Seat 6: TurboMuletto folded before Flop (didn't bet)



PokerStars Zoom Hand #257983901455:  Hold'em No Limit (€0.01/€0.02) [ADM ID: M62BA304494E32ST] - 2025/10/03 18:09:51 CET [2025/10/03 12:09:51 ET]
Table 'Sirio' 6-max Seat #1 is the button
Seat 1: monsterc99 (€0.28 in chips) 
Seat 2: panzapelata (€1.81 in chips) 
Seat 3: andresette (€2 in chips) 
Seat 4: Cruelplace84 (€2.62 in chips) 
Seat 5: caduceus369 (€1.82 in chips) 
Seat 6: ValenTom25 (€2.23 in chips) 
panzapelata: posts small blind €0.01
andresette: posts big blind €0.02
*** HOLE CARDS ***
Dealt to caduceus369 [4d 7d]
Cruelplace84: folds 
ValenTom25 is disconnected 
caduceus369: folds 
ValenTom25: folds 
monsterc99: folds 
panzapelata: raises €0.02 to €0.04
andresette: folds 
Uncalled bet (€0.02) returned to panzapelata
panzapelata collected €0.04 from pot
panzapelata: doesn't show hand 
*** SUMMARY ***
Total pot €0.04 | Rake €0 
Seat 1: monsterc99 (button) folded before Flop (didn't bet)
Seat 2: panzapelata (small blind) collected (€0.04)
Seat 3: andresette (big blind) folded before Flop
Seat 4: Cruelplace84 folded before Flop (didn't bet)
Seat 5: caduceus369 folded before Flop (didn't bet)
Seat 6: ValenTom25 folded before Flop (didn't bet)



PokerStars Zoom Hand #257983904384:  Hold'em No Limit (€0.01/€0.02) [ADM ID: M62BA304494E32ST] - 2025/10/03 18:10:07 CET [2025/10/03 12:10:07 ET]
Table 'Sirio' 6-max Seat #1 is the button
Seat 1: OMGWOLFX (€2.62 in chips) 
Seat 2: Cruelplace84 (€2.53 in chips) 
Seat 3: OSPREYSTORM (€2.01 in chips) 
Seat 4: SidneyPrescott (€2.46 in chips) 
Seat 5: GIacius (€2.08 in chips) 
Seat 6: caduceus369 (€1.81 in chips) 
Cruelplace84: posts small blind €0.01
OSPREYSTORM: posts big blind €0.02
*** HOLE CARDS ***
Dealt to caduceus369 [6d 3h]
SidneyPrescott: folds 
GIacius: raises €0.02 to €0.04
caduceus369: folds 
OMGWOLFX: folds 
Cruelplace84: folds 
OSPREYSTORM: calls €0.02
*** FLOP *** [4c Jh 5c]
OSPREYSTORM: checks 
GIacius: bets €0.03
OSPREYSTORM: folds 
Uncalled bet (€0.03) returned to GIacius
GIacius collected €0.09 from pot
GIacius: doesn't show hand 
*** SUMMARY ***
Total pot €0.09 | Rake €0 
Board [4c Jh 5c]
Seat 1: OMGWOLFX (button) folded before Flop (didn't bet)
Seat 2: Cruelplace84 (small blind) folded before Flop
Seat 3: OSPREYSTORM (big blind) folded on the Flop
Seat 4: SidneyPrescott folded before Flop (didn't bet)
Seat 5: GIacius collected (€0.09)
Seat 6: caduceus369 folded before Flop (didn't bet)



PokerStars Zoom Hand #257983905568:  Hold'em No Limit (€0.01/€0.02) [ADM ID: M62BA304494E32ST] - 2025/10/03 18:10:13 CET [2025/10/03 12:10:13 ET]
Table 'Sirio' 6-max Seat #1 is the button
Seat 1: andresette (€2 in chips) 
Seat 2: OSPREYSTORM (€2.02 in chips) 
Seat 3: SidneyPrescott (€2.46 in chips) 
Seat 4: pistaKKio23 (€3 in chips) 
Seat 5: caduceus369 (€1.81 in chips) 
Seat 6: OMGWOLFX (€2.62 in chips) 
OSPREYSTORM: posts small blind €0.01
SidneyPrescott: posts big blind €0.02
*** HOLE CARDS ***
Dealt to caduceus369 [7s Jh]
pistaKKio23 has timed out
pistaKKio23: folds 
caduceus369: folds 
OMGWOLFX: raises €0.04 to €0.06
andresette: folds 
OSPREYSTORM: folds 
SidneyPrescott: folds 
Uncalled bet (€0.04) returned to OMGWOLFX
OMGWOLFX collected €0.05 from pot
OMGWOLFX: doesn't show hand 
*** SUMMARY ***
Total pot €0.05 | Rake €0 
Seat 1: andresette (button) folded before Flop (didn't bet)
Seat 2: OSPREYSTORM (small blind) folded before Flop
Seat 3: SidneyPrescott (big blind) folded before Flop
Seat 4: pistaKKio23 folded before Flop (didn't bet)
Seat 5: caduceus369 folded before Flop (didn't bet)
Seat 6: OMGWOLFX collected (€0.05)



PokerStars Zoom Hand #257983902339:  Hold'em No Limit (€0.01/€0.02) [ADM ID: M62BA304494E32ST] - 2025/10/03 18:09:56 CET [2025/10/03 12:09:56 ET]
Table 'Sirio' 6-max Seat #1 is the button
Seat 1: winsper79 (€0.72 in chips) 
Seat 2: caduceus369 (€1.82 in chips) 
Seat 3: stfuplzudonk (€3.89 in chips) 
Seat 4: KilometroZer0 (€9.87 in chips) 
Seat 5: pistaKKio23 (€2.21 in chips) 
Seat 6: TurboMuletto (€0.97 in chips) 
caduceus369: posts small blind €0.01
stfuplzudonk: posts big blind €0.02
*** HOLE CARDS ***
Dealt to caduceus369 [Ah 8d]
KilometroZer0: raises €0.05 to €0.07
pistaKKio23: calls €0.07
TurboMuletto: folds 
winsper79: raises €0.65 to €0.72 and is all-in
caduceus369: folds 
stfuplzudonk: folds 
KilometroZer0: folds 
pistaKKio23: calls €0.65
*** FLOP *** [8c Ts 6c]
*** TURN *** [8c Ts 6c] [5s]
*** RIVER *** [8c Ts 6c 5s] [6d]
*** SHOW DOWN ***
pistaKKio23: shows [Qs Qd] (two pair, Queens and Sixes)
winsper79: shows [Kd Ad] (a pair of Sixes)
pistaKKio23 collected €1.46 from pot
*** SUMMARY ***
Total pot €1.54 | Rake €0.08 
Board [8c Ts 6c 5s 6d]
Seat 1: winsper79 (button) showed [Kd Ad] and lost with a pair of Sixes
Seat 2: caduceus369 (small blind) folded before Flop
Seat 3: stfuplzudonk (big blind) folded before Flop
Seat 4: KilometroZer0 folded before Flop
Seat 5: pistaKKio23 showed [Qs Qd] and won (€1.46) with two pair, Queens and Sixes
Seat 6: TurboMuletto folded before Flop (didn't bet)



PokerStars Zoom Hand #257983906634:  Hold'em No Limit (€0.01/€0.02) [ADM ID: M62BA304494E32ST] - 2025/10/03 18:10:20 CET [2025/10/03 12:10:20 ET]
Table 'Sirio' 6-max Seat #1 is the button
Seat 1: caduceus369 (€1.81 in chips) 
Seat 2: andresette (€2 in chips) 
Seat 3: monsterc99 (€0.24 in chips) 
Seat 4: cucuma21 (€1.12 in chips) 
Seat 5: 18Gugli81 (€1.87 in chips) 
Seat 6: SaTheNuts_77 (€4.99 in chips) 
andresette: posts small blind €0.01
monsterc99: posts big blind €0.02
*** HOLE CARDS ***
Dealt to caduceus369 [Kh 6h]
cucuma21: calls €0.02
18Gugli81: folds 
SaTheNuts_77: folds 
caduceus369: calls €0.02
andresette: folds 
monsterc99: checks 
*** FLOP *** [Th 8s 4h]
monsterc99: checks 
cucuma21: checks 
caduceus369: bets €0.02
monsterc99: calls €0.02
cucuma21: calls €0.02
*** TURN *** [Th 8s 4h] [6d]
monsterc99: checks 
cucuma21: checks 
caduceus369: bets €0.06
monsterc99: calls €0.06
cucuma21: folds 
*** RIVER *** [Th 8s 4h 6d] [Kc]
monsterc99: checks 
caduceus369: bets €0.24
monsterc99: folds 
Uncalled bet (€0.24) returned to caduceus369
caduceus369 collected €0.24 from pot
caduceus369: doesn't show hand 
*** SUMMARY ***
Total pot €0.25 | Rake €0.01 
Board [Th 8s 4h 6d Kc]
Seat 1: caduceus369 (button) collected (€0.24)
Seat 2: andresette (small blind) folded before Flop
Seat 3: monsterc99 (big blind) folded on the River
Seat 4: cucuma21 folded on the Turn
Seat 5: 18Gugli81 folded before Flop (didn't bet)
Seat 6: SaTheNuts_77 folded before Flop (didn't bet)



PokerStars Zoom Hand #257983917208:  Hold'em No Limit (€0.01/€0.02) [ADM ID: M62BA304494E32ST] - 2025/10/03 18:11:18 CET [2025/10/03 12:11:18 ET]
Table 'Sirio' 6-max Seat #1 is the button
Seat 1: Cruelplace84 (€2.54 in chips) 
Seat 2: panzapelata (€1.89 in chips) 
Seat 3: caduceus369 (€1.95 in chips) 
Seat 4: stfuplzudonk (€2.13 in chips) 
Seat 5: pistaKKio23 (€2.93 in chips) 
Seat 6: SidneyPrescott (€2.81 in chips) 
panzapelata: posts small blind €0.01
caduceus369: posts big blind €0.02
*** HOLE CARDS ***
Dealt to caduceus369 [5c Jd]
stfuplzudonk: folds 
pistaKKio23: folds 
SidneyPrescott: folds 
Cruelplace84: folds 
panzapelata: raises €0.04 to €0.06
caduceus369: folds 
Uncalled bet (€0.04) returned to panzapelata
panzapelata collected €0.04 from pot
panzapelata: doesn't show hand 
*** SUMMARY ***
Total pot €0.04 | Rake €0 
Seat 1: Cruelplace84 (button) folded before Flop (didn't bet)
Seat 2: panzapelata (small blind) collected (€0.04)
Seat 3: caduceus369 (big blind) folded before Flop
Seat 4: stfuplzudonk folded before Flop (didn't bet)
Seat 5: pistaKKio23 folded before Flop (didn't bet)
Seat 6: SidneyPrescott folded before Flop (didn't bet)



PokerStars Zoom Hand #257983916470:  Hold'em No Limit (€0.01/€0.02) [ADM ID: M62BA304494E32ST] - 2025/10/03 18:11:13 CET [2025/10/03 12:11:13 ET]
Table 'Sirio' 6-max Seat #1 is the button
Seat 1: SidneyPrescott (€2.81 in chips) 
Seat 2: panzapelata (€2.11 in chips) 
Seat 3: OMGWOLFX (€2 in chips) 
Seat 4: caduceus369 (€1.95 in chips) 
Seat 5: Cruelplace84 (€2.51 in chips) 
Seat 6: marina41978 (€0.74 in chips) 
panzapelata: posts small blind €0.01
OMGWOLFX: posts big blind €0.02
*** HOLE CARDS ***
Dealt to caduceus369 [6h Td]
caduceus369: folds 
Cruelplace84: folds 
marina41978: calls €0.02
SidneyPrescott: folds 
panzapelata: folds 
OMGWOLFX: checks 
*** FLOP *** [7d Qd 9h]
OMGWOLFX: checks 
marina41978: checks 
*** TURN *** [7d Qd 9h] [Ad]
OMGWOLFX: bets €0.04
marina41978: folds 
Uncalled bet (€0.04) returned to OMGWOLFX
OMGWOLFX collected €0.05 from pot
OMGWOLFX: doesn't show hand 
*** SUMMARY ***
Total pot €0.05 | Rake €0 
Board [7d Qd 9h Ad]
Seat 1: SidneyPrescott (button) folded before Flop (didn't bet)
Seat 2: panzapelata (small blind) folded before Flop
Seat 3: OMGWOLFX (big blind) collected (€0.05)
Seat 4: caduceus369 folded before Flop (didn't bet)
Seat 5: Cruelplace84 folded before Flop (didn't bet)
Seat 6: marina41978 folded on the Turn



PokerStars Zoom Hand #257983919690:  Hold'em No Limit (€0.01/€0.02) [ADM ID: M62BA304494E32ST] - 2025/10/03 18:11:32 CET [2025/10/03 12:11:32 ET]
Table 'Sirio' 6-max Seat #1 is the button
Seat 1: Catania838 (€1.28 in chips) 
Seat 2: caduceus369 (€1.93 in chips) 
Seat 3: OMGWOLFX (€2.50 in chips) 
Seat 4: GIacius (€3.30 in chips) 
Seat 5: panzapelata (€1.97 in chips) 
Seat 6: SalahUbeen (€2.70 in chips) 
caduceus369: posts small blind €0.01
OMGWOLFX: posts big blind €0.02
*** HOLE CARDS ***
Dealt to caduceus369 [Td 3s]
GIacius: raises €0.02 to €0.04
panzapelata: folds 
SalahUbeen: folds 
Catania838: folds 
caduceus369: folds 
OMGWOLFX: calls €0.02
*** FLOP *** [Qs 5s 3c]
OMGWOLFX: checks 
GIacius: bets €0.03
OMGWOLFX: calls €0.03
*** TURN *** [Qs 5s 3c] [6h]
OMGWOLFX: checks 
GIacius: bets €0.08
OMGWOLFX: folds 
Uncalled bet (€0.08) returned to GIacius
GIacius collected €0.15 from pot
GIacius: doesn't show hand 
*** SUMMARY ***
Total pot €0.15 | Rake €0 
Board [Qs 5s 3c 6h]
Seat 1: Catania838 (button) folded before Flop (didn't bet)
Seat 2: caduceus369 (small blind) folded before Flop
Seat 3: OMGWOLFX (big blind) folded on the Turn
Seat 4: GIacius collected (€0.15)
Seat 5: panzapelata folded before Flop (didn't bet)
Seat 6: SalahUbeen folded before Flop (didn't bet)



PokerStars Zoom Hand #257983926125:  Hold'em No Limit (€0.01/€0.02) [ADM ID: M62BA304494E32ST] - 2025/10/03 18:12:07 CET [2025/10/03 12:12:07 ET]
Table 'Sirio' 6-max Seat #1 is the button
Seat 1: TurboMuletto (€1.81 in chips) 
Seat 2: cucuma21 (€1.06 in chips) 
Seat 3: ZefirDevil (€1.88 in chips) 
Seat 4: heitel (€1.81 in chips) 
Seat 5: caduceus369 (€1.92 in chips) 
Seat 6: panzapelata (€1.94 in chips) 
cucuma21: posts small blind €0.01
ZefirDevil: posts big blind €0.02
*** HOLE CARDS ***
Dealt to caduceus369 [Jh 9h]
heitel: folds 
caduceus369: calls €0.02
panzapelata: folds 
TurboMuletto: folds 
cucuma21: raises €0.06 to €0.08
ZefirDevil: folds 
caduceus369: calls €0.06
*** FLOP *** [3d 7c 2d]
cucuma21: checks 
caduceus369: checks 
*** TURN *** [3d 7c 2d] [6s]
cucuma21: bets €0.18
caduceus369: folds 
Uncalled bet (€0.18) returned to cucuma21
cucuma21 collected €0.18 from pot
cucuma21: doesn't show hand 
*** SUMMARY ***
Total pot €0.18 | Rake €0 
Board [3d 7c 2d 6s]
Seat 1: TurboMuletto (button) folded before Flop (didn't bet)
Seat 2: cucuma21 (small blind) collected (€0.18)
Seat 3: ZefirDevil (big blind) folded before Flop
Seat 4: heitel folded before Flop (didn't bet)
Seat 5: caduceus369 folded on the Turn
Seat 6: panzapelata folded before Flop (didn't bet)



PokerStars Zoom Hand #257983932903:  Hold'em No Limit (€0.01/€0.02) [ADM ID: M62BA304494E32ST] - 2025/10/03 18:12:45 CET [2025/10/03 12:12:45 ET]
Table 'Sirio' 6-max Seat #1 is the button
Seat 1: lilluz46424 (€2.74 in chips) 
Seat 2: pistaKKio23 (€2.90 in chips) 
Seat 3: TurboMuletto (€1.80 in chips) 
Seat 4: Catania838 (€1.37 in chips) 
Seat 5: Anto8911 (€0.68 in chips) 
Seat 6: caduceus369 (€1.84 in chips) 
pistaKKio23: posts small blind €0.01
TurboMuletto: posts big blind €0.02
*** HOLE CARDS ***
Dealt to caduceus369 [4h 7h]
Catania838: folds 
Anto8911: folds 
caduceus369: folds 
lilluz46424: folds 
pistaKKio23: raises €0.04 to €0.06
TurboMuletto: raises €0.12 to €0.18
pistaKKio23: folds 
Uncalled bet (€0.12) returned to TurboMuletto
TurboMuletto collected €0.12 from pot
TurboMuletto: doesn't show hand 
*** SUMMARY ***
Total pot €0.12 | Rake €0 
Seat 1: lilluz46424 (button) folded before Flop (didn't bet)
Seat 2: pistaKKio23 (small blind) folded before Flop
Seat 3: TurboMuletto (big blind) collected (€0.12)
Seat 4: Catania838 folded before Flop (didn't bet)
Seat 5: Anto8911 folded before Flop (didn't bet)
Seat 6: caduceus369 folded before Flop (didn't bet)



PokerStars Zoom Hand #257983933555:  Hold'em No Limit (€0.01/€0.02) [ADM ID: M62BA304494E32ST] - 2025/10/03 18:12:48 CET [2025/10/03 12:12:48 ET]
Table 'Sirio' 6-max Seat #1 is the button
Seat 1: andresette (€3.80 in chips) 
Seat 2: panzapelata (€2.07 in chips) 
Seat 3: OMGWOLFX (€11.60 in chips) 
Seat 4: ZefirDevil (€1.85 in chips) 
Seat 5: KilometroZer0 (€9.80 in chips) 
Seat 6: caduceus369 (€1.84 in chips) 
panzapelata: posts small blind €0.01
OMGWOLFX: posts big blind €0.02
*** HOLE CARDS ***
Dealt to caduceus369 [6d Kc]
ZefirDevil: folds 
KilometroZer0: folds 
caduceus369: folds 
andresette: raises €0.04 to €0.06
panzapelata: folds 
OMGWOLFX: folds 
Uncalled bet (€0.04) returned to andresette
andresette collected €0.05 from pot
andresette: doesn't show hand 
*** SUMMARY ***
Total pot €0.05 | Rake €0 
Seat 1: andresette (button) collected (€0.05)
Seat 2: panzapelata (small blind) folded before Flop
Seat 3: OMGWOLFX (big blind) folded before Flop
Seat 4: ZefirDevil folded before Flop (didn't bet)
Seat 5: KilometroZer0 folded before Flop (didn't bet)
Seat 6: caduceus369 folded before Flop (didn't bet)



PokerStars Zoom Hand #257983936764:  Hold'em No Limit (€0.01/€0.02) [ADM ID: M62BA304494E32ST] - 2025/10/03 18:13:06 CET [2025/10/03 12:13:06 ET]
Table 'Sirio' 6-max Seat #1 is the button
Seat 1: OMGWOLFX (€11.58 in chips) 
Seat 2: SalahUbeen (€2.86 in chips) 
Seat 3: caduceus369 (€1.83 in chips) 
Seat 4: Nicolino20802 (€0.89 in chips) 
Seat 5: OSPREYSTORM (€2.13 in chips) 
Seat 6: SaTheNuts_77 (€5.31 in chips) 
SalahUbeen: posts small blind €0.01
caduceus369: posts big blind €0.02
*** HOLE CARDS ***
Dealt to caduceus369 [8c Jd]
Nicolino20802: folds 
OSPREYSTORM: folds 
SaTheNuts_77: folds 
OMGWOLFX: folds 
SalahUbeen: folds 
Uncalled bet (€0.01) returned to caduceus369
caduceus369 collected €0.02 from pot
caduceus369: doesn't show hand 
*** SUMMARY ***
Total pot €0.02 | Rake €0 
Seat 1: OMGWOLFX (button) folded before Flop (didn't bet)
Seat 2: SalahUbeen (small blind) folded before Flop
Seat 3: caduceus369 (big blind) collected (€0.02)
Seat 4: Nicolino20802 folded before Flop (didn't bet)
Seat 5: OSPREYSTORM folded before Flop (didn't bet)
Seat 6: SaTheNuts_77 folded before Flop (didn't bet)



PokerStars Zoom Hand #257983934199:  Hold'em No Limit (€0.01/€0.02) [ADM ID: M62BA304494E32ST] - 2025/10/03 18:12:52 CET [2025/10/03 12:12:52 ET]
Table 'Sirio' 6-max Seat #1 is the button
Seat 1: heitel (€1.86 in chips) 
Seat 2: caduceus369 (€1.84 in chips) 
Seat 3: mariokart137 (€3.08 in chips) 
Seat 4: 18Gugli81 (€1.64 in chips) 
Seat 5: Cruelplace84 (€2.60 in chips) 
Seat 6: panzapelata (€2.06 in chips) 
caduceus369: posts small blind €0.01
mariokart137: posts big blind €0.02
*** HOLE CARDS ***
Dealt to caduceus369 [6h 2c]
18Gugli81: folds 
Cruelplace84: folds 
panzapelata: folds 
heitel: raises €0.04 to €0.06
caduceus369: folds 
mariokart137: calls €0.04
*** FLOP *** [Td 2d 3s]
mariokart137: checks 
heitel: bets €0.09
mariokart137: calls €0.09
*** TURN *** [Td 2d 3s] [4s]
mariokart137: checks 
heitel: checks 
*** RIVER *** [Td 2d 3s 4s] [5s]
mariokart137: checks 
heitel: checks 
*** SHOW DOWN ***
mariokart137: shows [5d 3d] (two pair, Fives and Threes)
heitel: mucks hand 
mariokart137 collected €0.30 from pot
*** SUMMARY ***
Total pot €0.31 | Rake €0.01 
Board [Td 2d 3s 4s 5s]
Seat 1: heitel (button) mucked [Tc 9d]
Seat 2: caduceus369 (small blind) folded before Flop
Seat 3: mariokart137 (big blind) showed [5d 3d] and won (€0.30) with two pair, Fives and Threes
Seat 4: 18Gugli81 folded before Flop (didn't bet)
Seat 5: Cruelplace84 folded before Flop (didn't bet)
Seat 6: panzapelata folded before Flop (didn't bet)



PokerStars Zoom Hand #257983934957:  Hold'em No Limit (€0.01/€0.02) [ADM ID: M62BA304494E32ST] - 2025/10/03 18:12:56 CET [2025/10/03 12:12:56 ET]
Table 'Sirio' 6-max Seat #1 is the button
Seat 1: caduceus369 (€1.83 in chips) 
Seat 2: ValenTom25 (€0.99 in chips) 
Seat 3: deojking (€2 in chips) 
Seat 4: ZefirDevil (€1.85 in chips) 
Seat 5: stfuplzudonk (€2 in chips) 
Seat 6: SalahUbeen (€2.58 in chips) 
ValenTom25: posts small blind €0.01
deojking: posts big blind €0.02
*** HOLE CARDS ***
Dealt to caduceus369 [8d Qs]
ZefirDevil: folds 
stfuplzudonk: raises €0.04 to €0.06
SalahUbeen: calls €0.06
caduceus369: folds 
ValenTom25: calls €0.05
deojking: folds 
*** FLOP *** [Th 4h Ac]
ValenTom25: checks 
stfuplzudonk: checks 
SalahUbeen: checks 
*** TURN *** [Th 4h Ac] [7h]
ValenTom25: bets €0.10
stfuplzudonk: folds 
SalahUbeen: raises €0.29 to €0.39
ValenTom25: folds 
Uncalled bet (€0.29) returned to SalahUbeen
SalahUbeen collected €0.38 from pot
SalahUbeen: doesn't show hand 
ValenTom25 is disconnected 
*** SUMMARY ***
Total pot €0.40 | Rake €0.02 
Board [Th 4h Ac 7h]
Seat 1: caduceus369 (button) folded before Flop (didn't bet)
Seat 2: ValenTom25 (small blind) folded on the Turn
Seat 3: deojking (big blind) folded before Flop
Seat 4: ZefirDevil folded before Flop (didn't bet)
Seat 5: stfuplzudonk folded on the Turn
Seat 6: SalahUbeen collected (€0.38)



PokerStars Zoom Hand #257983939432:  Hold'em No Limit (€0.01/€0.02) [ADM ID: M62BA304494E32ST] - 2025/10/03 18:13:20 CET [2025/10/03 12:13:20 ET]
Table 'Sirio' 6-max Seat #1 is the button
Seat 1: panzapelata (€2.08 in chips) 
Seat 2: Nicolino20802 (€0.87 in chips) 
Seat 3: stfuplzudonk (€3.85 in chips) 
Seat 4: OMGWOLFX (€2 in chips) 
Seat 5: caduceus369 (€1.84 in chips) 
Seat 6: pistaKKio23 (€2.95 in chips) 
Nicolino20802: posts small blind €0.01
stfuplzudonk: posts big blind €0.02
*** HOLE CARDS ***
Dealt to caduceus369 [6c Qh]
OMGWOLFX: folds 
caduceus369: folds 
pistaKKio23: folds 
panzapelata: raises €0.04 to €0.06
Nicolino20802: folds 
stfuplzudonk: calls €0.04
*** FLOP *** [Jh 7c 2h]
stfuplzudonk: checks 
panzapelata: bets €0.13
stfuplzudonk: calls €0.13
*** TURN *** [Jh 7c 2h] [Kd]
stfuplzudonk: checks 
panzapelata: bets €0.19
stfuplzudonk: calls €0.19
*** RIVER *** [Jh 7c 2h Kd] [2s]
stfuplzudonk: checks 
panzapelata: checks 
*** SHOW DOWN ***
stfuplzudonk: shows [Th 7h] (two pair, Sevens and Deuces)
panzapelata: shows [8c 8d] (two pair, Eights and Deuces)
panzapelata collected €0.73 from pot
*** SUMMARY ***
Total pot €0.77 | Rake €0.04 
Board [Jh 7c 2h Kd 2s]
Seat 1: panzapelata (button) showed [8c 8d] and won (€0.73) with two pair, Eights and Deuces
Seat 2: Nicolino20802 (small blind) folded before Flop
Seat 3: stfuplzudonk (big blind) showed [Th 7h] and lost with two pair, Sevens and Deuces
Seat 4: OMGWOLFX folded before Flop (didn't bet)
Seat 5: caduceus369 folded before Flop (didn't bet)
Seat 6: pistaKKio23 folded before Flop (didn't bet)



PokerStars Zoom Hand #257983940091:  Hold'em No Limit (€0.01/€0.02) [ADM ID: M62BA304494E32ST] - 2025/10/03 18:13:24 CET [2025/10/03 12:13:24 ET]
Table 'Sirio' 6-max Seat #1 is the button
Seat 1: Nicolino20802 (€0.86 in chips) 
Seat 2: OSPREYSTORM (€2.13 in chips) 
Seat 3: Cruelplace84 (€2.66 in chips) 
Seat 4: caduceus369 (€1.84 in chips) 
Seat 5: KilometroZer0 (€3.28 in chips) 
Seat 6: egidiosky (€1.64 in chips) 
OSPREYSTORM: posts small blind €0.01
Cruelplace84: posts big blind €0.02
*** HOLE CARDS ***
Dealt to caduceus369 [Ac Qc]
caduceus369: raises €0.02 to €0.04
KilometroZer0: folds 
egidiosky: folds 
Nicolino20802: calls €0.04
OSPREYSTORM: folds 
Cruelplace84: folds 
*** FLOP *** [As 9s Qh]
caduceus369: checks 
Nicolino20802: checks 
*** TURN *** [As 9s Qh] [Jc]
caduceus369: checks 
Nicolino20802: bets €0.02
caduceus369: calls €0.02
*** RIVER *** [As 9s Qh Jc] [Tc]
caduceus369: checks 
Nicolino20802: checks 
*** SHOW DOWN ***
caduceus369: shows [Ac Qc] (two pair, Aces and Queens)
Nicolino20802: mucks hand 
caduceus369 collected €0.15 from pot
*** SUMMARY ***
Total pot €0.15 | Rake €0 
Board [As 9s Qh Jc Tc]
Seat 1: Nicolino20802 (button) mucked [Th 7c]
Seat 2: OSPREYSTORM (small blind) folded before Flop
Seat 3: Cruelplace84 (big blind) folded before Flop
Seat 4: caduceus369 showed [Ac Qc] and won (€0.15) with two pair, Aces and Queens
Seat 5: KilometroZer0 folded before Flop (didn't bet)
Seat 6: egidiosky folded before Flop (didn't bet)



PokerStars Zoom Hand #257983947292:  Hold'em No Limit (€0.01/€0.02) [ADM ID: M62BA304494E32ST] - 2025/10/03 18:14:03 CET [2025/10/03 12:14:03 ET]
Table 'Sirio' 6-max Seat #1 is the button
Seat 1: caduceus369 (€1.93 in chips) 
Seat 2: SalahUbeen (€2.88 in chips) 
Seat 3: GIacius (€4.07 in chips) 
Seat 4: ZefirDevil (€0.50 in chips) 
Seat 5: Nicolino20802 (€0.80 in chips) 
Seat 6: mimmo2223 (€1.47 in chips) 
SalahUbeen: posts small blind €0.01
GIacius: posts big blind €0.02
*** HOLE CARDS ***
Dealt to caduceus369 [4s Th]
ZefirDevil: folds 
Nicolino20802: raises €0.02 to €0.04
mimmo2223 has timed out
mimmo2223: folds 
caduceus369: folds 
SalahUbeen: folds 
GIacius: calls €0.02
*** FLOP *** [7h Jc Kc]
GIacius: checks 
Nicolino20802: bets €0.02
GIacius: folds 
Uncalled bet (€0.02) returned to Nicolino20802
Nicolino20802 collected €0.09 from pot
Nicolino20802: doesn't show hand 
*** SUMMARY ***
Total pot €0.09 | Rake €0 
Board [7h Jc Kc]
Seat 1: caduceus369 (button) folded before Flop (didn't bet)
Seat 2: SalahUbeen (small blind) folded before Flop
Seat 3: GIacius (big blind) folded on the Flop
Seat 4: ZefirDevil folded before Flop (didn't bet)
Seat 5: Nicolino20802 collected (€0.09)
Seat 6: mimmo2223 folded before Flop (didn't bet)



PokerStars Zoom Hand #257983955688:  Hold'em No Limit (€0.01/€0.02) [ADM ID: M62BA304494E32ST] - 2025/10/03 18:14:49 CET [2025/10/03 12:14:49 ET]
Table 'Sirio' 6-max Seat #1 is the button
Seat 1: 18Gugli81 (€1.63 in chips) 
Seat 2: Gabrielefante (€2.87 in chips) 
Seat 3: caduceus369 (€1.91 in chips) 
Seat 4: Pupu300 (€2.51 in chips) 
Seat 5: GIacius (€4.73 in chips) 
Seat 6: pistaKKio23 (€1.64 in chips) 
Gabrielefante: posts small blind €0.01
caduceus369: posts big blind €0.02
*** HOLE CARDS ***
Dealt to caduceus369 [8s 3d]
Pupu300: folds 
GIacius: folds 
pistaKKio23: folds 
18Gugli81: folds 
Gabrielefante: folds 
Uncalled bet (€0.01) returned to caduceus369
caduceus369 collected €0.02 from pot
caduceus369: doesn't show hand 
*** SUMMARY ***
Total pot €0.02 | Rake €0 
Seat 1: 18Gugli81 (button) folded before Flop (didn't bet)
Seat 2: Gabrielefante (small blind) folded before Flop
Seat 3: caduceus369 (big blind) collected (€0.02)
Seat 4: Pupu300 folded before Flop (didn't bet)
Seat 5: GIacius folded before Flop (didn't bet)
Seat 6: pistaKKio23 folded before Flop (didn't bet)



PokerStars Zoom Hand #257983948211:  Hold'em No Limit (€0.01/€0.02) [ADM ID: M62BA304494E32ST] - 2025/10/03 18:14:08 CET [2025/10/03 12:14:08 ET]
Table 'Sirio' 6-max Seat #1 is the button
Seat 1: KilometroZer0 (€3.24 in chips) 
Seat 2: jeeslike (€7.43 in chips) 
Seat 3: ZefirDevil (€0.50 in chips) 
Seat 4: panzapelata (€1.88 in chips) 
Seat 5: 18Gugli81 (€1.63 in chips) 
Seat 6: caduceus369 (€1.93 in chips) 
jeeslike: posts small blind €0.01
ZefirDevil: posts big blind €0.02
*** HOLE CARDS ***
Dealt to caduceus369 [Qs Ac]
panzapelata: calls €0.02
18Gugli81: folds 
caduceus369: calls €0.02
KilometroZer0: folds 
jeeslike: folds 
ZefirDevil: checks 
*** FLOP *** [8h 9d Th]
ZefirDevil: checks 
panzapelata: bets €0.04
caduceus369: folds 
ZefirDevil: folds 
Uncalled bet (€0.04) returned to panzapelata
panzapelata collected €0.07 from pot
panzapelata: doesn't show hand 
*** SUMMARY ***
Total pot €0.07 | Rake €0 
Board [8h 9d Th]
Seat 1: KilometroZer0 (button) folded before Flop (didn't bet)
Seat 2: jeeslike (small blind) folded before Flop
Seat 3: ZefirDevil (big blind) folded on the Flop
Seat 4: panzapelata collected (€0.07)
Seat 5: 18Gugli81 folded before Flop (didn't bet)
Seat 6: caduceus369 folded on the Flop



PokerStars Zoom Hand #257983960438:  Hold'em No Limit (€0.01/€0.02) [ADM ID: M62BA304494E32ST] - 2025/10/03 18:15:15 CET [2025/10/03 12:15:15 ET]
Table 'Sirio' 6-max Seat #1 is the button
Seat 1: OMGWOLFX (€2 in chips) 
Seat 2: yanez61 (€0.98 in chips) 
Seat 3: CiroFireFist (€1.38 in chips) 
Seat 4: deojking (€1.96 in chips) 
Seat 5: S'dj83 (€3.65 in chips) 
Seat 6: caduceus369 (€1.91 in chips) 
yanez61: posts small blind €0.01
CiroFireFist: posts big blind €0.02
*** HOLE CARDS ***
Dealt to caduceus369 [7d 9s]
deojking: calls €0.02
S'dj83: folds 
caduceus369: folds 
OMGWOLFX: calls €0.02
yanez61: folds 
CiroFireFist: checks 
*** FLOP *** [8d Ah 7c]
CiroFireFist: checks 
deojking: checks 
OMGWOLFX: bets €0.04
CiroFireFist: folds 
deojking: folds 
Uncalled bet (€0.04) returned to OMGWOLFX
OMGWOLFX collected €0.07 from pot
OMGWOLFX: doesn't show hand 
*** SUMMARY ***
Total pot €0.07 | Rake €0 
Board [8d Ah 7c]
Seat 1: OMGWOLFX (button) collected (€0.07)
Seat 2: yanez61 (small blind) folded before Flop
Seat 3: CiroFireFist (big blind) folded on the Flop
Seat 4: deojking folded on the Flop
Seat 5: S'dj83 folded before Flop (didn't bet)
Seat 6: caduceus369 folded before Flop (didn't bet)



PokerStars Zoom Hand #257983958252:  Hold'em No Limit (€0.01/€0.02) [ADM ID: M62BA304494E32ST] - 2025/10/03 18:15:02 CET [2025/10/03 12:15:02 ET]
Table 'Sirio' 6-max Seat #1 is the button
Seat 1: KilometroZer0 (€1.67 in chips) 
Seat 2: caduceus369 (€1.92 in chips) 
Seat 3: SalahUbeen (€2.85 in chips) 
Seat 4: Cruelplace84 (€2.23 in chips) 
Seat 5: SaTheNuts_77 (€5.34 in chips) 
Seat 6: heitel (€1.87 in chips) 
caduceus369: posts small blind €0.01
SalahUbeen: posts big blind €0.02
*** HOLE CARDS ***
Dealt to caduceus369 [8c Td]
Cruelplace84: raises €0.03 to €0.05
SaTheNuts_77: folds 
heitel: calls €0.05
KilometroZer0: folds 
caduceus369: folds 
SalahUbeen: raises €0.19 to €0.24
Cruelplace84: folds 
heitel: folds 
Uncalled bet (€0.19) returned to SalahUbeen
SalahUbeen collected €0.16 from pot
SalahUbeen: doesn't show hand 
*** SUMMARY ***
Total pot €0.16 | Rake €0 
Seat 1: KilometroZer0 (button) folded before Flop (didn't bet)
Seat 2: caduceus369 (small blind) folded before Flop
Seat 3: SalahUbeen (big blind) collected (€0.16)
Seat 4: Cruelplace84 folded before Flop
Seat 5: SaTheNuts_77 folded before Flop (didn't bet)
Seat 6: heitel folded before Flop



PokerStars Zoom Hand #257983960895:  Hold'em No Limit (€0.01/€0.02) [ADM ID: M62BA304494E32ST] - 2025/10/03 18:15:17 CET [2025/10/03 12:15:17 ET]
Table 'Sirio' 6-max Seat #1 is the button
Seat 1: SidneyPrescott (€2.37 in chips) 
Seat 2: Nicolino20802 (€0.83 in chips) 
Seat 3: caduceus369 (€1.91 in chips) 
Seat 4: panzapelata (€1.91 in chips) 
Seat 5: cucuma21 (€1.11 in chips) 
Seat 6: luchino74 (€2 in chips) 
Nicolino20802: posts small blind €0.01
caduceus369: posts big blind €0.02
*** HOLE CARDS ***
Dealt to caduceus369 [8s 9c]
panzapelata: folds 
cucuma21: folds 
luchino74: folds 
SidneyPrescott: raises €0.04 to €0.06
Nicolino20802: folds 
caduceus369: calls €0.04
*** FLOP *** [7s Qd 9h]
caduceus369: checks 
SidneyPrescott: checks 
*** TURN *** [7s Qd 9h] [Qc]
caduceus369: bets €0.02
SidneyPrescott: folds 
Uncalled bet (€0.02) returned to caduceus369
caduceus369 collected €0.13 from pot
caduceus369: doesn't show hand 
*** SUMMARY ***
Total pot €0.13 | Rake €0 
Board [7s Qd 9h Qc]
Seat 1: SidneyPrescott (button) folded on the Turn
Seat 2: Nicolino20802 (small blind) folded before Flop
Seat 3: caduceus369 (big blind) collected (€0.13)
Seat 4: panzapelata folded before Flop (didn't bet)
Seat 5: cucuma21 folded before Flop (didn't bet)
Seat 6: luchino74 folded before Flop (didn't bet)



PokerStars Zoom Hand #257983959606:  Hold'em No Limit (€0.01/€0.02) [ADM ID: M62BA304494E32ST] - 2025/10/03 18:15:10 CET [2025/10/03 12:15:10 ET]
Table 'Sirio' 6-max Seat #1 is the button
Seat 1: ZefirDevil (€0.48 in chips) 
Seat 2: KilometroZer0 (€1.67 in chips) 
Seat 3: Nicolino20802 (€0.85 in chips) 
Seat 4: andresette (€3.79 in chips) 
Seat 5: caduceus369 (€1.91 in chips) 
Seat 6: OSPREYSTORM (€2.15 in chips) 
KilometroZer0: posts small blind €0.01
Nicolino20802: posts big blind €0.02
*** HOLE CARDS ***
Dealt to caduceus369 [4s 5d]
andresette: raises €0.04 to €0.06
caduceus369: folds 
OSPREYSTORM: calls €0.06
ZefirDevil: folds 
KilometroZer0: folds 
Nicolino20802: folds 
*** FLOP *** [2c 3d Ad]
andresette: bets €0.08
OSPREYSTORM: calls €0.08
*** TURN *** [2c 3d Ad] [5h]
andresette: bets €0.23
OSPREYSTORM: folds 
Uncalled bet (€0.23) returned to andresette
andresette collected €0.30 from pot
andresette: doesn't show hand 
*** SUMMARY ***
Total pot €0.31 | Rake €0.01 
Board [2c 3d Ad 5h]
Seat 1: ZefirDevil (button) folded before Flop (didn't bet)
Seat 2: KilometroZer0 (small blind) folded before Flop
Seat 3: Nicolino20802 (big blind) folded before Flop
Seat 4: andresette collected (€0.30)
Seat 5: caduceus369 folded before Flop (didn't bet)
Seat 6: OSPREYSTORM folded on the Turn



PokerStars Zoom Hand #257983974180:  Hold'em No Limit (€0.01/€0.02) [ADM ID: M62BA304494E32ST] - 2025/10/03 18:16:30 CET [2025/10/03 12:16:30 ET]
Table 'Sirio' 6-max Seat #1 is the button
Seat 1: OMGWOLFX (€3.62 in chips) 
Seat 2: cucuma21 (€1.15 in chips) 
Seat 3: pistaKKio23 (€1.61 in chips) 
Seat 4: stfuplzudonk (€3.73 in chips) 
Seat 5: caduceus369 (€1.98 in chips) 
Seat 6: GIacius (€3.09 in chips) 
cucuma21: posts small blind €0.01
pistaKKio23: posts big blind €0.02
*** HOLE CARDS ***
Dealt to caduceus369 [3d 7d]
stfuplzudonk: folds 
caduceus369: folds 
GIacius: folds 
OMGWOLFX: raises €0.04 to €0.06
cucuma21: folds 
pistaKKio23: folds 
Uncalled bet (€0.04) returned to OMGWOLFX
OMGWOLFX collected €0.05 from pot
OMGWOLFX: doesn't show hand 
*** SUMMARY ***
Total pot €0.05 | Rake €0 
Seat 1: OMGWOLFX (button) collected (€0.05)
Seat 2: cucuma21 (small blind) folded before Flop
Seat 3: pistaKKio23 (big blind) folded before Flop
Seat 4: stfuplzudonk folded before Flop (didn't bet)
Seat 5: caduceus369 folded before Flop (didn't bet)
Seat 6: GIacius folded before Flop (didn't bet)



PokerStars Zoom Hand #257983970076:  Hold'em No Limit (€0.01/€0.02) [ADM ID: M62BA304494E32ST] - 2025/10/03 18:16:07 CET [2025/10/03 12:16:07 ET]
Table 'Sirio' 6-max Seat #1 is the button
Seat 1: caduceus369 (€1.98 in chips) 
Seat 2: GIacius (€4.71 in chips) 
Seat 3: Skizzo6711 (€0.95 in chips) 
Seat 4: pistaKKio23 (€2.89 in chips) 
Seat 5: SalahUbeen (€2.20 in chips) 
Seat 6: OMGWOLFX (€3.66 in chips) 
GIacius: posts small blind €0.01
Skizzo6711: posts big blind €0.02
*** HOLE CARDS ***
Dealt to caduceus369 [Kd 4d]
pistaKKio23 has timed out
pistaKKio23: folds 
SalahUbeen: folds 
OMGWOLFX: folds 
caduceus369: folds 
GIacius: raises €0.04 to €0.06
Skizzo6711: calls €0.04
*** FLOP *** [8h Tc Ks]
GIacius: checks 
Skizzo6711: checks 
*** TURN *** [8h Tc Ks] [Jh]
GIacius: bets €0.09
Skizzo6711: folds 
Uncalled bet (€0.09) returned to GIacius
GIacius collected €0.12 from pot
GIacius: doesn't show hand 
*** SUMMARY ***
Total pot €0.12 | Rake €0 
Board [8h Tc Ks Jh]
Seat 1: caduceus369 (button) folded before Flop (didn't bet)
Seat 2: GIacius (small blind) collected (€0.12)
Seat 3: Skizzo6711 (big blind) folded on the Turn
Seat 4: pistaKKio23 folded before Flop (didn't bet)
Seat 5: SalahUbeen folded before Flop (didn't bet)
Seat 6: OMGWOLFX folded before Flop (didn't bet)



PokerStars Zoom Hand #257983976984:  Hold'em No Limit (€0.01/€0.02) [ADM ID: M62BA304494E32ST] - 2025/10/03 18:16:45 CET [2025/10/03 12:16:45 ET]
Table 'Sirio' 6-max Seat #1 is the button
Seat 1: andresette (€3.95 in chips) 
Seat 2: OMGWOLFX (€11.67 in chips) 
Seat 3: stfuplzudonk (€3.73 in chips) 
Seat 4: caduceus369 (€1.97 in chips) 
Seat 5: SidneyPrescott (€2.47 in chips) 
Seat 6: trillycata (€1.66 in chips) 
OMGWOLFX: posts small blind €0.01
stfuplzudonk: posts big blind €0.02
*** HOLE CARDS ***
Dealt to caduceus369 [Tc 5c]
caduceus369: folds 
SidneyPrescott: raises €0.04 to €0.06
trillycata: folds 
andresette: folds 
OMGWOLFX: folds 
stfuplzudonk: folds 
Uncalled bet (€0.04) returned to SidneyPrescott
SidneyPrescott collected €0.05 from pot
SidneyPrescott: doesn't show hand 
*** SUMMARY ***
Total pot €0.05 | Rake €0 
Seat 1: andresette (button) folded before Flop (didn't bet)
Seat 2: OMGWOLFX (small blind) folded before Flop
Seat 3: stfuplzudonk (big blind) folded before Flop
Seat 4: caduceus369 folded before Flop (didn't bet)
Seat 5: SidneyPrescott collected (€0.05)
Seat 6: trillycata folded before Flop (didn't bet)



PokerStars Zoom Hand #257983976420:  Hold'em No Limit (€0.01/€0.02) [ADM ID: M62BA304494E32ST] - 2025/10/03 18:16:42 CET [2025/10/03 12:16:42 ET]
Table 'Sirio' 6-max Seat #1 is the button
Seat 1: GIacius (€3.93 in chips) 
Seat 2: 18Gugli81 (€1.18 in chips) 
Seat 3: SalahUbeen (€2.20 in chips) 
Seat 4: caduceus369 (€1.97 in chips) 
Seat 5: OMGWOLFX (€3.65 in chips) 
Seat 6: Cruelplace84 (€2.20 in chips) 
18Gugli81: posts small blind €0.01
SalahUbeen: posts big blind €0.02
*** HOLE CARDS ***
Dealt to caduceus369 [9h 6d]
caduceus369: folds 
OMGWOLFX: raises €0.04 to €0.06
Cruelplace84: raises €0.12 to €0.18
GIacius: folds 
18Gugli81: folds 
SalahUbeen: folds 
OMGWOLFX: folds 
Uncalled bet (€0.12) returned to Cruelplace84
Cruelplace84 collected €0.15 from pot
Cruelplace84: doesn't show hand 
*** SUMMARY ***
Total pot €0.15 | Rake €0 
Seat 1: GIacius (button) folded before Flop (didn't bet)
Seat 2: 18Gugli81 (small blind) folded before Flop
Seat 3: SalahUbeen (big blind) folded before Flop
Seat 4: caduceus369 folded before Flop (didn't bet)
Seat 5: OMGWOLFX folded before Flop
Seat 6: Cruelplace84 collected (€0.15)



PokerStars Zoom Hand #257983974935:  Hold'em No Limit (€0.01/€0.02) [ADM ID: M62BA304494E32ST] - 2025/10/03 18:16:34 CET [2025/10/03 12:16:34 ET]
Table 'Sirio' 6-max Seat #1 is the button
Seat 1: stfuplzudonk (€1.92 in chips) 
Seat 2: caduceus369 (€1.98 in chips) 
Seat 3: panzapelata (€2.07 in chips) 
Seat 4: Cruelplace84 (€2 in chips) 
Seat 5: GIacius (€3.09 in chips) 
Seat 6: ZefirDevil (€0.45 in chips) 
caduceus369: posts small blind €0.01
panzapelata: posts big blind €0.02
*** HOLE CARDS ***
Dealt to caduceus369 [9d Ts]
Cruelplace84: folds 
GIacius: folds 
ZefirDevil: raises €0.02 to €0.04
stfuplzudonk: calls €0.04
caduceus369: folds 
panzapelata: folds 
*** FLOP *** [Kh 6d 6s]
ZefirDevil: checks 
stfuplzudonk: checks 
*** TURN *** [Kh 6d 6s] [4h]
ZefirDevil: checks 
stfuplzudonk: checks 
*** RIVER *** [Kh 6d 6s 4h] [As]
ZefirDevil: checks 
stfuplzudonk: checks 
*** SHOW DOWN ***
ZefirDevil: shows [9s Th] (a pair of Sixes)
stfuplzudonk: shows [5h 5d] (two pair, Sixes and Fives)
stfuplzudonk collected €0.11 from pot
*** SUMMARY ***
Total pot €0.11 | Rake €0 
Board [Kh 6d 6s 4h As]
Seat 1: stfuplzudonk (button) showed [5h 5d] and won (€0.11) with two pair, Sixes and Fives
Seat 2: caduceus369 (small blind) folded before Flop
Seat 3: panzapelata (big blind) folded before Flop
Seat 4: Cruelplace84 folded before Flop (didn't bet)
Seat 5: GIacius folded before Flop (didn't bet)
Seat 6: ZefirDevil showed [9s Th] and lost with a pair of Sixes



PokerStars Zoom Hand #257983977631:  Hold'em No Limit (€0.01/€0.02) [ADM ID: M62BA304494E32ST] - 2025/10/03 18:16:48 CET [2025/10/03 12:16:48 ET]
Table 'Sirio' 6-max Seat #1 is the button
Seat 1: caduceus369 (€1.97 in chips) 
Seat 2: luchino74 (€2.10 in chips) 
Seat 3: deojking (€2.44 in chips) 
Seat 4: Catania838 (€1.34 in chips) 
Seat 5: panzapelata (€2.26 in chips) 
Seat 6: 18Gugli81 (€1.17 in chips) 
luchino74: posts small blind €0.01
deojking: posts big blind €0.02
*** HOLE CARDS ***
Dealt to caduceus369 [Ah Qc]
Catania838: folds 
panzapelata: folds 
18Gugli81: folds 
caduceus369: raises €0.02 to €0.04
luchino74: folds 
deojking: calls €0.02
*** FLOP *** [5d Ts Tc]
deojking: checks 
caduceus369: bets €0.03
deojking: folds 
Uncalled bet (€0.03) returned to caduceus369
caduceus369 collected €0.09 from pot
caduceus369: doesn't show hand 
*** SUMMARY ***
Total pot €0.09 | Rake €0 
Board [5d Ts Tc]
Seat 1: caduceus369 (button) collected (€0.09)
Seat 2: luchino74 (small blind) folded before Flop
Seat 3: deojking (big blind) folded on the Flop
Seat 4: Catania838 folded before Flop (didn't bet)
Seat 5: panzapelata folded before Flop (didn't bet)
Seat 6: 18Gugli81 folded before Flop (didn't bet)



PokerStars Zoom Hand #257983986045:  Hold'em No Limit (€0.01/€0.02) [ADM ID: M62BA304494E32ST] - 2025/10/03 18:17:34 CET [2025/10/03 12:17:34 ET]
Table 'Sirio' 6-max Seat #1 is the button
Seat 1: kolain17 (€2.11 in chips) 
Seat 2: Cruelplace84 (€3.13 in chips) 
Seat 3: caduceus369 (€2.01 in chips) 
Seat 4: OSPREYSTORM (€2.73 in chips) 
Seat 5: SalahUbeen (€2.85 in chips) 
Seat 6: cucuma21 (€1.09 in chips) 
Cruelplace84: posts small blind €0.01
caduceus369: posts big blind €0.02
*** HOLE CARDS ***
Dealt to caduceus369 [Tc 2h]
OSPREYSTORM: folds 
SalahUbeen: folds 
cucuma21: calls €0.02
kolain17: raises €0.07 to €0.09
Cruelplace84: folds 
caduceus369: folds 
cucuma21: folds 
Uncalled bet (€0.07) returned to kolain17
kolain17 collected €0.07 from pot
kolain17: doesn't show hand 
*** SUMMARY ***
Total pot €0.07 | Rake €0 
Seat 1: kolain17 (button) collected (€0.07)
Seat 2: Cruelplace84 (small blind) folded before Flop
Seat 3: caduceus369 (big blind) folded before Flop
Seat 4: OSPREYSTORM folded before Flop (didn't bet)
Seat 5: SalahUbeen folded before Flop (didn't bet)
Seat 6: cucuma21 folded before Flop



PokerStars Zoom Hand #257983969009:  Hold'em No Limit (€0.01/€0.02) [ADM ID: M62BA304494E32ST] - 2025/10/03 18:16:02 CET [2025/10/03 12:16:02 ET]
Table 'Sirio' 6-max Seat #1 is the button
Seat 1: lilluz46424 (€3.58 in chips) 
Seat 2: GIacius (€2.18 in chips) 
Seat 3: OSPREYSTORM (€2.01 in chips) 
Seat 4: caduceus369 (€1.98 in chips) 
Seat 5: SalahUbeen (€2.74 in chips) 
Seat 6: Pupu300 (€2.53 in chips) 
GIacius: posts small blind €0.01
OSPREYSTORM: posts big blind €0.02
*** HOLE CARDS ***
Dealt to caduceus369 [8h 5h]
caduceus369: folds 
SalahUbeen: folds 
Pupu300: folds 
lilluz46424: raises €0.02 to €0.04
GIacius: folds 
OSPREYSTORM: raises €0.12 to €0.16
lilluz46424: calls €0.12
*** FLOP *** [Kh 9c As]
OSPREYSTORM: checks 
lilluz46424: bets €0.02
OSPREYSTORM: raises €0.12 to €0.14
lilluz46424: calls €0.12
*** TURN *** [Kh 9c As] [Qs]
OSPREYSTORM: checks 
lilluz46424: bets €0.29
OSPREYSTORM: raises €0.47 to €0.76
lilluz46424: raises €0.47 to €1.23
OSPREYSTORM: raises €0.48 to €1.71 and is all-in
lilluz46424: calls €0.48
*** RIVER *** [Kh 9c As Qs] [3c]
*** SHOW DOWN ***
OSPREYSTORM: shows [Kd Ah] (two pair, Aces and Kings)
lilluz46424: shows [Ac Qc] (two pair, Aces and Queens)
OSPREYSTORM collected €3.81 from pot
*** SUMMARY ***
Total pot €4.03 | Rake €0.22 
Board [Kh 9c As Qs 3c]
Seat 1: lilluz46424 (button) showed [Ac Qc] and lost with two pair, Aces and Queens
Seat 2: GIacius (small blind) folded before Flop
Seat 3: OSPREYSTORM (big blind) showed [Kd Ah] and won (€3.81) with two pair, Aces and Kings
Seat 4: caduceus369 folded before Flop (didn't bet)
Seat 5: SalahUbeen folded before Flop (didn't bet)
Seat 6: Pupu300 folded before Flop (didn't bet)



PokerStars Zoom Hand #257983984664:  Hold'em No Limit (€0.01/€0.02) [ADM ID: M62BA304494E32ST] - 2025/10/03 18:17:26 CET [2025/10/03 12:17:26 ET]
Table 'Sirio' 6-max Seat #1 is the button
Seat 1: QUATTRODAME (€5.28 in chips) 
Seat 2: caduceus369 (€2.02 in chips) 
Seat 3: deojking (€1.65 in chips) 
Seat 4: TheBigFlash (€2.14 in chips) 
Seat 5: Grifo546 (€2.48 in chips) 
Seat 6: Cruelplace84 (€3.13 in chips) 
caduceus369: posts small blind €0.01
deojking: posts big blind €0.02
*** HOLE CARDS ***
Dealt to caduceus369 [6h Kd]
TheBigFlash: calls €0.02
Grifo546: raises €0.04 to €0.06
Cruelplace84: folds 
QUATTRODAME: folds 
caduceus369: folds 
deojking: folds 
TheBigFlash: calls €0.04
*** FLOP *** [8d 7c 5c]
TheBigFlash: checks 
Grifo546: bets €0.15
TheBigFlash: folds 
Uncalled bet (€0.15) returned to Grifo546
Grifo546 collected €0.15 from pot
Grifo546: doesn't show hand 
*** SUMMARY ***
Total pot €0.15 | Rake €0 
Board [8d 7c 5c]
Seat 1: QUATTRODAME (button) folded before Flop (didn't bet)
Seat 2: caduceus369 (small blind) folded before Flop
Seat 3: deojking (big blind) folded before Flop
Seat 4: TheBigFlash folded on the Flop
Seat 5: Grifo546 collected (€0.15)
Seat 6: Cruelplace84 folded before Flop (didn't bet)



PokerStars Zoom Hand #257983988778:  Hold'em No Limit (€0.01/€0.02) [ADM ID: M62BA304494E32ST] - 2025/10/03 18:17:48 CET [2025/10/03 12:17:48 ET]
Table 'Sirio' 6-max Seat #1 is the button
Seat 1: QUATTRODAME (€5.27 in chips) 
Seat 2: GIacius (€4.75 in chips) 
Seat 3: heitel (€1.31 in chips) 
Seat 4: panzapelata (€0.88 in chips) 
Seat 5: Dijess (€1.91 in chips) 
Seat 6: caduceus369 (€1.99 in chips) 
GIacius: posts small blind €0.01
heitel: posts big blind €0.02
*** HOLE CARDS ***
Dealt to caduceus369 [5s 5h]
panzapelata: folds 
Dijess: folds 
caduceus369: calls €0.02
QUATTRODAME: raises €0.07 to €0.09
GIacius: folds 
heitel: calls €0.07
caduceus369: calls €0.07
*** FLOP *** [5d Ad Ks]
heitel: checks 
caduceus369: checks 
QUATTRODAME: checks 
*** TURN *** [5d Ad Ks] [7c]
heitel: bets €0.27
caduceus369: calls €0.27
QUATTRODAME: raises €1.08 to €1.35
heitel: folds 
caduceus369: raises €0.55 to €1.90 and is all-in
QUATTRODAME: calls €0.55
*** RIVER *** [5d Ad Ks 7c] [Ah]
*** SHOW DOWN ***
caduceus369: shows [5s 5h] (a full house, Fives full of Aces)
QUATTRODAME: shows [As Kd] (a full house, Aces full of Kings)
QUATTRODAME collected €4.12 from pot
*** SUMMARY ***
Total pot €4.35 | Rake €0.23 
Board [5d Ad Ks 7c Ah]
Seat 1: QUATTRODAME (button) showed [As Kd] and won (€4.12) with a full house, Aces full of Kings
Seat 2: GIacius (small blind) folded before Flop
Seat 3: heitel (big blind) folded on the Turn
Seat 4: panzapelata folded before Flop (didn't bet)
Seat 5: Dijess folded before Flop (didn't bet)
Seat 6: caduceus369 showed [5s 5h] and lost with a full house, Fives full of Aces



PokerStars Zoom Hand #257984009617:  Hold'em No Limit (€0.01/€0.02) [ADM ID: M62BA304494E32ST] - 2025/10/03 18:19:39 CET [2025/10/03 12:19:39 ET]
Table 'Sirio' 6-max Seat #1 is the button
Seat 1: bubu1554 (€1.20 in chips) 
Seat 2: capovujadin (€3.36 in chips) 
Seat 3: Catania838 (€2.01 in chips) 
Seat 4: SalahUbeen (€1.46 in chips) 
Seat 5: Gabrielefante (€2.70 in chips) 
Seat 6: caduceus369 (€2 in chips) 
capovujadin: posts small blind €0.01
Catania838: posts big blind €0.02
*** HOLE CARDS ***
Dealt to caduceus369 [4h Tc]
SalahUbeen: folds 
Gabrielefante: folds 
caduceus369: folds 
bubu1554: folds 
capovujadin: calls €0.01
Catania838: checks 
*** FLOP *** [Qs 8c 7c]
capovujadin: bets €0.04
Catania838: folds 
Uncalled bet (€0.04) returned to capovujadin
capovujadin collected €0.04 from pot
capovujadin: doesn't show hand 
*** SUMMARY ***
Total pot €0.04 | Rake €0 
Board [Qs 8c 7c]
Seat 1: bubu1554 (button) folded before Flop (didn't bet)
Seat 2: capovujadin (small blind) collected (€0.04)
Seat 3: Catania838 (big blind) folded on the Flop
Seat 4: SalahUbeen folded before Flop (didn't bet)
Seat 5: Gabrielefante folded before Flop (didn't bet)
Seat 6: caduceus369 folded before Flop (didn't bet)



PokerStars Zoom Hand #257984008227:  Hold'em No Limit (€0.01/€0.02) [ADM ID: M62BA304494E32ST] - 2025/10/03 18:19:32 CET [2025/10/03 12:19:32 ET]
Table 'Sirio' 6-max Seat #1 is the button
Seat 1: marina41978 (€0.82 in chips) 
Seat 2: Gabrielefante (€2.71 in chips) 
Seat 3: panzapelata (€2.15 in chips) 
Seat 4: SidneyPrescott (€2.48 in chips) 
Seat 5: caduceus369 (€2 in chips) 
Seat 6: monsterc99 (€0.96 in chips) 
Gabrielefante: posts small blind €0.01
panzapelata: posts big blind €0.02
*** HOLE CARDS ***
Dealt to caduceus369 [Qs 7d]
SidneyPrescott: folds 
caduceus369: folds 
monsterc99: calls €0.02
marina41978: folds 
Gabrielefante: folds 
panzapelata: checks 
*** FLOP *** [9c Kd 9h]
panzapelata: checks 
monsterc99: bets €0.02
panzapelata: folds 
Uncalled bet (€0.02) returned to monsterc99
monsterc99 collected €0.05 from pot
monsterc99: doesn't show hand 
*** SUMMARY ***
Total pot €0.05 | Rake €0 
Board [9c Kd 9h]
Seat 1: marina41978 (button) folded before Flop (didn't bet)
Seat 2: Gabrielefante (small blind) folded before Flop
Seat 3: panzapelata (big blind) folded on the Flop
Seat 4: SidneyPrescott folded before Flop (didn't bet)
Seat 5: caduceus369 folded before Flop (didn't bet)
Seat 6: monsterc99 collected (€0.05)



PokerStars Zoom Hand #257984012026:  Hold'em No Limit (€0.01/€0.02) [ADM ID: M62BA304494E32ST] - 2025/10/03 18:19:52 CET [2025/10/03 12:19:52 ET]
Table 'Sirio' 6-max Seat #1 is the button
Seat 1: caduceus369 (€2 in chips) 
Seat 2: Kamiros01 (€3.62 in chips) 
Seat 3: Ceribelli1705 (€0.52 in chips) 
Seat 4: luchino74 (€4.46 in chips) 
Seat 5: mariokart137 (€3.86 in chips) 
Seat 6: Gabrielefante (€2.68 in chips) 
Kamiros01: posts small blind €0.01
Ceribelli1705: posts big blind €0.02
*** HOLE CARDS ***
Dealt to caduceus369 [8s 5h]
luchino74: folds 
mariokart137: raises €0.04 to €0.06
Gabrielefante: folds 
caduceus369: folds 
Kamiros01: folds 
Ceribelli1705: calls €0.04
*** FLOP *** [4h Ts 7s]
Ceribelli1705: checks 
mariokart137: bets €0.10
Ceribelli1705: calls €0.10
*** TURN *** [4h Ts 7s] [2d]
Ceribelli1705: bets €0.12
mariokart137: calls €0.12
*** RIVER *** [4h Ts 7s 2d] [3s]
Ceribelli1705: bets €0.08
mariokart137: calls €0.08
*** SHOW DOWN ***
Ceribelli1705: shows [7c 7d] (three of a kind, Sevens)
mariokart137: mucks hand 
Ceribelli1705 collected €0.69 from pot
*** SUMMARY ***
Total pot €0.73 | Rake €0.04 
Board [4h Ts 7s 2d 3s]
Seat 1: caduceus369 (button) folded before Flop (didn't bet)
Seat 2: Kamiros01 (small blind) folded before Flop
Seat 3: Ceribelli1705 (big blind) showed [7c 7d] and won (€0.69) with three of a kind, Sevens
Seat 4: luchino74 folded before Flop (didn't bet)
Seat 5: mariokart137 mucked [Ah Th]
Seat 6: Gabrielefante folded before Flop (didn't bet)



PokerStars Zoom Hand #257984019472:  Hold'em No Limit (€0.01/€0.02) [ADM ID: M62BA304494E32ST] - 2025/10/03 18:20:32 CET [2025/10/03 12:20:32 ET]
Table 'Sirio' 6-max Seat #1 is the button
Seat 1: stfuplzudonk (€3.80 in chips) 
Seat 2: caduceus369 (€1.97 in chips) 
Seat 3: pistaKKio23 (€1.90 in chips) 
Seat 4: SalahUbeen (€1.70 in chips) 
Seat 5: monsterc99 (€0.98 in chips) 
Seat 6: TurboMuletto (€1.65 in chips) 
caduceus369: posts small blind €0.01
pistaKKio23: posts big blind €0.02
*** HOLE CARDS ***
Dealt to caduceus369 [6h Jc]
SalahUbeen: raises €0.03 to €0.05
monsterc99: folds 
TurboMuletto: folds 
stfuplzudonk: folds 
caduceus369: folds 
pistaKKio23: folds 
Uncalled bet (€0.03) returned to SalahUbeen
SalahUbeen collected €0.05 from pot
SalahUbeen: doesn't show hand 
*** SUMMARY ***
Total pot €0.05 | Rake €0 
Seat 1: stfuplzudonk (button) folded before Flop (didn't bet)
Seat 2: caduceus369 (small blind) folded before Flop
Seat 3: pistaKKio23 (big blind) folded before Flop
Seat 4: SalahUbeen collected (€0.05)
Seat 5: monsterc99 folded before Flop (didn't bet)
Seat 6: TurboMuletto folded before Flop (didn't bet)



PokerStars Zoom Hand #257984014581:  Hold'em No Limit (€0.01/€0.02) [ADM ID: M62BA304494E32ST] - 2025/10/03 18:20:06 CET [2025/10/03 12:20:06 ET]
Table 'Sirio' 6-max Seat #1 is the button
Seat 1: capovujadin (€3.38 in chips) 
Seat 2: pistaKKio23 (€2.86 in chips) 
Seat 3: caduceus369 (€2 in chips) 
Seat 4: SalahUbeen (€2.73 in chips) 
Seat 5: stfuplzudonk (€2.53 in chips) 
Seat 6: KilometroZer0 (€4.14 in chips) 
pistaKKio23: posts small blind €0.01
caduceus369: posts big blind €0.02
*** HOLE CARDS ***
Dealt to caduceus369 [Qd 4c]
SalahUbeen: raises €0.03 to €0.05
stfuplzudonk: folds 
KilometroZer0: calls €0.05
capovujadin: calls €0.05
pistaKKio23: folds 
caduceus369: folds 
*** FLOP *** [4d 4h 3d]
SalahUbeen: checks 
KilometroZer0: checks 
capovujadin: bets €0.11
SalahUbeen: folds 
KilometroZer0: folds 
Uncalled bet (€0.11) returned to capovujadin
capovujadin collected €0.18 from pot
capovujadin: doesn't show hand 
*** SUMMARY ***
Total pot €0.18 | Rake €0 
Board [4d 4h 3d]
Seat 1: capovujadin (button) collected (€0.18)
Seat 2: pistaKKio23 (small blind) folded before Flop
Seat 3: caduceus369 (big blind) folded before Flop
Seat 4: SalahUbeen folded on the Flop
Seat 5: stfuplzudonk folded before Flop (didn't bet)
Seat 6: KilometroZer0 folded on the Flop



PokerStars Zoom Hand #257984016183:  Hold'em No Limit (€0.01/€0.02) [ADM ID: M62BA304494E32ST] - 2025/10/03 18:20:14 CET [2025/10/03 12:20:14 ET]
Table 'Sirio' 6-max Seat #1 is the button
Seat 1: Grifo546 (€2.46 in chips) 
Seat 2: caduceus369 (€1.98 in chips) 
Seat 3: MarcoVent94 (€1.10 in chips) 
Seat 4: GIacius (€3.15 in chips) 
Seat 5: TurboMuletto (€1.66 in chips) 
Seat 6: Dijess (€1.90 in chips) 
caduceus369: posts small blind €0.01
MarcoVent94: posts big blind €0.02
*** HOLE CARDS ***
Dealt to caduceus369 [9s Th]
GIacius: raises €0.02 to €0.04
TurboMuletto: folds 
Dijess: folds 
Grifo546: calls €0.04
caduceus369: folds 
MarcoVent94: folds 
*** FLOP *** [3d Jc Jd]
GIacius: checks 
Grifo546: checks 
*** TURN *** [3d Jc Jd] [Js]
GIacius: checks 
Grifo546: checks 
*** RIVER *** [3d Jc Jd Js] [Kd]
GIacius: bets €0.23
Grifo546: folds 
Uncalled bet (€0.23) returned to GIacius
GIacius collected €0.11 from pot
GIacius: doesn't show hand 
*** SUMMARY ***
Total pot €0.11 | Rake €0 
Board [3d Jc Jd Js Kd]
Seat 1: Grifo546 (button) folded on the River
Seat 2: caduceus369 (small blind) folded before Flop
Seat 3: MarcoVent94 (big blind) folded before Flop
Seat 4: GIacius collected (€0.11)
Seat 5: TurboMuletto folded before Flop (didn't bet)
Seat 6: Dijess folded before Flop (didn't bet)



PokerStars Zoom Hand #257984017498:  Hold'em No Limit (€0.01/€0.02) [ADM ID: M62BA304494E32ST] - 2025/10/03 18:20:21 CET [2025/10/03 12:20:21 ET]
Table 'Sirio' 6-max Seat #1 is the button
Seat 1: GIacius (€3.25 in chips) 
Seat 2: TurboMuletto (€1.66 in chips) 
Seat 3: franck19621962 (€0.50 in chips) 
Seat 4: OMGWOLFX (€2.10 in chips) 
Seat 5: pylonstrip (€2.24 in chips) 
Seat 6: caduceus369 (€1.97 in chips) 
TurboMuletto: posts small blind €0.01
franck19621962: posts big blind €0.02
*** HOLE CARDS ***
Dealt to caduceus369 [Js 5s]
OMGWOLFX: raises €0.04 to €0.06
pylonstrip: folds 
caduceus369: folds 
GIacius: folds 
TurboMuletto: folds 
franck19621962: calls €0.04
*** FLOP *** [5c 3h Ah]
franck19621962: checks 
OMGWOLFX: bets €0.07
franck19621962: calls €0.07
*** TURN *** [5c 3h Ah] [9s]
franck19621962: checks 
OMGWOLFX: checks 
*** RIVER *** [5c 3h Ah 9s] [Qd]
franck19621962: bets €0.10
OMGWOLFX: folds 
Uncalled bet (€0.10) returned to franck19621962
franck19621962 collected €0.26 from pot
franck19621962: doesn't show hand 
*** SUMMARY ***
Total pot €0.27 | Rake €0.01 
Board [5c 3h Ah 9s Qd]
Seat 1: GIacius (button) folded before Flop (didn't bet)
Seat 2: TurboMuletto (small blind) folded before Flop
Seat 3: franck19621962 (big blind) collected (€0.26)
Seat 4: OMGWOLFX folded on the River
Seat 5: pylonstrip folded before Flop (didn't bet)
Seat 6: caduceus369 folded before Flop (didn't bet)



PokerStars Zoom Hand #257984010649:  Hold'em No Limit (€0.01/€0.02) [ADM ID: M62BA304494E32ST] - 2025/10/03 18:19:45 CET [2025/10/03 12:19:45 ET]
Table 'Sirio' 6-max Seat #1 is the button
Seat 1: pistaKKio23 (€2.86 in chips) 
Seat 2: Pupu300 (€1.98 in chips) 
Seat 3: cagliari59 (€1 in chips) 
Seat 4: GIacius (€4.77 in chips) 
Seat 5: caduceus369 (€2 in chips) 
Seat 6: OMGWOLFX (€2.33 in chips) 
Pupu300: posts small blind €0.01
cagliari59: posts big blind €0.02
*** HOLE CARDS ***
Dealt to caduceus369 [9c Jc]
GIacius: folds 
caduceus369: folds 
OMGWOLFX: folds 
pistaKKio23: folds 
Pupu300: calls €0.01
cagliari59: checks 
*** FLOP *** [2h Td Jd]
Pupu300: checks 
cagliari59: checks 
*** TURN *** [2h Td Jd] [5c]
Pupu300 is disconnected 
Pupu300: checks 
cagliari59: checks 
*** RIVER *** [2h Td Jd 5c] [5s]
Pupu300: checks 
cagliari59: checks 
*** SHOW DOWN ***
Pupu300: shows [2c 9s] (two pair, Fives and Deuces)
cagliari59: mucks hand 
Pupu300 collected €0.04 from pot
*** SUMMARY ***
Total pot €0.04 | Rake €0 
Board [2h Td Jd 5c 5s]
Seat 1: pistaKKio23 (button) folded before Flop (didn't bet)
Seat 2: Pupu300 (small blind) showed [2c 9s] and won (€0.04) with two pair, Fives and Deuces
Seat 3: cagliari59 (big blind) mucked [4s Kc]
Seat 4: GIacius folded before Flop (didn't bet)
Seat 5: caduceus369 folded before Flop (didn't bet)
Seat 6: OMGWOLFX folded before Flop (didn't bet)



PokerStars Zoom Hand #257984013805:  Hold'em No Limit (€0.01/€0.02) [ADM ID: M62BA304494E32ST] - 2025/10/03 18:20:02 CET [2025/10/03 12:20:02 ET]
Table 'Sirio' 6-max Seat #1 is the button
Seat 1: SaTheNuts_77 (€5.76 in chips) 
Seat 2: deojking (€2.17 in chips) 
Seat 3: egidiosky (€1.05 in chips) 
Seat 4: caduceus369 (€2 in chips) 
Seat 5: KilometroZer0 (€1.37 in chips) 
Seat 6: kolain17 (€2.09 in chips) 
deojking: posts small blind €0.01
egidiosky: posts big blind €0.02
*** HOLE CARDS ***
Dealt to caduceus369 [7s Jc]
caduceus369: folds 
KilometroZer0: raises €0.05 to €0.07
kolain17: raises €0.05 to €0.12
SaTheNuts_77: folds 
deojking: folds 
egidiosky: folds 
KilometroZer0: raises €0.30 to €0.42
kolain17: calls €0.30
*** FLOP *** [2c Kh Kc]
KilometroZer0: checks 
kolain17: bets €0.02
KilometroZer0: calls €0.02
*** TURN *** [2c Kh Kc] [8h]
KilometroZer0: checks 
kolain17: bets €0.14
KilometroZer0: calls €0.14
*** RIVER *** [2c Kh Kc 8h] [9c]
KilometroZer0: checks 
kolain17: bets €0.16
KilometroZer0: calls €0.16
*** SHOW DOWN ***
kolain17: shows [2s Ks] (a full house, Kings full of Deuces)
KilometroZer0: mucks hand 
kolain17 collected €1.43 from pot
*** SUMMARY ***
Total pot €1.51 | Rake €0.08 
Board [2c Kh Kc 8h 9c]
Seat 1: SaTheNuts_77 (button) folded before Flop (didn't bet)
Seat 2: deojking (small blind) folded before Flop
Seat 3: egidiosky (big blind) folded before Flop
Seat 4: caduceus369 folded before Flop (didn't bet)
Seat 5: KilometroZer0 mucked [Ac As]
Seat 6: kolain17 showed [2s Ks] and won (€1.43) with a full house, Kings full of Deuces



PokerStars Zoom Hand #257984018662:  Hold'em No Limit (€0.01/€0.02) [ADM ID: M62BA304494E32ST] - 2025/10/03 18:20:27 CET [2025/10/03 12:20:27 ET]
Table 'Sirio' 6-max Seat #1 is the button
Seat 1: Catania838 (€1.06 in chips) 
Seat 2: SaTheNuts_77 (€5.74 in chips) 
Seat 3: Cruelplace84 (€3.67 in chips) 
Seat 4: caduceus369 (€1.97 in chips) 
Seat 5: yanez61 (€1.81 in chips) 
Seat 6: GIacius (€4.74 in chips) 
SaTheNuts_77: posts small blind €0.01
Cruelplace84: posts big blind €0.02
*** HOLE CARDS ***
Dealt to caduceus369 [Kh 2h]
caduceus369: folds 
yanez61: calls €0.02
GIacius: folds 
Catania838: calls €0.02
SaTheNuts_77: calls €0.01
Cruelplace84: checks 
*** FLOP *** [3d 6c Ts]
SaTheNuts_77: checks 
Cruelplace84: bets €0.05
yanez61: calls €0.05
Catania838: raises €0.13 to €0.18
SaTheNuts_77: folds 
Cruelplace84: folds 
yanez61: folds 
Uncalled bet (€0.13) returned to Catania838
Catania838 collected €0.22 from pot
Catania838: doesn't show hand 
*** SUMMARY ***
Total pot €0.23 | Rake €0.01 
Board [3d 6c Ts]
Seat 1: Catania838 (button) collected (€0.22)
Seat 2: SaTheNuts_77 (small blind) folded on the Flop
Seat 3: Cruelplace84 (big blind) folded on the Flop
Seat 4: caduceus369 folded before Flop (didn't bet)
Seat 5: yanez61 folded on the Flop
Seat 6: GIacius folded before Flop (didn't bet)



PokerStars Zoom Hand #257984020541:  Hold'em No Limit (€0.01/€0.02) [ADM ID: M62BA304494E32ST] - 2025/10/03 18:20:38 CET [2025/10/03 12:20:38 ET]
Table 'Sirio' 6-max Seat #1 is the button
Seat 1: caduceus369 (€1.96 in chips) 
Seat 2: ZefirDevil (€1.90 in chips) 
Seat 3: OSPREYSTORM (€2.75 in chips) 
Seat 4: pistaKKio23 (€2.85 in chips) 
Seat 5: SidneyPrescott (€2.86 in chips) 
Seat 6: Kamiros01 (€3.85 in chips) 
ZefirDevil: posts small blind €0.01
OSPREYSTORM: posts big blind €0.02
*** HOLE CARDS ***
Dealt to caduceus369 [Qc Qh]
pistaKKio23: folds 
SidneyPrescott: folds 
Kamiros01: folds 
caduceus369: raises €0.04 to €0.06
ZefirDevil: calls €0.05
OSPREYSTORM: calls €0.04
*** FLOP *** [Th 5s Ks]
ZefirDevil: checks 
OSPREYSTORM: checks 
caduceus369: bets €0.04
ZefirDevil: calls €0.04
OSPREYSTORM: folds 
*** TURN *** [Th 5s Ks] [4s]
ZefirDevil: checks 
caduceus369: checks 
*** RIVER *** [Th 5s Ks 4s] [2s]
ZefirDevil: bets €0.06
caduceus369: folds 
Uncalled bet (€0.06) returned to ZefirDevil
ZefirDevil collected €0.25 from pot
ZefirDevil: doesn't show hand 
*** SUMMARY ***
Total pot €0.26 | Rake €0.01 
Board [Th 5s Ks 4s 2s]
Seat 1: caduceus369 (button) folded on the River
Seat 2: ZefirDevil (small blind) collected (€0.25)
Seat 3: OSPREYSTORM (big blind) folded on the Flop
Seat 4: pistaKKio23 folded before Flop (didn't bet)
Seat 5: SidneyPrescott folded before Flop (didn't bet)
Seat 6: Kamiros01 folded before Flop (didn't bet)



PokerStars Zoom Hand #257984033890:  Hold'em No Limit (€0.01/€0.02) [ADM ID: M62BA304494E32ST] - 2025/10/03 18:21:48 CET [2025/10/03 12:21:48 ET]
Table 'Sirio' 6-max Seat #1 is the button
Seat 1: pistaKKio23 (€2.70 in chips) 
Seat 2: Ceribelli1705 (€0.75 in chips) 
Seat 3: caduceus369 (€1.86 in chips) 
Seat 4: franck19621962 (€0.67 in chips) 
Seat 5: mariokart137 (€3.49 in chips) 
Seat 6: OSPREYSTORM (€2.67 in chips) 
Ceribelli1705: posts small blind €0.01
caduceus369: posts big blind €0.02
*** HOLE CARDS ***
Dealt to caduceus369 [8s Qc]
franck19621962: folds 
mariokart137: calls €0.02
OSPREYSTORM: folds 
pistaKKio23: folds 
Ceribelli1705: calls €0.01
caduceus369: checks 
*** FLOP *** [3s 6d 7c]
Ceribelli1705: checks 
caduceus369: checks 
mariokart137: checks 
*** TURN *** [3s 6d 7c] [Kc]
Ceribelli1705: checks 
caduceus369: checks 
mariokart137: checks 
*** RIVER *** [3s 6d 7c Kc] [7h]
Ceribelli1705: checks 
caduceus369: bets €0.02
mariokart137: folds 
Ceribelli1705: folds 
Uncalled bet (€0.02) returned to caduceus369
caduceus369 collected €0.06 from pot
caduceus369: doesn't show hand 
*** SUMMARY ***
Total pot €0.06 | Rake €0 
Board [3s 6d 7c Kc 7h]
Seat 1: pistaKKio23 (button) folded before Flop (didn't bet)
Seat 2: Ceribelli1705 (small blind) folded on the River
Seat 3: caduceus369 (big blind) collected (€0.06)
Seat 4: franck19621962 folded before Flop (didn't bet)
Seat 5: mariokart137 folded on the River
Seat 6: OSPREYSTORM folded before Flop (didn't bet)



PokerStars Zoom Hand #257984040631:  Hold'em No Limit (€0.01/€0.02) [ADM ID: M62BA304494E32ST] - 2025/10/03 18:22:24 CET [2025/10/03 12:22:24 ET]
Table 'Sirio' 6-max Seat #1 is the button
Seat 1: OSPREYSTORM (€2.89 in chips) 
Seat 2: pylonstrip (€2 in chips) 
Seat 3: Emm3B1 (€2 in chips) 
Seat 4: marina41978 (€0.80 in chips) 
Seat 5: caduceus369 (€1.90 in chips) 
Seat 6: GIacius (€4.54 in chips) 
pylonstrip: posts small blind €0.01
Emm3B1: posts big blind €0.02
*** HOLE CARDS ***
Dealt to caduceus369 [7s 6d]
marina41978: folds 
caduceus369: folds 
GIacius: raises €0.03 to €0.05
OSPREYSTORM: folds 
pylonstrip: folds 
Emm3B1: folds 
Uncalled bet (€0.03) returned to GIacius
GIacius collected €0.05 from pot
GIacius: doesn't show hand 
*** SUMMARY ***
Total pot €0.05 | Rake €0 
Seat 1: OSPREYSTORM (button) folded before Flop (didn't bet)
Seat 2: pylonstrip (small blind) folded before Flop
Seat 3: Emm3B1 (big blind) folded before Flop
Seat 4: marina41978 folded before Flop (didn't bet)
Seat 5: caduceus369 folded before Flop (didn't bet)
Seat 6: GIacius collected (€0.05)



PokerStars Zoom Hand #257984041764:  Hold'em No Limit (€0.01/€0.02) [ADM ID: M62BA304494E32ST] - 2025/10/03 18:22:30 CET [2025/10/03 12:22:30 ET]
Table 'Sirio' 6-max Seat #1 is the button
Seat 1: capovujadin (€2.88 in chips) 
Seat 2: TurboMuletto (€1.69 in chips) 
Seat 3: monsterc99 (€1.06 in chips) 
Seat 4: Cruelplace84 (€3.13 in chips) 
Seat 5: panzapelata (€1.08 in chips) 
Seat 6: caduceus369 (€1.90 in chips) 
TurboMuletto: posts small blind €0.01
monsterc99: posts big blind €0.02
*** HOLE CARDS ***
Dealt to caduceus369 [7d 8d]
Cruelplace84: folds 
panzapelata: folds 
caduceus369: raises €0.02 to €0.04
capovujadin: calls €0.04
TurboMuletto: folds 
monsterc99: calls €0.02
*** FLOP *** [5h 6s Js]
monsterc99: checks 
caduceus369: checks 
capovujadin: checks 
*** TURN *** [5h 6s Js] [2c]
monsterc99: checks 
caduceus369: bets €0.04
capovujadin: calls €0.04
monsterc99: calls €0.04
*** RIVER *** [5h 6s Js 2c] [4d]
monsterc99: bets €0.08
caduceus369: raises €0.14 to €0.22
capovujadin: raises €0.14 to €0.36
monsterc99: calls €0.28
caduceus369: raises €0.34 to €0.70
capovujadin: calls €0.34
monsterc99: calls €0.34
*** SHOW DOWN ***
caduceus369: shows [7d 8d] (a straight, Four to Eight)
capovujadin: mucks hand 
monsterc99: mucks hand 
caduceus369 collected €2.23 from pot
*** SUMMARY ***
Total pot €2.35 | Rake €0.12 
Board [5h 6s Js 2c 4d]
Seat 1: capovujadin (button) mucked [6c 3c]
Seat 2: TurboMuletto (small blind) folded before Flop
Seat 3: monsterc99 (big blind) mucked [3h As]
Seat 4: Cruelplace84 folded before Flop (didn't bet)
Seat 5: panzapelata folded before Flop (didn't bet)
Seat 6: caduceus369 showed [7d 8d] and won (€2.23) with a straight, Four to Eight



PokerStars Zoom Hand #257984061814:  Hold'em No Limit (€0.01/€0.02) [ADM ID: M62BA304494E32ST] - 2025/10/03 18:24:17 CET [2025/10/03 12:24:17 ET]
Table 'Sirio' 6-max Seat #1 is the button
Seat 1: Emm3B1 (€2.03 in chips) 
Seat 2: caduceus369 (€3.35 in chips) 
Seat 3: egidiosky (€0.79 in chips) 
Seat 4: TurboMuletto (€1.62 in chips) 
Seat 5: luchino74 (€4.54 in chips) 
Seat 6: OSPREYSTORM (€2.40 in chips) 
caduceus369: posts small blind €0.01
egidiosky: posts big blind €0.02
*** HOLE CARDS ***
Dealt to caduceus369 [Qd 5s]
TurboMuletto: folds 
luchino74: folds 
OSPREYSTORM: folds 
Emm3B1: folds 
caduceus369: folds 
Uncalled bet (€0.01) returned to egidiosky
egidiosky collected €0.02 from pot
egidiosky: doesn't show hand 
*** SUMMARY ***
Total pot €0.02 | Rake €0 
Seat 1: Emm3B1 (button) folded before Flop (didn't bet)
Seat 2: caduceus369 (small blind) folded before Flop
Seat 3: egidiosky (big blind) collected (€0.02)
Seat 4: TurboMuletto folded before Flop (didn't bet)
Seat 5: luchino74 folded before Flop (didn't bet)
Seat 6: OSPREYSTORM folded before Flop (didn't bet)



PokerStars Zoom Hand #257984060715:  Hold'em No Limit (€0.01/€0.02) [ADM ID: M62BA304494E32ST] - 2025/10/03 18:24:11 CET [2025/10/03 12:24:11 ET]
Table 'Sirio' 6-max Seat #1 is the button
Seat 1: pistaKKio23 (€1.96 in chips) 
Seat 2: monsterc99 (€0.28 in chips) 
Seat 3: SKERZA (€1.82 in chips) 
Seat 4: marina41978 (€0.72 in chips) 
Seat 5: caduceus369 (€3.35 in chips) 
Seat 6: SidneyPrescott (€2.23 in chips) 
monsterc99: posts small blind €0.01
SKERZA: posts big blind €0.02
*** HOLE CARDS ***
Dealt to caduceus369 [7s 5s]
marina41978: calls €0.02
caduceus369: folds 
SidneyPrescott: raises €0.08 to €0.10
pistaKKio23: folds 
monsterc99: folds 
SKERZA: folds 
marina41978: calls €0.08
*** FLOP *** [Kc 4d 9d]
marina41978: checks 
SidneyPrescott: bets €0.11
marina41978: calls €0.11
*** TURN *** [Kc 4d 9d] [4h]
marina41978: checks 
SidneyPrescott: bets €0.30
marina41978: calls €0.30
*** RIVER *** [Kc 4d 9d 4h] [Qh]
marina41978: checks 
SidneyPrescott: bets €0.22
marina41978: folds 
Uncalled bet (€0.22) returned to SidneyPrescott
SidneyPrescott collected €1 from pot
SidneyPrescott: doesn't show hand 
*** SUMMARY ***
Total pot €1.05 | Rake €0.05 
Board [Kc 4d 9d 4h Qh]
Seat 1: pistaKKio23 (button) folded before Flop (didn't bet)
Seat 2: monsterc99 (small blind) folded before Flop
Seat 3: SKERZA (big blind) folded before Flop
Seat 4: marina41978 folded on the River
Seat 5: caduceus369 folded before Flop (didn't bet)
Seat 6: SidneyPrescott collected (€1)



PokerStars Zoom Hand #257984063925:  Hold'em No Limit (€0.01/€0.02) [ADM ID: M62BA304494E32ST] - 2025/10/03 18:24:29 CET [2025/10/03 12:24:29 ET]
Table 'Sirio' 6-max Seat #1 is the button
Seat 1: GIacius (€2.80 in chips) 
Seat 2: SaTheNuts_77 (€5.60 in chips) 
Seat 3: caduceus369 (€3.34 in chips) 
Seat 4: kolain17 (€2.95 in chips) 
Seat 5: Dijess (€2.22 in chips) 
Seat 6: deojking (€1.87 in chips) 
SaTheNuts_77: posts small blind €0.01
caduceus369: posts big blind €0.02
*** HOLE CARDS ***
Dealt to caduceus369 [6h 8s]
kolain17: raises €0.05 to €0.07
Dijess: folds 
deojking: folds 
GIacius: calls €0.07
SaTheNuts_77: folds 
caduceus369: folds 
*** FLOP *** [Jc Th Kh]
kolain17: bets €0.02
GIacius: calls €0.02
*** TURN *** [Jc Th Kh] [7h]
kolain17: bets €0.32
GIacius: folds 
Uncalled bet (€0.32) returned to kolain17
kolain17 collected €0.20 from pot
kolain17: doesn't show hand 
*** SUMMARY ***
Total pot €0.21 | Rake €0.01 
Board [Jc Th Kh 7h]
Seat 1: GIacius (button) folded on the Turn
Seat 2: SaTheNuts_77 (small blind) folded before Flop
Seat 3: caduceus369 (big blind) folded before Flop
Seat 4: kolain17 collected (€0.20)
Seat 5: Dijess folded before Flop (didn't bet)
Seat 6: deojking folded before Flop (didn't bet)



PokerStars Zoom Hand #257984067494:  Hold'em No Limit (€0.01/€0.02) [ADM ID: M62BA304494E32ST] - 2025/10/03 18:24:48 CET [2025/10/03 12:24:48 ET]
Table 'Sirio' 6-max Seat #1 is the button
Seat 1: caduceus369 (€3.32 in chips) 
Seat 2: yanez61 (€1.60 in chips) 
Seat 3: deojking (€2.23 in chips) 
Seat 4: pistaKKio23 (€2.62 in chips) 
Seat 5: luchino74 (€4.55 in chips) 
Seat 6: OSPREYSTORM (€2.37 in chips) 
yanez61: posts small blind €0.01
deojking: posts big blind €0.02
*** HOLE CARDS ***
Dealt to caduceus369 [Qs Js]
pistaKKio23: raises €0.02 to €0.04
luchino74: folds 
OSPREYSTORM: folds 
caduceus369: calls €0.04
yanez61: folds 
deojking: folds 
*** FLOP *** [7d 3d Ts]
pistaKKio23: checks 
caduceus369: checks 
*** TURN *** [7d 3d Ts] [7h]
pistaKKio23: checks 
caduceus369: bets €0.03
pistaKKio23: folds 
Uncalled bet (€0.03) returned to caduceus369
caduceus369 collected €0.11 from pot
caduceus369: doesn't show hand 
*** SUMMARY ***
Total pot €0.11 | Rake €0 
Board [7d 3d Ts 7h]
Seat 1: caduceus369 (button) collected (€0.11)
Seat 2: yanez61 (small blind) folded before Flop
Seat 3: deojking (big blind) folded before Flop
Seat 4: pistaKKio23 folded on the Turn
Seat 5: luchino74 folded before Flop (didn't bet)
Seat 6: OSPREYSTORM folded before Flop (didn't bet)



PokerStars Zoom Hand #257984074768:  Hold'em No Limit (€0.01/€0.02) [ADM ID: M62BA304494E32ST] - 2025/10/03 18:25:27 CET [2025/10/03 12:25:27 ET]
Table 'Sirio' 6-max Seat #1 is the button
Seat 1: GIacius (€4.70 in chips) 
Seat 2: OMGWOLFX (€2 in chips) 
Seat 3: deojking (€3.06 in chips) 
Seat 4: caduceus369 (€3.39 in chips) 
Seat 5: luchino74 (€4.52 in chips) 
Seat 6: TurboMuletto (€1.69 in chips) 
OMGWOLFX: posts small blind €0.01
deojking: posts big blind €0.02
*** HOLE CARDS ***
Dealt to caduceus369 [5h 2h]
caduceus369: folds 
luchino74: folds 
TurboMuletto: folds 
GIacius: folds 
OMGWOLFX: raises €0.04 to €0.06
deojking: folds 
Uncalled bet (€0.04) returned to OMGWOLFX
OMGWOLFX collected €0.04 from pot
OMGWOLFX: doesn't show hand 
*** SUMMARY ***
Total pot €0.04 | Rake €0 
Seat 1: GIacius (button) folded before Flop (didn't bet)
Seat 2: OMGWOLFX (small blind) collected (€0.04)
Seat 3: deojking (big blind) folded before Flop
Seat 4: caduceus369 folded before Flop (didn't bet)
Seat 5: luchino74 folded before Flop (didn't bet)
Seat 6: TurboMuletto folded before Flop (didn't bet)



PokerStars Zoom Hand #257984076388:  Hold'em No Limit (€0.01/€0.02) [ADM ID: M62BA304494E32ST] - 2025/10/03 18:25:35 CET [2025/10/03 12:25:35 ET]
Table 'Sirio' 6-max Seat #1 is the button
Seat 1: OSPREYSTORM (€2.89 in chips) 
Seat 2: luchino74 (€4.52 in chips) 
Seat 3: ZefirDevil (€1.08 in chips) 
Seat 4: SidneyPrescott (€2.72 in chips) 
Seat 5: caduceus369 (€3.39 in chips) 
Seat 6: franck19621962 (€0.61 in chips) 
luchino74: posts small blind €0.01
ZefirDevil: posts big blind €0.02
*** HOLE CARDS ***
Dealt to caduceus369 [Kh 3s]
SidneyPrescott: folds 
caduceus369: folds 
franck19621962: folds 
OSPREYSTORM: folds 
luchino74: folds 
Uncalled bet (€0.01) returned to ZefirDevil
ZefirDevil collected €0.02 from pot
ZefirDevil: doesn't show hand 
*** SUMMARY ***
Total pot €0.02 | Rake €0 
Seat 1: OSPREYSTORM (button) folded before Flop (didn't bet)
Seat 2: luchino74 (small blind) folded before Flop
Seat 3: ZefirDevil (big blind) collected (€0.02)
Seat 4: SidneyPrescott folded before Flop (didn't bet)
Seat 5: caduceus369 folded before Flop (didn't bet)
Seat 6: franck19621962 folded before Flop (didn't bet)



PokerStars Zoom Hand #257984077415:  Hold'em No Limit (€0.01/€0.02) [ADM ID: M62BA304494E32ST] - 2025/10/03 18:25:41 CET [2025/10/03 12:25:41 ET]
Table 'Sirio' 6-max Seat #1 is the button
Seat 1: SaTheNuts_77 (€5.56 in chips) 
Seat 2: Kamiros01 (€3.98 in chips) 
Seat 3: caduceus369 (€3.39 in chips) 
Seat 4: OSPREYSTORM (€2.43 in chips) 
Seat 5: Skizzo6711 (€0.84 in chips) 
Seat 6: deojking (€2.20 in chips) 
Kamiros01: posts small blind €0.01
caduceus369: posts big blind €0.02
*** HOLE CARDS ***
Dealt to caduceus369 [Qd 5c]
OSPREYSTORM: folds 
Skizzo6711: calls €0.02
deojking: folds 
SaTheNuts_77: raises €0.07 to €0.09
Kamiros01: folds 
caduceus369: folds 
Skizzo6711: calls €0.07
*** FLOP *** [5s Kd 2h]
Skizzo6711: checks 
SaTheNuts_77: bets €0.07
Skizzo6711: raises €0.34 to €0.41
SaTheNuts_77: folds 
Uncalled bet (€0.34) returned to Skizzo6711
Skizzo6711 collected €0.34 from pot
Skizzo6711: doesn't show hand 
*** SUMMARY ***
Total pot €0.35 | Rake €0.01 
Board [5s Kd 2h]
Seat 1: SaTheNuts_77 (button) folded on the Flop
Seat 2: Kamiros01 (small blind) folded before Flop
Seat 3: caduceus369 (big blind) folded before Flop
Seat 4: OSPREYSTORM folded before Flop (didn't bet)
Seat 5: Skizzo6711 collected (€0.34)
Seat 6: deojking folded before Flop (didn't bet)



PokerStars Zoom Hand #257984075598:  Hold'em No Limit (€0.01/€0.02) [ADM ID: M62BA304494E32ST] - 2025/10/03 18:25:31 CET [2025/10/03 12:25:31 ET]
Table 'Sirio' 6-max Seat #1 is the button
Seat 1: panzapelata (€2.59 in chips) 
Seat 2: SKERZA (€1.72 in chips) 
Seat 3: GIacius (€3.61 in chips) 
Seat 4: luchino74 (€4.52 in chips) 
Seat 5: Emm3B1 (€2.18 in chips) 
Seat 6: caduceus369 (€3.39 in chips) 
SKERZA: posts small blind €0.01
GIacius: posts big blind €0.02
*** HOLE CARDS ***
Dealt to caduceus369 [Js Tc]
luchino74: folds 
Emm3B1: folds 
caduceus369: folds 
panzapelata: folds 
SKERZA: raises €0.03 to €0.05
GIacius: calls €0.03
*** FLOP *** [2h 4s 9s]
SKERZA: bets €0.03
GIacius: calls €0.03
*** TURN *** [2h 4s 9s] [Ah]
SKERZA: bets €0.09
GIacius: folds 
Uncalled bet (€0.09) returned to SKERZA
SKERZA collected €0.16 from pot
SKERZA: doesn't show hand 
*** SUMMARY ***
Total pot €0.16 | Rake €0 
Board [2h 4s 9s Ah]
Seat 1: panzapelata (button) folded before Flop (didn't bet)
Seat 2: SKERZA (small blind) collected (€0.16)
Seat 3: GIacius (big blind) folded on the Turn
Seat 4: luchino74 folded before Flop (didn't bet)
Seat 5: Emm3B1 folded before Flop (didn't bet)
Seat 6: caduceus369 folded before Flop (didn't bet)



PokerStars Zoom Hand #257984079449:  Hold'em No Limit (€0.01/€0.02) [ADM ID: M62BA304494E32ST] - 2025/10/03 18:25:52 CET [2025/10/03 12:25:52 ET]
Table 'Sirio' 6-max Seat #1 is the button
Seat 1: OSPREYSTORM (€3.13 in chips) 
Seat 2: caduceus369 (€3.37 in chips) 
Seat 3: Emm3B1 (€2.22 in chips) 
Seat 4: Gabrielefante (€2.97 in chips) 
Seat 5: QUATTRODAME (€0.64 in chips) 
Seat 6: deojking (€3.04 in chips) 
caduceus369: posts small blind €0.01
Emm3B1: posts big blind €0.02
*** HOLE CARDS ***
Dealt to caduceus369 [Td 2s]
Gabrielefante: folds 
QUATTRODAME: folds 
deojking: folds 
OSPREYSTORM: folds 
caduceus369: folds 
Uncalled bet (€0.01) returned to Emm3B1
Emm3B1 collected €0.02 from pot
Emm3B1: doesn't show hand 
*** SUMMARY ***
Total pot €0.02 | Rake €0 
Seat 1: OSPREYSTORM (button) folded before Flop (didn't bet)
Seat 2: caduceus369 (small blind) folded before Flop
Seat 3: Emm3B1 (big blind) collected (€0.02)
Seat 4: Gabrielefante folded before Flop (didn't bet)
Seat 5: QUATTRODAME folded before Flop (didn't bet)
Seat 6: deojking folded before Flop (didn't bet)



PokerStars Zoom Hand #257984080123:  Hold'em No Limit (€0.01/€0.02) [ADM ID: M62BA304494E32ST] - 2025/10/03 18:25:55 CET [2025/10/03 12:25:55 ET]
Table 'Sirio' 6-max Seat #1 is the button
Seat 1: SalahUbeen (€2.08 in chips) 
Seat 2: Gabrielefante (€2.97 in chips) 
Seat 3: GanchanS7 (€2 in chips) 
Seat 4: panzapelata (€0.56 in chips) 
Seat 5: Kamiros01 (€3.97 in chips) 
Seat 6: caduceus369 (€3.36 in chips) 
Gabrielefante: posts small blind €0.01
GanchanS7: posts big blind €0.02
*** HOLE CARDS ***
Dealt to caduceus369 [4s 5h]
panzapelata: raises €0.04 to €0.06
Kamiros01: folds 
caduceus369: folds 
SalahUbeen: folds 
Gabrielefante: folds 
GanchanS7: folds 
Uncalled bet (€0.04) returned to panzapelata
panzapelata collected €0.05 from pot
panzapelata: doesn't show hand 
*** SUMMARY ***
Total pot €0.05 | Rake €0 
Seat 1: SalahUbeen (button) folded before Flop (didn't bet)
Seat 2: Gabrielefante (small blind) folded before Flop
Seat 3: GanchanS7 (big blind) folded before Flop
Seat 4: panzapelata collected (€0.05)
Seat 5: Kamiros01 folded before Flop (didn't bet)
Seat 6: caduceus369 folded before Flop (didn't bet)



PokerStars Zoom Hand #257984080875:  Hold'em No Limit (€0.01/€0.02) [ADM ID: M62BA304494E32ST] - 2025/10/03 18:26:00 CET [2025/10/03 12:26:00 ET]
Table 'Sirio' 6-max Seat #1 is the button
Seat 1: caduceus369 (€3.36 in chips) 
Seat 2: KilometroZer0 (€3.98 in chips) 
Seat 3: cagliari59 (€0.54 in chips) 
Seat 4: Kamiros01 (€3.97 in chips) 
Seat 5: OMGWOLFX (€11.81 in chips) 
Seat 6: OSPREYSTORM (€3.13 in chips) 
KilometroZer0: posts small blind €0.01
cagliari59: posts big blind €0.02
*** HOLE CARDS ***
Dealt to caduceus369 [2c Jd]
Kamiros01: folds 
OMGWOLFX: raises €0.04 to €0.06
OSPREYSTORM: folds 
caduceus369: folds 
KilometroZer0: folds 
cagliari59: folds 
Uncalled bet (€0.04) returned to OMGWOLFX
OMGWOLFX collected €0.05 from pot
OMGWOLFX: doesn't show hand 
*** SUMMARY ***
Total pot €0.05 | Rake €0 
Seat 1: caduceus369 (button) folded before Flop (didn't bet)
Seat 2: KilometroZer0 (small blind) folded before Flop
Seat 3: cagliari59 (big blind) folded before Flop
Seat 4: Kamiros01 folded before Flop (didn't bet)
Seat 5: OMGWOLFX collected (€0.05)
Seat 6: OSPREYSTORM folded before Flop (didn't bet)



PokerStars Zoom Hand #257984083473:  Hold'em No Limit (€0.01/€0.02) [ADM ID: M62BA304494E32ST] - 2025/10/03 18:26:14 CET [2025/10/03 12:26:14 ET]
Table 'Sirio' 6-max Seat #1 is the button
Seat 1: BetNoLook (€2.82 in chips) 
Seat 2: OSPREYSTORM (€2.40 in chips) 
Seat 3: cucuma21 (€1.01 in chips) 
Seat 4: GIacius (€3.52 in chips) 
Seat 5: caduceus369 (€3.36 in chips) 
Seat 6: cagliari59 (€0.52 in chips) 
OSPREYSTORM: posts small blind €0.01
cucuma21: posts big blind €0.02
*** HOLE CARDS ***
Dealt to caduceus369 [3d 3h]
GIacius: folds 
caduceus369: calls €0.02
cagliari59: folds 
BetNoLook: folds 
OSPREYSTORM: folds 
cucuma21: checks 
*** FLOP *** [4d 8h 6c]
cucuma21: checks 
caduceus369: checks 
*** TURN *** [4d 8h 6c] [3s]
cucuma21: checks 
caduceus369: checks 
*** RIVER *** [4d 8h 6c 3s] [Qc]
cucuma21: checks 
caduceus369: bets €0.14
cucuma21: folds 
Uncalled bet (€0.14) returned to caduceus369
caduceus369 collected €0.05 from pot
caduceus369: doesn't show hand 
*** SUMMARY ***
Total pot €0.05 | Rake €0 
Board [4d 8h 6c 3s Qc]
Seat 1: BetNoLook (button) folded before Flop (didn't bet)
Seat 2: OSPREYSTORM (small blind) folded before Flop
Seat 3: cucuma21 (big blind) folded on the River
Seat 4: GIacius folded before Flop (didn't bet)
Seat 5: caduceus369 collected (€0.05)
Seat 6: cagliari59 folded before Flop (didn't bet)



PokerStars Zoom Hand #257984081574:  Hold'em No Limit (€0.01/€0.02) [ADM ID: M62BA304494E32ST] - 2025/10/03 18:26:04 CET [2025/10/03 12:26:04 ET]
Table 'Sirio' 6-max Seat #1 is the button
Seat 1: Ceribelli1705 (€0.55 in chips) 
Seat 2: yanez61 (€1.66 in chips) 
Seat 3: OSPREYSTORM (€3.13 in chips) 
Seat 4: caduceus369 (€3.36 in chips) 
Seat 5: GanchanS7 (€2.07 in chips) 
Seat 6: Skizzo6711 (€1.02 in chips) 
yanez61: posts small blind €0.01
OSPREYSTORM: posts big blind €0.02
*** HOLE CARDS ***
Dealt to caduceus369 [9d 3d]
Ceribelli1705 is disconnected 
caduceus369: folds 
GanchanS7: raises €0.03 to €0.05
Skizzo6711: folds 
Ceribelli1705 has timed out while disconnected
Ceribelli1705: folds 
yanez61: folds 
OSPREYSTORM: calls €0.03
*** FLOP *** [Jd Js 9c]
OSPREYSTORM: checks 
GanchanS7: bets €0.07
OSPREYSTORM: folds 
Uncalled bet (€0.07) returned to GanchanS7
GanchanS7 collected €0.11 from pot
GanchanS7: doesn't show hand 
*** SUMMARY ***
Total pot €0.11 | Rake €0 
Board [Jd Js 9c]
Seat 1: Ceribelli1705 (button) folded before Flop (didn't bet)
Seat 2: yanez61 (small blind) folded before Flop
Seat 3: OSPREYSTORM (big blind) folded on the Flop
Seat 4: caduceus369 folded before Flop (didn't bet)
Seat 5: GanchanS7 collected (€0.11)
Seat 6: Skizzo6711 folded before Flop (didn't bet)



PokerStars Zoom Hand #257984089015:  Hold'em No Limit (€0.01/€0.02) [ADM ID: M62BA304494E32ST] - 2025/10/03 18:26:44 CET [2025/10/03 12:26:44 ET]
Table 'Sirio' 6-max Seat #1 is the button
Seat 1: SidneyPrescott (€2.69 in chips) 
Seat 2: panzapelata (€2.94 in chips) 
Seat 3: OSPREYSTORM (€2.86 in chips) 
Seat 4: caduceus369 (€3.39 in chips) 
Seat 5: SKERZA (€1.68 in chips) 
Seat 6: mariokart137 (€3.38 in chips) 
panzapelata: posts small blind €0.01
OSPREYSTORM: posts big blind €0.02
*** HOLE CARDS ***
Dealt to caduceus369 [Tc 8s]
caduceus369: folds 
SKERZA: raises €0.03 to €0.05
mariokart137: folds 
SidneyPrescott: folds 
panzapelata: folds 
OSPREYSTORM: folds 
Uncalled bet (€0.03) returned to SKERZA
SKERZA collected €0.05 from pot
SKERZA: doesn't show hand 
*** SUMMARY ***
Total pot €0.05 | Rake €0 
Seat 1: SidneyPrescott (button) folded before Flop (didn't bet)
Seat 2: panzapelata (small blind) folded before Flop
Seat 3: OSPREYSTORM (big blind) folded before Flop
Seat 4: caduceus369 folded before Flop (didn't bet)
Seat 5: SKERZA collected (€0.05)
Seat 6: mariokart137 folded before Flop (didn't bet)



PokerStars Zoom Hand #257984091963:  Hold'em No Limit (€0.01/€0.02) [ADM ID: M62BA304494E32ST] - 2025/10/03 18:26:59 CET [2025/10/03 12:26:59 ET]
Table 'Sirio' 6-max Seat #1 is the button
Seat 1: SalahUbeen (€2.39 in chips) 
Seat 2: caduceus369 (€3.37 in chips) 
Seat 3: luchino74 (€4.48 in chips) 
Seat 4: franck19621962 (€0.44 in chips) 
Seat 5: deojking (€1.82 in chips) 
Seat 6: cagliari59 (€0.48 in chips) 
caduceus369: posts small blind €0.01
luchino74: posts big blind €0.02
*** HOLE CARDS ***
Dealt to caduceus369 [5d 2c]
franck19621962: folds 
deojking: folds 
cagliari59: folds 
SalahUbeen: raises €0.04 to €0.06
caduceus369: folds 
luchino74: folds 
Uncalled bet (€0.04) returned to SalahUbeen
SalahUbeen collected €0.05 from pot
SalahUbeen: doesn't show hand 
*** SUMMARY ***
Total pot €0.05 | Rake €0 
Seat 1: SalahUbeen (button) collected (€0.05)
Seat 2: caduceus369 (small blind) folded before Flop
Seat 3: luchino74 (big blind) folded before Flop
Seat 4: franck19621962 folded before Flop (didn't bet)
Seat 5: deojking folded before Flop (didn't bet)
Seat 6: cagliari59 folded before Flop (didn't bet)



PokerStars Zoom Hand #257984094383:  Hold'em No Limit (€0.01/€0.02) [ADM ID: M62BA304494E32ST] - 2025/10/03 18:27:13 CET [2025/10/03 12:27:13 ET]
Table 'Sirio' 6-max Seat #1 is the button
Seat 1: SidneyPrescott (€2.35 in chips) 
Seat 2: BetNoLook (€2.72 in chips) 
Seat 3: SalahUbeen (€2.11 in chips) 
Seat 4: Kamiros01 (€3.93 in chips) 
Seat 5: caduceus369 (€3.36 in chips) 
Seat 6: luchino74 (€4.46 in chips) 
BetNoLook: posts small blind €0.01
SalahUbeen: posts big blind €0.02
*** HOLE CARDS ***
Dealt to caduceus369 [6h Kd]
Kamiros01: folds 
caduceus369: folds 
luchino74: folds 
SidneyPrescott: folds 
BetNoLook: folds 
Uncalled bet (€0.01) returned to SalahUbeen
SalahUbeen collected €0.02 from pot
SalahUbeen: doesn't show hand 
*** SUMMARY ***
Total pot €0.02 | Rake €0 
Seat 1: SidneyPrescott (button) folded before Flop (didn't bet)
Seat 2: BetNoLook (small blind) folded before Flop
Seat 3: SalahUbeen (big blind) collected (€0.02)
Seat 4: Kamiros01 folded before Flop (didn't bet)
Seat 5: caduceus369 folded before Flop (didn't bet)
Seat 6: luchino74 folded before Flop (didn't bet)



PokerStars Zoom Hand #257984089874:  Hold'em No Limit (€0.01/€0.02) [ADM ID: M62BA304494E32ST] - 2025/10/03 18:26:48 CET [2025/10/03 12:26:48 ET]
Table 'Sirio' 6-max Seat #1 is the button
Seat 1: OSPREYSTORM (€3.08 in chips) 
Seat 2: OMGWOLFX (€5.20 in chips) 
Seat 3: caduceus369 (€3.39 in chips) 
Seat 4: pistaKKio23 (€2.61 in chips) 
Seat 5: cucuma21 (€0.98 in chips) 
Seat 6: trillycata (€1.90 in chips) 
OMGWOLFX: posts small blind €0.01
caduceus369: posts big blind €0.02
*** HOLE CARDS ***
Dealt to caduceus369 [7s 6c]
pistaKKio23: folds 
cucuma21: calls €0.02
trillycata: folds 
OSPREYSTORM: folds 
OMGWOLFX: raises €0.04 to €0.06
caduceus369: folds 
cucuma21: calls €0.04
*** FLOP *** [3c 3s As]
OMGWOLFX: bets €0.07
cucuma21: calls €0.07
*** TURN *** [3c 3s As] [Ac]
OMGWOLFX: checks 
cucuma21: checks 
*** RIVER *** [3c 3s As Ac] [9h]
OMGWOLFX: checks 
cucuma21: checks 
*** SHOW DOWN ***
OMGWOLFX: shows [8c 9c] (two pair, Aces and Nines)
cucuma21: shows [Qh Qc] (two pair, Aces and Queens)
cucuma21 collected €0.27 from pot
*** SUMMARY ***
Total pot €0.28 | Rake €0.01 
Board [3c 3s As Ac 9h]
Seat 1: OSPREYSTORM (button) folded before Flop (didn't bet)
Seat 2: OMGWOLFX (small blind) showed [8c 9c] and lost with two pair, Aces and Nines
Seat 3: caduceus369 (big blind) folded before Flop
Seat 4: pistaKKio23 folded before Flop (didn't bet)
Seat 5: cucuma21 showed [Qh Qc] and won (€0.27) with two pair, Aces and Queens
Seat 6: trillycata folded before Flop (didn't bet)



PokerStars Zoom Hand #257984093872:  Hold'em No Limit (€0.01/€0.02) [ADM ID: M62BA304494E32ST] - 2025/10/03 18:27:10 CET [2025/10/03 12:27:10 ET]
Table 'Sirio' 6-max Seat #1 is the button
Seat 1: caduceus369 (€3.36 in chips) 
Seat 2: pistaKKio23 (€3.33 in chips) 
Seat 3: deojking (€2.13 in chips) 
Seat 4: mariokart137 (€3.36 in chips) 
Seat 5: KilometroZer0 (€3.98 in chips) 
Seat 6: GIacius (€3.52 in chips) 
pistaKKio23: posts small blind €0.01
deojking: posts big blind €0.02
*** HOLE CARDS ***
Dealt to caduceus369 [2c 8s]
mariokart137: raises €0.04 to €0.06
KilometroZer0: folds 
GIacius: folds 
caduceus369: folds 
pistaKKio23: folds 
deojking: folds 
Uncalled bet (€0.04) returned to mariokart137
mariokart137 collected €0.05 from pot
mariokart137: doesn't show hand 
*** SUMMARY ***
Total pot €0.05 | Rake €0 
Seat 1: caduceus369 (button) folded before Flop (didn't bet)
Seat 2: pistaKKio23 (small blind) folded before Flop
Seat 3: deojking (big blind) folded before Flop
Seat 4: mariokart137 collected (€0.05)
Seat 5: KilometroZer0 folded before Flop (didn't bet)
Seat 6: GIacius folded before Flop (didn't bet)



PokerStars Zoom Hand #257984095109:  Hold'em No Limit (€0.01/€0.02) [ADM ID: M62BA304494E32ST] - 2025/10/03 18:27:17 CET [2025/10/03 12:27:17 ET]
Table 'Sirio' 6-max Seat #1 is the button
Seat 1: KilometroZer0 (€5.87 in chips) 
Seat 2: Kamiros01 (€3.93 in chips) 
Seat 3: jeeslike (€6.88 in chips) 
Seat 4: SalahUbeen (€2.55 in chips) 
Seat 5: deojking (€2.43 in chips) 
Seat 6: caduceus369 (€3.36 in chips) 
Kamiros01: posts small blind €0.01
jeeslike: posts big blind €0.02
*** HOLE CARDS ***
Dealt to caduceus369 [Kc Qs]
SalahUbeen: folds 
deojking: folds 
caduceus369: calls €0.02
KilometroZer0: folds 
Kamiros01: raises €0.06 to €0.08
jeeslike: folds 
caduceus369: calls €0.06
*** FLOP *** [Js 7c Jc]
Kamiros01: bets €0.18
caduceus369: folds 
Uncalled bet (€0.18) returned to Kamiros01
Kamiros01 collected €0.18 from pot
Kamiros01: doesn't show hand 
*** SUMMARY ***
Total pot €0.18 | Rake €0 
Board [Js 7c Jc]
Seat 1: KilometroZer0 (button) folded before Flop (didn't bet)
Seat 2: Kamiros01 (small blind) collected (€0.18)
Seat 3: jeeslike (big blind) folded before Flop
Seat 4: SalahUbeen folded before Flop (didn't bet)
Seat 5: deojking folded before Flop (didn't bet)
Seat 6: caduceus369 folded on the Flop



PokerStars Zoom Hand #257984100223:  Hold'em No Limit (€0.01/€0.02) [ADM ID: M62BA304494E32ST] - 2025/10/03 18:27:45 CET [2025/10/03 12:27:45 ET]
Table 'Sirio' 6-max Seat #1 is the button
Seat 1: marina41978 (€0.82 in chips) 
Seat 2: caduceus369 (€3.28 in chips) 
Seat 3: KilometroZer0 (€3.97 in chips) 
Seat 4: pistaKKio23 (€2.88 in chips) 
Seat 5: cucuma21 (€1.11 in chips) 
Seat 6: OSPREYSTORM (€3.30 in chips) 
caduceus369: posts small blind €0.01
KilometroZer0: posts big blind €0.02
*** HOLE CARDS ***
Dealt to caduceus369 [Js 8h]
pistaKKio23: folds 
cucuma21: folds 
OSPREYSTORM: folds 
marina41978: folds 
caduceus369: folds 
Uncalled bet (€0.01) returned to KilometroZer0
KilometroZer0 collected €0.02 from pot
KilometroZer0: doesn't show hand 
*** SUMMARY ***
Total pot €0.02 | Rake €0 
Seat 1: marina41978 (button) folded before Flop (didn't bet)
Seat 2: caduceus369 (small blind) folded before Flop
Seat 3: KilometroZer0 (big blind) collected (€0.02)
Seat 4: pistaKKio23 folded before Flop (didn't bet)
Seat 5: cucuma21 folded before Flop (didn't bet)
Seat 6: OSPREYSTORM folded before Flop (didn't bet)



PokerStars Zoom Hand #257984102391:  Hold'em No Limit (€0.01/€0.02) [ADM ID: M62BA304494E32ST] - 2025/10/03 18:27:56 CET [2025/10/03 12:27:56 ET]
Table 'Sirio' 6-max Seat #1 is the button
Seat 1: SalahUbeen (€2.42 in chips) 
Seat 2: franck19621962 (€0.32 in chips) 
Seat 3: deojking (€3 in chips) 
Seat 4: OSPREYSTORM (€3.29 in chips) 
Seat 5: marina41978 (€0.82 in chips) 
Seat 6: caduceus369 (€3.27 in chips) 
franck19621962: posts small blind €0.01
deojking: posts big blind €0.02
*** HOLE CARDS ***
Dealt to caduceus369 [7s 6d]
OSPREYSTORM: folds 
marina41978: folds 
caduceus369: folds 
SalahUbeen: folds 
franck19621962: calls €0.01
deojking: checks 
*** FLOP *** [Qh 4c 3c]
franck19621962: checks 
deojking: checks 
*** TURN *** [Qh 4c 3c] [8s]
franck19621962: checks 
deojking: checks 
*** RIVER *** [Qh 4c 3c 8s] [4s]
franck19621962: checks 
deojking: bets €0.03
franck19621962: folds 
Uncalled bet (€0.03) returned to deojking
deojking collected €0.04 from pot
deojking: doesn't show hand 
*** SUMMARY ***
Total pot €0.04 | Rake €0 
Board [Qh 4c 3c 8s 4s]
Seat 1: SalahUbeen (button) folded before Flop (didn't bet)
Seat 2: franck19621962 (small blind) folded on the River
Seat 3: deojking (big blind) collected (€0.04)
Seat 4: OSPREYSTORM folded before Flop (didn't bet)
Seat 5: marina41978 folded before Flop (didn't bet)
Seat 6: caduceus369 folded before Flop (didn't bet)



PokerStars Zoom Hand #257984103376:  Hold'em No Limit (€0.01/€0.02) [ADM ID: M62BA304494E32ST] - 2025/10/03 18:28:02 CET [2025/10/03 12:28:02 ET]
Table 'Sirio' 6-max Seat #1 is the button
Seat 1: OSPREYSTORM (€2.86 in chips) 
Seat 2: bif84fibra (€2.04 in chips) 
Seat 3: caduceus369 (€3.27 in chips) 
Seat 4: OMGWOLFX (€5.14 in chips) 
Seat 5: capovujadin (€1.33 in chips) 
Seat 6: Pupu300 (€2 in chips) 
bif84fibra: posts small blind €0.01
caduceus369: posts big blind €0.02
*** HOLE CARDS ***
Dealt to caduceus369 [8c Ks]
OMGWOLFX: folds 
capovujadin: raises €0.02 to €0.04
Pupu300: folds 
OSPREYSTORM: folds 
bif84fibra: calls €0.03
caduceus369: calls €0.02
*** FLOP *** [Ah 6s 5h]
bif84fibra: checks 
caduceus369: checks 
capovujadin: bets €0.04
bif84fibra: folds 
caduceus369: folds 
Uncalled bet (€0.04) returned to capovujadin
capovujadin collected €0.12 from pot
capovujadin: doesn't show hand 
*** SUMMARY ***
Total pot €0.12 | Rake €0 
Board [Ah 6s 5h]
Seat 1: OSPREYSTORM (button) folded before Flop (didn't bet)
Seat 2: bif84fibra (small blind) folded on the Flop
Seat 3: caduceus369 (big blind) folded on the Flop
Seat 4: OMGWOLFX folded before Flop (didn't bet)
Seat 5: capovujadin collected (€0.12)
Seat 6: Pupu300 folded before Flop (didn't bet)



PokerStars Zoom Hand #257984101109:  Hold'em No Limit (€0.01/€0.02) [ADM ID: M62BA304494E32ST] - 2025/10/03 18:27:50 CET [2025/10/03 12:27:50 ET]
Table 'Sirio' 6-max Seat #1 is the button
Seat 1: GanchanS7 (€2.23 in chips) 
Seat 2: Genny040893 (€0.73 in chips) 
Seat 3: cucuma21 (€1.11 in chips) 
Seat 4: caduceus369 (€3.27 in chips) 
Seat 5: Emm3B1 (€2.15 in chips) 
Seat 6: SidneyPrescott (€2.57 in chips) 
Genny040893: posts small blind €0.01
cucuma21: posts big blind €0.02
*** HOLE CARDS ***
Dealt to caduceus369 [6d 5s]
caduceus369: folds 
Emm3B1: raises €0.04 to €0.06
SidneyPrescott: folds 
GanchanS7: folds 
Genny040893: folds 
cucuma21: calls €0.04
*** FLOP *** [Kc 3d 2c]
cucuma21: checks 
Emm3B1: checks 
*** TURN *** [Kc 3d 2c] [9h]
cucuma21: checks 
Emm3B1: bets €0.12
cucuma21: calls €0.12
*** RIVER *** [Kc 3d 2c 9h] [7h]
cucuma21: checks 
Emm3B1: checks 
*** SHOW DOWN ***
cucuma21: shows [Ac 7c] (a pair of Sevens)
Emm3B1: mucks hand 
cucuma21 collected €0.35 from pot
*** SUMMARY ***
Total pot €0.37 | Rake €0.02 
Board [Kc 3d 2c 9h 7h]
Seat 1: GanchanS7 (button) folded before Flop (didn't bet)
Seat 2: Genny040893 (small blind) folded before Flop
Seat 3: cucuma21 (big blind) showed [Ac 7c] and won (€0.35) with a pair of Sevens
Seat 4: caduceus369 folded before Flop (didn't bet)
Seat 5: Emm3B1 mucked [Ad Td]
Seat 6: SidneyPrescott folded before Flop (didn't bet)



PokerStars Zoom Hand #257984111073:  Hold'em No Limit (€0.01/€0.02) [ADM ID: M62BA304494E32ST] - 2025/10/03 18:28:43 CET [2025/10/03 12:28:43 ET]
Table 'Sirio' 6-max Seat #1 is the button
Seat 1: caduceus369 (€3.23 in chips) 
Seat 2: jeeslike (€7.98 in chips) 
Seat 3: bruciapelo (€2.89 in chips) 
Seat 4: KilometroZer0 (€5.83 in chips) 
Seat 5: panzapelata (€0.69 in chips) 
Seat 6: GanchanS7 (€2.25 in chips) 
jeeslike: posts small blind €0.01
bruciapelo: posts big blind €0.02
*** HOLE CARDS ***
Dealt to caduceus369 [5s Qs]
KilometroZer0: folds 
panzapelata: folds 
GanchanS7: folds 
caduceus369: raises €0.02 to €0.04
jeeslike: folds 
bruciapelo: raises €0.09 to €0.13
caduceus369: folds 
Uncalled bet (€0.09) returned to bruciapelo
bruciapelo collected €0.09 from pot
bruciapelo: doesn't show hand 
*** SUMMARY ***
Total pot €0.09 | Rake €0 
Seat 1: caduceus369 (button) folded before Flop
Seat 2: jeeslike (small blind) folded before Flop
Seat 3: bruciapelo (big blind) collected (€0.09)
Seat 4: KilometroZer0 folded before Flop (didn't bet)
Seat 5: panzapelata folded before Flop (didn't bet)
Seat 6: GanchanS7 folded before Flop (didn't bet)



PokerStars Zoom Hand #257984117885:  Hold'em No Limit (€0.01/€0.02) [ADM ID: M62BA304494E32ST] - 2025/10/03 18:29:19 CET [2025/10/03 12:29:19 ET]
Table 'Sirio' 6-max Seat #1 is the button
Seat 1: Emm3B1 (€1.61 in chips) 
Seat 2: KilometroZer0 (€9.10 in chips) 
Seat 3: OMGWOLFX (€11.85 in chips) 
Seat 4: caduceus369 (€3.19 in chips) 
Seat 5: OSPREYSTORM (€2.30 in chips) 
Seat 6: pistaKKio23 (€2.82 in chips) 
KilometroZer0: posts small blind €0.01
OMGWOLFX: posts big blind €0.02
*** HOLE CARDS ***
Dealt to caduceus369 [3s 2h]
caduceus369: folds 
OSPREYSTORM: folds 
pistaKKio23: folds 
Emm3B1: folds 
KilometroZer0: folds 
Uncalled bet (€0.01) returned to OMGWOLFX
OMGWOLFX collected €0.02 from pot
OMGWOLFX: doesn't show hand 
*** SUMMARY ***
Total pot €0.02 | Rake €0 
Seat 1: Emm3B1 (button) folded before Flop (didn't bet)
Seat 2: KilometroZer0 (small blind) folded before Flop
Seat 3: OMGWOLFX (big blind) collected (€0.02)
Seat 4: caduceus369 folded before Flop (didn't bet)
Seat 5: OSPREYSTORM folded before Flop (didn't bet)
Seat 6: pistaKKio23 folded before Flop (didn't bet)



PokerStars Zoom Hand #257984117122:  Hold'em No Limit (€0.01/€0.02) [ADM ID: M62BA304494E32ST] - 2025/10/03 18:29:15 CET [2025/10/03 12:29:15 ET]
Table 'Sirio' 6-max Seat #1 is the button
Seat 1: mariokart137 (€3.55 in chips) 
Seat 2: jolli180 (€1.21 in chips) 
Seat 3: SidneyPrescott (€3.06 in chips) 
Seat 4: SalahUbeen (€2.09 in chips) 
Seat 5: caduceus369 (€3.19 in chips) 
Seat 6: Gabrielefante (€2.84 in chips) 
jolli180: posts small blind €0.01
SidneyPrescott: posts big blind €0.02
*** HOLE CARDS ***
Dealt to caduceus369 [7h 3d]
SalahUbeen: raises €0.03 to €0.05
caduceus369: folds 
Gabrielefante: calls €0.05
mariokart137: folds 
jolli180: folds 
SidneyPrescott: calls €0.03
*** FLOP *** [9d 8c 6d]
SidneyPrescott: checks 
SalahUbeen: checks 
Gabrielefante: checks 
*** TURN *** [9d 8c 6d] [2h]
SidneyPrescott: bets €0.10
SalahUbeen: folds 
Gabrielefante: folds 
Uncalled bet (€0.10) returned to SidneyPrescott
SidneyPrescott collected €0.16 from pot
SidneyPrescott: doesn't show hand 
*** SUMMARY ***
Total pot €0.16 | Rake €0 
Board [9d 8c 6d 2h]
Seat 1: mariokart137 (button) folded before Flop (didn't bet)
Seat 2: jolli180 (small blind) folded before Flop
Seat 3: SidneyPrescott (big blind) collected (€0.16)
Seat 4: SalahUbeen folded on the Turn
Seat 5: caduceus369 folded before Flop (didn't bet)
Seat 6: Gabrielefante folded on the Turn



PokerStars Zoom Hand #257984118673:  Hold'em No Limit (€0.01/€0.02) [ADM ID: M62BA304494E32ST] - 2025/10/03 18:29:24 CET [2025/10/03 12:29:24 ET]
Table 'Sirio' 6-max Seat #1 is the button
Seat 1: bruciapelo (€2.94 in chips) 
Seat 2: deojking (€2.44 in chips) 
Seat 3: caduceus369 (€3.19 in chips) 
Seat 4: OSPREYSTORM (€2.25 in chips) 
Seat 5: GanchanS7 (€2.12 in chips) 
Seat 6: jolli180 (€1.20 in chips) 
deojking: posts small blind €0.01
caduceus369: posts big blind €0.02
*** HOLE CARDS ***
Dealt to caduceus369 [Jh 6h]
OSPREYSTORM: folds 
GanchanS7: folds 
jolli180: folds 
bruciapelo: folds 
deojking: calls €0.01
caduceus369: checks 
*** FLOP *** [Ad 3d Ks]
deojking: checks 
caduceus369: bets €0.02
deojking: calls €0.02
*** TURN *** [Ad 3d Ks] [8c]
deojking: checks 
caduceus369: bets €0.03
deojking: folds 
Uncalled bet (€0.03) returned to caduceus369
caduceus369 collected €0.08 from pot
caduceus369: doesn't show hand 
*** SUMMARY ***
Total pot €0.08 | Rake €0 
Board [Ad 3d Ks 8c]
Seat 1: bruciapelo (button) folded before Flop (didn't bet)
Seat 2: deojking (small blind) folded on the Turn
Seat 3: caduceus369 (big blind) collected (€0.08)
Seat 4: OSPREYSTORM folded before Flop (didn't bet)
Seat 5: GanchanS7 folded before Flop (didn't bet)
Seat 6: jolli180 folded before Flop (didn't bet)



PokerStars Zoom Hand #257984128652:  Hold'em No Limit (€0.01/€0.02) [ADM ID: M62BA304494E32ST] - 2025/10/03 18:30:16 CET [2025/10/03 12:30:16 ET]
Table 'Sirio' 6-max Seat #1 is the button
Seat 1: caduceus369 (€3.22 in chips) 
Seat 2: Catania838 (€1.42 in chips) 
Seat 3: panzapelata (€2.44 in chips) 
Seat 4: OMGWOLFX (€2 in chips) 
Seat 5: luchino74 (€4.35 in chips) 
Seat 6: deojking (€2.40 in chips) 
Catania838: posts small blind €0.01
panzapelata: posts big blind €0.02
*** HOLE CARDS ***
Dealt to caduceus369 [9d 8s]
OMGWOLFX: folds 
luchino74: folds 
deojking: folds 
caduceus369: folds 
Catania838: raises €0.02 to €0.04
panzapelata: folds 
Uncalled bet (€0.02) returned to Catania838
Catania838 collected €0.04 from pot
Catania838: doesn't show hand 
*** SUMMARY ***
Total pot €0.04 | Rake €0 
Seat 1: caduceus369 (button) folded before Flop (didn't bet)
Seat 2: Catania838 (small blind) collected (€0.04)
Seat 3: panzapelata (big blind) folded before Flop
Seat 4: OMGWOLFX folded before Flop (didn't bet)
Seat 5: luchino74 folded before Flop (didn't bet)
Seat 6: deojking folded before Flop (didn't bet)



PokerStars Zoom Hand #257984130087:  Hold'em No Limit (€0.01/€0.02) [ADM ID: M62BA304494E32ST] - 2025/10/03 18:30:24 CET [2025/10/03 12:30:24 ET]
Table 'Sirio' 6-max Seat #1 is the button
Seat 1: Emm3B1 (€1.96 in chips) 
Seat 2: KilometroZer0 (€9.10 in chips) 
Seat 3: deojking (€1.64 in chips) 
Seat 4: Kamiros01 (€3.44 in chips) 
Seat 5: caduceus369 (€3.22 in chips) 
Seat 6: luchino74 (€4.35 in chips) 
KilometroZer0: posts small blind €0.01
deojking: posts big blind €0.02
*** HOLE CARDS ***
Dealt to caduceus369 [9c Kd]
Kamiros01: folds 
caduceus369: folds 
luchino74: folds 
Emm3B1: folds 
KilometroZer0: folds 
Uncalled bet (€0.01) returned to deojking
deojking collected €0.02 from pot
deojking: doesn't show hand 
*** SUMMARY ***
Total pot €0.02 | Rake €0 
Seat 1: Emm3B1 (button) folded before Flop (didn't bet)
Seat 2: KilometroZer0 (small blind) folded before Flop
Seat 3: deojking (big blind) collected (€0.02)
Seat 4: Kamiros01 folded before Flop (didn't bet)
Seat 5: caduceus369 folded before Flop (didn't bet)
Seat 6: luchino74 folded before Flop (didn't bet)



PokerStars Zoom Hand #257984131483:  Hold'em No Limit (€0.01/€0.02) [ADM ID: M62BA304494E32ST] - 2025/10/03 18:30:31 CET [2025/10/03 12:30:31 ET]
Table 'Sirio' 6-max Seat #1 is the button
Seat 1: Dijess (€2.06 in chips) 
Seat 2: OMGWOLFX (€11.80 in chips) 
Seat 3: pylonstrip (€2.82 in chips) 
Seat 4: Catania838 (€1.93 in chips) 
Seat 5: SidneyPrescott (€3.05 in chips) 
Seat 6: caduceus369 (€3.22 in chips) 
OMGWOLFX: posts small blind €0.01
pylonstrip: posts big blind €0.02
*** HOLE CARDS ***
Dealt to caduceus369 [Ad 7h]
Catania838: folds 
SidneyPrescott: folds 
caduceus369: folds 
Dijess: folds 
OMGWOLFX: folds 
Uncalled bet (€0.01) returned to pylonstrip
pylonstrip collected €0.02 from pot
pylonstrip: doesn't show hand 
*** SUMMARY ***
Total pot €0.02 | Rake €0 
Seat 1: Dijess (button) folded before Flop (didn't bet)
Seat 2: OMGWOLFX (small blind) folded before Flop
Seat 3: pylonstrip (big blind) collected (€0.02)
Seat 4: Catania838 folded before Flop (didn't bet)
Seat 5: SidneyPrescott folded before Flop (didn't bet)
Seat 6: caduceus369 folded before Flop (didn't bet)



PokerStars Zoom Hand #257984127172:  Hold'em No Limit (€0.01/€0.02) [ADM ID: M62BA304494E32ST] - 2025/10/03 18:30:08 CET [2025/10/03 12:30:08 ET]
Table 'Sirio' 6-max Seat #1 is the button
Seat 1: QUATTRODAME (€0.74 in chips) 
Seat 2: caduceus369 (€3.23 in chips) 
Seat 3: OSPREYSTORM (€2.22 in chips) 
Seat 4: deojking (€2.40 in chips) 
Seat 5: pistaKKio23 (€3.25 in chips) 
Seat 6: KilometroZer0 (€9.10 in chips) 
caduceus369: posts small blind €0.01
OSPREYSTORM: posts big blind €0.02
*** HOLE CARDS ***
Dealt to caduceus369 [8c 2c]
deojking: folds 
pistaKKio23: folds 
KilometroZer0: folds 
QUATTRODAME: calls €0.02
caduceus369: folds 
OSPREYSTORM: raises €0.08 to €0.10
QUATTRODAME: calls €0.08
*** FLOP *** [Ad Tc Td]
OSPREYSTORM: checks 
QUATTRODAME: checks 
*** TURN *** [Ad Tc Td] [2h]
OSPREYSTORM: bets €0.11
QUATTRODAME: calls €0.11
*** RIVER *** [Ad Tc Td 2h] [3h]
OSPREYSTORM: bets €0.23
QUATTRODAME: raises €0.30 to €0.53 and is all-in
OSPREYSTORM: calls €0.30
*** SHOW DOWN ***
QUATTRODAME: shows [Ts Jc] (three of a kind, Tens)
OSPREYSTORM: shows [Kh Ac] (two pair, Aces and Tens)
QUATTRODAME collected €1.41 from pot
*** SUMMARY ***
Total pot €1.49 | Rake €0.08 
Board [Ad Tc Td 2h 3h]
Seat 1: QUATTRODAME (button) showed [Ts Jc] and won (€1.41) with three of a kind, Tens
Seat 2: caduceus369 (small blind) folded before Flop
Seat 3: OSPREYSTORM (big blind) showed [Kh Ac] and lost with two pair, Aces and Tens
Seat 4: deojking folded before Flop (didn't bet)
Seat 5: pistaKKio23 folded before Flop (didn't bet)
Seat 6: KilometroZer0 folded before Flop (didn't bet)



PokerStars Zoom Hand #257984132546:  Hold'em No Limit (€0.01/€0.02) [ADM ID: M62BA304494E32ST] - 2025/10/03 18:30:37 CET [2025/10/03 12:30:37 ET]
Table 'Sirio' 6-max Seat #1 is the button
Seat 1: SalahUbeen (€2.51 in chips) 
Seat 2: Paolino532 (€0.90 in chips) 
Seat 3: caduceus369 (€3.22 in chips) 
Seat 4: Kamiros01 (€3.42 in chips) 
Seat 5: pistaKKio23 (€2.59 in chips) 
Seat 6: deojking (€1.65 in chips) 
Paolino532: posts small blind €0.01
caduceus369: posts big blind €0.02
*** HOLE CARDS ***
Dealt to caduceus369 [9c 4c]
Kamiros01: folds 
pistaKKio23: folds 
deojking: folds 
SalahUbeen: folds 
Paolino532: calls €0.01
caduceus369: checks 
*** FLOP *** [8s Qh Qd]
Paolino532: checks 
caduceus369: checks 
*** TURN *** [8s Qh Qd] [5h]
Paolino532: checks 
caduceus369: bets €0.02
Paolino532: raises €0.02 to €0.04
caduceus369: calls €0.02
*** RIVER *** [8s Qh Qd 5h] [6d]
Paolino532: checks 
caduceus369: bets €0.04
Paolino532: raises €0.20 to €0.24
caduceus369: folds 
Uncalled bet (€0.20) returned to Paolino532
Paolino532 collected €0.19 from pot
Paolino532: doesn't show hand 
*** SUMMARY ***
Total pot €0.20 | Rake €0.01 
Board [8s Qh Qd 5h 6d]
Seat 1: SalahUbeen (button) folded before Flop (didn't bet)
Seat 2: Paolino532 (small blind) collected (€0.19)
Seat 3: caduceus369 (big blind) folded on the River
Seat 4: Kamiros01 folded before Flop (didn't bet)
Seat 5: pistaKKio23 folded before Flop (didn't bet)
Seat 6: deojking folded before Flop (didn't bet)



PokerStars Zoom Hand #257984146043:  Hold'em No Limit (€0.01/€0.02) [ADM ID: M62BA304494E32ST] - 2025/10/03 18:31:49 CET [2025/10/03 12:31:49 ET]
Table 'Sirio' 6-max Seat #1 is the button
Seat 1: Kamiros01 (€3.27 in chips) 
Seat 2: caduceus369 (€3.12 in chips) 
Seat 3: jolli180 (€2.23 in chips) 
Seat 4: pistaKKio23 (€2.58 in chips) 
Seat 5: CiroFireFist (€0.46 in chips) 
Seat 6: panzapelata (€0.49 in chips) 
caduceus369: posts small blind €0.01
jolli180: posts big blind €0.02
*** HOLE CARDS ***
Dealt to caduceus369 [Qs 7h]
pistaKKio23: folds 
CiroFireFist: folds 
panzapelata: folds 
Kamiros01: folds 
caduceus369: folds 
Uncalled bet (€0.01) returned to jolli180
jolli180 collected €0.02 from pot
jolli180: doesn't show hand 
*** SUMMARY ***
Total pot €0.02 | Rake €0 
Seat 1: Kamiros01 (button) folded before Flop (didn't bet)
Seat 2: caduceus369 (small blind) folded before Flop
Seat 3: jolli180 (big blind) collected (€0.02)
Seat 4: pistaKKio23 folded before Flop (didn't bet)
Seat 5: CiroFireFist folded before Flop (didn't bet)
Seat 6: panzapelata folded before Flop (didn't bet)



PokerStars Zoom Hand #257984148742:  Hold'em No Limit (€0.01/€0.02) [ADM ID: M62BA304494E32ST] - 2025/10/03 18:32:03 CET [2025/10/03 12:32:03 ET]
Table 'Sirio' 6-max Seat #1 is the button
Seat 1: caduceus369 (€3.11 in chips) 
Seat 2: GanchanS7 (€2.11 in chips) 
Seat 3: OSPREYSTORM (€2.30 in chips) 
Seat 4: deojking (€2.43 in chips) 
Seat 5: Dijess (€2.05 in chips) 
Seat 6: Emm3B1 (€1.98 in chips) 
GanchanS7: posts small blind €0.01
OSPREYSTORM: posts big blind €0.02
*** HOLE CARDS ***
Dealt to caduceus369 [Tc 5s]
deojking: folds 
Dijess: folds 
Emm3B1: folds 
caduceus369: folds 
GanchanS7: folds 
Uncalled bet (€0.01) returned to OSPREYSTORM
OSPREYSTORM collected €0.02 from pot
OSPREYSTORM: doesn't show hand 
*** SUMMARY ***
Total pot €0.02 | Rake €0 
Seat 1: caduceus369 (button) folded before Flop (didn't bet)
Seat 2: GanchanS7 (small blind) folded before Flop
Seat 3: OSPREYSTORM (big blind) collected (€0.02)
Seat 4: deojking folded before Flop (didn't bet)
Seat 5: Dijess folded before Flop (didn't bet)
Seat 6: Emm3B1 folded before Flop (didn't bet)



PokerStars Zoom Hand #257984149668:  Hold'em No Limit (€0.01/€0.02) [ADM ID: M62BA304494E32ST] - 2025/10/03 18:32:08 CET [2025/10/03 12:32:08 ET]
Table 'Sirio' 6-max Seat #1 is the button
Seat 1: Emm3B1 (€1.98 in chips) 
Seat 2: Dijess (€2.05 in chips) 
Seat 3: deojking (€2.43 in chips) 
Seat 4: panzapelata (€0.49 in chips) 
Seat 5: Gabrielefante (€2.77 in chips) 
Seat 6: caduceus369 (€3.11 in chips) 
Dijess: posts small blind €0.01
deojking: posts big blind €0.02
*** HOLE CARDS ***
Dealt to caduceus369 [2s 8c]
panzapelata: folds 
Gabrielefante: folds 
caduceus369: folds 
Emm3B1: folds 
Dijess: folds 
Uncalled bet (€0.01) returned to deojking
deojking collected €0.02 from pot
deojking: doesn't show hand 
*** SUMMARY ***
Total pot €0.02 | Rake €0 
Seat 1: Emm3B1 (button) folded before Flop (didn't bet)
Seat 2: Dijess (small blind) folded before Flop
Seat 3: deojking (big blind) collected (€0.02)
Seat 4: panzapelata folded before Flop (didn't bet)
Seat 5: Gabrielefante folded before Flop (didn't bet)
Seat 6: caduceus369 folded before Flop (didn't bet)



PokerStars Zoom Hand #257984151447:  Hold'em No Limit (€0.01/€0.02) [ADM ID: M62BA304494E32ST] - 2025/10/03 18:32:18 CET [2025/10/03 12:32:18 ET]
Table 'Sirio' 6-max Seat #1 is the button
Seat 1: OSPREYSTORM (€2.31 in chips) 
Seat 2: caduceus369 (€3.11 in chips) 
Seat 3: panzapelata (€0.49 in chips) 
Seat 4: pistaKKio23 (€2.51 in chips) 
Seat 5: OMGWOLFX (€5.81 in chips) 
Seat 6: luchino74 (€4.34 in chips) 
caduceus369: posts small blind €0.01
panzapelata: posts big blind €0.02
*** HOLE CARDS ***
Dealt to caduceus369 [3c Kd]
pistaKKio23: raises €0.04 to €0.06
OMGWOLFX: folds 
luchino74: folds 
OSPREYSTORM: folds 
caduceus369: folds 
panzapelata: folds 
Uncalled bet (€0.04) returned to pistaKKio23
pistaKKio23 collected €0.05 from pot
pistaKKio23: doesn't show hand 
*** SUMMARY ***
Total pot €0.05 | Rake €0 
Seat 1: OSPREYSTORM (button) folded before Flop (didn't bet)
Seat 2: caduceus369 (small blind) folded before Flop
Seat 3: panzapelata (big blind) folded before Flop
Seat 4: pistaKKio23 collected (€0.05)
Seat 5: OMGWOLFX folded before Flop (didn't bet)
Seat 6: luchino74 folded before Flop (didn't bet)



PokerStars Zoom Hand #257984147279:  Hold'em No Limit (€0.01/€0.02) [ADM ID: M62BA304494E32ST] - 2025/10/03 18:31:56 CET [2025/10/03 12:31:56 ET]
Table 'Sirio' 6-max Seat #1 is the button
Seat 1: panzapelata (€0.49 in chips) 
Seat 2: mariokart137 (€3.54 in chips) 
Seat 3: KilometroZer0 (€1.77 in chips) 
Seat 4: Emm3B1 (€1.98 in chips) 
Seat 5: caduceus369 (€3.11 in chips) 
Seat 6: GanchanS7 (€4.43 in chips) 
mariokart137: posts small blind €0.01
KilometroZer0: posts big blind €0.02
*** HOLE CARDS ***
Dealt to caduceus369 [Jd 4h]
Emm3B1: folds 
caduceus369: folds 
GanchanS7: folds 
panzapelata: folds 
mariokart137: calls €0.01
KilometroZer0: checks 
*** FLOP *** [6s Qs 6h]
mariokart137: checks 
KilometroZer0: checks 
*** TURN *** [6s Qs 6h] [7d]
mariokart137: checks 
KilometroZer0: bets €0.04
mariokart137: folds 
Uncalled bet (€0.04) returned to KilometroZer0
KilometroZer0 collected €0.04 from pot
KilometroZer0: doesn't show hand 
*** SUMMARY ***
Total pot €0.04 | Rake €0 
Board [6s Qs 6h 7d]
Seat 1: panzapelata (button) folded before Flop (didn't bet)
Seat 2: mariokart137 (small blind) folded on the Turn
Seat 3: KilometroZer0 (big blind) collected (€0.04)
Seat 4: Emm3B1 folded before Flop (didn't bet)
Seat 5: caduceus369 folded before Flop (didn't bet)
Seat 6: GanchanS7 folded before Flop (didn't bet)



PokerStars Zoom Hand #257984152741:  Hold'em No Limit (€0.01/€0.02) [ADM ID: M62BA304494E32ST] - 2025/10/03 18:32:25 CET [2025/10/03 12:32:25 ET]
Table 'Sirio' 6-max Seat #1 is the button
Seat 1: caduceus369 (€3.10 in chips) 
Seat 2: panzapelata (€0.47 in chips) 
Seat 3: SalahUbeen (€2.58 in chips) 
Seat 4: KilometroZer0 (€3.71 in chips) 
Seat 5: monsterc99 (€0.55 in chips) 
Seat 6: yanez61 (€3.02 in chips) 
panzapelata: posts small blind €0.01
SalahUbeen: posts big blind €0.02
*** HOLE CARDS ***
Dealt to caduceus369 [5d 6s]
KilometroZer0: folds 
monsterc99: folds 
yanez61: folds 
caduceus369: folds 
panzapelata: raises €0.02 to €0.04
SalahUbeen: calls €0.02
*** FLOP *** [4s Js 7d]
panzapelata: bets €0.10
SalahUbeen: folds 
Uncalled bet (€0.10) returned to panzapelata
panzapelata collected €0.08 from pot
panzapelata: doesn't show hand 
*** SUMMARY ***
Total pot €0.08 | Rake €0 
Board [4s Js 7d]
Seat 1: caduceus369 (button) folded before Flop (didn't bet)
Seat 2: panzapelata (small blind) collected (€0.08)
Seat 3: SalahUbeen (big blind) folded on the Flop
Seat 4: KilometroZer0 folded before Flop (didn't bet)
Seat 5: monsterc99 folded before Flop (didn't bet)
Seat 6: yanez61 folded before Flop (didn't bet)



PokerStars Zoom Hand #257984150646:  Hold'em No Limit (€0.01/€0.02) [ADM ID: M62BA304494E32ST] - 2025/10/03 18:32:14 CET [2025/10/03 12:32:14 ET]
Table 'Sirio' 6-max Seat #1 is the button
Seat 1: Gabrielefante (€2.77 in chips) 
Seat 2: S'dj83 (€4.91 in chips) 
Seat 3: Genny040893 (€0.81 in chips) 
Seat 4: caduceus369 (€3.11 in chips) 
Seat 5: trisco66 (€1.74 in chips) 
Seat 6: panzapelata (€0.49 in chips) 
S'dj83: posts small blind €0.01
Genny040893: posts big blind €0.02
*** HOLE CARDS ***
Dealt to caduceus369 [Jc 6c]
caduceus369: folds 
trisco66: raises €0.04 to €0.06
panzapelata: folds 
Gabrielefante: folds 
S'dj83: calls €0.05
Genny040893: folds 
*** FLOP *** [7c 2s 4h]
S'dj83: checks 
trisco66: checks 
*** TURN *** [7c 2s 4h] [4d]
S'dj83: checks 
trisco66: checks 
*** RIVER *** [7c 2s 4h 4d] [Js]
S'dj83: checks 
trisco66: checks 
*** SHOW DOWN ***
S'dj83: shows [3h 3d] (two pair, Fours and Threes)
trisco66: mucks hand 
S'dj83 collected €0.14 from pot
*** SUMMARY ***
Total pot €0.14 | Rake €0 
Board [7c 2s 4h 4d Js]
Seat 1: Gabrielefante (button) folded before Flop (didn't bet)
Seat 2: S'dj83 (small blind) showed [3h 3d] and won (€0.14) with two pair, Fours and Threes
Seat 3: Genny040893 (big blind) folded before Flop
Seat 4: caduceus369 folded before Flop (didn't bet)
Seat 5: trisco66 mucked [Tc Qh]
Seat 6: panzapelata folded before Flop (didn't bet)



PokerStars Zoom Hand #257984156491:  Hold'em No Limit (€0.01/€0.02) [ADM ID: M62BA304494E32ST] - 2025/10/03 18:32:45 CET [2025/10/03 12:32:45 ET]
Table 'Sirio' 6-max Seat #1 is the button
Seat 1: Grifo546 (€1.99 in chips) 
Seat 2: SalahUbeen (€2.30 in chips) 
Seat 3: jeeslike (€8.19 in chips) 
Seat 4: Emm3B1 (€1.84 in chips) 
Seat 5: Dijess (€2.02 in chips) 
Seat 6: caduceus369 (€3.08 in chips) 
SalahUbeen: posts small blind €0.01
jeeslike: posts big blind €0.02
*** HOLE CARDS ***
Dealt to caduceus369 [9d 4c]
Emm3B1: folds 
Dijess: folds 
caduceus369: folds 
Grifo546: folds 
SalahUbeen: folds 
Uncalled bet (€0.01) returned to jeeslike
jeeslike collected €0.02 from pot
jeeslike: doesn't show hand 
*** SUMMARY ***
Total pot €0.02 | Rake €0 
Seat 1: Grifo546 (button) folded before Flop (didn't bet)
Seat 2: SalahUbeen (small blind) folded before Flop
Seat 3: jeeslike (big blind) collected (€0.02)
Seat 4: Emm3B1 folded before Flop (didn't bet)
Seat 5: Dijess folded before Flop (didn't bet)
Seat 6: caduceus369 folded before Flop (didn't bet)



PokerStars Zoom Hand #257984153484:  Hold'em No Limit (€0.01/€0.02) [ADM ID: M62BA304494E32ST] - 2025/10/03 18:32:29 CET [2025/10/03 12:32:29 ET]
Table 'Sirio' 6-max Seat #1 is the button
Seat 1: GanchanS7 (€2.17 in chips) 
Seat 2: pistaKKio23 (€2.54 in chips) 
Seat 3: BetNoLook (€3.39 in chips) 
Seat 4: caduceus369 (€3.10 in chips) 
Seat 5: yanez61 (€3.02 in chips) 
Seat 6: monsterc99 (€0.55 in chips) 
pistaKKio23: posts small blind €0.01
BetNoLook: posts big blind €0.02
*** HOLE CARDS ***
Dealt to caduceus369 [Jd 8d]
caduceus369: folds 
yanez61: folds 
monsterc99: raises €0.02 to €0.04
GanchanS7: raises €0.11 to €0.15
pistaKKio23: folds 
BetNoLook: calls €0.13
monsterc99: folds 
*** FLOP *** [Ad 9c 5d]
BetNoLook: checks 
GanchanS7: bets €0.23
BetNoLook: calls €0.23
*** TURN *** [Ad 9c 5d] [5h]
BetNoLook: checks 
GanchanS7: bets €0.36
BetNoLook: folds 
Uncalled bet (€0.36) returned to GanchanS7
GanchanS7 collected €0.77 from pot
GanchanS7: doesn't show hand 
*** SUMMARY ***
Total pot €0.81 | Rake €0.04 
Board [Ad 9c 5d 5h]
Seat 1: GanchanS7 (button) collected (€0.77)
Seat 2: pistaKKio23 (small blind) folded before Flop
Seat 3: BetNoLook (big blind) folded on the Turn
Seat 4: caduceus369 folded before Flop (didn't bet)
Seat 5: yanez61 folded before Flop (didn't bet)
Seat 6: monsterc99 folded before Flop



PokerStars Zoom Hand #257984158767:  Hold'em No Limit (€0.01/€0.02) [ADM ID: M62BA304494E32ST] - 2025/10/03 18:32:57 CET [2025/10/03 12:32:57 ET]
Table 'Sirio' 6-max Seat #1 is the button
Seat 1: GanchanS7 (€2 in chips) 
Seat 2: KilometroZer0 (€9.12 in chips) 
Seat 3: caduceus369 (€3.08 in chips) 
Seat 4: shakthi (€0.85 in chips) 
Seat 5: heitel (€1.55 in chips) 
Seat 6: SalahUbeen (€2.42 in chips) 
KilometroZer0: posts small blind €0.01
caduceus369: posts big blind €0.02
*** HOLE CARDS ***
Dealt to caduceus369 [2d Jc]
shakthi: folds 
heitel: folds 
SalahUbeen: folds 
GanchanS7: folds 
KilometroZer0: folds 
Uncalled bet (€0.01) returned to caduceus369
caduceus369 collected €0.02 from pot
caduceus369: doesn't show hand 
*** SUMMARY ***
Total pot €0.02 | Rake €0 
Seat 1: GanchanS7 (button) folded before Flop (didn't bet)
Seat 2: KilometroZer0 (small blind) folded before Flop
Seat 3: caduceus369 (big blind) collected (€0.02)
Seat 4: shakthi folded before Flop (didn't bet)
Seat 5: heitel folded before Flop (didn't bet)
Seat 6: SalahUbeen folded before Flop (didn't bet)



PokerStars Zoom Hand #257984154592:  Hold'em No Limit (€0.01/€0.02) [ADM ID: M62BA304494E32ST] - 2025/10/03 18:32:35 CET [2025/10/03 12:32:35 ET]
Table 'Sirio' 6-max Seat #1 is the button
Seat 1: Dijess (€2.02 in chips) 
Seat 2: KilometroZer0 (€6.26 in chips) 
Seat 3: caduceus369 (€3.10 in chips) 
Seat 4: Emm3B1 (€1.98 in chips) 
Seat 5: Gabrielefante (€2.74 in chips) 
Seat 6: Spillo.RN (€2 in chips) 
KilometroZer0: posts small blind €0.01
caduceus369: posts big blind €0.02
*** HOLE CARDS ***
Dealt to caduceus369 [7c 2d]
Emm3B1: raises €0.04 to €0.06
Gabrielefante: folds 
Spillo.RN: calls €0.06
Dijess: folds 
KilometroZer0: folds 
caduceus369: folds 
*** FLOP *** [4c Ts 4d]
Emm3B1: bets €0.06
Spillo.RN: calls €0.06
*** TURN *** [4c Ts 4d] [3d]
Emm3B1: bets €0.16
Spillo.RN: calls €0.16
*** RIVER *** [4c Ts 4d 3d] [6c]
Emm3B1: bets €0.44
Spillo.RN: calls €0.44
*** SHOW DOWN ***
Emm3B1: shows [Kh Ks] (two pair, Kings and Fours)
Spillo.RN: mucks hand 
Emm3B1 collected €1.39 from pot
*** SUMMARY ***
Total pot €1.47 | Rake €0.08 
Board [4c Ts 4d 3d 6c]
Seat 1: Dijess (button) folded before Flop (didn't bet)
Seat 2: KilometroZer0 (small blind) folded before Flop
Seat 3: caduceus369 (big blind) folded before Flop
Seat 4: Emm3B1 showed [Kh Ks] and won (€1.39) with two pair, Kings and Fours
Seat 5: Gabrielefante folded before Flop (didn't bet)
Seat 6: Spillo.RN mucked [8s 8c]



PokerStars Zoom Hand #257984160886:  Hold'em No Limit (€0.01/€0.02) [ADM ID: M62BA304494E32ST] - 2025/10/03 18:33:08 CET [2025/10/03 12:33:08 ET]
Table 'Sirio' 6-max Seat #1 is the button
Seat 1: Dijess (€2.02 in chips) 
Seat 2: caduceus369 (€3.09 in chips) 
Seat 3: panzapelata (€1.44 in chips) 
Seat 4: SidneyPrescott (€3.32 in chips) 
Seat 5: Kamiros01 (€3.75 in chips) 
Seat 6: QUATTRODAME (€1.47 in chips) 
caduceus369: posts small blind €0.01
panzapelata: posts big blind €0.02
*** HOLE CARDS ***
Dealt to caduceus369 [2h 4s]
SidneyPrescott: raises €0.04 to €0.06
Kamiros01: folds 
QUATTRODAME: folds 
Dijess: folds 
caduceus369: folds 
panzapelata: folds 
Uncalled bet (€0.04) returned to SidneyPrescott
SidneyPrescott collected €0.05 from pot
SidneyPrescott: doesn't show hand 
*** SUMMARY ***
Total pot €0.05 | Rake €0 
Seat 1: Dijess (button) folded before Flop (didn't bet)
Seat 2: caduceus369 (small blind) folded before Flop
Seat 3: panzapelata (big blind) folded before Flop
Seat 4: SidneyPrescott collected (€0.05)
Seat 5: Kamiros01 folded before Flop (didn't bet)
Seat 6: QUATTRODAME folded before Flop (didn't bet)



PokerStars Zoom Hand #257984157190:  Hold'em No Limit (€0.01/€0.02) [ADM ID: M62BA304494E32ST] - 2025/10/03 18:32:49 CET [2025/10/03 12:32:49 ET]
Table 'Sirio' 6-max Seat #1 is the button
Seat 1: ZefirDevil (€1.17 in chips) 
Seat 2: OSPREYSTORM (€1.90 in chips) 
Seat 3: OMGWOLFX (€2 in chips) 
Seat 4: SidneyPrescott (€2.60 in chips) 
Seat 5: caduceus369 (€3.08 in chips) 
Seat 6: Grifo546 (€1.99 in chips) 
OSPREYSTORM: posts small blind €0.01
OMGWOLFX: posts big blind €0.02
*** HOLE CARDS ***
Dealt to caduceus369 [7d Kh]
SidneyPrescott: raises €0.04 to €0.06
caduceus369: folds 
Grifo546: folds 
ZefirDevil: calls €0.06
OSPREYSTORM: folds 
OMGWOLFX: folds 
*** FLOP *** [9s Jh 8s]
SidneyPrescott: checks 
ZefirDevil: bets €0.04
SidneyPrescott: calls €0.04
*** TURN *** [9s Jh 8s] [Jd]
SidneyPrescott: checks 
ZefirDevil: checks 
*** RIVER *** [9s Jh 8s Jd] [Ah]
SidneyPrescott: checks 
ZefirDevil: bets €0.07
SidneyPrescott: calls €0.07
*** SHOW DOWN ***
ZefirDevil: shows [7h 6s] (a pair of Jacks)
SidneyPrescott: shows [6h As] (two pair, Aces and Jacks)
SidneyPrescott collected €0.35 from pot
*** SUMMARY ***
Total pot €0.37 | Rake €0.02 
Board [9s Jh 8s Jd Ah]
Seat 1: ZefirDevil (button) showed [7h 6s] and lost with a pair of Jacks
Seat 2: OSPREYSTORM (small blind) folded before Flop
Seat 3: OMGWOLFX (big blind) folded before Flop
Seat 4: SidneyPrescott showed [6h As] and won (€0.35) with two pair, Aces and Jacks
Seat 5: caduceus369 folded before Flop (didn't bet)
Seat 6: Grifo546 folded before Flop (didn't bet)



PokerStars Zoom Hand #257984155883:  Hold'em No Limit (€0.01/€0.02) [ADM ID: M62BA304494E32ST] - 2025/10/03 18:32:42 CET [2025/10/03 12:32:42 ET]
Table 'Sirio' 6-max Seat #1 is the button
Seat 1: marina41978 (€0.81 in chips) 
Seat 2: kolain17 (€0.78 in chips) 
Seat 3: mariokart137 (€3.52 in chips) 
Seat 4: caduceus369 (€3.08 in chips) 
Seat 5: pylonstrip (€2.84 in chips) 
Seat 6: KilometroZer0 (€1.79 in chips) 
kolain17: posts small blind €0.01
mariokart137: posts big blind €0.02
*** HOLE CARDS ***
Dealt to caduceus369 [5c Qd]
caduceus369: folds 
pylonstrip: folds 
KilometroZer0: folds 
marina41978: calls €0.02
kolain17: calls €0.01
mariokart137: checks 
*** FLOP *** [3s 9c 6c]
kolain17: checks 
mariokart137: checks 
marina41978: checks 
*** TURN *** [3s 9c 6c] [Qs]
kolain17: checks 
mariokart137: checks 
marina41978: checks 
*** RIVER *** [3s 9c 6c Qs] [As]
kolain17: checks 
mariokart137: checks 
marina41978: checks 
*** SHOW DOWN ***
kolain17: shows [Jd 5h] (high card Ace)
mariokart137: shows [4d Jc] (high card Ace)
marina41978: shows [8s Jh] (high card Ace - Queen+Jack+Nine+Eight kicker)
marina41978 collected €0.06 from pot
*** SUMMARY ***
Total pot €0.06 | Rake €0 
Board [3s 9c 6c Qs As]
Seat 1: marina41978 (button) showed [8s Jh] and won (€0.06) with high card Ace
Seat 2: kolain17 (small blind) showed [Jd 5h] and lost with high card Ace
Seat 3: mariokart137 (big blind) showed [4d Jc] and lost with high card Ace
Seat 4: caduceus369 folded before Flop (didn't bet)
Seat 5: pylonstrip folded before Flop (didn't bet)
Seat 6: KilometroZer0 folded before Flop (didn't bet)



PokerStars Zoom Hand #257984164118:  Hold'em No Limit (€0.01/€0.02) [ADM ID: M62BA304494E32ST] - 2025/10/03 18:33:25 CET [2025/10/03 12:33:25 ET]
Table 'Sirio' 6-max Seat #1 is the button
Seat 1: shakthi (€0.82 in chips) 
Seat 2: QUATTRODAME (€1.45 in chips) 
Seat 3: KilometroZer0 (€1.63 in chips) 
Seat 4: OSPREYSTORM (€1.94 in chips) 
Seat 5: caduceus369 (€3.08 in chips) 
Seat 6: cucuma21 (€0.97 in chips) 
QUATTRODAME: posts small blind €0.01
KilometroZer0: posts big blind €0.02
*** HOLE CARDS ***
Dealt to caduceus369 [8d 6h]
OSPREYSTORM: folds 
caduceus369: folds 
cucuma21: folds 
shakthi: folds 
QUATTRODAME: folds 
Uncalled bet (€0.01) returned to KilometroZer0
KilometroZer0 collected €0.02 from pot
KilometroZer0: doesn't show hand 
*** SUMMARY ***
Total pot €0.02 | Rake €0 
Seat 1: shakthi (button) folded before Flop (didn't bet)
Seat 2: QUATTRODAME (small blind) folded before Flop
Seat 3: KilometroZer0 (big blind) collected (€0.02)
Seat 4: OSPREYSTORM folded before Flop (didn't bet)
Seat 5: caduceus369 folded before Flop (didn't bet)
Seat 6: cucuma21 folded before Flop (didn't bet)



PokerStars Zoom Hand #257984157787:  Hold'em No Limit (€0.01/€0.02) [ADM ID: M62BA304494E32ST] - 2025/10/03 18:32:52 CET [2025/10/03 12:32:52 ET]
Table 'Sirio' 6-max Seat #1 is the button
Seat 1: S'dj83 (€4.99 in chips) 
Seat 2: Emm3B1 (€2.20 in chips) 
Seat 3: pistaKKio23 (€3.14 in chips) 
Seat 4: caduceus369 (€3.08 in chips) 
Seat 5: Grifo546 (€1.99 in chips) 
Seat 6: panzapelata (€0.51 in chips) 
Emm3B1: posts small blind €0.01
pistaKKio23: posts big blind €0.02
*** HOLE CARDS ***
Dealt to caduceus369 [Jc Kh]
caduceus369: folds 
Grifo546: raises €0.04 to €0.06
panzapelata: folds 
S'dj83: calls €0.06
Emm3B1: folds 
pistaKKio23: folds 
*** FLOP *** [8h 7h Qs]
Grifo546: bets €0.08
S'dj83: raises €0.12 to €0.20
Grifo546: calls €0.12
*** TURN *** [8h 7h Qs] [9s]
Grifo546: checks 
S'dj83: checks 
*** RIVER *** [8h 7h Qs 9s] [9d]
Grifo546: checks 
S'dj83: checks 
*** SHOW DOWN ***
Grifo546: shows [8c Tc] (two pair, Nines and Eights)
S'dj83: shows [8d Qd] (two pair, Queens and Nines)
S'dj83 collected €0.52 from pot
*** SUMMARY ***
Total pot €0.55 | Rake €0.03 
Board [8h 7h Qs 9s 9d]
Seat 1: S'dj83 (button) showed [8d Qd] and won (€0.52) with two pair, Queens and Nines
Seat 2: Emm3B1 (small blind) folded before Flop
Seat 3: pistaKKio23 (big blind) folded before Flop
Seat 4: caduceus369 folded before Flop (didn't bet)
Seat 5: Grifo546 showed [8c Tc] and lost with two pair, Nines and Eights
Seat 6: panzapelata folded before Flop (didn't bet)



PokerStars Zoom Hand #257984161397:  Hold'em No Limit (€0.01/€0.02) [ADM ID: M62BA304494E32ST] - 2025/10/03 18:33:11 CET [2025/10/03 12:33:11 ET]
Table 'Sirio' 6-max Seat #1 is the button
Seat 1: caduceus369 (€3.08 in chips) 
Seat 2: KilometroZer0 (€3.67 in chips) 
Seat 3: SalahUbeen (€2.29 in chips) 
Seat 4: trisco66 (€1.56 in chips) 
Seat 5: OMGWOLFX (€2 in chips) 
Seat 6: Dijess (€2.02 in chips) 
KilometroZer0: posts small blind €0.01
SalahUbeen: posts big blind €0.02
*** HOLE CARDS ***
Dealt to caduceus369 [9h Th]
trisco66: raises €0.04 to €0.06
OMGWOLFX: raises €0.12 to €0.18
Dijess: folds 
caduceus369: folds 
KilometroZer0: folds 
SalahUbeen: folds 
trisco66: calls €0.12
*** FLOP *** [Ac 4c 2s]
trisco66: checks 
OMGWOLFX: bets €0.19
trisco66: folds 
Uncalled bet (€0.19) returned to OMGWOLFX
OMGWOLFX collected €0.37 from pot
OMGWOLFX: doesn't show hand 
*** SUMMARY ***
Total pot €0.39 | Rake €0.02 
Board [Ac 4c 2s]
Seat 1: caduceus369 (button) folded before Flop (didn't bet)
Seat 2: KilometroZer0 (small blind) folded before Flop
Seat 3: SalahUbeen (big blind) folded before Flop
Seat 4: trisco66 folded on the Flop
Seat 5: OMGWOLFX collected (€0.37)
Seat 6: Dijess folded before Flop (didn't bet)



PokerStars Zoom Hand #257984166266:  Hold'em No Limit (€0.01/€0.02) [ADM ID: M62BA304494E32ST] - 2025/10/03 18:33:36 CET [2025/10/03 12:33:36 ET]
Table 'Sirio' 6-max Seat #1 is the button
Seat 1: Dijess (€2.01 in chips) 
Seat 2: pylonstrip (€2.79 in chips) 
Seat 3: caduceus369 (€3.08 in chips) 
Seat 4: mariokart137 (€3.50 in chips) 
Seat 5: shakthi (€0.82 in chips) 
Seat 6: Spillo.RN (€1.25 in chips) 
pylonstrip: posts small blind €0.01
caduceus369: posts big blind €0.02
*** HOLE CARDS ***
Dealt to caduceus369 [4s Jh]
mariokart137: folds 
shakthi: folds 
Spillo.RN: folds 
Dijess: folds 
pylonstrip: raises €0.04 to €0.06
caduceus369: folds 
Uncalled bet (€0.04) returned to pylonstrip
pylonstrip collected €0.04 from pot
pylonstrip: doesn't show hand 
*** SUMMARY ***
Total pot €0.04 | Rake €0 
Seat 1: Dijess (button) folded before Flop (didn't bet)
Seat 2: pylonstrip (small blind) collected (€0.04)
Seat 3: caduceus369 (big blind) folded before Flop
Seat 4: mariokart137 folded before Flop (didn't bet)
Seat 5: shakthi folded before Flop (didn't bet)
Seat 6: Spillo.RN folded before Flop (didn't bet)



PokerStars Zoom Hand #257984165089:  Hold'em No Limit (€0.01/€0.02) [ADM ID: M62BA304494E32ST] - 2025/10/03 18:33:30 CET [2025/10/03 12:33:30 ET]
Table 'Sirio' 6-max Seat #1 is the button
Seat 1: Stanzio625 (€1.24 in chips) 
Seat 2: OSPREYSTORM (€1.94 in chips) 
Seat 3: KilometroZer0 (€9.14 in chips) 
Seat 4: marina41978 (€0.85 in chips) 
Seat 5: cucuma21 (€0.97 in chips) 
Seat 6: caduceus369 (€3.08 in chips) 
OSPREYSTORM: posts small blind €0.01
KilometroZer0: posts big blind €0.02
*** HOLE CARDS ***
Dealt to caduceus369 [3c Ts]
marina41978: folds 
cucuma21: folds 
caduceus369: folds 
Stanzio625: calls €0.02
OSPREYSTORM: folds 
KilometroZer0: checks 
*** FLOP *** [7d 6h Js]
KilometroZer0: checks 
Stanzio625: bets €0.04
KilometroZer0: calls €0.04
*** TURN *** [7d 6h Js] [Tc]
KilometroZer0: checks 
Stanzio625: checks 
*** RIVER *** [7d 6h Js Tc] [3h]
KilometroZer0: bets €0.07
Stanzio625: folds 
Uncalled bet (€0.07) returned to KilometroZer0
KilometroZer0 collected €0.13 from pot
KilometroZer0: doesn't show hand 
*** SUMMARY ***
Total pot €0.13 | Rake €0 
Board [7d 6h Js Tc 3h]
Seat 1: Stanzio625 (button) folded on the River
Seat 2: OSPREYSTORM (small blind) folded before Flop
Seat 3: KilometroZer0 (big blind) collected (€0.13)
Seat 4: marina41978 folded before Flop (didn't bet)
Seat 5: cucuma21 folded before Flop (didn't bet)
Seat 6: caduceus369 folded before Flop (didn't bet)



PokerStars Zoom Hand #257984168122:  Hold'em No Limit (€0.01/€0.02) [ADM ID: M62BA304494E32ST] - 2025/10/03 18:33:46 CET [2025/10/03 12:33:46 ET]
Table 'Sirio' 6-max Seat #1 is the button
Seat 1: caduceus369 (€3.06 in chips) 
Seat 2: OMGWOLFX (€5.69 in chips) 
Seat 3: OSPREYSTORM (€1.93 in chips) 
Seat 4: Emm3B1 (€2.19 in chips) 
Seat 5: KilometroZer0 (€1.63 in chips) 
Seat 6: cagliari59 (€0.36 in chips) 
OMGWOLFX: posts small blind €0.01
OSPREYSTORM: posts big blind €0.02
*** HOLE CARDS ***
Dealt to caduceus369 [Th Ah]
Emm3B1: folds 
KilometroZer0: folds 
cagliari59: folds 
caduceus369: raises €0.02 to €0.04
OMGWOLFX: calls €0.03
OSPREYSTORM: folds 
*** FLOP *** [6s 9h Jd]
OMGWOLFX: checks 
caduceus369: bets €0.03
OMGWOLFX: folds 
Uncalled bet (€0.03) returned to caduceus369
caduceus369 collected €0.10 from pot
caduceus369: doesn't show hand 
*** SUMMARY ***
Total pot €0.10 | Rake €0 
Board [6s 9h Jd]
Seat 1: caduceus369 (button) collected (€0.10)
Seat 2: OMGWOLFX (small blind) folded on the Flop
Seat 3: OSPREYSTORM (big blind) folded before Flop
Seat 4: Emm3B1 folded before Flop (didn't bet)
Seat 5: KilometroZer0 folded before Flop (didn't bet)
Seat 6: cagliari59 folded before Flop (didn't bet)



PokerStars Zoom Hand #257984174267:  Hold'em No Limit (€0.01/€0.02) [ADM ID: M62BA304494E32ST] - 2025/10/03 18:34:18 CET [2025/10/03 12:34:18 ET]
Table 'Sirio' 6-max Seat #1 is the button
Seat 1: yanez61 (€2.94 in chips) 
Seat 2: KilometroZer0 (€9.21 in chips) 
Seat 3: ZefirDevil (€0.90 in chips) 
Seat 4: panzapelata (€0.39 in chips) 
Seat 5: caduceus369 (€3.12 in chips) 
Seat 6: SidneyPrescott (€3.52 in chips) 
KilometroZer0: posts small blind €0.01
ZefirDevil: posts big blind €0.02
*** HOLE CARDS ***
Dealt to caduceus369 [Ks 8c]
panzapelata: raises €0.37 to €0.39 and is all-in
caduceus369: folds 
SidneyPrescott: folds 
yanez61: folds 
KilometroZer0: folds 
ZefirDevil: folds 
Uncalled bet (€0.37) returned to panzapelata
panzapelata collected €0.05 from pot
panzapelata: doesn't show hand 
*** SUMMARY ***
Total pot €0.05 | Rake €0 
Seat 1: yanez61 (button) folded before Flop (didn't bet)
Seat 2: KilometroZer0 (small blind) folded before Flop
Seat 3: ZefirDevil (big blind) folded before Flop
Seat 4: panzapelata collected (€0.05)
Seat 5: caduceus369 folded before Flop (didn't bet)
Seat 6: SidneyPrescott folded before Flop (didn't bet)



PokerStars Zoom Hand #257984177000:  Hold'em No Limit (€0.01/€0.02) [ADM ID: M62BA304494E32ST] - 2025/10/03 18:34:33 CET [2025/10/03 12:34:33 ET]
Table 'Sirio' 6-max Seat #1 is the button
Seat 1: cucuma21 (€0.92 in chips) 
Seat 2: SalahUbeen (€1.89 in chips) 
Seat 3: pistaKKio23 (€2.39 in chips) 
Seat 4: caduceus369 (€3.11 in chips) 
Seat 5: QUATTRODAME (€1.35 in chips) 
Seat 6: jolli180 (€2.25 in chips) 
SalahUbeen: posts small blind €0.01
pistaKKio23: posts big blind €0.02
*** HOLE CARDS ***
Dealt to caduceus369 [Qc Js]
caduceus369: folds 
QUATTRODAME: folds 
jolli180: raises €0.02 to €0.04
cucuma21: folds 
SalahUbeen: folds 
pistaKKio23: folds 
Uncalled bet (€0.02) returned to jolli180
jolli180 collected €0.05 from pot
jolli180: doesn't show hand 
*** SUMMARY ***
Total pot €0.05 | Rake €0 
Seat 1: cucuma21 (button) folded before Flop (didn't bet)
Seat 2: SalahUbeen (small blind) folded before Flop
Seat 3: pistaKKio23 (big blind) folded before Flop
Seat 4: caduceus369 folded before Flop (didn't bet)
Seat 5: QUATTRODAME folded before Flop (didn't bet)
Seat 6: jolli180 collected (€0.05)



PokerStars Zoom Hand #257984179599:  Hold'em No Limit (€0.01/€0.02) [ADM ID: M62BA304494E32ST] - 2025/10/03 18:34:46 CET [2025/10/03 12:34:46 ET]
Table 'Sirio' 6-max Seat #1 is the button
Seat 1: OSPREYSTORM (€2.30 in chips) 
Seat 2: panzapelata (€5.47 in chips) 
Seat 3: caduceus369 (€3.11 in chips) 
Seat 4: pistaKKio23 (€3.38 in chips) 
Seat 5: marina41978 (€0.80 in chips) 
Seat 6: deojking (€1.45 in chips) 
panzapelata: posts small blind €0.01
caduceus369: posts big blind €0.02
*** HOLE CARDS ***
Dealt to caduceus369 [Ks Jd]
pistaKKio23: folds 
marina41978: folds 
deojking: folds 
OSPREYSTORM: folds 
panzapelata: folds 
Uncalled bet (€0.01) returned to caduceus369
caduceus369 collected €0.02 from pot
caduceus369: doesn't show hand 
*** SUMMARY ***
Total pot €0.02 | Rake €0 
Seat 1: OSPREYSTORM (button) folded before Flop (didn't bet)
Seat 2: panzapelata (small blind) folded before Flop
Seat 3: caduceus369 (big blind) collected (€0.02)
Seat 4: pistaKKio23 folded before Flop (didn't bet)
Seat 5: marina41978 folded before Flop (didn't bet)
Seat 6: deojking folded before Flop (didn't bet)



PokerStars Zoom Hand #257984177670:  Hold'em No Limit (€0.01/€0.02) [ADM ID: M62BA304494E32ST] - 2025/10/03 18:34:36 CET [2025/10/03 12:34:36 ET]
Table 'Sirio' 6-max Seat #1 is the button
Seat 1: deojking (€2.08 in chips) 
Seat 2: Emm3B1 (€2.17 in chips) 
Seat 3: OMGWOLFX (€2.21 in chips) 
Seat 4: jeeslike (€6.95 in chips) 
Seat 5: Gabrielefante (€2.66 in chips) 
Seat 6: caduceus369 (€3.11 in chips) 
Emm3B1: posts small blind €0.01
OMGWOLFX: posts big blind €0.02
*** HOLE CARDS ***
Dealt to caduceus369 [Ah 3c]
jeeslike: folds 
Gabrielefante: raises €0.04 to €0.06
caduceus369: folds 
deojking: calls €0.06
Emm3B1: folds 
OMGWOLFX: calls €0.04
*** FLOP *** [Kd Jc 6s]
OMGWOLFX: checks 
Gabrielefante: bets €0.08
deojking: folds 
OMGWOLFX: folds 
Uncalled bet (€0.08) returned to Gabrielefante
Gabrielefante collected €0.18 from pot
Gabrielefante: doesn't show hand 
*** SUMMARY ***
Total pot €0.19 | Rake €0.01 
Board [Kd Jc 6s]
Seat 1: deojking (button) folded on the Flop
Seat 2: Emm3B1 (small blind) folded before Flop
Seat 3: OMGWOLFX (big blind) folded on the Flop
Seat 4: jeeslike folded before Flop (didn't bet)
Seat 5: Gabrielefante collected (€0.18)
Seat 6: caduceus369 folded before Flop (didn't bet)



PokerStars Zoom Hand #257984178642:  Hold'em No Limit (€0.01/€0.02) [ADM ID: M62BA304494E32ST] - 2025/10/03 18:34:41 CET [2025/10/03 12:34:41 ET]
Table 'Sirio' 6-max Seat #1 is the button
Seat 1: Goal779 (€0.58 in chips) 
Seat 2: cucuma21 (€0.92 in chips) 
Seat 3: SidneyPrescott (€2.35 in chips) 
Seat 4: caduceus369 (€3.11 in chips) 
Seat 5: marina41978 (€0.80 in chips) 
Seat 6: trisco66 (€1.35 in chips) 
cucuma21: posts small blind €0.01
SidneyPrescott: posts big blind €0.02
*** HOLE CARDS ***
Dealt to caduceus369 [Kh 5h]
caduceus369: folds 
marina41978: folds 
trisco66: raises €0.10 to €0.12
Goal779: raises €0.12 to €0.24
cucuma21: folds 
SidneyPrescott: folds 
trisco66: calls €0.12
*** FLOP *** [3d 3c 6h]
trisco66: checks 
Goal779: bets €0.10
trisco66: calls €0.10
*** TURN *** [3d 3c 6h] [6d]
trisco66: checks 
Goal779: bets €0.24 and is all-in
trisco66: folds 
Uncalled bet (€0.24) returned to Goal779
Goal779 collected €0.68 from pot
Goal779: doesn't show hand 
*** SUMMARY ***
Total pot €0.71 | Rake €0.03 
Board [3d 3c 6h 6d]
Seat 1: Goal779 (button) collected (€0.68)
Seat 2: cucuma21 (small blind) folded before Flop
Seat 3: SidneyPrescott (big blind) folded before Flop
Seat 4: caduceus369 folded before Flop (didn't bet)
Seat 5: marina41978 folded before Flop (didn't bet)
Seat 6: trisco66 folded on the Turn



PokerStars Zoom Hand #257984175334:  Hold'em No Limit (€0.01/€0.02) [ADM ID: M62BA304494E32ST] - 2025/10/03 18:34:24 CET [2025/10/03 12:34:24 ET]
Table 'Sirio' 6-max Seat #1 is the button
Seat 1: Emm3B1 (€1.95 in chips) 
Seat 2: caduceus369 (€3.12 in chips) 
Seat 3: yanez61 (€2.94 in chips) 
Seat 4: pistaKKio23 (€2.39 in chips) 
Seat 5: OSPREYSTORM (€2.36 in chips) 
Seat 6: BetNoLook (€2.80 in chips) 
caduceus369: posts small blind €0.01
yanez61: posts big blind €0.02
*** HOLE CARDS ***
Dealt to caduceus369 [8s Qh]
pistaKKio23: folds 
OSPREYSTORM: folds 
BetNoLook: folds 
Emm3B1: raises €0.04 to €0.06
caduceus369: folds 
yanez61: calls €0.04
*** FLOP *** [8h 7h Ks]
yanez61: checks 
Emm3B1: bets €0.06
yanez61: calls €0.06
*** TURN *** [8h 7h Ks] [5d]
yanez61: checks 
Emm3B1: checks 
*** RIVER *** [8h 7h Ks 5d] [7c]
yanez61: checks 
Emm3B1: checks 
*** SHOW DOWN ***
yanez61: shows [Qs 9h] (a pair of Sevens)
Emm3B1: shows [3d 3c] (two pair, Sevens and Threes)
Emm3B1 collected €0.24 from pot
*** SUMMARY ***
Total pot €0.25 | Rake €0.01 
Board [8h 7h Ks 5d 7c]
Seat 1: Emm3B1 (button) showed [3d 3c] and won (€0.24) with two pair, Sevens and Threes
Seat 2: caduceus369 (small blind) folded before Flop
Seat 3: yanez61 (big blind) showed [Qs 9h] and lost with a pair of Sevens
Seat 4: pistaKKio23 folded before Flop (didn't bet)
Seat 5: OSPREYSTORM folded before Flop (didn't bet)
Seat 6: BetNoLook folded before Flop (didn't bet)



PokerStars Zoom Hand #257984182301:  Hold'em No Limit (€0.01/€0.02) [ADM ID: M62BA304494E32ST] - 2025/10/03 18:35:00 CET [2025/10/03 12:35:00 ET]
Table 'Sirio' 6-max Seat #1 is the button
Seat 1: MRsN00b25 (€0.92 in chips) 
Seat 2: caduceus369 (€3.12 in chips) 
Seat 3: OMGWOLFX (€5.77 in chips) 
Seat 4: cagliari59 (€0.27 in chips) 
Seat 5: OSPREYSTORM (€1.83 in chips) 
Seat 6: SalahUbeen (€1.78 in chips) 
caduceus369: posts small blind €0.01
OMGWOLFX: posts big blind €0.02
*** HOLE CARDS ***
Dealt to caduceus369 [4h 4d]
cagliari59: raises €0.04 to €0.06
OSPREYSTORM: folds 
SalahUbeen: folds 
MRsN00b25: folds 
caduceus369: folds 
OMGWOLFX: folds 
Uncalled bet (€0.04) returned to cagliari59
cagliari59 collected €0.05 from pot
cagliari59: doesn't show hand 
*** SUMMARY ***
Total pot €0.05 | Rake €0 
Seat 1: MRsN00b25 (button) folded before Flop (didn't bet)
Seat 2: caduceus369 (small blind) folded before Flop
Seat 3: OMGWOLFX (big blind) folded before Flop
Seat 4: cagliari59 collected (€0.05)
Seat 5: OSPREYSTORM folded before Flop (didn't bet)
Seat 6: SalahUbeen folded before Flop (didn't bet)



PokerStars Zoom Hand #257984185543:  Hold'em No Limit (€0.01/€0.02) [ADM ID: M62BA304494E32ST] - 2025/10/03 18:35:18 CET [2025/10/03 12:35:18 ET]
Table 'Sirio' 6-max Seat #1 is the button
Seat 1: caduceus369 (€3.11 in chips) 
Seat 2: SalahUbeen (€1.78 in chips) 
Seat 3: OSPREYSTORM (€1.18 in chips) 
Seat 4: Goal779 (€0.92 in chips) 
Seat 5: GanchanS7 (€4.40 in chips) 
Seat 6: SaTheNuts_77 (€5.66 in chips) 
SalahUbeen: posts small blind €0.01
OSPREYSTORM: posts big blind €0.02
*** HOLE CARDS ***
Dealt to caduceus369 [Jc 5d]
Goal779: calls €0.02
GanchanS7: folds 
SaTheNuts_77: calls €0.02
caduceus369: folds 
SalahUbeen: calls €0.01
OSPREYSTORM: checks 
*** FLOP *** [9s 8d Qh]
SalahUbeen: checks 
OSPREYSTORM: checks 
Goal779: bets €0.02
SaTheNuts_77: folds 
SalahUbeen: calls €0.02
OSPREYSTORM: calls €0.02
*** TURN *** [9s 8d Qh] [Js]
SalahUbeen: checks 
OSPREYSTORM: checks 
Goal779: bets €0.14
SalahUbeen: calls €0.14
OSPREYSTORM: calls €0.14
*** RIVER *** [9s 8d Qh Js] [3h]
SalahUbeen: checks 
OSPREYSTORM: checks 
Goal779: bets €0.53
SalahUbeen: folds 
OSPREYSTORM: calls €0.53
*** SHOW DOWN ***
Goal779: shows [Th Jh] (a straight, Eight to Queen)
OSPREYSTORM: shows [Qc Td] (a straight, Eight to Queen)
OSPREYSTORM collected €0.77 from pot
Goal779 collected €0.77 from pot
*** SUMMARY ***
Total pot €1.62 | Rake €0.08 
Board [9s 8d Qh Js 3h]
Seat 1: caduceus369 (button) folded before Flop (didn't bet)
Seat 2: SalahUbeen (small blind) folded on the River
Seat 3: OSPREYSTORM (big blind) showed [Qc Td] and won (€0.77) with a straight, Eight to Queen
Seat 4: Goal779 showed [Th Jh] and won (€0.77) with a straight, Eight to Queen
Seat 5: GanchanS7 folded before Flop (didn't bet)
Seat 6: SaTheNuts_77 folded on the Flop



PokerStars Zoom Hand #257984186084:  Hold'em No Limit (€0.01/€0.02) [ADM ID: M62BA304494E32ST] - 2025/10/03 18:35:20 CET [2025/10/03 12:35:20 ET]
Table 'Sirio' 6-max Seat #1 is the button
Seat 1: pistaKKio23 (€3.38 in chips) 
Seat 2: Paolino532 (€2.07 in chips) 
Seat 3: caduceus369 (€3.11 in chips) 
Seat 4: jolli180 (€1.95 in chips) 
Seat 5: yanez61 (€2.82 in chips) 
Seat 6: Emm3B1 (€2.07 in chips) 
Paolino532: posts small blind €0.01
caduceus369: posts big blind €0.02
*** HOLE CARDS ***
Dealt to caduceus369 [3c Ah]
jolli180: folds 
yanez61: folds 
Emm3B1: folds 
pistaKKio23: folds 
Paolino532: calls €0.01
caduceus369: checks 
*** FLOP *** [Jd 2c 6c]
Paolino532: checks 
caduceus369: checks 
*** TURN *** [Jd 2c 6c] [4c]
Paolino532: checks 
caduceus369: bets €0.02
Paolino532: raises €0.02 to €0.04
caduceus369: calls €0.02
*** RIVER *** [Jd 2c 6c 4c] [Qh]
Paolino532: checks 
caduceus369: bets €0.08
Paolino532: raises €0.28 to €0.36
caduceus369: folds 
Uncalled bet (€0.28) returned to Paolino532
Paolino532 collected €0.27 from pot
Paolino532: doesn't show hand 
*** SUMMARY ***
Total pot €0.28 | Rake €0.01 
Board [Jd 2c 6c 4c Qh]
Seat 1: pistaKKio23 (button) folded before Flop (didn't bet)
Seat 2: Paolino532 (small blind) collected (€0.27)
Seat 3: caduceus369 (big blind) folded on the River
Seat 4: jolli180 folded before Flop (didn't bet)
Seat 5: yanez61 folded before Flop (didn't bet)
Seat 6: Emm3B1 folded before Flop (didn't bet)



PokerStars Zoom Hand #257984197849:  Hold'em No Limit (€0.01/€0.02) [ADM ID: M62BA304494E32ST] - 2025/10/03 18:36:21 CET [2025/10/03 12:36:21 ET]
Table 'Sirio' 6-max Seat #1 is the button
Seat 1: OMGWOLFX (€4.63 in chips) 
Seat 2: SalahUbeen (€1.49 in chips) 
Seat 3: OSPREYSTORM (€1.80 in chips) 
Seat 4: Emm3B1 (€2.13 in chips) 
Seat 5: cucuma21 (€0.79 in chips) 
Seat 6: caduceus369 (€2.97 in chips) 
SalahUbeen: posts small blind €0.01
OSPREYSTORM: posts big blind €0.02
*** HOLE CARDS ***
Dealt to caduceus369 [Ks 7c]
Emm3B1: folds 
cucuma21: calls €0.02
caduceus369: folds 
OMGWOLFX: folds 
SalahUbeen: folds 
OSPREYSTORM: checks 
*** FLOP *** [Jh 5d 2s]
OSPREYSTORM: checks 
cucuma21: checks 
*** TURN *** [Jh 5d 2s] [Ts]
OSPREYSTORM: checks 
cucuma21: checks 
*** RIVER *** [Jh 5d 2s Ts] [Ac]
OSPREYSTORM: checks 
cucuma21: checks 
*** SHOW DOWN ***
OSPREYSTORM: shows [7s 4h] (high card Ace)
cucuma21: shows [3d 3s] (a pair of Threes)
cucuma21 collected €0.05 from pot
*** SUMMARY ***
Total pot €0.05 | Rake €0 
Board [Jh 5d 2s Ts Ac]
Seat 1: OMGWOLFX (button) folded before Flop (didn't bet)
Seat 2: SalahUbeen (small blind) folded before Flop
Seat 3: OSPREYSTORM (big blind) showed [7s 4h] and lost with high card Ace
Seat 4: Emm3B1 folded before Flop (didn't bet)
Seat 5: cucuma21 showed [3d 3s] and won (€0.05) with a pair of Threes
Seat 6: caduceus369 folded before Flop (didn't bet)



PokerStars Zoom Hand #257984199363:  Hold'em No Limit (€0.01/€0.02) [ADM ID: M62BA304494E32ST] - 2025/10/03 18:36:29 CET [2025/10/03 12:36:29 ET]
Table 'Sirio' 6-max Seat #1 is the button
Seat 1: SidneyPrescott (€3.51 in chips) 
Seat 2: themagnetich (€1.92 in chips) 
Seat 3: MRmarisa (€3.96 in chips) 
Seat 4: monsterc99 (€0.75 in chips) 
Seat 5: caduceus369 (€2.96 in chips) 
Seat 6: deojking (€1.39 in chips) 
themagnetich: posts small blind €0.01
MRmarisa: posts big blind €0.02
*** HOLE CARDS ***
Dealt to caduceus369 [6d 4s]
monsterc99: calls €0.02
caduceus369: folds 
deojking: folds 
SidneyPrescott: raises €0.06 to €0.08
themagnetich: folds 
MRmarisa: raises €0.19 to €0.27
monsterc99: folds 
SidneyPrescott: folds 
Uncalled bet (€0.19) returned to MRmarisa
MRmarisa collected €0.19 from pot
MRmarisa: doesn't show hand 
*** SUMMARY ***
Total pot €0.19 | Rake €0 
Seat 1: SidneyPrescott (button) folded before Flop
Seat 2: themagnetich (small blind) folded before Flop
Seat 3: MRmarisa (big blind) collected (€0.19)
Seat 4: monsterc99 folded before Flop
Seat 5: caduceus369 folded before Flop (didn't bet)
Seat 6: deojking folded before Flop (didn't bet)



PokerStars Zoom Hand #257984200341:  Hold'em No Limit (€0.01/€0.02) [ADM ID: M62BA304494E32ST] - 2025/10/03 18:36:34 CET [2025/10/03 12:36:34 ET]
Table 'Sirio' 6-max Seat #1 is the button
Seat 1: pistaKKio23 (€2.72 in chips) 
Seat 2: OMGWOLFX (€4.63 in chips) 
Seat 3: SaTheNuts_77 (€5.64 in chips) 
Seat 4: OSPREYSTORM (€2 in chips) 
Seat 5: shakthi (€1.57 in chips) 
Seat 6: caduceus369 (€2.96 in chips) 
OMGWOLFX: posts small blind €0.01
SaTheNuts_77: posts big blind €0.02
*** HOLE CARDS ***
Dealt to caduceus369 [7s 2s]
OSPREYSTORM: raises €0.04 to €0.06
shakthi: folds 
caduceus369: folds 
pistaKKio23: folds 
OMGWOLFX: folds 
SaTheNuts_77: calls €0.04
*** FLOP *** [6h Kc 2h]
SaTheNuts_77: checks 
OSPREYSTORM: checks 
*** TURN *** [6h Kc 2h] [9d]
SaTheNuts_77: bets €0.03
OSPREYSTORM: folds 
Uncalled bet (€0.03) returned to SaTheNuts_77
SaTheNuts_77 collected €0.13 from pot
SaTheNuts_77: doesn't show hand 
*** SUMMARY ***
Total pot €0.13 | Rake €0 
Board [6h Kc 2h 9d]
Seat 1: pistaKKio23 (button) folded before Flop (didn't bet)
Seat 2: OMGWOLFX (small blind) folded before Flop
Seat 3: SaTheNuts_77 (big blind) collected (€0.13)
Seat 4: OSPREYSTORM folded on the Turn
Seat 5: shakthi folded before Flop (didn't bet)
Seat 6: caduceus369 folded before Flop (didn't bet)



PokerStars Zoom Hand #257984203586:  Hold'em No Limit (€0.01/€0.02) [ADM ID: M62BA304494E32ST] - 2025/10/03 18:36:51 CET [2025/10/03 12:36:51 ET]
Table 'Sirio' 6-max Seat #1 is the button
Seat 1: pistaKKio23 (€2.31 in chips) 
Seat 2: SidneyPrescott (€2.31 in chips) 
Seat 3: Cruelplace84 (€3.52 in chips) 
Seat 4: caduceus369 (€2.96 in chips) 
Seat 5: OSPREYSTORM (€2.20 in chips) 
Seat 6: mariokart137 (€4.01 in chips) 
SidneyPrescott: posts small blind €0.01
Cruelplace84: posts big blind €0.02
*** HOLE CARDS ***
Dealt to caduceus369 [8c 2c]
caduceus369: folds 
OSPREYSTORM: folds 
mariokart137: folds 
pistaKKio23: folds 
SidneyPrescott: folds 
Uncalled bet (€0.01) returned to Cruelplace84
Cruelplace84 collected €0.02 from pot
Cruelplace84: doesn't show hand 
*** SUMMARY ***
Total pot €0.02 | Rake €0 
Seat 1: pistaKKio23 (button) folded before Flop (didn't bet)
Seat 2: SidneyPrescott (small blind) folded before Flop
Seat 3: Cruelplace84 (big blind) collected (€0.02)
Seat 4: caduceus369 folded before Flop (didn't bet)
Seat 5: OSPREYSTORM folded before Flop (didn't bet)
Seat 6: mariokart137 folded before Flop (didn't bet)



PokerStars Zoom Hand #257984202583:  Hold'em No Limit (€0.01/€0.02) [ADM ID: M62BA304494E32ST] - 2025/10/03 18:36:46 CET [2025/10/03 12:36:46 ET]
Table 'Sirio' 6-max Seat #1 is the button
Seat 1: signorgi1 (€1.25 in chips) 
Seat 2: OSPREYSTORM (€2.21 in chips) 
Seat 3: deojking (€1.39 in chips) 
Seat 4: SidneyPrescott (€2.31 in chips) 
Seat 5: caduceus369 (€2.96 in chips) 
Seat 6: cucuma21 (€0.82 in chips) 
OSPREYSTORM: posts small blind €0.01
deojking: posts big blind €0.02
*** HOLE CARDS ***
Dealt to caduceus369 [3h 7h]
SidneyPrescott: folds 
caduceus369: folds 
cucuma21: folds 
signorgi1: calls €0.02
OSPREYSTORM: folds 
deojking: checks 
*** FLOP *** [4h Ks Ad]
deojking: checks 
signorgi1: checks 
*** TURN *** [4h Ks Ad] [2h]
deojking: checks 
signorgi1: bets €0.02
deojking: folds 
Uncalled bet (€0.02) returned to signorgi1
signorgi1 collected €0.05 from pot
signorgi1: doesn't show hand 
*** SUMMARY ***
Total pot €0.05 | Rake €0 
Board [4h Ks Ad 2h]
Seat 1: signorgi1 (button) collected (€0.05)
Seat 2: OSPREYSTORM (small blind) folded before Flop
Seat 3: deojking (big blind) folded on the Turn
Seat 4: SidneyPrescott folded before Flop (didn't bet)
Seat 5: caduceus369 folded before Flop (didn't bet)
Seat 6: cucuma21 folded before Flop (didn't bet)



PokerStars Zoom Hand #257984198435:  Hold'em No Limit (€0.01/€0.02) [ADM ID: M62BA304494E32ST] - 2025/10/03 18:36:25 CET [2025/10/03 12:36:25 ET]
Table 'Sirio' 6-max Seat #1 is the button
Seat 1: Paolino532 (€2.20 in chips) 
Seat 2: caduceus369 (€2.97 in chips) 
Seat 3: Emm3B1 (€2.13 in chips) 
Seat 4: Cruelplace84 (€2.05 in chips) 
Seat 5: pistaKKio23 (€2.72 in chips) 
Seat 6: signorgi1 (€1.25 in chips) 
caduceus369: posts small blind €0.01
Emm3B1: posts big blind €0.02
*** HOLE CARDS ***
Dealt to caduceus369 [Qh 2d]
Cruelplace84: folds 
pistaKKio23: folds 
signorgi1: folds 
Paolino532: calls €0.02
caduceus369: folds 
Emm3B1: checks 
*** FLOP *** [3c 7h 8d]
Emm3B1: checks 
Paolino532: bets €0.03
Emm3B1: calls €0.03
*** TURN *** [3c 7h 8d] [7d]
Emm3B1: checks 
Paolino532: bets €0.06
Emm3B1: calls €0.06
*** RIVER *** [3c 7h 8d 7d] [8s]
Emm3B1: checks 
Paolino532: bets €0.11
Emm3B1: folds 
Uncalled bet (€0.11) returned to Paolino532
Paolino532 collected €0.22 from pot
Paolino532: doesn't show hand 
*** SUMMARY ***
Total pot €0.23 | Rake €0.01 
Board [3c 7h 8d 7d 8s]
Seat 1: Paolino532 (button) collected (€0.22)
Seat 2: caduceus369 (small blind) folded before Flop
Seat 3: Emm3B1 (big blind) folded on the River
Seat 4: Cruelplace84 folded before Flop (didn't bet)
Seat 5: pistaKKio23 folded before Flop (didn't bet)
Seat 6: signorgi1 folded before Flop (didn't bet)



PokerStars Zoom Hand #257984201217:  Hold'em No Limit (€0.01/€0.02) [ADM ID: M62BA304494E32ST] - 2025/10/03 18:36:39 CET [2025/10/03 12:36:39 ET]
Table 'Sirio' 6-max Seat #1 is the button
Seat 1: caduceus369 (€2.96 in chips) 
Seat 2: monsterc99 (€0.73 in chips) 
Seat 3: shakthi (€1.57 in chips) 
Seat 4: pistaKKio23 (€3.35 in chips) 
Seat 5: GanchanS7 (€2 in chips) 
Seat 6: SalahUbeen (€1.61 in chips) 
monsterc99: posts small blind €0.01
shakthi: posts big blind €0.02
*** HOLE CARDS ***
Dealt to caduceus369 [5h 4d]
pistaKKio23: folds 
GanchanS7 has timed out
GanchanS7: folds 
SalahUbeen: raises €0.03 to €0.05
caduceus369: folds 
monsterc99: calls €0.04
shakthi: folds 
*** FLOP *** [Tc 6s 8d]
monsterc99: checks 
SalahUbeen: checks 
*** TURN *** [Tc 6s 8d] [Kh]
monsterc99: bets €0.02
SalahUbeen: calls €0.02
*** RIVER *** [Tc 6s 8d Kh] [7h]
monsterc99: checks 
SalahUbeen: checks 
*** SHOW DOWN ***
monsterc99: shows [Qc As] (high card Ace)
SalahUbeen: shows [3d 3s] (a pair of Threes)
SalahUbeen collected €0.16 from pot
*** SUMMARY ***
Total pot €0.16 | Rake €0 
Board [Tc 6s 8d Kh 7h]
Seat 1: caduceus369 (button) folded before Flop (didn't bet)
Seat 2: monsterc99 (small blind) showed [Qc As] and lost with high card Ace
Seat 3: shakthi (big blind) folded before Flop
Seat 4: pistaKKio23 folded before Flop (didn't bet)
Seat 5: GanchanS7 folded before Flop (didn't bet)
Seat 6: SalahUbeen showed [3d 3s] and won (€0.16) with a pair of Threes



PokerStars Zoom Hand #257984204952:  Hold'em No Limit (€0.01/€0.02) [ADM ID: M62BA304494E32ST] - 2025/10/03 18:36:59 CET [2025/10/03 12:36:59 ET]
Table 'Sirio' 6-max Seat #1 is the button
Seat 1: Genny040893 (€1.11 in chips) 
Seat 2: OMGWOLFX (€11.17 in chips) 
Seat 3: OSPREYSTORM (€1.97 in chips) 
Seat 4: caduceus369 (€2.96 in chips) 
Seat 5: SidneyPrescott (€2.33 in chips) 
Seat 6: trillycata (€1.57 in chips) 
OMGWOLFX: posts small blind €0.01
OSPREYSTORM: posts big blind €0.02
*** HOLE CARDS ***
Dealt to caduceus369 [Jh Th]
caduceus369: calls €0.02
SidneyPrescott: folds 
trillycata: folds 
Genny040893 has timed out
Genny040893: folds 
OMGWOLFX: folds 
OSPREYSTORM: raises €0.08 to €0.10
caduceus369: folds 
Uncalled bet (€0.08) returned to OSPREYSTORM
OSPREYSTORM collected €0.05 from pot
OSPREYSTORM: doesn't show hand 
*** SUMMARY ***
Total pot €0.05 | Rake €0 
Seat 1: Genny040893 (button) folded before Flop (didn't bet)
Seat 2: OMGWOLFX (small blind) folded before Flop
Seat 3: OSPREYSTORM (big blind) collected (€0.05)
Seat 4: caduceus369 folded before Flop
Seat 5: SidneyPrescott folded before Flop (didn't bet)
Seat 6: trillycata folded before Flop (didn't bet)



PokerStars Zoom Hand #257984214055:  Hold'em No Limit (€0.01/€0.02) [ADM ID: M62BA304494E32ST] - 2025/10/03 18:37:46 CET [2025/10/03 12:37:46 ET]
Table 'Sirio' 6-max Seat #1 is the button
Seat 1: franck19621962 (€0.75 in chips) 
Seat 2: SidneyPrescott (€2.37 in chips) 
Seat 3: caduceus369 (€2.94 in chips) 
Seat 4: OSPREYSTORM (€1.91 in chips) 
Seat 5: pistaKKio23 (€2.69 in chips) 
Seat 6: Catania838 (€2.11 in chips) 
SidneyPrescott: posts small blind €0.01
caduceus369: posts big blind €0.02
*** HOLE CARDS ***
Dealt to caduceus369 [2h Js]
OSPREYSTORM: folds 
pistaKKio23: folds 
Catania838: calls €0.02
franck19621962: folds 
SidneyPrescott: folds 
caduceus369: checks 
*** FLOP *** [8s 3s Jc]
caduceus369: checks 
Catania838: bets €0.02
caduceus369: calls €0.02
*** TURN *** [8s 3s Jc] [7c]
caduceus369: checks 
Catania838: checks 
*** RIVER *** [8s 3s Jc 7c] [Th]
caduceus369: bets €0.02
Catania838: calls €0.02
*** SHOW DOWN ***
caduceus369: shows [2h Js] (a pair of Jacks)
Catania838: mucks hand 
caduceus369 collected €0.13 from pot
*** SUMMARY ***
Total pot €0.13 | Rake €0 
Board [8s 3s Jc 7c Th]
Seat 1: franck19621962 (button) folded before Flop (didn't bet)
Seat 2: SidneyPrescott (small blind) folded before Flop
Seat 3: caduceus369 (big blind) showed [2h Js] and won (€0.13) with a pair of Jacks
Seat 4: OSPREYSTORM folded before Flop (didn't bet)
Seat 5: pistaKKio23 folded before Flop (didn't bet)
Seat 6: Catania838 mucked [Kc Ad]



PokerStars Zoom Hand #257984226988:  Hold'em No Limit (€0.01/€0.02) [ADM ID: M62BA304494E32ST] - 2025/10/03 18:38:53 CET [2025/10/03 12:38:53 ET]
Table 'Sirio' 6-max Seat #1 is the button
Seat 1: franck19621962 (€0.92 in chips) 
Seat 2: OMGWOLFX (€11.23 in chips) 
Seat 3: Cruelplace84 (€3.31 in chips) 
Seat 4: yanez61 (€1.97 in chips) 
Seat 5: pistaKKio23 (€3.26 in chips) 
Seat 6: caduceus369 (€3 in chips) 
OMGWOLFX: posts small blind €0.01
Cruelplace84: posts big blind €0.02
*** HOLE CARDS ***
Dealt to caduceus369 [5s 2c]
yanez61: raises €0.08 to €0.10
pistaKKio23: folds 
caduceus369: folds 
franck19621962: folds 
OMGWOLFX: folds 
Cruelplace84: folds 
Uncalled bet (€0.08) returned to yanez61
yanez61 collected €0.05 from pot
yanez61: doesn't show hand 
*** SUMMARY ***
Total pot €0.05 | Rake €0 
Seat 1: franck19621962 (button) folded before Flop (didn't bet)
Seat 2: OMGWOLFX (small blind) folded before Flop
Seat 3: Cruelplace84 (big blind) folded before Flop
Seat 4: yanez61 collected (€0.05)
Seat 5: pistaKKio23 folded before Flop (didn't bet)
Seat 6: caduceus369 folded before Flop (didn't bet)



PokerStars Zoom Hand #257984222881:  Hold'em No Limit (€0.01/€0.02) [ADM ID: M62BA304494E32ST] - 2025/10/03 18:38:31 CET [2025/10/03 12:38:31 ET]
Table 'Sirio' 6-max Seat #1 is the button
Seat 1: Catania838 (€2.05 in chips) 
Seat 2: caduceus369 (€3.01 in chips) 
Seat 3: SidneyPrescott (€2.39 in chips) 
Seat 4: themagnetich (€1.91 in chips) 
Seat 5: OSPREYSTORM (€2.19 in chips) 
Seat 6: deojking (€3.31 in chips) 
caduceus369: posts small blind €0.01
SidneyPrescott: posts big blind €0.02
*** HOLE CARDS ***
Dealt to caduceus369 [5h 9d]
themagnetich: folds 
OSPREYSTORM: folds 
deojking: folds 
Catania838: raises €0.04 to €0.06
caduceus369: folds 
SidneyPrescott: raises €0.14 to €0.20
Catania838: calls €0.14
*** FLOP *** [2d 3s Qs]
SidneyPrescott: bets €0.12
Catania838: raises €1.73 to €1.85 and is all-in
SidneyPrescott: calls €1.73
*** TURN *** [2d 3s Qs] [Tc]
*** RIVER *** [2d 3s Qs Tc] [Ad]
*** SHOW DOWN ***
SidneyPrescott: shows [Qd Ts] (two pair, Queens and Tens)
Catania838: shows [Qh As] (two pair, Aces and Queens)
Catania838 collected €3.89 from pot
*** SUMMARY ***
Total pot €4.11 | Rake €0.22 
Board [2d 3s Qs Tc Ad]
Seat 1: Catania838 (button) showed [Qh As] and won (€3.89) with two pair, Aces and Queens
Seat 2: caduceus369 (small blind) folded before Flop
Seat 3: SidneyPrescott (big blind) showed [Qd Ts] and lost with two pair, Queens and Tens
Seat 4: themagnetich folded before Flop (didn't bet)
Seat 5: OSPREYSTORM folded before Flop (didn't bet)
Seat 6: deojking folded before Flop (didn't bet)



PokerStars Zoom Hand #257984225326:  Hold'em No Limit (€0.01/€0.02) [ADM ID: M62BA304494E32ST] - 2025/10/03 18:38:44 CET [2025/10/03 12:38:44 ET]
Table 'Sirio' 6-max Seat #1 is the button
Seat 1: marina41978 (€0.87 in chips) 
Seat 2: luchino74 (€4.36 in chips) 
Seat 3: OSPREYSTORM (€1.97 in chips) 
Seat 4: caduceus369 (€3 in chips) 
Seat 5: pistaKKio23 (€3.27 in chips) 
Seat 6: Goal779 (€0.86 in chips) 
luchino74: posts small blind €0.01
OSPREYSTORM: posts big blind €0.02
*** HOLE CARDS ***
Dealt to caduceus369 [6h Qs]
caduceus369: folds 
pistaKKio23: folds 
Goal779: raises €0.04 to €0.06
marina41978: calls €0.06
luchino74: folds 
OSPREYSTORM: calls €0.04
*** FLOP *** [Jd Ts 6c]
OSPREYSTORM: checks 
Goal779: checks 
marina41978: bets €0.81 and is all-in
OSPREYSTORM: folds 
Goal779: folds 
Uncalled bet (€0.81) returned to marina41978
marina41978 collected €0.18 from pot
marina41978: doesn't show hand 
*** SUMMARY ***
Total pot €0.19 | Rake €0.01 
Board [Jd Ts 6c]
Seat 1: marina41978 (button) collected (€0.18)
Seat 2: luchino74 (small blind) folded before Flop
Seat 3: OSPREYSTORM (big blind) folded on the Flop
Seat 4: caduceus369 folded before Flop (didn't bet)
Seat 5: pistaKKio23 folded before Flop (didn't bet)
Seat 6: Goal779 folded on the Flop



PokerStars Zoom Hand #257984225975:  Hold'em No Limit (€0.01/€0.02) [ADM ID: M62BA304494E32ST] - 2025/10/03 18:38:47 CET [2025/10/03 12:38:47 ET]
Table 'Sirio' 6-max Seat #1 is the button
Seat 1: caduceus369 (€3 in chips) 
Seat 2: mariokart137 (€3.95 in chips) 
Seat 3: S'dj83 (€5.91 in chips) 
Seat 4: shakthi (€1.62 in chips) 
Seat 5: SidneyPrescott (€3.08 in chips) 
Seat 6: Gabrielefante (€2.85 in chips) 
mariokart137: posts small blind €0.01
S'dj83: posts big blind €0.02
*** HOLE CARDS ***
Dealt to caduceus369 [5h 9d]
shakthi: raises €0.02 to €0.04
SidneyPrescott: folds 
Gabrielefante: calls €0.04
caduceus369: folds 
mariokart137: folds 
S'dj83: calls €0.02
*** FLOP *** [4s 2s 4h]
S'dj83: checks 
shakthi: checks 
Gabrielefante: bets €0.13
S'dj83: folds 
shakthi: folds 
Uncalled bet (€0.13) returned to Gabrielefante
Gabrielefante collected €0.13 from pot
Gabrielefante: doesn't show hand 
*** SUMMARY ***
Total pot €0.13 | Rake €0 
Board [4s 2s 4h]
Seat 1: caduceus369 (button) folded before Flop (didn't bet)
Seat 2: mariokart137 (small blind) folded before Flop
Seat 3: S'dj83 (big blind) folded on the Flop
Seat 4: shakthi folded on the Flop
Seat 5: SidneyPrescott folded before Flop (didn't bet)
Seat 6: Gabrielefante collected (€0.13)



PokerStars Zoom Hand #257984227734:  Hold'em No Limit (€0.01/€0.02) [ADM ID: M62BA304494E32ST] - 2025/10/03 18:38:56 CET [2025/10/03 12:38:56 ET]
Table 'Sirio' 6-max Seat #1 is the button
Seat 1: SidneyPrescott (€3.08 in chips) 
Seat 2: deojking (€1.32 in chips) 
Seat 3: caduceus369 (€3 in chips) 
Seat 4: franck19621962 (€0.92 in chips) 
Seat 5: SalahUbeen (€2.18 in chips) 
Seat 6: GanchanS7 (€4.23 in chips) 
deojking: posts small blind €0.01
caduceus369: posts big blind €0.02
*** HOLE CARDS ***
Dealt to caduceus369 [6c Th]
franck19621962: folds 
SalahUbeen: folds 
GanchanS7: raises €0.02 to €0.04
SidneyPrescott: raises €0.10 to €0.14
deojking: folds 
caduceus369: folds 
GanchanS7: folds 
Uncalled bet (€0.10) returned to SidneyPrescott
SidneyPrescott collected €0.11 from pot
SidneyPrescott: doesn't show hand 
*** SUMMARY ***
Total pot €0.11 | Rake €0 
Seat 1: SidneyPrescott (button) collected (€0.11)
Seat 2: deojking (small blind) folded before Flop
Seat 3: caduceus369 (big blind) folded before Flop
Seat 4: franck19621962 folded before Flop (didn't bet)
Seat 5: SalahUbeen folded before Flop (didn't bet)
Seat 6: GanchanS7 folded before Flop



PokerStars Zoom Hand #257984230563:  Hold'em No Limit (€0.01/€0.02) [ADM ID: M62BA304494E32ST] - 2025/10/03 18:39:11 CET [2025/10/03 12:39:11 ET]
Table 'Sirio' 6-max Seat #1 is the button
Seat 1: ZefirDevil (€0.81 in chips) 
Seat 2: caduceus369 (€2.98 in chips) 
Seat 3: franck19621962 (€0.92 in chips) 
Seat 4: Emm3B1 (€2.37 in chips) 
Seat 5: S'dj83 (€5.87 in chips) 
Seat 6: pistaKKio23 (€2.22 in chips) 
caduceus369: posts small blind €0.01
franck19621962: posts big blind €0.02
*** HOLE CARDS ***
Dealt to caduceus369 [7s Td]
Emm3B1: folds 
S'dj83 has timed out
S'dj83: folds 
pistaKKio23: folds 
ZefirDevil: raises €0.02 to €0.04
caduceus369: folds 
franck19621962: calls €0.02
*** FLOP *** [9s 6c 2h]
franck19621962: bets €0.02
ZefirDevil: calls €0.02
*** TURN *** [9s 6c 2h] [Js]
franck19621962: bets €0.02
ZefirDevil: folds 
Uncalled bet (€0.02) returned to franck19621962
franck19621962 collected €0.13 from pot
franck19621962: doesn't show hand 
*** SUMMARY ***
Total pot €0.13 | Rake €0 
Board [9s 6c 2h Js]
Seat 1: ZefirDevil (button) folded on the Turn
Seat 2: caduceus369 (small blind) folded before Flop
Seat 3: franck19621962 (big blind) collected (€0.13)
Seat 4: Emm3B1 folded before Flop (didn't bet)
Seat 5: S'dj83 folded before Flop (didn't bet)
Seat 6: pistaKKio23 folded before Flop (didn't bet)



PokerStars Zoom Hand #257984231951:  Hold'em No Limit (€0.01/€0.02) [ADM ID: M62BA304494E32ST] - 2025/10/03 18:39:18 CET [2025/10/03 12:39:18 ET]
Table 'Sirio' 6-max Seat #1 is the button
Seat 1: caduceus369 (€2.97 in chips) 
Seat 2: trisco66 (€0.94 in chips) 
Seat 3: OSPREYSTORM (€2.19 in chips) 
Seat 4: SalahUbeen (€1.32 in chips) 
Seat 5: Cruelplace84 (€2 in chips) 
Seat 6: Kamiros01 (€3.42 in chips) 
trisco66: posts small blind €0.01
OSPREYSTORM: posts big blind €0.02
*** HOLE CARDS ***
Dealt to caduceus369 [Ah Ac]
SalahUbeen: folds 
Cruelplace84: folds 
Kamiros01: folds 
caduceus369: raises €0.02 to €0.04
trisco66: folds 
OSPREYSTORM: raises €0.12 to €0.16
caduceus369: calls €0.12
*** FLOP *** [3h 9c Tc]
OSPREYSTORM: bets €0.11
caduceus369: calls €0.11
*** TURN *** [3h 9c Tc] [9s]
OSPREYSTORM: checks 
caduceus369: checks 
*** RIVER *** [3h 9c Tc 9s] [5d]
OSPREYSTORM: bets €0.29
caduceus369: raises €0.29 to €0.58
OSPREYSTORM: calls €0.29
*** SHOW DOWN ***
caduceus369: shows [Ah Ac] (two pair, Aces and Nines)
OSPREYSTORM: mucks hand 
caduceus369 collected €1.62 from pot
*** SUMMARY ***
Total pot €1.71 | Rake €0.09 
Board [3h 9c Tc 9s 5d]
Seat 1: caduceus369 (button) showed [Ah Ac] and won (€1.62) with two pair, Aces and Nines
Seat 2: trisco66 (small blind) folded before Flop
Seat 3: OSPREYSTORM (big blind) mucked [Kc Kd]
Seat 4: SalahUbeen folded before Flop (didn't bet)
Seat 5: Cruelplace84 folded before Flop (didn't bet)
Seat 6: Kamiros01 folded before Flop (didn't bet)



PokerStars Zoom Hand #257984243637:  Hold'em No Limit (€0.01/€0.02) [ADM ID: M62BA304494E32ST] - 2025/10/03 18:40:19 CET [2025/10/03 12:40:19 ET]
Table 'Sirio' 6-max Seat #1 is the button
Seat 1: OMGWOLFX (€11.08 in chips) 
Seat 2: deojking (€2.22 in chips) 
Seat 3: Spillo.RN (€1.52 in chips) 
Seat 4: OSPREYSTORM (€1.34 in chips) 
Seat 5: caduceus369 (€3.74 in chips) 
Seat 6: Cruelplace84 (€2.64 in chips) 
deojking: posts small blind €0.01
Spillo.RN: posts big blind €0.02
*** HOLE CARDS ***
Dealt to caduceus369 [7s 3h]
OSPREYSTORM: folds 
caduceus369: folds 
Cruelplace84: raises €0.03 to €0.05
OMGWOLFX: folds 
deojking: folds 
Spillo.RN: folds 
Uncalled bet (€0.03) returned to Cruelplace84
Cruelplace84 collected €0.05 from pot
Cruelplace84: doesn't show hand 
*** SUMMARY ***
Total pot €0.05 | Rake €0 
Seat 1: OMGWOLFX (button) folded before Flop (didn't bet)
Seat 2: deojking (small blind) folded before Flop
Seat 3: Spillo.RN (big blind) folded before Flop
Seat 4: OSPREYSTORM folded before Flop (didn't bet)
Seat 5: caduceus369 folded before Flop (didn't bet)
Seat 6: Cruelplace84 collected (€0.05)



PokerStars Zoom Hand #257984246860:  Hold'em No Limit (€0.01/€0.02) [ADM ID: M62BA304494E32ST] - 2025/10/03 18:40:35 CET [2025/10/03 12:40:35 ET]
Table 'Sirio' 6-max Seat #1 is the button
Seat 1: Kamiros01 (€3.39 in chips) 
Seat 2: pistaKKio23 (€2.22 in chips) 
Seat 3: Emm3B1 (€1.82 in chips) 
Seat 4: GanchanS7 (€2 in chips) 
Seat 5: Cruelplace84 (€2.67 in chips) 
Seat 6: caduceus369 (€3.74 in chips) 
pistaKKio23: posts small blind €0.01
Emm3B1: posts big blind €0.02
*** HOLE CARDS ***
Dealt to caduceus369 [5d Ac]
GanchanS7: raises €0.03 to €0.05
Cruelplace84: folds 
caduceus369: folds 
Kamiros01: folds 
pistaKKio23: folds 
Emm3B1: folds 
Uncalled bet (€0.03) returned to GanchanS7
GanchanS7 collected €0.05 from pot
GanchanS7: doesn't show hand 
*** SUMMARY ***
Total pot €0.05 | Rake €0 
Seat 1: Kamiros01 (button) folded before Flop (didn't bet)
Seat 2: pistaKKio23 (small blind) folded before Flop
Seat 3: Emm3B1 (big blind) folded before Flop
Seat 4: GanchanS7 collected (€0.05)
Seat 5: Cruelplace84 folded before Flop (didn't bet)
Seat 6: caduceus369 folded before Flop (didn't bet)



PokerStars Zoom Hand #257984244837:  Hold'em No Limit (€0.01/€0.02) [ADM ID: M62BA304494E32ST] - 2025/10/03 18:40:25 CET [2025/10/03 12:40:25 ET]
Table 'Sirio' 6-max Seat #1 is the button
Seat 1: SalahUbeen (€2.27 in chips) 
Seat 2: S'dj83 (€5.95 in chips) 
Seat 3: QUATTRODAME (€1.69 in chips) 
Seat 4: caduceus369 (€3.74 in chips) 
Seat 5: Cruelplace84 (€3.20 in chips) 
Seat 6: OMGWOLFX (€11.08 in chips) 
S'dj83: posts small blind €0.01
QUATTRODAME: posts big blind €0.02
*** HOLE CARDS ***
Dealt to caduceus369 [9d Jh]
caduceus369: folds 
Cruelplace84: folds 
OMGWOLFX: folds 
SalahUbeen: raises €0.04 to €0.06
S'dj83: folds 
QUATTRODAME: calls €0.04
*** FLOP *** [5d 8s 9h]
QUATTRODAME: checks 
SalahUbeen: checks 
*** TURN *** [5d 8s 9h] [8d]
QUATTRODAME: bets €0.07
SalahUbeen: folds 
Uncalled bet (€0.07) returned to QUATTRODAME
QUATTRODAME collected €0.13 from pot
QUATTRODAME: doesn't show hand 
*** SUMMARY ***
Total pot €0.13 | Rake €0 
Board [5d 8s 9h 8d]
Seat 1: SalahUbeen (button) folded on the Turn
Seat 2: S'dj83 (small blind) folded before Flop
Seat 3: QUATTRODAME (big blind) collected (€0.13)
Seat 4: caduceus369 folded before Flop (didn't bet)
Seat 5: Cruelplace84 folded before Flop (didn't bet)
Seat 6: OMGWOLFX folded before Flop (didn't bet)



PokerStars Zoom Hand #257984248000:  Hold'em No Limit (€0.01/€0.02) [ADM ID: M62BA304494E32ST] - 2025/10/03 18:40:42 CET [2025/10/03 12:40:42 ET]
Table 'Sirio' 6-max Seat #1 is the button
Seat 1: Cruelplace84 (€3.64 in chips) 
Seat 2: signorgi1 (€1.69 in chips) 
Seat 3: caduceus369 (€3.74 in chips) 
Seat 4: Kamiros01 (€3.39 in chips) 
Seat 5: jolli180 (€2.37 in chips) 
Seat 6: OMGWOLFX (€2.87 in chips) 
signorgi1: posts small blind €0.01
caduceus369: posts big blind €0.02
*** HOLE CARDS ***
Dealt to caduceus369 [8d Kh]
Kamiros01: folds 
jolli180: folds 
OMGWOLFX: raises €0.04 to €0.06
Cruelplace84: folds 
signorgi1: folds 
caduceus369: folds 
Uncalled bet (€0.04) returned to OMGWOLFX
OMGWOLFX collected €0.05 from pot
OMGWOLFX: doesn't show hand 
*** SUMMARY ***
Total pot €0.05 | Rake €0 
Seat 1: Cruelplace84 (button) folded before Flop (didn't bet)
Seat 2: signorgi1 (small blind) folded before Flop
Seat 3: caduceus369 (big blind) folded before Flop
Seat 4: Kamiros01 folded before Flop (didn't bet)
Seat 5: jolli180 folded before Flop (didn't bet)
Seat 6: OMGWOLFX collected (€0.05)



PokerStars Zoom Hand #257984252929:  Hold'em No Limit (€0.01/€0.02) [ADM ID: M62BA304494E32ST] - 2025/10/03 18:41:07 CET [2025/10/03 12:41:07 ET]
Table 'Sirio' 6-max Seat #1 is the button
Seat 1: deojking (€1.26 in chips) 
Seat 2: caduceus369 (€3.72 in chips) 
Seat 3: pistaKKio23 (€3.22 in chips) 
Seat 4: Cruelplace84 (€2.62 in chips) 
Seat 5: BetNoLook (€4.39 in chips) 
Seat 6: SalahUbeen (€2.30 in chips) 
caduceus369: posts small blind €0.01
pistaKKio23: posts big blind €0.02
*** HOLE CARDS ***
Dealt to caduceus369 [Qs 8s]
Cruelplace84: folds 
BetNoLook: raises €0.05 to €0.07
SalahUbeen: folds 
deojking: folds 
caduceus369: folds 
pistaKKio23: folds 
Uncalled bet (€0.05) returned to BetNoLook
BetNoLook collected €0.05 from pot
BetNoLook: doesn't show hand 
*** SUMMARY ***
Total pot €0.05 | Rake €0 
Seat 1: deojking (button) folded before Flop (didn't bet)
Seat 2: caduceus369 (small blind) folded before Flop
Seat 3: pistaKKio23 (big blind) folded before Flop
Seat 4: Cruelplace84 folded before Flop (didn't bet)
Seat 5: BetNoLook collected (€0.05)
Seat 6: SalahUbeen folded before Flop (didn't bet)



PokerStars Zoom Hand #257984251741:  Hold'em No Limit (€0.01/€0.02) [ADM ID: M62BA304494E32ST] - 2025/10/03 18:41:01 CET [2025/10/03 12:41:01 ET]
Table 'Sirio' 6-max Seat #1 is the button
Seat 1: caduceus369 (€3.72 in chips) 
Seat 2: Emm3B1 (€2.37 in chips) 
Seat 3: Cruelplace84 (€2.78 in chips) 
Seat 4: shakthi (€1.47 in chips) 
Seat 5: deojking (€1.26 in chips) 
Seat 6: BetNoLook (€4.39 in chips) 
Emm3B1: posts small blind €0.01
Cruelplace84: posts big blind €0.02
*** HOLE CARDS ***
Dealt to caduceus369 [9c 5s]
shakthi: folds 
deojking: folds 
BetNoLook: folds 
caduceus369: folds 
Emm3B1: raises €0.04 to €0.06
Cruelplace84: calls €0.04
*** FLOP *** [9d 7s Kc]
Emm3B1: checks 
Cruelplace84: checks 
*** TURN *** [9d 7s Kc] [6d]
Emm3B1: checks 
Cruelplace84: checks 
*** RIVER *** [9d 7s Kc 6d] [Ah]
Emm3B1: bets €0.08
Cruelplace84: folds 
Uncalled bet (€0.08) returned to Emm3B1
Emm3B1 collected €0.12 from pot
Emm3B1: doesn't show hand 
Emm3B1 is disconnected 
*** SUMMARY ***
Total pot €0.12 | Rake €0 
Board [9d 7s Kc 6d Ah]
Seat 1: caduceus369 (button) folded before Flop (didn't bet)
Seat 2: Emm3B1 (small blind) collected (€0.12)
Seat 3: Cruelplace84 (big blind) folded on the River
Seat 4: shakthi folded before Flop (didn't bet)
Seat 5: deojking folded before Flop (didn't bet)
Seat 6: BetNoLook folded before Flop (didn't bet)



PokerStars Zoom Hand #257984254584:  Hold'em No Limit (€0.01/€0.02) [ADM ID: M62BA304494E32ST] - 2025/10/03 18:41:16 CET [2025/10/03 12:41:16 ET]
Table 'Sirio' 6-max Seat #1 is the button
Seat 1: OMGWOLFX (€10.93 in chips) 
Seat 2: GanchanS7 (€2.01 in chips) 
Seat 3: SalahUbeen (€2.30 in chips) 
Seat 4: SidneyPrescott (€3.65 in chips) 
Seat 5: Cruelplace84 (€2.62 in chips) 
Seat 6: caduceus369 (€3.71 in chips) 
GanchanS7: posts small blind €0.01
SalahUbeen: posts big blind €0.02
*** HOLE CARDS ***
Dealt to caduceus369 [Qd 3h]
SidneyPrescott: raises €0.04 to €0.06
Cruelplace84: folds 
caduceus369: folds 
OMGWOLFX: folds 
GanchanS7: folds 
SalahUbeen: folds 
Uncalled bet (€0.04) returned to SidneyPrescott
SidneyPrescott collected €0.05 from pot
SidneyPrescott: doesn't show hand 
*** SUMMARY ***
Total pot €0.05 | Rake €0 
Seat 1: OMGWOLFX (button) folded before Flop (didn't bet)
Seat 2: GanchanS7 (small blind) folded before Flop
Seat 3: SalahUbeen (big blind) folded before Flop
Seat 4: SidneyPrescott collected (€0.05)
Seat 5: Cruelplace84 folded before Flop (didn't bet)
Seat 6: caduceus369 folded before Flop (didn't bet)



PokerStars Zoom Hand #257984255207:  Hold'em No Limit (€0.01/€0.02) [ADM ID: M62BA304494E32ST] - 2025/10/03 18:41:19 CET [2025/10/03 12:41:19 ET]
Table 'Sirio' 6-max Seat #1 is the button
Seat 1: Spillo.RN (€1.52 in chips) 
Seat 2: Catania838 (€2.63 in chips) 
Seat 3: pylonstrip (€2.02 in chips) 
Seat 4: Paolino532 (€2.48 in chips) 
Seat 5: caduceus369 (€3.71 in chips) 
Seat 6: OSPREYSTORM (€2 in chips) 
Catania838: posts small blind €0.01
pylonstrip: posts big blind €0.02
*** HOLE CARDS ***
Dealt to caduceus369 [6c 3c]
Paolino532: calls €0.02
caduceus369: folds 
OSPREYSTORM: folds 
Spillo.RN: folds 
Catania838: folds 
pylonstrip: checks 
*** FLOP *** [Qh 3s 5c]
pylonstrip: checks 
Paolino532: bets €0.03
pylonstrip: calls €0.03
*** TURN *** [Qh 3s 5c] [Ks]
pylonstrip: checks 
Paolino532: checks 
*** RIVER *** [Qh 3s 5c Ks] [2h]
pylonstrip: checks 
Paolino532: bets €0.11
pylonstrip: folds 
Uncalled bet (€0.11) returned to Paolino532
Paolino532 collected €0.11 from pot
Paolino532: doesn't show hand 
*** SUMMARY ***
Total pot €0.11 | Rake €0 
Board [Qh 3s 5c Ks 2h]
Seat 1: Spillo.RN (button) folded before Flop (didn't bet)
Seat 2: Catania838 (small blind) folded before Flop
Seat 3: pylonstrip (big blind) folded on the River
Seat 4: Paolino532 collected (€0.11)
Seat 5: caduceus369 folded before Flop (didn't bet)
Seat 6: OSPREYSTORM folded before Flop (didn't bet)



PokerStars Zoom Hand #257984255852:  Hold'em No Limit (€0.01/€0.02) [ADM ID: M62BA304494E32ST] - 2025/10/03 18:41:22 CET [2025/10/03 12:41:22 ET]
Table 'Sirio' 6-max Seat #1 is the button
Seat 1: Sararafusa11 (€2.26 in chips) 
Seat 2: Spillo.RN (€1.52 in chips) 
Seat 3: jolli180 (€2.36 in chips) 
Seat 4: caduceus369 (€3.71 in chips) 
Seat 5: Genny040893 (€0.83 in chips) 
Seat 6: pistaKKio23 (€2.19 in chips) 
Spillo.RN: posts small blind €0.01
jolli180: posts big blind €0.02
*** HOLE CARDS ***
Dealt to caduceus369 [Qs 9s]
caduceus369: folds 
Genny040893: raises €0.14 to €0.16
pistaKKio23: folds 
Sararafusa11: folds 
Spillo.RN: folds 
jolli180: folds 
Uncalled bet (€0.14) returned to Genny040893
Genny040893 collected €0.05 from pot
Genny040893: doesn't show hand 
*** SUMMARY ***
Total pot €0.05 | Rake €0 
Seat 1: Sararafusa11 (button) folded before Flop (didn't bet)
Seat 2: Spillo.RN (small blind) folded before Flop
Seat 3: jolli180 (big blind) folded before Flop
Seat 4: caduceus369 folded before Flop (didn't bet)
Seat 5: Genny040893 collected (€0.05)
Seat 6: pistaKKio23 folded before Flop (didn't bet)



PokerStars Zoom Hand #257984256957:  Hold'em No Limit (€0.01/€0.02) [ADM ID: M62BA304494E32ST] - 2025/10/03 18:41:28 CET [2025/10/03 12:41:28 ET]
Table 'Sirio' 6-max Seat #1 is the button
Seat 1: caduceus369 (€3.71 in chips) 
Seat 2: SalahUbeen (€2.28 in chips) 
Seat 3: deojking (€2.76 in chips) 
Seat 4: BetNoLook (€4.42 in chips) 
Seat 5: OSPREYSTORM (€2.77 in chips) 
Seat 6: trillycata (€1.41 in chips) 
SalahUbeen: posts small blind €0.01
deojking: posts big blind €0.02
*** HOLE CARDS ***
Dealt to caduceus369 [Ac Kh]
BetNoLook: folds 
OSPREYSTORM: raises €0.04 to €0.06
trillycata: folds 
caduceus369: raises €0.12 to €0.18
SalahUbeen: folds 
deojking: folds 
OSPREYSTORM: calls €0.12
*** FLOP *** [Qh Qc Kd]
OSPREYSTORM: checks 
caduceus369: bets €0.15
OSPREYSTORM: calls €0.15
*** TURN *** [Qh Qc Kd] [7h]
OSPREYSTORM: checks 
caduceus369: bets €0.22
OSPREYSTORM: folds 
Uncalled bet (€0.22) returned to caduceus369
caduceus369 collected €0.66 from pot
caduceus369: doesn't show hand 
*** SUMMARY ***
Total pot €0.69 | Rake €0.03 
Board [Qh Qc Kd 7h]
Seat 1: caduceus369 (button) collected (€0.66)
Seat 2: SalahUbeen (small blind) folded before Flop
Seat 3: deojking (big blind) folded before Flop
Seat 4: BetNoLook folded before Flop (didn't bet)
Seat 5: OSPREYSTORM folded on the Turn
Seat 6: trillycata folded before Flop (didn't bet)



PokerStars Zoom Hand #257984269810:  Hold'em No Limit (€0.01/€0.02) [ADM ID: M62BA304494E32ST] - 2025/10/03 18:42:34 CET [2025/10/03 12:42:34 ET]
Table 'Sirio' 6-max Seat #1 is the button
Seat 1: Miele69409 (€1.19 in chips) 
Seat 2: caduceus369 (€4.04 in chips) 
Seat 3: SidneyPrescott (€2.84 in chips) 
Seat 4: shakthi (€1.57 in chips) 
Seat 5: Gabrielefante (€2.57 in chips) 
Seat 6: parker1318 (€1.97 in chips) 
caduceus369: posts small blind €0.01
SidneyPrescott: posts big blind €0.02
*** HOLE CARDS ***
Dealt to caduceus369 [4s Kc]
shakthi: folds 
Gabrielefante: folds 
parker1318: raises €0.03 to €0.05
Miele69409: calls €0.05
caduceus369: folds 
SidneyPrescott: folds 
*** FLOP *** [Qs 9s Jh]
parker1318: checks 
Miele69409: bets €0.02
parker1318: calls €0.02
*** TURN *** [Qs 9s Jh] [8c]
parker1318: checks 
Miele69409: bets €0.17
parker1318: folds 
Uncalled bet (€0.17) returned to Miele69409
Miele69409 collected €0.17 from pot
Miele69409: doesn't show hand 
*** SUMMARY ***
Total pot €0.17 | Rake €0 
Board [Qs 9s Jh 8c]
Seat 1: Miele69409 (button) collected (€0.17)
Seat 2: caduceus369 (small blind) folded before Flop
Seat 3: SidneyPrescott (big blind) folded before Flop
Seat 4: shakthi folded before Flop (didn't bet)
Seat 5: Gabrielefante folded before Flop (didn't bet)
Seat 6: parker1318 folded on the Turn



PokerStars Zoom Hand #257984274085:  Hold'em No Limit (€0.01/€0.02) [ADM ID: M62BA304494E32ST] - 2025/10/03 18:42:56 CET [2025/10/03 12:42:56 ET]
Table 'Sirio' 6-max Seat #1 is the button
Seat 1: OMGWOLFX (€10.64 in chips) 
Seat 2: GanchanS7 (€2.07 in chips) 
Seat 3: Cruelplace84 (€2.72 in chips) 
Seat 4: pistaKKio23 (€2.63 in chips) 
Seat 5: luchino74 (€4.89 in chips) 
Seat 6: caduceus369 (€4.01 in chips) 
GanchanS7: posts small blind €0.01
Cruelplace84: posts big blind €0.02
*** HOLE CARDS ***
Dealt to caduceus369 [4s 9d]
pistaKKio23: folds 
luchino74: folds 
caduceus369: folds 
OMGWOLFX: folds 
GanchanS7: folds 
Uncalled bet (€0.01) returned to Cruelplace84
Cruelplace84 collected €0.02 from pot
Cruelplace84: doesn't show hand 
*** SUMMARY ***
Total pot €0.02 | Rake €0 
Seat 1: OMGWOLFX (button) folded before Flop (didn't bet)
Seat 2: GanchanS7 (small blind) folded before Flop
Seat 3: Cruelplace84 (big blind) collected (€0.02)
Seat 4: pistaKKio23 folded before Flop (didn't bet)
Seat 5: luchino74 folded before Flop (didn't bet)
Seat 6: caduceus369 folded before Flop (didn't bet)



PokerStars Zoom Hand #257984276695:  Hold'em No Limit (€0.01/€0.02) [ADM ID: M62BA304494E32ST] - 2025/10/03 18:43:09 CET [2025/10/03 12:43:09 ET]
Table 'Sirio' 6-max Seat #1 is the button
Seat 1: luchino74 (€2 in chips) 
Seat 2: Paolino532 (€2.68 in chips) 
Seat 3: OMGWOLFX (€4.61 in chips) 
Seat 4: Cruelplace84 (€3.18 in chips) 
Seat 5: caduceus369 (€4.01 in chips) 
Seat 6: pistaKKio23 (€2.16 in chips) 
Paolino532: posts small blind €0.01
OMGWOLFX: posts big blind €0.02
*** HOLE CARDS ***
Dealt to caduceus369 [7s Jd]
Cruelplace84: folds 
caduceus369: folds 
pistaKKio23: folds 
luchino74: raises €0.03 to €0.05
Paolino532: folds 
OMGWOLFX: folds 
Uncalled bet (€0.03) returned to luchino74
luchino74 collected €0.05 from pot
luchino74: doesn't show hand 
*** SUMMARY ***
Total pot €0.05 | Rake €0 
Seat 1: luchino74 (button) collected (€0.05)
Seat 2: Paolino532 (small blind) folded before Flop
Seat 3: OMGWOLFX (big blind) folded before Flop
Seat 4: Cruelplace84 folded before Flop (didn't bet)
Seat 5: caduceus369 folded before Flop (didn't bet)
Seat 6: pistaKKio23 folded before Flop (didn't bet)



PokerStars Zoom Hand #257984279772:  Hold'em No Limit (€0.01/€0.02) [ADM ID: M62BA304494E32ST] - 2025/10/03 18:43:25 CET [2025/10/03 12:43:25 ET]
Table 'Sirio' 6-max Seat #1 is the button
Seat 1: SidneyPrescott (€3.73 in chips) 
Seat 2: OSPREYSTORM (€2.41 in chips) 
Seat 3: caduceus369 (€4 in chips) 
Seat 4: potodds1979 (€2.03 in chips) 
Seat 5: OMGWOLFX (€4.05 in chips) 
Seat 6: luchino74 (€2.03 in chips) 
OSPREYSTORM: posts small blind €0.01
caduceus369: posts big blind €0.02
*** HOLE CARDS ***
Dealt to caduceus369 [As Jd]
potodds1979: folds 
OMGWOLFX has timed out while disconnected
OMGWOLFX: folds 
luchino74: folds 
SidneyPrescott: folds 
OSPREYSTORM: folds 
Uncalled bet (€0.01) returned to caduceus369
caduceus369 collected €0.02 from pot
caduceus369: doesn't show hand 
*** SUMMARY ***
Total pot €0.02 | Rake €0 
Seat 1: SidneyPrescott (button) folded before Flop (didn't bet)
Seat 2: OSPREYSTORM (small blind) folded before Flop
Seat 3: caduceus369 (big blind) collected (€0.02)
Seat 4: potodds1979 folded before Flop (didn't bet)
Seat 5: OMGWOLFX folded before Flop (didn't bet)
Seat 6: luchino74 folded before Flop (didn't bet)



PokerStars Zoom Hand #257984271180:  Hold'em No Limit (€0.01/€0.02) [ADM ID: M62BA304494E32ST] - 2025/10/03 18:42:41 CET [2025/10/03 12:42:41 ET]
Table 'Sirio' 6-max Seat #1 is the button
Seat 1: OSPREYSTORM (€2.43 in chips) 
Seat 2: ZefirDevil (€0.74 in chips) 
Seat 3: caduceus369 (€4.03 in chips) 
Seat 4: trillycata (€1.38 in chips) 
Seat 5: shakthi (€1.56 in chips) 
Seat 6: Cruelplace84 (€2.69 in chips) 
ZefirDevil: posts small blind €0.01
caduceus369: posts big blind €0.02
*** HOLE CARDS ***
Dealt to caduceus369 [5c 5h]
trillycata: raises €0.05 to €0.07
shakthi: raises €0.09 to €0.16
Cruelplace84: folds 
OSPREYSTORM: folds 
ZefirDevil: folds 
caduceus369: folds 
trillycata: calls €0.09
*** FLOP *** [Tc 7d 7s]
trillycata: checks 
shakthi: bets €0.17
trillycata: calls €0.17
*** TURN *** [Tc 7d 7s] [7c]
trillycata: checks 
shakthi: bets €0.33
trillycata: calls €0.33
*** RIVER *** [Tc 7d 7s 7c] [9h]
trillycata: checks 
shakthi: bets €0.90 and is all-in
trillycata: folds 
Uncalled bet (€0.90) returned to shakthi
shakthi collected €1.28 from pot
shakthi: doesn't show hand 
*** SUMMARY ***
Total pot €1.35 | Rake €0.07 
Board [Tc 7d 7s 7c 9h]
Seat 1: OSPREYSTORM (button) folded before Flop (didn't bet)
Seat 2: ZefirDevil (small blind) folded before Flop
Seat 3: caduceus369 (big blind) folded before Flop
Seat 4: trillycata folded on the River
Seat 5: shakthi collected (€1.28)
Seat 6: Cruelplace84 folded before Flop (didn't bet)



PokerStars Zoom Hand #257984275332:  Hold'em No Limit (€0.01/€0.02) [ADM ID: M62BA304494E32ST] - 2025/10/03 18:43:03 CET [2025/10/03 12:43:03 ET]
Table 'Sirio' 6-max Seat #1 is the button
Seat 1: SaTheNuts_77 (€6.52 in chips) 
Seat 2: QUATTRODAME (€2.02 in chips) 
Seat 3: Sararafusa11 (€2.66 in chips) 
Seat 4: caduceus369 (€4.01 in chips) 
Seat 5: OMGWOLFX (€10.64 in chips) 
Seat 6: stagniarihd (€2.57 in chips) 
QUATTRODAME: posts small blind €0.01
Sararafusa11: posts big blind €0.02
*** HOLE CARDS ***
Dealt to caduceus369 [6c Qs]
caduceus369: folds 
OMGWOLFX: folds 
stagniarihd: raises €0.02 to €0.04
SaTheNuts_77: raises €0.11 to €0.15
QUATTRODAME: folds 
Sararafusa11: folds 
stagniarihd: calls €0.11
*** FLOP *** [Qc 8d 5s]
stagniarihd: checks 
SaTheNuts_77: bets €0.08
stagniarihd: calls €0.08
*** TURN *** [Qc 8d 5s] [2c]
stagniarihd: checks 
SaTheNuts_77: bets €0.12
stagniarihd: calls €0.12
*** RIVER *** [Qc 8d 5s 2c] [9s]
stagniarihd: checks 
SaTheNuts_77: bets €0.51
stagniarihd: calls €0.51
*** SHOW DOWN ***
SaTheNuts_77: shows [Ah Jd] (high card Ace)
stagniarihd: shows [5d 5h] (three of a kind, Fives)
stagniarihd collected €1.66 from pot
*** SUMMARY ***
Total pot €1.75 | Rake €0.09 
Board [Qc 8d 5s 2c 9s]
Seat 1: SaTheNuts_77 (button) showed [Ah Jd] and lost with high card Ace
Seat 2: QUATTRODAME (small blind) folded before Flop
Seat 3: Sararafusa11 (big blind) folded before Flop
Seat 4: caduceus369 folded before Flop (didn't bet)
Seat 5: OMGWOLFX folded before Flop (didn't bet)
Seat 6: stagniarihd showed [5d 5h] and won (€1.66) with three of a kind, Fives



PokerStars Zoom Hand #257984278035:  Hold'em No Limit (€0.01/€0.02) [ADM ID: M62BA304494E32ST] - 2025/10/03 18:43:16 CET [2025/10/03 12:43:16 ET]
Table 'Sirio' 6-max Seat #1 is the button
Seat 1: pistaKKio23 (€3.19 in chips) 
Seat 2: caduceus369 (€4.01 in chips) 
Seat 3: GanchanS7 (€2.06 in chips) 
Seat 4: Kamiros01 (€3.27 in chips) 
Seat 5: themagnetich (€1.71 in chips) 
Seat 6: ZefirDevil (€0.67 in chips) 
caduceus369: posts small blind €0.01
GanchanS7: posts big blind €0.02
*** HOLE CARDS ***
Dealt to caduceus369 [4h 8c]
Kamiros01: folds 
themagnetich: raises €0.04 to €0.06
ZefirDevil: raises €0.12 to €0.18
pistaKKio23: folds 
caduceus369: folds 
GanchanS7: folds 
themagnetich: raises €1.53 to €1.71 and is all-in
ZefirDevil: calls €0.49 and is all-in
Uncalled bet (€1.04) returned to themagnetich
*** FLOP *** [Kd 8d Kc]
*** TURN *** [Kd 8d Kc] [7c]
*** RIVER *** [Kd 8d Kc 7c] [Js]
*** SHOW DOWN ***
themagnetich: shows [Jd Ad] (two pair, Kings and Jacks)
ZefirDevil: shows [9d 9h] (two pair, Kings and Nines)
themagnetich collected €1.30 from pot
*** SUMMARY ***
Total pot €1.37 | Rake €0.07 
Board [Kd 8d Kc 7c Js]
Seat 1: pistaKKio23 (button) folded before Flop (didn't bet)
Seat 2: caduceus369 (small blind) folded before Flop
Seat 3: GanchanS7 (big blind) folded before Flop
Seat 4: Kamiros01 folded before Flop (didn't bet)
Seat 5: themagnetich showed [Jd Ad] and won (€1.30) with two pair, Kings and Jacks
Seat 6: ZefirDevil showed [9d 9h] and lost with two pair, Kings and Nines



PokerStars Zoom Hand #257984277440:  Hold'em No Limit (€0.01/€0.02) [ADM ID: M62BA304494E32ST] - 2025/10/03 18:43:13 CET [2025/10/03 12:43:13 ET]
Table 'Sirio' 6-max Seat #1 is the button
Seat 1: Paolino532 (€2.67 in chips) 
Seat 2: Cruelplace84 (€2.73 in chips) 
Seat 3: SalahUbeen (€1.65 in chips) 
Seat 4: caduceus369 (€4.01 in chips) 
Seat 5: nonnapapera3 (€1.23 in chips) 
Seat 6: SidneyPrescott (€2 in chips) 
Cruelplace84: posts small blind €0.01
SalahUbeen: posts big blind €0.02
*** HOLE CARDS ***
Dealt to caduceus369 [3d 6s]
caduceus369: folds 
nonnapapera3: folds 
SidneyPrescott: folds 
Paolino532: calls €0.02
Cruelplace84: calls €0.01
SalahUbeen: checks 
*** FLOP *** [Th 9s 3c]
Cruelplace84: checks 
SalahUbeen: checks 
Paolino532: checks 
*** TURN *** [Th 9s 3c] [5c]
Cruelplace84: checks 
SalahUbeen: checks 
Paolino532: checks 
*** RIVER *** [Th 9s 3c 5c] [Ts]
Cruelplace84: checks 
SalahUbeen: checks 
Paolino532: bets €0.02
Cruelplace84: folds 
SalahUbeen: folds 
Uncalled bet (€0.02) returned to Paolino532
Paolino532 collected €0.06 from pot
Paolino532: doesn't show hand 
*** SUMMARY ***
Total pot €0.06 | Rake €0 
Board [Th 9s 3c 5c Ts]
Seat 1: Paolino532 (button) collected (€0.06)
Seat 2: Cruelplace84 (small blind) folded on the River
Seat 3: SalahUbeen (big blind) folded on the River
Seat 4: caduceus369 folded before Flop (didn't bet)
Seat 5: nonnapapera3 folded before Flop (didn't bet)
Seat 6: SidneyPrescott folded before Flop (didn't bet)



PokerStars Zoom Hand #257984285225:  Hold'em No Limit (€0.01/€0.02) [ADM ID: M62BA304494E32ST] - 2025/10/03 18:43:53 CET [2025/10/03 12:43:53 ET]
Table 'Sirio' 6-max Seat #1 is the button
Seat 1: caduceus369 (€4.01 in chips) 
Seat 2: luchino74 (€4.90 in chips) 
Seat 3: felll444 (€0.80 in chips) 
Seat 4: Sararafusa11 (€2.63 in chips) 
Seat 5: trisco66 (€0.61 in chips) 
Seat 6: shakthi (€2.18 in chips) 
luchino74: posts small blind €0.01
felll444: posts big blind €0.02
*** HOLE CARDS ***
Dealt to caduceus369 [6h Ah]
Sararafusa11: folds 
trisco66: raises €0.59 to €0.61 and is all-in
shakthi: folds 
caduceus369: folds 
luchino74: folds 
felll444: folds 
Uncalled bet (€0.59) returned to trisco66
trisco66 collected €0.05 from pot
trisco66: doesn't show hand 
*** SUMMARY ***
Total pot €0.05 | Rake €0 
Seat 1: caduceus369 (button) folded before Flop (didn't bet)
Seat 2: luchino74 (small blind) folded before Flop
Seat 3: felll444 (big blind) folded before Flop
Seat 4: Sararafusa11 folded before Flop (didn't bet)
Seat 5: trisco66 collected (€0.05)
Seat 6: shakthi folded before Flop (didn't bet)



PokerStars Zoom Hand #257984287742:  Hold'em No Limit (€0.01/€0.02) [ADM ID: M62BA304494E32ST] - 2025/10/03 18:44:07 CET [2025/10/03 12:44:07 ET]
Table 'Sirio' 6-max Seat #1 is the button
Seat 1: Gabrielefante (€2.39 in chips) 
Seat 2: potodds1979 (€2.09 in chips) 
Seat 3: SidneyPrescott (€3.67 in chips) 
Seat 4: SalahUbeen (€1.63 in chips) 
Seat 5: labronicus58 (€2 in chips) 
Seat 6: caduceus369 (€4.01 in chips) 
potodds1979: posts small blind €0.01
SidneyPrescott: posts big blind €0.02
*** HOLE CARDS ***
Dealt to caduceus369 [5c 8h]
SalahUbeen: folds 
labronicus58: folds 
caduceus369: folds 
Gabrielefante: folds 
potodds1979: folds 
Uncalled bet (€0.01) returned to SidneyPrescott
SidneyPrescott collected €0.02 from pot
SidneyPrescott: doesn't show hand 
*** SUMMARY ***
Total pot €0.02 | Rake €0 
Seat 1: Gabrielefante (button) folded before Flop (didn't bet)
Seat 2: potodds1979 (small blind) folded before Flop
Seat 3: SidneyPrescott (big blind) collected (€0.02)
Seat 4: SalahUbeen folded before Flop (didn't bet)
Seat 5: labronicus58 folded before Flop (didn't bet)
Seat 6: caduceus369 folded before Flop (didn't bet)



PokerStars Zoom Hand #257984283899:  Hold'em No Limit (€0.01/€0.02) [ADM ID: M62BA304494E32ST] - 2025/10/03 18:43:46 CET [2025/10/03 12:43:46 ET]
Table 'Sirio' 6-max Seat #1 is the button
Seat 1: Catania838 (€2.57 in chips) 
Seat 2: Spillo.RN (€1.35 in chips) 
Seat 3: Gabrielefante (€2.41 in chips) 
Seat 4: SidneyPrescott (€2 in chips) 
Seat 5: caduceus369 (€4.01 in chips) 
Seat 6: trillycata (€0.72 in chips) 
Spillo.RN: posts small blind €0.01
Gabrielefante: posts big blind €0.02
*** HOLE CARDS ***
Dealt to caduceus369 [9s 2s]
SidneyPrescott: folds 
caduceus369: folds 
trillycata: calls €0.02
Catania838: folds 
Spillo.RN: raises €0.04 to €0.06
Gabrielefante: folds 
trillycata: calls €0.04
*** FLOP *** [Ks 7h 6c]
Spillo.RN: bets €0.07
trillycata: raises €0.07 to €0.14
Spillo.RN: folds 
Uncalled bet (€0.07) returned to trillycata
trillycata collected €0.27 from pot
trillycata: doesn't show hand 
*** SUMMARY ***
Total pot €0.28 | Rake €0.01 
Board [Ks 7h 6c]
Seat 1: Catania838 (button) folded before Flop (didn't bet)
Seat 2: Spillo.RN (small blind) folded on the Flop
Seat 3: Gabrielefante (big blind) folded before Flop
Seat 4: SidneyPrescott folded before Flop (didn't bet)
Seat 5: caduceus369 folded before Flop (didn't bet)
Seat 6: trillycata collected (€0.27)



PokerStars Zoom Hand #257984289063:  Hold'em No Limit (€0.01/€0.02) [ADM ID: M62BA304494E32ST] - 2025/10/03 18:44:13 CET [2025/10/03 12:44:13 ET]
Table 'Sirio' 6-max Seat #1 is the button
Seat 1: felll444 (€0.77 in chips) 
Seat 2: shakthi (€2.16 in chips) 
Seat 3: caduceus369 (€4.01 in chips) 
Seat 4: trisco66 (€0.64 in chips) 
Seat 5: Kamiros01 (€3.27 in chips) 
Seat 6: potodds1979 (€2.08 in chips) 
shakthi: posts small blind €0.01
caduceus369: posts big blind €0.02
*** HOLE CARDS ***
Dealt to caduceus369 [Jc Kh]
trisco66: raises €0.62 to €0.64 and is all-in
Kamiros01: folds 
potodds1979: folds 
felll444: folds 
shakthi: folds 
caduceus369: folds 
Uncalled bet (€0.62) returned to trisco66
trisco66 collected €0.05 from pot
trisco66: doesn't show hand 
*** SUMMARY ***
Total pot €0.05 | Rake €0 
Seat 1: felll444 (button) folded before Flop (didn't bet)
Seat 2: shakthi (small blind) folded before Flop
Seat 3: caduceus369 (big blind) folded before Flop
Seat 4: trisco66 collected (€0.05)
Seat 5: Kamiros01 folded before Flop (didn't bet)
Seat 6: potodds1979 folded before Flop (didn't bet)



PokerStars Zoom Hand #257984293018:  Hold'em No Limit (€0.01/€0.02) [ADM ID: M62BA304494E32ST] - 2025/10/03 18:44:34 CET [2025/10/03 12:44:34 ET]
Table 'Sirio' 6-max Seat #1 is the button
Seat 1: SalahUbeen (€2.24 in chips) 
Seat 2: caduceus369 (€3.99 in chips) 
Seat 3: shakthi (€2.15 in chips) 
Seat 4: Cruelplace84 (€2.42 in chips) 
Seat 5: OSPREYSTORM (€2.14 in chips) 
Seat 6: QUATTRODAME (€1.96 in chips) 
caduceus369: posts small blind €0.01
shakthi: posts big blind €0.02
*** HOLE CARDS ***
Dealt to caduceus369 [9c 5s]
Cruelplace84: folds 
OSPREYSTORM: raises €0.04 to €0.06
QUATTRODAME: calls €0.06
SalahUbeen: calls €0.06
caduceus369: folds 
shakthi: folds 
*** FLOP *** [3c 6h 5d]
OSPREYSTORM: checks 
QUATTRODAME: checks 
SalahUbeen: checks 
*** TURN *** [3c 6h 5d] [9h]
OSPREYSTORM: checks 
QUATTRODAME: checks 
SalahUbeen: bets €0.16
OSPREYSTORM: calls €0.16
QUATTRODAME: folds 
*** RIVER *** [3c 6h 5d 9h] [7c]
OSPREYSTORM: checks 
SalahUbeen: checks 
*** SHOW DOWN ***
OSPREYSTORM: shows [8s 8h] (a straight, Five to Nine)
SalahUbeen: mucks hand 
OSPREYSTORM collected €0.51 from pot
*** SUMMARY ***
Total pot €0.53 | Rake €0.02 
Board [3c 6h 5d 9h 7c]
Seat 1: SalahUbeen (button) mucked [Kd 9d]
Seat 2: caduceus369 (small blind) folded before Flop
Seat 3: shakthi (big blind) folded before Flop
Seat 4: Cruelplace84 folded before Flop (didn't bet)
Seat 5: OSPREYSTORM showed [8s 8h] and won (€0.51) with a straight, Five to Nine
Seat 6: QUATTRODAME folded on the Turn



PokerStars Zoom Hand #257984293597:  Hold'em No Limit (€0.01/€0.02) [ADM ID: M62BA304494E32ST] - 2025/10/03 18:44:37 CET [2025/10/03 12:44:37 ET]
Table 'Sirio' 6-max Seat #1 is the button
Seat 1: caduceus369 (€3.98 in chips) 
Seat 2: Cruelplace84 (€3.38 in chips) 
Seat 3: Kamiros01 (€3.26 in chips) 
Seat 4: pistaKKio23 (€3.15 in chips) 
Seat 5: SidneyPrescott (€2 in chips) 
Seat 6: trisco66 (€0.67 in chips) 
Cruelplace84: posts small blind €0.01
Kamiros01: posts big blind €0.02
*** HOLE CARDS ***
Dealt to caduceus369 [Ad 6d]
pistaKKio23 has timed out
pistaKKio23: folds 
SidneyPrescott: raises €0.04 to €0.06
trisco66: folds 
caduceus369: folds 
Cruelplace84: folds 
Kamiros01: calls €0.04
*** FLOP *** [8c 5h As]
Kamiros01: checks 
SidneyPrescott: bets €0.08
Kamiros01: folds 
Uncalled bet (€0.08) returned to SidneyPrescott
SidneyPrescott collected €0.13 from pot
SidneyPrescott: doesn't show hand 
*** SUMMARY ***
Total pot €0.13 | Rake €0 
Board [8c 5h As]
Seat 1: caduceus369 (button) folded before Flop (didn't bet)
Seat 2: Cruelplace84 (small blind) folded before Flop
Seat 3: Kamiros01 (big blind) folded on the Flop
Seat 4: pistaKKio23 folded before Flop (didn't bet)
Seat 5: SidneyPrescott collected (€0.13)
Seat 6: trisco66 folded before Flop (didn't bet)



PokerStars Zoom Hand #257984288303:  Hold'em No Limit (€0.01/€0.02) [ADM ID: M62BA304494E32ST] - 2025/10/03 18:44:09 CET [2025/10/03 12:44:09 ET]
Table 'Sirio' 6-max Seat #1 is the button
Seat 1: pistaKKio23 (€2.60 in chips) 
Seat 2: mariokart137 (€4.19 in chips) 
Seat 3: GanchanS7 (€2.26 in chips) 
Seat 4: caduceus369 (€4.01 in chips) 
Seat 5: potodds1979 (€2.08 in chips) 
Seat 6: Cruelplace84 (€4.13 in chips) 
mariokart137: posts small blind €0.01
GanchanS7: posts big blind €0.02
*** HOLE CARDS ***
Dealt to caduceus369 [3s 8h]
caduceus369: folds 
potodds1979: folds 
Cruelplace84: raises €0.03 to €0.05
pistaKKio23: calls €0.05
mariokart137: folds 
GanchanS7: calls €0.03
*** FLOP *** [6d 9s 5s]
GanchanS7: checks 
Cruelplace84: bets €0.12
pistaKKio23: calls €0.12
GanchanS7: folds 
*** TURN *** [6d 9s 5s] [4s]
Cruelplace84: bets €0.25
pistaKKio23: calls €0.25
*** RIVER *** [6d 9s 5s 4s] [Qc]
Cruelplace84: checks 
pistaKKio23: bets €0.86
Cruelplace84: folds 
Uncalled bet (€0.86) returned to pistaKKio23
pistaKKio23 collected €0.86 from pot
pistaKKio23: doesn't show hand 
*** SUMMARY ***
Total pot €0.90 | Rake €0.04 
Board [6d 9s 5s 4s Qc]
Seat 1: pistaKKio23 (button) collected (€0.86)
Seat 2: mariokart137 (small blind) folded before Flop
Seat 3: GanchanS7 (big blind) folded on the Flop
Seat 4: caduceus369 folded before Flop (didn't bet)
Seat 5: potodds1979 folded before Flop (didn't bet)
Seat 6: Cruelplace84 folded on the River



PokerStars Zoom Hand #257984297301:  Hold'em No Limit (€0.01/€0.02) [ADM ID: M62BA304494E32ST] - 2025/10/03 18:44:56 CET [2025/10/03 12:44:56 ET]
Table 'Sirio' 6-max Seat #1 is the button
Seat 1: SalahUbeen (€2.68 in chips) 
Seat 2: luchino74 (€4.87 in chips) 
Seat 3: Paolino532 (€2.79 in chips) 
Seat 4: SidneyPrescott (€2.27 in chips) 
Seat 5: caduceus369 (€3.98 in chips) 
Seat 6: S'dj83 (€4.59 in chips) 
luchino74: posts small blind €0.01
Paolino532: posts big blind €0.02
*** HOLE CARDS ***
Dealt to caduceus369 [8h 9h]
SidneyPrescott: folds 
caduceus369: calls €0.02
S'dj83: folds 
SalahUbeen: folds 
luchino74: folds 
Paolino532: checks 
*** FLOP *** [3c 8c Qh]
Paolino532: checks 
caduceus369: bets €0.02
Paolino532: raises €0.02 to €0.04
caduceus369: calls €0.02
*** TURN *** [3c 8c Qh] [Js]
Paolino532: checks 
caduceus369: checks 
*** RIVER *** [3c 8c Qh Js] [9s]
Paolino532: checks 
caduceus369: bets €0.14
Paolino532: calls €0.14
*** SHOW DOWN ***
caduceus369: shows [8h 9h] (two pair, Nines and Eights)
Paolino532: mucks hand 
caduceus369 collected €0.39 from pot
*** SUMMARY ***
Total pot €0.41 | Rake €0.02 
Board [3c 8c Qh Js 9s]
Seat 1: SalahUbeen (button) folded before Flop (didn't bet)
Seat 2: luchino74 (small blind) folded before Flop
Seat 3: Paolino532 (big blind) mucked [5s Qs]
Seat 4: SidneyPrescott folded before Flop (didn't bet)
Seat 5: caduceus369 showed [8h 9h] and won (€0.39) with two pair, Nines and Eights
Seat 6: S'dj83 folded before Flop (didn't bet)



PokerStars Zoom Hand #257984311511:  Hold'em No Limit (€0.01/€0.02) [ADM ID: M62BA304494E32ST] - 2025/10/03 18:46:09 CET [2025/10/03 12:46:09 ET]
Table 'Sirio' 6-max Seat #1 is the button
Seat 1: GanchanS7 (€4.36 in chips) 
Seat 2: caduceus369 (€4.17 in chips) 
Seat 3: Catania838 (€6.20 in chips) 
Seat 4: parker1318 (€1.78 in chips) 
Seat 5: Teriferro (€1.11 in chips) 
Seat 6: OMGWOLFX (€4.53 in chips) 
caduceus369: posts small blind €0.01
Catania838: posts big blind €0.02
*** HOLE CARDS ***
Dealt to caduceus369 [2d Jc]
parker1318: folds 
Teriferro: folds 
OMGWOLFX: raises €0.04 to €0.06
GanchanS7: folds 
caduceus369: folds 
Catania838: folds 
Uncalled bet (€0.04) returned to OMGWOLFX
OMGWOLFX collected €0.05 from pot
OMGWOLFX: doesn't show hand 
*** SUMMARY ***
Total pot €0.05 | Rake €0 
Seat 1: GanchanS7 (button) folded before Flop (didn't bet)
Seat 2: caduceus369 (small blind) folded before Flop
Seat 3: Catania838 (big blind) folded before Flop
Seat 4: parker1318 folded before Flop (didn't bet)
Seat 5: Teriferro folded before Flop (didn't bet)
Seat 6: OMGWOLFX collected (€0.05)



PokerStars Zoom Hand #257984309774:  Hold'em No Limit (€0.01/€0.02) [ADM ID: M62BA304494E32ST] - 2025/10/03 18:46:00 CET [2025/10/03 12:46:00 ET]
Table 'Sirio' 6-max Seat #1 is the button
Seat 1: potodds1979 (€2.27 in chips) 
Seat 2: luchino74 (€4.87 in chips) 
Seat 3: SalahUbeen (€2.04 in chips) 
Seat 4: SaTheNuts_77 (€5.77 in chips) 
Seat 5: Catania838 (€6.20 in chips) 
Seat 6: caduceus369 (€4.17 in chips) 
luchino74: posts small blind €0.01
SalahUbeen: posts big blind €0.02
*** HOLE CARDS ***
Dealt to caduceus369 [6c 8s]
SaTheNuts_77: folds 
Catania838: folds 
caduceus369: folds 
potodds1979: raises €0.04 to €0.06
luchino74: folds 
SalahUbeen: calls €0.04
*** FLOP *** [6d Ac 7c]
SalahUbeen: checks 
potodds1979: bets €0.07
SalahUbeen: folds 
Uncalled bet (€0.07) returned to potodds1979
potodds1979 collected €0.13 from pot
potodds1979: doesn't show hand 
*** SUMMARY ***
Total pot €0.13 | Rake €0 
Board [6d Ac 7c]
Seat 1: potodds1979 (button) collected (€0.13)
Seat 2: luchino74 (small blind) folded before Flop
Seat 3: SalahUbeen (big blind) folded on the Flop
Seat 4: SaTheNuts_77 folded before Flop (didn't bet)
Seat 5: Catania838 folded before Flop (didn't bet)
Seat 6: caduceus369 folded before Flop (didn't bet)



PokerStars Zoom Hand #257984313228:  Hold'em No Limit (€0.01/€0.02) [ADM ID: M62BA304494E32ST] - 2025/10/03 18:46:18 CET [2025/10/03 12:46:18 ET]
Table 'Sirio' 6-max Seat #1 is the button
Seat 1: luchino74 (€2 in chips) 
Seat 2: Catania838 (€6.18 in chips) 
Seat 3: parker1318 (€1.78 in chips) 
Seat 4: Cruelplace84 (€3.61 in chips) 
Seat 5: caduceus369 (€4.16 in chips) 
Seat 6: GanchanS7 (€4.36 in chips) 
Catania838: posts small blind €0.01
parker1318: posts big blind €0.02
*** HOLE CARDS ***
Dealt to caduceus369 [Td 3s]
Cruelplace84: folds 
caduceus369: folds 
GanchanS7: folds 
luchino74: folds 
Catania838: folds 
Uncalled bet (€0.01) returned to parker1318
parker1318 collected €0.02 from pot
parker1318: doesn't show hand 
*** SUMMARY ***
Total pot €0.02 | Rake €0 
Seat 1: luchino74 (button) folded before Flop (didn't bet)
Seat 2: Catania838 (small blind) folded before Flop
Seat 3: parker1318 (big blind) collected (€0.02)
Seat 4: Cruelplace84 folded before Flop (didn't bet)
Seat 5: caduceus369 folded before Flop (didn't bet)
Seat 6: GanchanS7 folded before Flop (didn't bet)



PokerStars Zoom Hand #257984314570:  Hold'em No Limit (€0.01/€0.02) [ADM ID: M62BA304494E32ST] - 2025/10/03 18:46:25 CET [2025/10/03 12:46:25 ET]
Table 'Sirio' 6-max Seat #1 is the button
Seat 1: Catania838 (€2.63 in chips) 
Seat 2: Sararafusa11 (€2.66 in chips) 
Seat 3: caduceus369 (€4.16 in chips) 
Seat 4: Cruelplace84 (€3.54 in chips) 
Seat 5: GanchanS7 (€4.36 in chips) 
Seat 6: pylonstrip (€2.13 in chips) 
Sararafusa11: posts small blind €0.01
caduceus369: posts big blind €0.02
*** HOLE CARDS ***
Dealt to caduceus369 [3s As]
Cruelplace84: folds 
GanchanS7: folds 
pylonstrip: folds 
Catania838: folds 
Sararafusa11: folds 
Uncalled bet (€0.01) returned to caduceus369
caduceus369 collected €0.02 from pot
caduceus369: doesn't show hand 
*** SUMMARY ***
Total pot €0.02 | Rake €0 
Seat 1: Catania838 (button) folded before Flop (didn't bet)
Seat 2: Sararafusa11 (small blind) folded before Flop
Seat 3: caduceus369 (big blind) collected (€0.02)
Seat 4: Cruelplace84 folded before Flop (didn't bet)
Seat 5: GanchanS7 folded before Flop (didn't bet)
Seat 6: pylonstrip folded before Flop (didn't bet)



PokerStars Zoom Hand #257984317859:  Hold'em No Limit (€0.01/€0.02) [ADM ID: M62BA304494E32ST] - 2025/10/03 18:46:42 CET [2025/10/03 12:46:42 ET]
Table 'Sirio' 6-max Seat #1 is the button
Seat 1: caduceus369 (€4.17 in chips) 
Seat 2: nonnapapera3 (€1.08 in chips) 
Seat 3: stfuplzudonk (€2 in chips) 
Seat 4: pylonstrip (€2.13 in chips) 
Seat 5: pistaKKio23 (€2.97 in chips) 
Seat 6: mariokart137 (€4.39 in chips) 
nonnapapera3: posts small blind €0.01
stfuplzudonk: posts big blind €0.02
*** HOLE CARDS ***
Dealt to caduceus369 [6c Td]
pylonstrip: folds 
pistaKKio23: folds 
mariokart137: folds 
caduceus369: folds 
nonnapapera3: calls €0.01
stfuplzudonk: raises €0.06 to €0.08
nonnapapera3: folds 
Uncalled bet (€0.06) returned to stfuplzudonk
stfuplzudonk collected €0.04 from pot
stfuplzudonk: doesn't show hand 
*** SUMMARY ***
Total pot €0.04 | Rake €0 
Seat 1: caduceus369 (button) folded before Flop (didn't bet)
Seat 2: nonnapapera3 (small blind) folded before Flop
Seat 3: stfuplzudonk (big blind) collected (€0.04)
Seat 4: pylonstrip folded before Flop (didn't bet)
Seat 5: pistaKKio23 folded before Flop (didn't bet)
Seat 6: mariokart137 folded before Flop (didn't bet)



PokerStars Zoom Hand #257984319186:  Hold'em No Limit (€0.01/€0.02) [ADM ID: M62BA304494E32ST] - 2025/10/03 18:46:49 CET [2025/10/03 12:46:49 ET]
Table 'Sirio' 6-max Seat #1 is the button
Seat 1: Miele69409 (€1.11 in chips) 
Seat 2: stfuplzudonk (€2.01 in chips) 
Seat 3: potodds1979 (€2.33 in chips) 
Seat 4: SalahUbeen (€1.98 in chips) 
Seat 5: caduceus369 (€4.17 in chips) 
Seat 6: Catania838 (€2.15 in chips) 
stfuplzudonk: posts small blind €0.01
potodds1979: posts big blind €0.02
*** HOLE CARDS ***
Dealt to caduceus369 [9s 8c]
SalahUbeen: folds 
caduceus369: folds 
Catania838: folds 
Miele69409: raises €0.08 to €0.10
stfuplzudonk: folds 
potodds1979: folds 
Uncalled bet (€0.08) returned to Miele69409
Miele69409 collected €0.05 from pot
Miele69409: doesn't show hand 
*** SUMMARY ***
Total pot €0.05 | Rake €0 
Seat 1: Miele69409 (button) collected (€0.05)
Seat 2: stfuplzudonk (small blind) folded before Flop
Seat 3: potodds1979 (big blind) folded before Flop
Seat 4: SalahUbeen folded before Flop (didn't bet)
Seat 5: caduceus369 folded before Flop (didn't bet)
Seat 6: Catania838 folded before Flop (didn't bet)



PokerStars Zoom Hand #257984318618:  Hold'em No Limit (€0.01/€0.02) [ADM ID: M62BA304494E32ST] - 2025/10/03 18:46:46 CET [2025/10/03 12:46:46 ET]
Table 'Sirio' 6-max Seat #1 is the button
Seat 1: trillycata (€0.80 in chips) 
Seat 2: Catania838 (€2.16 in chips) 
Seat 3: mariokart137 (€4.39 in chips) 
Seat 4: GanchanS7 (€4.27 in chips) 
Seat 5: OSPREYSTORM (€2.78 in chips) 
Seat 6: caduceus369 (€4.17 in chips) 
Catania838: posts small blind €0.01
mariokart137: posts big blind €0.02
*** HOLE CARDS ***
Dealt to caduceus369 [4d Ts]
GanchanS7: folds 
OSPREYSTORM: folds 
caduceus369: folds 
trillycata: calls €0.02
Catania838: folds 
mariokart137: checks 
*** FLOP *** [Qs 4c Kd]
mariokart137: checks 
trillycata: bets €0.04
mariokart137: folds 
Uncalled bet (€0.04) returned to trillycata
trillycata collected €0.05 from pot
trillycata: doesn't show hand 
*** SUMMARY ***
Total pot €0.05 | Rake €0 
Board [Qs 4c Kd]
Seat 1: trillycata (button) collected (€0.05)
Seat 2: Catania838 (small blind) folded before Flop
Seat 3: mariokart137 (big blind) folded on the Flop
Seat 4: GanchanS7 folded before Flop (didn't bet)
Seat 5: OSPREYSTORM folded before Flop (didn't bet)
Seat 6: caduceus369 folded before Flop (didn't bet)



PokerStars Zoom Hand #257984320759:  Hold'em No Limit (€0.01/€0.02) [ADM ID: M62BA304494E32ST] - 2025/10/03 18:46:58 CET [2025/10/03 12:46:58 ET]
Table 'Sirio' 6-max Seat #1 is the button
Seat 1: OSPREYSTORM (€2.44 in chips) 
Seat 2: Gabrielefante (€2.39 in chips) 
Seat 3: pistaKKio23 (€2.97 in chips) 
Seat 4: caduceus369 (€4.17 in chips) 
Seat 5: jolli180 (€1.84 in chips) 
Seat 6: shakthi (€2.11 in chips) 
Gabrielefante: posts small blind €0.01
pistaKKio23: posts big blind €0.02
*** HOLE CARDS ***
Dealt to caduceus369 [8s 8d]
caduceus369: calls €0.02
jolli180: folds 
shakthi: raises €0.04 to €0.06
OSPREYSTORM: folds 
Gabrielefante: folds 
pistaKKio23: folds 
caduceus369: calls €0.04
*** FLOP *** [5h Qc Kh]
caduceus369: checks 
shakthi: bets €0.08
caduceus369: folds 
Uncalled bet (€0.08) returned to shakthi
shakthi collected €0.15 from pot
shakthi: doesn't show hand 
*** SUMMARY ***
Total pot €0.15 | Rake €0 
Board [5h Qc Kh]
Seat 1: OSPREYSTORM (button) folded before Flop (didn't bet)
Seat 2: Gabrielefante (small blind) folded before Flop
Seat 3: pistaKKio23 (big blind) folded before Flop
Seat 4: caduceus369 folded on the Flop
Seat 5: jolli180 folded before Flop (didn't bet)
Seat 6: shakthi collected (€0.15)



PokerStars Zoom Hand #257984325797:  Hold'em No Limit (€0.01/€0.02) [ADM ID: M62BA304494E32ST] - 2025/10/03 18:47:25 CET [2025/10/03 12:47:25 ET]
Table 'Sirio' 6-max Seat #1 is the button
Seat 1: Sararafusa11 (€2.73 in chips) 
Seat 2: caduceus369 (€4.11 in chips) 
Seat 3: Catania838 (€6.20 in chips) 
Seat 4: GanchanS7 (€4.27 in chips) 
Seat 5: pistaKKio23 (€2.76 in chips) 
Seat 6: shakthi (€2.20 in chips) 
caduceus369: posts small blind €0.01
Catania838: posts big blind €0.02
*** HOLE CARDS ***
Dealt to caduceus369 [3h Td]
GanchanS7: folds 
pistaKKio23: folds 
shakthi: raises €0.04 to €0.06
Sararafusa11: folds 
caduceus369: folds 
Catania838: folds 
Uncalled bet (€0.04) returned to shakthi
shakthi collected €0.05 from pot
shakthi: doesn't show hand 
*** SUMMARY ***
Total pot €0.05 | Rake €0 
Seat 1: Sararafusa11 (button) folded before Flop (didn't bet)
Seat 2: caduceus369 (small blind) folded before Flop
Seat 3: Catania838 (big blind) folded before Flop
Seat 4: GanchanS7 folded before Flop (didn't bet)
Seat 5: pistaKKio23 folded before Flop (didn't bet)
Seat 6: shakthi collected (€0.05)



PokerStars Zoom Hand #257984324401:  Hold'em No Limit (€0.01/€0.02) [ADM ID: M62BA304494E32ST] - 2025/10/03 18:47:17 CET [2025/10/03 12:47:17 ET]
Table 'Sirio' 6-max Seat #1 is the button
Seat 1: Catania838 (€2.12 in chips) 
Seat 2: mariokart137 (€4.37 in chips) 
Seat 3: themagnetich (€2.58 in chips) 
Seat 4: caduceus369 (€4.11 in chips) 
Seat 5: Cruelplace84 (€2.74 in chips) 
Seat 6: Teriferro (€1.03 in chips) 
mariokart137: posts small blind €0.01
themagnetich: posts big blind €0.02
*** HOLE CARDS ***
Dealt to caduceus369 [3c 3d]
caduceus369: folds 
Cruelplace84: raises €0.03 to €0.05
Teriferro: folds 
Catania838: folds 
mariokart137: folds 
themagnetich: raises €0.11 to €0.16
Cruelplace84: calls €0.11
*** FLOP *** [8h 7h 7s]
themagnetich: bets €0.16
Cruelplace84: folds 
Uncalled bet (€0.16) returned to themagnetich
themagnetich collected €0.32 from pot
themagnetich: doesn't show hand 
*** SUMMARY ***
Total pot €0.33 | Rake €0.01 
Board [8h 7h 7s]
Seat 1: Catania838 (button) folded before Flop (didn't bet)
Seat 2: mariokart137 (small blind) folded before Flop
Seat 3: themagnetich (big blind) collected (€0.32)
Seat 4: caduceus369 folded before Flop (didn't bet)
Seat 5: Cruelplace84 folded on the Flop
Seat 6: Teriferro folded before Flop (didn't bet)



PokerStars Zoom Hand #257984326618:  Hold'em No Limit (€0.01/€0.02) [ADM ID: M62BA304494E32ST] - 2025/10/03 18:47:29 CET [2025/10/03 12:47:29 ET]
Table 'Sirio' 6-max Seat #1 is the button
Seat 1: Kamiros01 (€3.23 in chips) 
Seat 2: GanchanS7 (€2 in chips) 
Seat 3: caduceus369 (€4.10 in chips) 
Seat 4: potodds1979 (€2.38 in chips) 
Seat 5: S'dj83 (€4.49 in chips) 
Seat 6: OSPREYSTORM (€2.79 in chips) 
GanchanS7: posts small blind €0.01
caduceus369: posts big blind €0.02
*** HOLE CARDS ***
Dealt to caduceus369 [Ks Qs]
potodds1979: folds 
S'dj83: folds 
OSPREYSTORM: folds 
Kamiros01: folds 
GanchanS7: folds 
Uncalled bet (€0.01) returned to caduceus369
caduceus369 collected €0.02 from pot
caduceus369: doesn't show hand 
*** SUMMARY ***
Total pot €0.02 | Rake €0 
Seat 1: Kamiros01 (button) folded before Flop (didn't bet)
Seat 2: GanchanS7 (small blind) folded before Flop
Seat 3: caduceus369 (big blind) collected (€0.02)
Seat 4: potodds1979 folded before Flop (didn't bet)
Seat 5: S'dj83 folded before Flop (didn't bet)
Seat 6: OSPREYSTORM folded before Flop (didn't bet)



PokerStars Zoom Hand #257984329499:  Hold'em No Limit (€0.01/€0.02) [ADM ID: M62BA304494E32ST] - 2025/10/03 18:47:44 CET [2025/10/03 12:47:44 ET]
Table 'Sirio' 6-max Seat #1 is the button
Seat 1: Spillo.RN (€1.78 in chips) 
Seat 2: stfuplzudonk (€1.90 in chips) 
Seat 3: Cruelplace84 (€3.63 in chips) 
Seat 4: themagnetich (€2.74 in chips) 
Seat 5: Paolino532 (€2.59 in chips) 
Seat 6: caduceus369 (€4.11 in chips) 
stfuplzudonk: posts small blind €0.01
Cruelplace84: posts big blind €0.02
*** HOLE CARDS ***
Dealt to caduceus369 [5s 6c]
themagnetich: folds 
Paolino532: folds 
caduceus369: folds 
Spillo.RN: folds 
stfuplzudonk: calls €0.01
Cruelplace84: checks 
*** FLOP *** [Kd Kh Th]
stfuplzudonk: checks 
Cruelplace84: checks 
*** TURN *** [Kd Kh Th] [Td]
stfuplzudonk: checks 
Cruelplace84: checks 
*** RIVER *** [Kd Kh Th Td] [4d]
stfuplzudonk: checks 
Cruelplace84: checks 
*** SHOW DOWN ***
stfuplzudonk: shows [3h 6h] (two pair, Kings and Tens)
Cruelplace84: shows [2d 7c] (two pair, Kings and Tens - Seven kicker)
Cruelplace84 collected €0.04 from pot
*** SUMMARY ***
Total pot €0.04 | Rake €0 
Board [Kd Kh Th Td 4d]
Seat 1: Spillo.RN (button) folded before Flop (didn't bet)
Seat 2: stfuplzudonk (small blind) showed [3h 6h] and lost with two pair, Kings and Tens
Seat 3: Cruelplace84 (big blind) showed [2d 7c] and won (€0.04) with two pair, Kings and Tens
Seat 4: themagnetich folded before Flop (didn't bet)
Seat 5: Paolino532 folded before Flop (didn't bet)
Seat 6: caduceus369 folded before Flop (didn't bet)



PokerStars Zoom Hand #257984330436:  Hold'em No Limit (€0.01/€0.02) [ADM ID: M62BA304494E32ST] - 2025/10/03 18:47:50 CET [2025/10/03 12:47:50 ET]
Table 'Sirio' 6-max Seat #1 is the button
Seat 1: Catania838 (€6.17 in chips) 
Seat 2: caduceus369 (€4.11 in chips) 
Seat 3: Sararafusa11 (€2.73 in chips) 
Seat 4: Cruelplace84 (€3.58 in chips) 
Seat 5: SalahUbeen (€2.83 in chips) 
Seat 6: SaTheNuts_77 (€5.93 in chips) 
caduceus369: posts small blind €0.01
Sararafusa11: posts big blind €0.02
*** HOLE CARDS ***
Dealt to caduceus369 [8d Ks]
Cruelplace84: folds 
SalahUbeen: folds 
SaTheNuts_77: raises €0.03 to €0.05
Catania838: folds 
caduceus369: folds 
Sararafusa11: folds 
Uncalled bet (€0.03) returned to SaTheNuts_77
SaTheNuts_77 collected €0.05 from pot
SaTheNuts_77: doesn't show hand 
*** SUMMARY ***
Total pot €0.05 | Rake €0 
Seat 1: Catania838 (button) folded before Flop (didn't bet)
Seat 2: caduceus369 (small blind) folded before Flop
Seat 3: Sararafusa11 (big blind) folded before Flop
Seat 4: Cruelplace84 folded before Flop (didn't bet)
Seat 5: SalahUbeen folded before Flop (didn't bet)
Seat 6: SaTheNuts_77 collected (€0.05)



PokerStars Zoom Hand #257984336168:  Hold'em No Limit (€0.01/€0.02) [ADM ID: M62BA304494E32ST] - 2025/10/03 18:48:20 CET [2025/10/03 12:48:20 ET]
Table 'Sirio' 6-max Seat #1 is the button
Seat 1: Genny040893 (€1.40 in chips) 
Seat 2: parker1318 (€1.94 in chips) 
Seat 3: GanchanS7 (€2.23 in chips) 
Seat 4: caduceus369 (€4.10 in chips) 
Seat 5: pistaKKio23 (€2.06 in chips) 
Seat 6: themagnetich (€3.03 in chips) 
parker1318: posts small blind €0.01
GanchanS7: posts big blind €0.02
*** HOLE CARDS ***
Dealt to caduceus369 [5c Qh]
caduceus369: folds 
pistaKKio23: folds 
themagnetich: raises €0.04 to €0.06
Genny040893: folds 
parker1318: folds 
GanchanS7: folds 
Uncalled bet (€0.04) returned to themagnetich
themagnetich collected €0.05 from pot
themagnetich: doesn't show hand 
*** SUMMARY ***
Total pot €0.05 | Rake €0 
Seat 1: Genny040893 (button) folded before Flop (didn't bet)
Seat 2: parker1318 (small blind) folded before Flop
Seat 3: GanchanS7 (big blind) folded before Flop
Seat 4: caduceus369 folded before Flop (didn't bet)
Seat 5: pistaKKio23 folded before Flop (didn't bet)
Seat 6: themagnetich collected (€0.05)



PokerStars Zoom Hand #257984335306:  Hold'em No Limit (€0.01/€0.02) [ADM ID: M62BA304494E32ST] - 2025/10/03 18:48:16 CET [2025/10/03 12:48:16 ET]
Table 'Sirio' 6-max Seat #1 is the button
Seat 1: luchino74 (€5.32 in chips) 
Seat 2: themagnetich (€3.04 in chips) 
Seat 3: SaTheNuts_77 (€5.96 in chips) 
Seat 4: Teriferro (€0.52 in chips) 
Seat 5: Genny040893 (€1.40 in chips) 
Seat 6: caduceus369 (€4.10 in chips) 
themagnetich: posts small blind €0.01
SaTheNuts_77: posts big blind €0.02
*** HOLE CARDS ***
Dealt to caduceus369 [6h 3c]
Teriferro: folds 
Genny040893: folds 
caduceus369: folds 
luchino74: folds 
themagnetich: folds 
Uncalled bet (€0.01) returned to SaTheNuts_77
SaTheNuts_77 collected €0.02 from pot
SaTheNuts_77: doesn't show hand 
*** SUMMARY ***
Total pot €0.02 | Rake €0 
Seat 1: luchino74 (button) folded before Flop (didn't bet)
Seat 2: themagnetich (small blind) folded before Flop
Seat 3: SaTheNuts_77 (big blind) collected (€0.02)
Seat 4: Teriferro folded before Flop (didn't bet)
Seat 5: Genny040893 folded before Flop (didn't bet)
Seat 6: caduceus369 folded before Flop (didn't bet)



PokerStars Zoom Hand #257984334212:  Hold'em No Limit (€0.01/€0.02) [ADM ID: M62BA304494E32ST] - 2025/10/03 18:48:10 CET [2025/10/03 12:48:10 ET]
Table 'Sirio' 6-max Seat #1 is the button
Seat 1: GanchanS7 (€2.03 in chips) 
Seat 2: luchino74 (€2.25 in chips) 
Seat 3: marina41978 (€1.57 in chips) 
Seat 4: Gabrielefante (€2.28 in chips) 
Seat 5: caduceus369 (€4.10 in chips) 
Seat 6: stagniarihd (€2.92 in chips) 
luchino74: posts small blind €0.01
marina41978: posts big blind €0.02
*** HOLE CARDS ***
Dealt to caduceus369 [4s 3d]
Gabrielefante: calls €0.02
caduceus369: folds 
stagniarihd: calls €0.02
GanchanS7: folds 
luchino74: folds 
marina41978: checks 
*** FLOP *** [Ac 6c 8d]
marina41978: checks 
Gabrielefante: checks 
stagniarihd: bets €0.07
marina41978: folds 
Gabrielefante: folds 
Uncalled bet (€0.07) returned to stagniarihd
stagniarihd collected €0.07 from pot
stagniarihd: doesn't show hand 
*** SUMMARY ***
Total pot €0.07 | Rake €0 
Board [Ac 6c 8d]
Seat 1: GanchanS7 (button) folded before Flop (didn't bet)
Seat 2: luchino74 (small blind) folded before Flop
Seat 3: marina41978 (big blind) folded on the Flop
Seat 4: Gabrielefante folded on the Flop
Seat 5: caduceus369 folded before Flop (didn't bet)
Seat 6: stagniarihd collected (€0.07)



PokerStars Zoom Hand #257984337090:  Hold'em No Limit (€0.01/€0.02) [ADM ID: M62BA304494E32ST] - 2025/10/03 18:48:25 CET [2025/10/03 12:48:25 ET]
Table 'Sirio' 6-max Seat #1 is the button
Seat 1: Catania838 (€2.25 in chips) 
Seat 2: Spillo.RN (€1.76 in chips) 
Seat 3: caduceus369 (€4.10 in chips) 
Seat 4: GanchanS7 (€2.03 in chips) 
Seat 5: potodds1979 (€2.42 in chips) 
Seat 6: luchino74 (€5.32 in chips) 
Spillo.RN: posts small blind €0.01
caduceus369: posts big blind €0.02
*** HOLE CARDS ***
Dealt to caduceus369 [9c As]
GanchanS7: folds 
potodds1979: raises €0.04 to €0.06
luchino74: folds 
Catania838: folds 
Spillo.RN: folds 
caduceus369: calls €0.04
*** FLOP *** [6s 4d 7s]
caduceus369: bets €0.04
potodds1979: folds 
Uncalled bet (€0.04) returned to caduceus369
caduceus369 collected €0.13 from pot
caduceus369: doesn't show hand 
*** SUMMARY ***
Total pot €0.13 | Rake €0 
Board [6s 4d 7s]
Seat 1: Catania838 (button) folded before Flop (didn't bet)
Seat 2: Spillo.RN (small blind) folded before Flop
Seat 3: caduceus369 (big blind) collected (€0.13)
Seat 4: GanchanS7 folded before Flop (didn't bet)
Seat 5: potodds1979 folded on the Flop
Seat 6: luchino74 folded before Flop (didn't bet)



PokerStars Zoom Hand #257984333539:  Hold'em No Limit (€0.01/€0.02) [ADM ID: M62BA304494E32ST] - 2025/10/03 18:48:06 CET [2025/10/03 12:48:06 ET]
Table 'Sirio' 6-max Seat #1 is the button
Seat 1: caduceus369 (€4.10 in chips) 
Seat 2: stfuplzudonk (€2.10 in chips) 
Seat 3: mariokart137 (€4.24 in chips) 
Seat 4: Gabrielefante (€2.28 in chips) 
Seat 5: OSPREYSTORM (€2.45 in chips) 
Seat 6: S'dj83 (€4.46 in chips) 
stfuplzudonk: posts small blind €0.01
mariokart137: posts big blind €0.02
*** HOLE CARDS ***
Dealt to caduceus369 [9h 4s]
Gabrielefante: folds 
OSPREYSTORM: raises €0.04 to €0.06
S'dj83: folds 
caduceus369: folds 
stfuplzudonk: folds 
mariokart137: calls €0.04
*** FLOP *** [3c Td 5c]
mariokart137: bets €0.10
OSPREYSTORM: raises €0.15 to €0.25
mariokart137: folds 
Uncalled bet (€0.15) returned to OSPREYSTORM
OSPREYSTORM collected €0.32 from pot
OSPREYSTORM: doesn't show hand 
*** SUMMARY ***
Total pot €0.33 | Rake €0.01 
Board [3c Td 5c]
Seat 1: caduceus369 (button) folded before Flop (didn't bet)
Seat 2: stfuplzudonk (small blind) folded before Flop
Seat 3: mariokart137 (big blind) folded on the Flop
Seat 4: Gabrielefante folded before Flop (didn't bet)
Seat 5: OSPREYSTORM collected (€0.32)
Seat 6: S'dj83 folded before Flop (didn't bet)



PokerStars Zoom Hand #257984344661:  Hold'em No Limit (€0.01/€0.02) [ADM ID: M62BA304494E32ST] - 2025/10/03 18:49:05 CET [2025/10/03 12:49:05 ET]
Table 'Sirio' 6-max Seat #1 is the button
Seat 1: pistaKKio23 (€2.85 in chips) 
Seat 2: caduceus369 (€4.17 in chips) 
Seat 3: OSPREYSTORM (€2.61 in chips) 
Seat 4: stfuplzudonk (€2.10 in chips) 
Seat 5: ZefirDevil (€0.50 in chips) 
Seat 6: OMGWOLFX (€4.28 in chips) 
caduceus369: posts small blind €0.01
OSPREYSTORM: posts big blind €0.02
*** HOLE CARDS ***
Dealt to caduceus369 [5s Jc]
stfuplzudonk: raises €0.04 to €0.06
ZefirDevil: folds 
OMGWOLFX: folds 
pistaKKio23: folds 
caduceus369: folds 
OSPREYSTORM: folds 
Uncalled bet (€0.04) returned to stfuplzudonk
stfuplzudonk collected €0.05 from pot
stfuplzudonk: doesn't show hand 
*** SUMMARY ***
Total pot €0.05 | Rake €0 
Seat 1: pistaKKio23 (button) folded before Flop (didn't bet)
Seat 2: caduceus369 (small blind) folded before Flop
Seat 3: OSPREYSTORM (big blind) folded before Flop
Seat 4: stfuplzudonk collected (€0.05)
Seat 5: ZefirDevil folded before Flop (didn't bet)
Seat 6: OMGWOLFX folded before Flop (didn't bet)



PokerStars Zoom Hand #257984343396:  Hold'em No Limit (€0.01/€0.02) [ADM ID: M62BA304494E32ST] - 2025/10/03 18:48:58 CET [2025/10/03 12:48:58 ET]
Table 'Sirio' 6-max Seat #1 is the button
Seat 1: caduceus369 (€4.17 in chips) 
Seat 2: Gabrielefante (€2.27 in chips) 
Seat 3: potodds1979 (€2.36 in chips) 
Seat 4: kolain17 (€0.77 in chips) 
Seat 5: GanchanS7 (€2.20 in chips) 
Seat 6: Cruelplace84 (€3.42 in chips) 
Gabrielefante: posts small blind €0.01
potodds1979: posts big blind €0.02
*** HOLE CARDS ***
Dealt to caduceus369 [Jc 6s]
kolain17: calls €0.02
GanchanS7: folds 
Cruelplace84: folds 
caduceus369: folds 
Gabrielefante: folds 
potodds1979: checks 
*** FLOP *** [Kc 8c Th]
potodds1979: checks 
kolain17: bets €0.05
potodds1979: folds 
Uncalled bet (€0.05) returned to kolain17
kolain17 collected €0.05 from pot
kolain17: doesn't show hand 
*** SUMMARY ***
Total pot €0.05 | Rake €0 
Board [Kc 8c Th]
Seat 1: caduceus369 (button) folded before Flop (didn't bet)
Seat 2: Gabrielefante (small blind) folded before Flop
Seat 3: potodds1979 (big blind) folded on the Flop
Seat 4: kolain17 collected (€0.05)
Seat 5: GanchanS7 folded before Flop (didn't bet)
Seat 6: Cruelplace84 folded before Flop (didn't bet)



PokerStars Zoom Hand #257984342211:  Hold'em No Limit (€0.01/€0.02) [ADM ID: M62BA304494E32ST] - 2025/10/03 18:48:52 CET [2025/10/03 12:48:52 ET]
Table 'Sirio' 6-max Seat #1 is the button
Seat 1: Gabrielefante (€2.27 in chips) 
Seat 2: QUATTRODAME (€1.52 in chips) 
Seat 3: parker1318 (€1.96 in chips) 
Seat 4: Cruelplace84 (€3.65 in chips) 
Seat 5: caduceus369 (€4.17 in chips) 
Seat 6: potodds1979 (€2.36 in chips) 
QUATTRODAME: posts small blind €0.01
parker1318: posts big blind €0.02
*** HOLE CARDS ***
Dealt to caduceus369 [Kh 4s]
Cruelplace84: raises €0.03 to €0.05
caduceus369: folds 
potodds1979: folds 
Gabrielefante: folds 
QUATTRODAME: calls €0.04
parker1318: folds 
*** FLOP *** [Tc 6c 5s]
QUATTRODAME: checks 
Cruelplace84: bets €0.10
QUATTRODAME: calls €0.10
*** TURN *** [Tc 6c 5s] [Ts]
QUATTRODAME: bets €0.31
Cruelplace84: raises €3.19 to €3.50 and is all-in
QUATTRODAME: calls €1.06 and is all-in
Uncalled bet (€2.13) returned to Cruelplace84
*** RIVER *** [Tc 6c 5s Ts] [5d]
*** SHOW DOWN ***
QUATTRODAME: shows [6h 6s] (a full house, Sixes full of Tens)
Cruelplace84: shows [Qh Qc] (two pair, Queens and Tens)
QUATTRODAME collected €2.90 from pot
*** SUMMARY ***
Total pot €3.06 | Rake €0.16 
Board [Tc 6c 5s Ts 5d]
Seat 1: Gabrielefante (button) folded before Flop (didn't bet)
Seat 2: QUATTRODAME (small blind) showed [6h 6s] and won (€2.90) with a full house, Sixes full of Tens
Seat 3: parker1318 (big blind) folded before Flop
Seat 4: Cruelplace84 showed [Qh Qc] and lost with two pair, Queens and Tens
Seat 5: caduceus369 folded before Flop (didn't bet)
Seat 6: potodds1979 folded before Flop (didn't bet)



PokerStars Zoom Hand #257984345886:  Hold'em No Limit (€0.01/€0.02) [ADM ID: M62BA304494E32ST] - 2025/10/03 18:49:12 CET [2025/10/03 12:49:12 ET]
Table 'Sirio' 6-max Seat #1 is the button
Seat 1: GanchanS7 (€4.33 in chips) 
Seat 2: Teriferro (€0.38 in chips) 
Seat 3: Cruelplace84 (€3.42 in chips) 
Seat 4: caduceus369 (€4.16 in chips) 
Seat 5: OMGWOLFX (€4.28 in chips) 
Seat 6: Spillo.RN (€1.68 in chips) 
Teriferro: posts small blind €0.01
Cruelplace84: posts big blind €0.02
*** HOLE CARDS ***
Dealt to caduceus369 [As 8d]
caduceus369: folds 
OMGWOLFX: folds 
Spillo.RN: calls €0.02
GanchanS7: folds 
Teriferro: folds 
Cruelplace84: checks 
*** FLOP *** [Kc Jh Qh]
Cruelplace84: checks 
Spillo.RN: bets €0.02
Cruelplace84: folds 
Uncalled bet (€0.02) returned to Spillo.RN
Spillo.RN collected €0.05 from pot
Spillo.RN: doesn't show hand 
*** SUMMARY ***
Total pot €0.05 | Rake €0 
Board [Kc Jh Qh]
Seat 1: GanchanS7 (button) folded before Flop (didn't bet)
Seat 2: Teriferro (small blind) folded before Flop
Seat 3: Cruelplace84 (big blind) folded on the Flop
Seat 4: caduceus369 folded before Flop (didn't bet)
Seat 5: OMGWOLFX folded before Flop (didn't bet)
Seat 6: Spillo.RN collected (€0.05)



PokerStars Zoom Hand #257984346876:  Hold'em No Limit (€0.01/€0.02) [ADM ID: M62BA304494E32ST] - 2025/10/03 18:49:17 CET [2025/10/03 12:49:17 ET]
Table 'Sirio' 6-max Seat #1 is the button
Seat 1: Teriferro (€0.37 in chips) 
Seat 2: SalahUbeen (€2.16 in chips) 
Seat 3: caduceus369 (€4.16 in chips) 
Seat 4: pistaKKio23 (€2.85 in chips) 
Seat 5: Gabrielefante (€2.26 in chips) 
Seat 6: stfuplzudonk (€1.72 in chips) 
SalahUbeen: posts small blind €0.01
caduceus369: posts big blind €0.02
*** HOLE CARDS ***
Dealt to caduceus369 [2h Js]
pistaKKio23: raises €0.04 to €0.06
Gabrielefante: folds 
stfuplzudonk: folds 
Teriferro: folds 
SalahUbeen: folds 
caduceus369: folds 
Uncalled bet (€0.04) returned to pistaKKio23
pistaKKio23 collected €0.05 from pot
pistaKKio23: doesn't show hand 
*** SUMMARY ***
Total pot €0.05 | Rake €0 
Seat 1: Teriferro (button) folded before Flop (didn't bet)
Seat 2: SalahUbeen (small blind) folded before Flop
Seat 3: caduceus369 (big blind) folded before Flop
Seat 4: pistaKKio23 collected (€0.05)
Seat 5: Gabrielefante folded before Flop (didn't bet)
Seat 6: stfuplzudonk folded before Flop (didn't bet)



PokerStars Zoom Hand #257984350297:  Hold'em No Limit (€0.01/€0.02) [ADM ID: M62BA304494E32ST] - 2025/10/03 18:49:35 CET [2025/10/03 12:49:35 ET]
Table 'Sirio' 6-max Seat #1 is the button
Seat 1: Cruelplace84 (€3.40 in chips) 
Seat 2: Miele69409 (€0.93 in chips) 
Seat 3: QUATTRODAME (€2.90 in chips) 
Seat 4: caduceus369 (€4.14 in chips) 
Seat 5: Spillo.RN (€1.71 in chips) 
Seat 6: stfuplzudonk (€2.11 in chips) 
Miele69409: posts small blind €0.01
QUATTRODAME: posts big blind €0.02
*** HOLE CARDS ***
Dealt to caduceus369 [3h Qh]
caduceus369: folds 
Spillo.RN: folds 
stfuplzudonk: folds 
Cruelplace84: folds 
Miele69409: calls €0.01
QUATTRODAME: checks 
*** FLOP *** [2d Jc 5d]
Miele69409: checks 
QUATTRODAME: checks 
*** TURN *** [2d Jc 5d] [2s]
Miele69409: bets €0.02
QUATTRODAME: calls €0.02
*** RIVER *** [2d Jc 5d 2s] [Th]
Miele69409: bets €0.02
QUATTRODAME: folds 
Uncalled bet (€0.02) returned to Miele69409
Miele69409 collected €0.08 from pot
Miele69409: doesn't show hand 
*** SUMMARY ***
Total pot €0.08 | Rake €0 
Board [2d Jc 5d 2s Th]
Seat 1: Cruelplace84 (button) folded before Flop (didn't bet)
Seat 2: Miele69409 (small blind) collected (€0.08)
Seat 3: QUATTRODAME (big blind) folded on the River
Seat 4: caduceus369 folded before Flop (didn't bet)
Seat 5: Spillo.RN folded before Flop (didn't bet)
Seat 6: stfuplzudonk folded before Flop (didn't bet)



PokerStars Zoom Hand #257984350981:  Hold'em No Limit (€0.01/€0.02) [ADM ID: M62BA304494E32ST] - 2025/10/03 18:49:39 CET [2025/10/03 12:49:39 ET]
Table 'Sirio' 6-max Seat #1 is the button
Seat 1: Cruelplace84 (€3.64 in chips) 
Seat 2: caduceus369 (€4.14 in chips) 
Seat 3: themagnetich (€3.15 in chips) 
Seat 4: Spillo.RN (€1.71 in chips) 
Seat 5: stfuplzudonk (€1.72 in chips) 
Seat 6: Catania838 (€6.13 in chips) 
caduceus369: posts small blind €0.01
themagnetich: posts big blind €0.02
*** HOLE CARDS ***
Dealt to caduceus369 [7c Ks]
Spillo.RN: raises €0.02 to €0.04
stfuplzudonk: folds 
Catania838: folds 
Cruelplace84: folds 
caduceus369: folds 
themagnetich: calls €0.02
*** FLOP *** [6h 4h 3h]
themagnetich: checks 
Spillo.RN: bets €0.09
themagnetich: calls €0.09
*** TURN *** [6h 4h 3h] [Qh]
themagnetich: checks 
Spillo.RN: bets €0.26
themagnetich: folds 
Uncalled bet (€0.26) returned to Spillo.RN
Spillo.RN collected €0.26 from pot
Spillo.RN: doesn't show hand 
*** SUMMARY ***
Total pot €0.27 | Rake €0.01 
Board [6h 4h 3h Qh]
Seat 1: Cruelplace84 (button) folded before Flop (didn't bet)
Seat 2: caduceus369 (small blind) folded before Flop
Seat 3: themagnetich (big blind) folded on the Turn
Seat 4: Spillo.RN collected (€0.26)
Seat 5: stfuplzudonk folded before Flop (didn't bet)
Seat 6: Catania838 folded before Flop (didn't bet)



PokerStars Zoom Hand #257984349340:  Hold'em No Limit (€0.01/€0.02) [ADM ID: M62BA304494E32ST] - 2025/10/03 18:49:30 CET [2025/10/03 12:49:30 ET]
Table 'Sirio' 6-max Seat #1 is the button
Seat 1: Cruelplace84 (€2.13 in chips) 
Seat 2: ZefirDevil (€0.48 in chips) 
Seat 3: GanchanS7 (€4.18 in chips) 
Seat 4: Gabrielefante (€2.26 in chips) 
Seat 5: QUATTRODAME (€2.90 in chips) 
Seat 6: caduceus369 (€4.14 in chips) 
ZefirDevil: posts small blind €0.01
GanchanS7: posts big blind €0.02
*** HOLE CARDS ***
Dealt to caduceus369 [Qc 3h]
Gabrielefante: calls €0.02
QUATTRODAME: folds 
caduceus369: folds 
Cruelplace84: folds 
ZefirDevil: calls €0.01
GanchanS7: checks 
*** FLOP *** [8c 6s 3s]
ZefirDevil: checks 
GanchanS7: checks 
Gabrielefante: checks 
*** TURN *** [8c 6s 3s] [Kc]
ZefirDevil: checks 
GanchanS7: checks 
Gabrielefante: checks 
*** RIVER *** [8c 6s 3s Kc] [4d]
ZefirDevil: checks 
GanchanS7: checks 
Gabrielefante: checks 
*** SHOW DOWN ***
ZefirDevil: shows [Qs Jc] (high card King)
GanchanS7: shows [Ah Ts] (high card Ace)
Gabrielefante: shows [Qd Qh] (a pair of Queens)
Gabrielefante collected €0.06 from pot
*** SUMMARY ***
Total pot €0.06 | Rake €0 
Board [8c 6s 3s Kc 4d]
Seat 1: Cruelplace84 (button) folded before Flop (didn't bet)
Seat 2: ZefirDevil (small blind) showed [Qs Jc] and lost with high card King
Seat 3: GanchanS7 (big blind) showed [Ah Ts] and lost with high card Ace
Seat 4: Gabrielefante showed [Qd Qh] and won (€0.06) with a pair of Queens
Seat 5: QUATTRODAME folded before Flop (didn't bet)
Seat 6: caduceus369 folded before Flop (didn't bet)



PokerStars Zoom Hand #257984352208:  Hold'em No Limit (€0.01/€0.02) [ADM ID: M62BA304494E32ST] - 2025/10/03 18:49:45 CET [2025/10/03 12:49:45 ET]
Table 'Sirio' 6-max Seat #1 is the button
Seat 1: shakthi (€2.25 in chips) 
Seat 2: luchino74 (€4.14 in chips) 
Seat 3: caduceus369 (€4.13 in chips) 
Seat 4: pistaKKio23 (€3.31 in chips) 
Seat 5: Kamiros01 (€3.27 in chips) 
Seat 6: nonnapapera3 (€0.76 in chips) 
luchino74: posts small blind €0.01
caduceus369: posts big blind €0.02
*** HOLE CARDS ***
Dealt to caduceus369 [8s Th]
pistaKKio23: folds 
Kamiros01: folds 
nonnapapera3: calls €0.02
shakthi: folds 
luchino74: calls €0.01
caduceus369: checks 
*** FLOP *** [Ac 8h Ks]
luchino74: checks 
caduceus369: checks 
nonnapapera3: bets €0.02
luchino74: calls €0.02
caduceus369: calls €0.02
*** TURN *** [Ac 8h Ks] [2s]
luchino74: checks 
caduceus369: checks 
nonnapapera3: bets €0.02
luchino74: calls €0.02
caduceus369: calls €0.02
*** RIVER *** [Ac 8h Ks 2s] [Jh]
luchino74: checks 
caduceus369: bets €0.04
nonnapapera3: calls €0.04
luchino74: folds 
*** SHOW DOWN ***
caduceus369: shows [8s Th] (a pair of Eights)
nonnapapera3: shows [Ah 6s] (a pair of Aces)
nonnapapera3 collected €0.25 from pot
*** SUMMARY ***
Total pot €0.26 | Rake €0.01 
Board [Ac 8h Ks 2s Jh]
Seat 1: shakthi (button) folded before Flop (didn't bet)
Seat 2: luchino74 (small blind) folded on the River
Seat 3: caduceus369 (big blind) showed [8s Th] and lost with a pair of Eights
Seat 4: pistaKKio23 folded before Flop (didn't bet)
Seat 5: Kamiros01 folded before Flop (didn't bet)
Seat 6: nonnapapera3 showed [Ah 6s] and won (€0.25) with a pair of Aces



PokerStars Zoom Hand #257984362629:  Hold'em No Limit (€0.01/€0.02) [ADM ID: M62BA304494E32ST] - 2025/10/03 18:50:41 CET [2025/10/03 12:50:41 ET]
Table 'Sirio' 6-max Seat #1 is the button
Seat 1: caduceus369 (€4.03 in chips) 
Seat 2: Sararafusa11 (€2.95 in chips) 
Seat 3: Cruelplace84 (€3.40 in chips) 
Seat 4: nonnapapera3 (€0.91 in chips) 
Seat 5: stfuplzudonk (€2.14 in chips) 
Seat 6: Paolino532 (€3.06 in chips) 
Sararafusa11: posts small blind €0.01
Cruelplace84: posts big blind €0.02
*** HOLE CARDS ***
Dealt to caduceus369 [Qd Ah]
nonnapapera3: calls €0.02
stfuplzudonk: folds 
Paolino532: folds 
caduceus369: raises €0.06 to €0.08
Sararafusa11: folds 
Cruelplace84: folds 
nonnapapera3: folds 
Uncalled bet (€0.06) returned to caduceus369
caduceus369 collected €0.07 from pot
caduceus369: doesn't show hand 
*** SUMMARY ***
Total pot €0.07 | Rake €0 
Seat 1: caduceus369 (button) collected (€0.07)
Seat 2: Sararafusa11 (small blind) folded before Flop
Seat 3: Cruelplace84 (big blind) folded before Flop
Seat 4: nonnapapera3 folded before Flop
Seat 5: stfuplzudonk folded before Flop (didn't bet)
Seat 6: Paolino532 folded before Flop (didn't bet)



PokerStars Zoom Hand #257984367381:  Hold'em No Limit (€0.01/€0.02) [ADM ID: M62BA304494E32ST] - 2025/10/03 18:51:06 CET [2025/10/03 12:51:06 ET]
Table 'Sirio' 6-max Seat #1 is the button
Seat 1: OMGWOLFX (€6.27 in chips) 
Seat 2: QUATTRODAME (€2.95 in chips) 
Seat 3: Spillo.RN (€1.76 in chips) 
Seat 4: stfuplzudonk (€2.19 in chips) 
Seat 5: GanchanS7 (€2 in chips) 
Seat 6: caduceus369 (€4.08 in chips) 
QUATTRODAME: posts small blind €0.01
Spillo.RN: posts big blind €0.02
*** HOLE CARDS ***
Dealt to caduceus369 [9s 7s]
stfuplzudonk: folds 
GanchanS7: folds 
caduceus369: folds 
OMGWOLFX: raises €0.04 to €0.06
QUATTRODAME: folds 
Spillo.RN: folds 
Uncalled bet (€0.04) returned to OMGWOLFX
OMGWOLFX collected €0.05 from pot
OMGWOLFX: doesn't show hand 
*** SUMMARY ***
Total pot €0.05 | Rake €0 
Seat 1: OMGWOLFX (button) collected (€0.05)
Seat 2: QUATTRODAME (small blind) folded before Flop
Seat 3: Spillo.RN (big blind) folded before Flop
Seat 4: stfuplzudonk folded before Flop (didn't bet)
Seat 5: GanchanS7 folded before Flop (didn't bet)
Seat 6: caduceus369 folded before Flop (didn't bet)



PokerStars Zoom Hand #257984369339:  Hold'em No Limit (€0.01/€0.02) [ADM ID: M62BA304494E32ST] - 2025/10/03 18:51:16 CET [2025/10/03 12:51:16 ET]
Table 'Sirio' 6-max Seat #1 is the button
Seat 1: SalahUbeen (€2.59 in chips) 
Seat 2: caduceus369 (€4.08 in chips) 
Seat 3: Catania838 (€6.02 in chips) 
Seat 4: QUATTRODAME (€2.94 in chips) 
Seat 5: GanchanS7 (€4.17 in chips) 
Seat 6: Kamiros01 (€3.38 in chips) 
caduceus369: posts small blind €0.01
Catania838: posts big blind €0.02
*** HOLE CARDS ***
Dealt to caduceus369 [7h Jh]
QUATTRODAME: calls €0.02
GanchanS7: folds 
Kamiros01: raises €0.06 to €0.08
SalahUbeen: folds 
caduceus369: folds 
Catania838: folds 
QUATTRODAME: folds 
Uncalled bet (€0.06) returned to Kamiros01
Kamiros01 collected €0.07 from pot
Kamiros01: doesn't show hand 
*** SUMMARY ***
Total pot €0.07 | Rake €0 
Seat 1: SalahUbeen (button) folded before Flop (didn't bet)
Seat 2: caduceus369 (small blind) folded before Flop
Seat 3: Catania838 (big blind) folded before Flop
Seat 4: QUATTRODAME folded before Flop
Seat 5: GanchanS7 folded before Flop (didn't bet)
Seat 6: Kamiros01 collected (€0.07)



PokerStars Zoom Hand #257984370321:  Hold'em No Limit (€0.01/€0.02) [ADM ID: M62BA304494E32ST] - 2025/10/03 18:51:21 CET [2025/10/03 12:51:21 ET]
Table 'Sirio' 6-max Seat #1 is the button
Seat 1: caduceus369 (€4.07 in chips) 
Seat 2: marina41978 (€0.62 in chips) 
Seat 3: pistaKKio23 (€4.48 in chips) 
Seat 4: GanchanS7 (€4.17 in chips) 
Seat 5: pylonstrip (€2.62 in chips) 
Seat 6: OMGWOLFX (€10.26 in chips) 
marina41978: posts small blind €0.01
pistaKKio23: posts big blind €0.02
*** HOLE CARDS ***
Dealt to caduceus369 [5h Ad]
GanchanS7: folds 
pylonstrip: folds 
OMGWOLFX: folds 
caduceus369: raises €0.02 to €0.04
marina41978: calls €0.03
pistaKKio23: folds 
*** FLOP *** [8d 2d Td]
marina41978: checks 
caduceus369: bets €0.03
marina41978: folds 
Uncalled bet (€0.03) returned to caduceus369
caduceus369 collected €0.10 from pot
caduceus369: doesn't show hand 
*** SUMMARY ***
Total pot €0.10 | Rake €0 
Board [8d 2d Td]
Seat 1: caduceus369 (button) collected (€0.10)
Seat 2: marina41978 (small blind) folded on the Flop
Seat 3: pistaKKio23 (big blind) folded before Flop
Seat 4: GanchanS7 folded before Flop (didn't bet)
Seat 5: pylonstrip folded before Flop (didn't bet)
Seat 6: OMGWOLFX folded before Flop (didn't bet)



PokerStars Zoom Hand #257984376521:  Hold'em No Limit (€0.01/€0.02) [ADM ID: M62BA304494E32ST] - 2025/10/03 18:51:53 CET [2025/10/03 12:51:53 ET]
Table 'Sirio' 6-max Seat #1 is the button
Seat 1: OMGWOLFX (€4.11 in chips) 
Seat 2: S'dj83 (€4.14 in chips) 
Seat 3: icerini (€1.99 in chips) 
Seat 4: potodds1979 (€2.44 in chips) 
Seat 5: caduceus369 (€4.13 in chips) 
Seat 6: pistaKKio23 (€4.46 in chips) 
S'dj83: posts small blind €0.01
icerini: posts big blind €0.02
*** HOLE CARDS ***
Dealt to caduceus369 [6c Kd]
potodds1979: raises €0.04 to €0.06
caduceus369: folds 
pistaKKio23: folds 
OMGWOLFX: folds 
S'dj83: folds 
icerini: folds 
Uncalled bet (€0.04) returned to potodds1979
potodds1979 collected €0.05 from pot
potodds1979: doesn't show hand 
*** SUMMARY ***
Total pot €0.05 | Rake €0 
Seat 1: OMGWOLFX (button) folded before Flop (didn't bet)
Seat 2: S'dj83 (small blind) folded before Flop
Seat 3: icerini (big blind) folded before Flop
Seat 4: potodds1979 collected (€0.05)
Seat 5: caduceus369 folded before Flop (didn't bet)
Seat 6: pistaKKio23 folded before Flop (didn't bet)



PokerStars Zoom Hand #257984375411:  Hold'em No Limit (€0.01/€0.02) [ADM ID: M62BA304494E32ST] - 2025/10/03 18:51:47 CET [2025/10/03 12:51:47 ET]
Table 'Sirio' 6-max Seat #1 is the button
Seat 1: SalahUbeen (€2.03 in chips) 
Seat 2: pistaKKio23 (€3.07 in chips) 
Seat 3: mariokart137 (€3.96 in chips) 
Seat 4: Cruelplace84 (€2 in chips) 
Seat 5: caduceus369 (€4.13 in chips) 
Seat 6: potodds1979 (€2.44 in chips) 
pistaKKio23: posts small blind €0.01
mariokart137: posts big blind €0.02
*** HOLE CARDS ***
Dealt to caduceus369 [4s 4h]
Cruelplace84: raises €0.03 to €0.05
caduceus369: folds 
potodds1979: folds 
SalahUbeen: folds 
pistaKKio23: folds 
mariokart137: folds 
Uncalled bet (€0.03) returned to Cruelplace84
Cruelplace84 collected €0.05 from pot
Cruelplace84: doesn't show hand 
*** SUMMARY ***
Total pot €0.05 | Rake €0 
Seat 1: SalahUbeen (button) folded before Flop (didn't bet)
Seat 2: pistaKKio23 (small blind) folded before Flop
Seat 3: mariokart137 (big blind) folded before Flop
Seat 4: Cruelplace84 collected (€0.05)
Seat 5: caduceus369 folded before Flop (didn't bet)
Seat 6: potodds1979 folded before Flop (didn't bet)



PokerStars Zoom Hand #257984377186:  Hold'em No Limit (€0.01/€0.02) [ADM ID: M62BA304494E32ST] - 2025/10/03 18:51:57 CET [2025/10/03 12:51:57 ET]
Table 'Sirio' 6-max Seat #1 is the button
Seat 1: mariokart137 (€3.94 in chips) 
Seat 2: GanchanS7 (€4.15 in chips) 
Seat 3: OSPREYSTORM (€2.30 in chips) 
Seat 4: caduceus369 (€4.13 in chips) 
Seat 5: stagniarihd (€2.68 in chips) 
Seat 6: stfuplzudonk (€2.06 in chips) 
GanchanS7: posts small blind €0.01
OSPREYSTORM: posts big blind €0.02
*** HOLE CARDS ***
Dealt to caduceus369 [4s 5d]
caduceus369: folds 
stagniarihd: folds 
stfuplzudonk: folds 
mariokart137: calls €0.02
GanchanS7: folds 
OSPREYSTORM: raises €0.08 to €0.10
mariokart137: folds 
Uncalled bet (€0.08) returned to OSPREYSTORM
OSPREYSTORM collected €0.05 from pot
OSPREYSTORM: doesn't show hand 
*** SUMMARY ***
Total pot €0.05 | Rake €0 
Seat 1: mariokart137 (button) folded before Flop
Seat 2: GanchanS7 (small blind) folded before Flop
Seat 3: OSPREYSTORM (big blind) collected (€0.05)
Seat 4: caduceus369 folded before Flop (didn't bet)
Seat 5: stagniarihd folded before Flop (didn't bet)
Seat 6: stfuplzudonk folded before Flop (didn't bet)



PokerStars Zoom Hand #257984378291:  Hold'em No Limit (€0.01/€0.02) [ADM ID: M62BA304494E32ST] - 2025/10/03 18:52:02 CET [2025/10/03 12:52:02 ET]
Table 'Sirio' 6-max Seat #1 is the button
Seat 1: Roxy7077 (€0.49 in chips) 
Seat 2: pistaKKio23 (€4.46 in chips) 
Seat 3: caduceus369 (€4.13 in chips) 
Seat 4: stagniarihd (€2.68 in chips) 
Seat 5: stfuplzudonk (€2.06 in chips) 
Seat 6: SalahUbeen (€2.73 in chips) 
pistaKKio23: posts small blind €0.01
caduceus369: posts big blind €0.02
*** HOLE CARDS ***
Dealt to caduceus369 [4d 3s]
stagniarihd: calls €0.02
stfuplzudonk: folds 
SalahUbeen: folds 
Roxy7077: folds 
pistaKKio23: calls €0.01
caduceus369: checks 
*** FLOP *** [3d 8d 7c]
pistaKKio23: checks 
caduceus369: checks 
stagniarihd: checks 
*** TURN *** [3d 8d 7c] [7s]
pistaKKio23: checks 
caduceus369: bets €0.02
stagniarihd: calls €0.02
pistaKKio23: folds 
*** RIVER *** [3d 8d 7c 7s] [8h]
caduceus369: bets €0.03
stagniarihd: folds 
Uncalled bet (€0.03) returned to caduceus369
caduceus369 collected €0.10 from pot
caduceus369: doesn't show hand 
*** SUMMARY ***
Total pot €0.10 | Rake €0 
Board [3d 8d 7c 7s 8h]
Seat 1: Roxy7077 (button) folded before Flop (didn't bet)
Seat 2: pistaKKio23 (small blind) folded on the Turn
Seat 3: caduceus369 (big blind) collected (€0.10)
Seat 4: stagniarihd folded on the River
Seat 5: stfuplzudonk folded before Flop (didn't bet)
Seat 6: SalahUbeen folded before Flop (didn't bet)



PokerStars Zoom Hand #257984389003:  Hold'em No Limit (€0.01/€0.02) [ADM ID: M62BA304494E32ST] - 2025/10/03 18:52:59 CET [2025/10/03 12:52:59 ET]
Table 'Sirio' 6-max Seat #1 is the button
Seat 1: mariokart137 (€3.88 in chips) 
Seat 2: caduceus369 (€4.19 in chips) 
Seat 3: trillycata (€0.97 in chips) 
Seat 4: OSPREYSTORM (€3.29 in chips) 
Seat 5: potodds1979 (€2.51 in chips) 
Seat 6: stfuplzudonk (€1.88 in chips) 
caduceus369: posts small blind €0.01
trillycata: posts big blind €0.02
*** HOLE CARDS ***
Dealt to caduceus369 [5d Td]
OSPREYSTORM: folds 
potodds1979: raises €0.04 to €0.06
stfuplzudonk: folds 
mariokart137: folds 
caduceus369: folds 
trillycata: folds 
Uncalled bet (€0.04) returned to potodds1979
potodds1979 collected €0.05 from pot
potodds1979: doesn't show hand 
*** SUMMARY ***
Total pot €0.05 | Rake €0 
Seat 1: mariokart137 (button) folded before Flop (didn't bet)
Seat 2: caduceus369 (small blind) folded before Flop
Seat 3: trillycata (big blind) folded before Flop
Seat 4: OSPREYSTORM folded before Flop (didn't bet)
Seat 5: potodds1979 collected (€0.05)
Seat 6: stfuplzudonk folded before Flop (didn't bet)



PokerStars Zoom Hand #257984387345:  Hold'em No Limit (€0.01/€0.02) [ADM ID: M62BA304494E32ST] - 2025/10/03 18:52:50 CET [2025/10/03 12:52:50 ET]
Table 'Sirio' 6-max Seat #1 is the button
Seat 1: potodds1979 (€2.51 in chips) 
Seat 2: Genny040893 (€0.82 in chips) 
Seat 3: Katymirax (€1.22 in chips) 
Seat 4: Roxy7077 (€0.51 in chips) 
Seat 5: stfuplzudonk (€1.88 in chips) 
Seat 6: caduceus369 (€4.19 in chips) 
Genny040893: posts small blind €0.01
Katymirax: posts big blind €0.02
*** HOLE CARDS ***
Dealt to caduceus369 [6h 3c]
Roxy7077: raises €0.02 to €0.04
stfuplzudonk: folds 
caduceus369: folds 
potodds1979: folds 
Genny040893: raises €0.02 to €0.06
Katymirax: folds 
Roxy7077: calls €0.02
*** FLOP *** [4h Ac Ad]
Genny040893: checks 
Roxy7077: checks 
*** TURN *** [4h Ac Ad] [3d]
Genny040893: checks 
Roxy7077: checks 
*** RIVER *** [4h Ac Ad 3d] [8h]
Genny040893: checks 
Roxy7077: checks 
*** SHOW DOWN ***
Genny040893: shows [6s 5s] (a pair of Aces)
Roxy7077: shows [Jh Qd] (a pair of Aces - Queen kicker)
Roxy7077 collected €0.14 from pot
*** SUMMARY ***
Total pot €0.14 | Rake €0 
Board [4h Ac Ad 3d 8h]
Seat 1: potodds1979 (button) folded before Flop (didn't bet)
Seat 2: Genny040893 (small blind) showed [6s 5s] and lost with a pair of Aces
Seat 3: Katymirax (big blind) folded before Flop
Seat 4: Roxy7077 showed [Jh Qd] and won (€0.14) with a pair of Aces
Seat 5: stfuplzudonk folded before Flop (didn't bet)
Seat 6: caduceus369 folded before Flop (didn't bet)



PokerStars Zoom Hand #257984389870:  Hold'em No Limit (€0.01/€0.02) [ADM ID: M62BA304494E32ST] - 2025/10/03 18:53:04 CET [2025/10/03 12:53:04 ET]
Table 'Sirio' 6-max Seat #1 is the button
Seat 1: pistaKKio23 (€3.03 in chips) 
Seat 2: OMGWOLFX (€4.16 in chips) 
Seat 3: Cruelplace84 (€3.71 in chips) 
Seat 4: SalahUbeen (€2.70 in chips) 
Seat 5: caduceus369 (€4.18 in chips) 
Seat 6: GanchanS7 (€3.85 in chips) 
OMGWOLFX: posts small blind €0.01
Cruelplace84: posts big blind €0.02
*** HOLE CARDS ***
Dealt to caduceus369 [4c 8h]
SalahUbeen: folds 
caduceus369: folds 
GanchanS7: folds 
pistaKKio23: folds 
OMGWOLFX: folds 
Uncalled bet (€0.01) returned to Cruelplace84
Cruelplace84 collected €0.02 from pot
Cruelplace84: doesn't show hand 
*** SUMMARY ***
Total pot €0.02 | Rake €0 
Seat 1: pistaKKio23 (button) folded before Flop (didn't bet)
Seat 2: OMGWOLFX (small blind) folded before Flop
Seat 3: Cruelplace84 (big blind) collected (€0.02)
Seat 4: SalahUbeen folded before Flop (didn't bet)
Seat 5: caduceus369 folded before Flop (didn't bet)
Seat 6: GanchanS7 folded before Flop (didn't bet)



PokerStars Zoom Hand #257984388088:  Hold'em No Limit (€0.01/€0.02) [ADM ID: M62BA304494E32ST] - 2025/10/03 18:52:54 CET [2025/10/03 12:52:54 ET]
Table 'Sirio' 6-max Seat #1 is the button
Seat 1: caduceus369 (€4.19 in chips) 
Seat 2: OSPREYSTORM (€3.30 in chips) 
Seat 3: stagniarihd (€2.63 in chips) 
Seat 4: trillycata (€0.97 in chips) 
Seat 5: SalahUbeen (€2.70 in chips) 
Seat 6: QUATTRODAME (€2.98 in chips) 
OSPREYSTORM: posts small blind €0.01
stagniarihd: posts big blind €0.02
*** HOLE CARDS ***
Dealt to caduceus369 [8h 4d]
trillycata: folds 
SalahUbeen: folds 
QUATTRODAME: calls €0.02
caduceus369: folds 
OSPREYSTORM: folds 
stagniarihd: raises €0.08 to €0.10
QUATTRODAME: calls €0.08
*** FLOP *** [9c 3h 3d]
stagniarihd: checks 
QUATTRODAME: bets €0.20
stagniarihd: calls €0.20
*** TURN *** [9c 3h 3d] [Th]
stagniarihd: checks 
QUATTRODAME: checks 
*** RIVER *** [9c 3h 3d Th] [2s]
stagniarihd: bets €0.58
QUATTRODAME: calls €0.58
*** SHOW DOWN ***
stagniarihd: shows [8s 8d] (two pair, Eights and Threes)
QUATTRODAME: shows [Ks 9s] (two pair, Nines and Threes)
QUATTRODAME collected €1.68 from pot
*** SUMMARY ***
Total pot €1.77 | Rake €0.09 
Board [9c 3h 3d Th 2s]
Seat 1: caduceus369 (button) folded before Flop (didn't bet)
Seat 2: OSPREYSTORM (small blind) folded before Flop
Seat 3: stagniarihd (big blind) showed [8s 8d] and lost with two pair, Eights and Threes
Seat 4: trillycata folded before Flop (didn't bet)
Seat 5: SalahUbeen folded before Flop (didn't bet)
Seat 6: QUATTRODAME showed [Ks 9s] and won (€1.68) with two pair, Nines and Threes



PokerStars Zoom Hand #257984390665:  Hold'em No Limit (€0.01/€0.02) [ADM ID: M62BA304494E32ST] - 2025/10/03 18:53:08 CET [2025/10/03 12:53:08 ET]
Table 'Sirio' 6-max Seat #1 is the button
Seat 1: OMGWOLFX (€6.13 in chips) 
Seat 2: GanchanS7 (€4.18 in chips) 
Seat 3: Paolino532 (€0.65 in chips) 
Seat 4: caduceus369 (€4.18 in chips) 
Seat 5: stfuplzudonk (€2.16 in chips) 
Seat 6: luchino74 (€4.59 in chips) 
GanchanS7: posts small blind €0.01
Paolino532: posts big blind €0.02
*** HOLE CARDS ***
Dealt to caduceus369 [4c Ks]
caduceus369: folds 
stfuplzudonk: folds 
luchino74: folds 
OMGWOLFX: raises €0.04 to €0.06
GanchanS7: folds 
Paolino532: raises €0.59 to €0.65 and is all-in
OMGWOLFX: calls €0.59
*** FLOP *** [Qh 6c 9h]
*** TURN *** [Qh 6c 9h] [5d]
*** RIVER *** [Qh 6c 9h 5d] [5c]
*** SHOW DOWN ***
Paolino532: shows [7h Ac] (a pair of Fives)
OMGWOLFX: shows [Th Tc] (two pair, Tens and Fives)
OMGWOLFX collected €1.24 from pot
*** SUMMARY ***
Total pot €1.31 | Rake €0.07 
Board [Qh 6c 9h 5d 5c]
Seat 1: OMGWOLFX (button) showed [Th Tc] and won (€1.24) with two pair, Tens and Fives
Seat 2: GanchanS7 (small blind) folded before Flop
Seat 3: Paolino532 (big blind) showed [7h Ac] and lost with a pair of Fives
Seat 4: caduceus369 folded before Flop (didn't bet)
Seat 5: stfuplzudonk folded before Flop (didn't bet)
Seat 6: luchino74 folded before Flop (didn't bet)



PokerStars Zoom Hand #257984393420:  Hold'em No Limit (€0.01/€0.02) [ADM ID: M62BA304494E32ST] - 2025/10/03 18:53:22 CET [2025/10/03 12:53:22 ET]
Table 'Sirio' 6-max Seat #1 is the button
Seat 1: GanchanS7 (€4.17 in chips) 
Seat 2: LentaM3nte (€1.92 in chips) 
Seat 3: caduceus369 (€4.17 in chips) 
Seat 4: pistaKKio23 (€5.98 in chips) 
Seat 5: OMGWOLFX (€4.15 in chips) 
Seat 6: Miele69409 (€2.04 in chips) 
LentaM3nte: posts small blind €0.01
caduceus369: posts big blind €0.02
*** HOLE CARDS ***
Dealt to caduceus369 [Qh 2d]
pistaKKio23: folds 
OMGWOLFX: folds 
Miele69409: raises €0.14 to €0.16
GanchanS7: folds 
LentaM3nte: folds 
caduceus369: folds 
Uncalled bet (€0.14) returned to Miele69409
Miele69409 collected €0.05 from pot
Miele69409: doesn't show hand 
*** SUMMARY ***
Total pot €0.05 | Rake €0 
Seat 1: GanchanS7 (button) folded before Flop (didn't bet)
Seat 2: LentaM3nte (small blind) folded before Flop
Seat 3: caduceus369 (big blind) folded before Flop
Seat 4: pistaKKio23 folded before Flop (didn't bet)
Seat 5: OMGWOLFX folded before Flop (didn't bet)
Seat 6: Miele69409 collected (€0.05)



PokerStars Zoom Hand #257984391263:  Hold'em No Limit (€0.01/€0.02) [ADM ID: M62BA304494E32ST] - 2025/10/03 18:53:11 CET [2025/10/03 12:53:11 ET]
Table 'Sirio' 6-max Seat #1 is the button
Seat 1: marina41978 (€0.50 in chips) 
Seat 2: caduceus369 (€4.18 in chips) 
Seat 3: Catania838 (€1.65 in chips) 
Seat 4: OMGWOLFX (€10.30 in chips) 
Seat 5: OSPREYSTORM (€2.77 in chips) 
Seat 6: mariokart137 (€3.88 in chips) 
caduceus369: posts small blind €0.01
Catania838: posts big blind €0.02
*** HOLE CARDS ***
Dealt to caduceus369 [8c 6c]
OMGWOLFX: folds 
OSPREYSTORM: folds 
mariokart137: raises €0.04 to €0.06
marina41978: calls €0.06
caduceus369: folds 
Catania838: raises €0.08 to €0.14
mariokart137: calls €0.08
marina41978: calls €0.08
*** FLOP *** [Qd 8d 4s]
Catania838: checks 
mariokart137: checks 
marina41978: checks 
*** TURN *** [Qd 8d 4s] [9s]
Catania838: checks 
mariokart137: checks 
marina41978: checks 
*** RIVER *** [Qd 8d 4s 9s] [4d]
Catania838: bets €0.41
mariokart137: folds 
marina41978: folds 
Uncalled bet (€0.41) returned to Catania838
Catania838 collected €0.41 from pot
Catania838: doesn't show hand 
*** SUMMARY ***
Total pot €0.43 | Rake €0.02 
Board [Qd 8d 4s 9s 4d]
Seat 1: marina41978 (button) folded on the River
Seat 2: caduceus369 (small blind) folded before Flop
Seat 3: Catania838 (big blind) collected (€0.41)
Seat 4: OMGWOLFX folded before Flop (didn't bet)
Seat 5: OSPREYSTORM folded before Flop (didn't bet)
Seat 6: mariokart137 folded on the River



PokerStars Zoom Hand #257984396584:  Hold'em No Limit (€0.01/€0.02) [ADM ID: M62BA304494E32ST] - 2025/10/03 18:53:39 CET [2025/10/03 12:53:39 ET]
Table 'Sirio' 6-max Seat #1 is the button
Seat 1: caduceus369 (€4.15 in chips) 
Seat 2: SalahUbeen (€2.18 in chips) 
Seat 3: GanchanS7 (€2 in chips) 
Seat 4: OSPREYSTORM (€2.75 in chips) 
Seat 5: OMGWOLFX (€10.28 in chips) 
Seat 6: Sararafusa11 (€2.44 in chips) 
SalahUbeen: posts small blind €0.01
GanchanS7: posts big blind €0.02
*** HOLE CARDS ***
Dealt to caduceus369 [7h 2d]
OSPREYSTORM: folds 
OMGWOLFX: folds 
Sararafusa11: folds 
caduceus369: folds 
SalahUbeen: raises €0.02 to €0.04
GanchanS7: folds 
Uncalled bet (€0.02) returned to SalahUbeen
SalahUbeen collected €0.04 from pot
SalahUbeen: doesn't show hand 
*** SUMMARY ***
Total pot €0.04 | Rake €0 
Seat 1: caduceus369 (button) folded before Flop (didn't bet)
Seat 2: SalahUbeen (small blind) collected (€0.04)
Seat 3: GanchanS7 (big blind) folded before Flop
Seat 4: OSPREYSTORM folded before Flop (didn't bet)
Seat 5: OMGWOLFX folded before Flop (didn't bet)
Seat 6: Sararafusa11 folded before Flop (didn't bet)



PokerStars Zoom Hand #257984398361:  Hold'em No Limit (€0.01/€0.02) [ADM ID: M62BA304494E32ST] - 2025/10/03 18:53:48 CET [2025/10/03 12:53:48 ET]
Table 'Sirio' 6-max Seat #1 is the button
Seat 1: S'dj83 (€4.13 in chips) 
Seat 2: LentaM3nte (€1.91 in chips) 
Seat 3: Topastro27 (€1.99 in chips) 
Seat 4: potodds1979 (€2.61 in chips) 
Seat 5: caduceus369 (€4.15 in chips) 
Seat 6: Catania838 (€1.69 in chips) 
LentaM3nte: posts small blind €0.01
Topastro27: posts big blind €0.02
*** HOLE CARDS ***
Dealt to caduceus369 [3s Qh]
potodds1979: folds 
caduceus369: folds 
Catania838: folds 
S'dj83: raises €0.04 to €0.06
LentaM3nte: folds 
Topastro27: folds 
Uncalled bet (€0.04) returned to S'dj83
S'dj83 collected €0.05 from pot
S'dj83: doesn't show hand 
*** SUMMARY ***
Total pot €0.05 | Rake €0 
Seat 1: S'dj83 (button) collected (€0.05)
Seat 2: LentaM3nte (small blind) folded before Flop
Seat 3: Topastro27 (big blind) folded before Flop
Seat 4: potodds1979 folded before Flop (didn't bet)
Seat 5: caduceus369 folded before Flop (didn't bet)
Seat 6: Catania838 folded before Flop (didn't bet)



PokerStars Zoom Hand #257984399612:  Hold'em No Limit (€0.01/€0.02) [ADM ID: M62BA304494E32ST] - 2025/10/03 18:53:55 CET [2025/10/03 12:53:55 ET]
Table 'Sirio' 6-max Seat #1 is the button
Seat 1: OSPREYSTORM (€4.42 in chips) 
Seat 2: shakthi (€2.26 in chips) 
Seat 3: potodds1979 (€2.61 in chips) 
Seat 4: stfuplzudonk (€3.43 in chips) 
Seat 5: jolli180 (€2.13 in chips) 
Seat 6: caduceus369 (€4.15 in chips) 
shakthi: posts small blind €0.01
potodds1979: posts big blind €0.02
*** HOLE CARDS ***
Dealt to caduceus369 [9d Jh]
stfuplzudonk: folds 
jolli180: folds 
caduceus369: folds 
OSPREYSTORM: folds 
shakthi: folds 
Uncalled bet (€0.01) returned to potodds1979
potodds1979 collected €0.02 from pot
potodds1979: doesn't show hand 
*** SUMMARY ***
Total pot €0.02 | Rake €0 
Seat 1: OSPREYSTORM (button) folded before Flop (didn't bet)
Seat 2: shakthi (small blind) folded before Flop
Seat 3: potodds1979 (big blind) collected (€0.02)
Seat 4: stfuplzudonk folded before Flop (didn't bet)
Seat 5: jolli180 folded before Flop (didn't bet)
Seat 6: caduceus369 folded before Flop (didn't bet)



PokerStars Zoom Hand #257984397752:  Hold'em No Limit (€0.01/€0.02) [ADM ID: M62BA304494E32ST] - 2025/10/03 18:53:45 CET [2025/10/03 12:53:45 ET]
Table 'Sirio' 6-max Seat #1 is the button
Seat 1: Katymirax (€1.14 in chips) 
Seat 2: SalahUbeen (€1.42 in chips) 
Seat 3: Tantononpasso (€2 in chips) 
Seat 4: caduceus369 (€4.15 in chips) 
Seat 5: OMGWOLFX (€6.72 in chips) 
Seat 6: GanchanS7 (€4.17 in chips) 
SalahUbeen: posts small blind €0.01
Tantononpasso: posts big blind €0.02
*** HOLE CARDS ***
Dealt to caduceus369 [6h 3c]
caduceus369: folds 
OMGWOLFX: raises €0.04 to €0.06
GanchanS7: folds 
Katymirax: calls €0.06
SalahUbeen: folds 
Tantononpasso: folds 
*** FLOP *** [3d Kc 9c]
OMGWOLFX: bets €0.08
Katymirax: folds 
Uncalled bet (€0.08) returned to OMGWOLFX
OMGWOLFX collected €0.15 from pot
OMGWOLFX: doesn't show hand 
*** SUMMARY ***
Total pot €0.15 | Rake €0 
Board [3d Kc 9c]
Seat 1: Katymirax (button) folded on the Flop
Seat 2: SalahUbeen (small blind) folded before Flop
Seat 3: Tantononpasso (big blind) folded before Flop
Seat 4: caduceus369 folded before Flop (didn't bet)
Seat 5: OMGWOLFX collected (€0.15)
Seat 6: GanchanS7 folded before Flop (didn't bet)



PokerStars Zoom Hand #257984400422:  Hold'em No Limit (€0.01/€0.02) [ADM ID: M62BA304494E32ST] - 2025/10/03 18:53:59 CET [2025/10/03 12:53:59 ET]
Table 'Sirio' 6-max Seat #1 is the button
Seat 1: Catania838 (€1.69 in chips) 
Seat 2: Cruelplace84 (€3.67 in chips) 
Seat 3: OSPREYSTORM (€4.42 in chips) 
Seat 4: caduceus369 (€4.15 in chips) 
Seat 5: stfuplzudonk (€3.43 in chips) 
Seat 6: shakthi (€2.25 in chips) 
Cruelplace84: posts small blind €0.01
OSPREYSTORM: posts big blind €0.02
*** HOLE CARDS ***
Dealt to caduceus369 [Th 5c]
caduceus369: folds 
stfuplzudonk: folds 
shakthi: folds 
Catania838: folds 
Cruelplace84: folds 
Uncalled bet (€0.01) returned to OSPREYSTORM
OSPREYSTORM collected €0.02 from pot
OSPREYSTORM: doesn't show hand 
*** SUMMARY ***
Total pot €0.02 | Rake €0 
Seat 1: Catania838 (button) folded before Flop (didn't bet)
Seat 2: Cruelplace84 (small blind) folded before Flop
Seat 3: OSPREYSTORM (big blind) collected (€0.02)
Seat 4: caduceus369 folded before Flop (didn't bet)
Seat 5: stfuplzudonk folded before Flop (didn't bet)
Seat 6: shakthi folded before Flop (didn't bet)



PokerStars Zoom Hand #257984403206:  Hold'em No Limit (€0.01/€0.02) [ADM ID: M62BA304494E32ST] - 2025/10/03 18:54:14 CET [2025/10/03 12:54:14 ET]
Table 'Sirio' 6-max Seat #1 is the button
Seat 1: S'dj83 (€4.16 in chips) 
Seat 2: jolli180 (€2.11 in chips) 
Seat 3: caduceus369 (€4.15 in chips) 
Seat 4: SalahUbeen (€2.23 in chips) 
Seat 5: potodds1979 (€2.62 in chips) 
Seat 6: LentaM3nte (€1.88 in chips) 
jolli180: posts small blind €0.01
caduceus369: posts big blind €0.02
*** HOLE CARDS ***
Dealt to caduceus369 [3s Ts]
SalahUbeen: folds 
potodds1979: folds 
LentaM3nte: folds 
S'dj83: folds 
jolli180: raises €0.02 to €0.04
caduceus369: folds 
Uncalled bet (€0.02) returned to jolli180
jolli180 collected €0.04 from pot
jolli180: doesn't show hand 
*** SUMMARY ***
Total pot €0.04 | Rake €0 
Seat 1: S'dj83 (button) folded before Flop (didn't bet)
Seat 2: jolli180 (small blind) collected (€0.04)
Seat 3: caduceus369 (big blind) folded before Flop
Seat 4: SalahUbeen folded before Flop (didn't bet)
Seat 5: potodds1979 folded before Flop (didn't bet)
Seat 6: LentaM3nte folded before Flop (didn't bet)



PokerStars Zoom Hand #257984395949:  Hold'em No Limit (€0.01/€0.02) [ADM ID: M62BA304494E32ST] - 2025/10/03 18:53:35 CET [2025/10/03 12:53:35 ET]
Table 'Sirio' 6-max Seat #1 is the button
Seat 1: luchino74 (€4.61 in chips) 
Seat 2: Cruelplace84 (€2.60 in chips) 
Seat 3: Gabrielefante (€2.31 in chips) 
Seat 4: OMGWOLFX (€10.28 in chips) 
Seat 5: pistaKKio23 (€3.03 in chips) 
Seat 6: caduceus369 (€4.15 in chips) 
Cruelplace84: posts small blind €0.01
Gabrielefante: posts big blind €0.02
*** HOLE CARDS ***
Dealt to caduceus369 [2c 3d]
OMGWOLFX: folds 
pistaKKio23: raises €0.02 to €0.04
caduceus369: folds 
luchino74: folds 
Cruelplace84: folds 
Gabrielefante: calls €0.02
*** FLOP *** [Js Kc 8d]
Gabrielefante: checks 
pistaKKio23: checks 
*** TURN *** [Js Kc 8d] [6d]
Gabrielefante: checks 
pistaKKio23: checks 
*** RIVER *** [Js Kc 8d 6d] [5s]
Gabrielefante: checks 
pistaKKio23: checks 
*** SHOW DOWN ***
Gabrielefante: shows [As Ts] (high card Ace)
pistaKKio23: shows [Ac Td] (high card Ace)
Gabrielefante collected €0.05 from pot
pistaKKio23 collected €0.04 from pot
*** SUMMARY ***
Total pot €0.09 | Rake €0 
Board [Js Kc 8d 6d 5s]
Seat 1: luchino74 (button) folded before Flop (didn't bet)
Seat 2: Cruelplace84 (small blind) folded before Flop
Seat 3: Gabrielefante (big blind) showed [As Ts] and won (€0.05) with high card Ace
Seat 4: OMGWOLFX folded before Flop (didn't bet)
Seat 5: pistaKKio23 showed [Ac Td] and won (€0.04) with high card Ace
Seat 6: caduceus369 folded before Flop (didn't bet)



PokerStars Zoom Hand #257984402158:  Hold'em No Limit (€0.01/€0.02) [ADM ID: M62BA304494E32ST] - 2025/10/03 18:54:08 CET [2025/10/03 12:54:08 ET]
Table 'Sirio' 6-max Seat #1 is the button
Seat 1: Cruelplace84 (€2.59 in chips) 
Seat 2: Tantononpasso (€1.98 in chips) 
Seat 3: GanchanS7 (€4.16 in chips) 
Seat 4: caduceus369 (€4.15 in chips) 
Seat 5: luchino74 (€4.35 in chips) 
Seat 6: SalahUbeen (€2.23 in chips) 
Tantononpasso: posts small blind €0.01
GanchanS7: posts big blind €0.02
*** HOLE CARDS ***
Dealt to caduceus369 [8h 6c]
caduceus369: folds 
luchino74: raises €0.03 to €0.05
SalahUbeen: folds 
Cruelplace84: raises €0.13 to €0.18
Tantononpasso: folds 
GanchanS7: folds 
luchino74: folds 
Uncalled bet (€0.13) returned to Cruelplace84
Cruelplace84 collected €0.13 from pot
Cruelplace84: doesn't show hand 
*** SUMMARY ***
Total pot €0.13 | Rake €0 
Seat 1: Cruelplace84 (button) collected (€0.13)
Seat 2: Tantononpasso (small blind) folded before Flop
Seat 3: GanchanS7 (big blind) folded before Flop
Seat 4: caduceus369 folded before Flop (didn't bet)
Seat 5: luchino74 folded before Flop
Seat 6: SalahUbeen folded before Flop (didn't bet)



PokerStars Zoom Hand #257984407679:  Hold'em No Limit (€0.01/€0.02) [ADM ID: M62BA304494E32ST] - 2025/10/03 18:54:38 CET [2025/10/03 12:54:38 ET]
Table 'Sirio' 6-max Seat #1 is the button
Seat 1: caduceus369 (€4.12 in chips) 
Seat 2: Gabrielefante (€2.32 in chips) 
Seat 3: GanchanS7 (€2.20 in chips) 
Seat 4: pistaKKio23 (€6.02 in chips) 
Seat 5: nonnapapera3 (€0.67 in chips) 
Seat 6: SalahUbeen (€2.18 in chips) 
Gabrielefante: posts small blind €0.01
GanchanS7: posts big blind €0.02
*** HOLE CARDS ***
Dealt to caduceus369 [5c Ks]
pistaKKio23: folds 
nonnapapera3: folds 
SalahUbeen: folds 
caduceus369: folds 
Gabrielefante: raises €0.04 to €0.06
GanchanS7: folds 
Uncalled bet (€0.04) returned to Gabrielefante
Gabrielefante collected €0.04 from pot
Gabrielefante: doesn't show hand 
*** SUMMARY ***
Total pot €0.04 | Rake €0 
Seat 1: caduceus369 (button) folded before Flop (didn't bet)
Seat 2: Gabrielefante (small blind) collected (€0.04)
Seat 3: GanchanS7 (big blind) folded before Flop
Seat 4: pistaKKio23 folded before Flop (didn't bet)
Seat 5: nonnapapera3 folded before Flop (didn't bet)
Seat 6: SalahUbeen folded before Flop (didn't bet)



PokerStars Zoom Hand #257984405693:  Hold'em No Limit (€0.01/€0.02) [ADM ID: M62BA304494E32ST] - 2025/10/03 18:54:27 CET [2025/10/03 12:54:27 ET]
Table 'Sirio' 6-max Seat #1 is the button
Seat 1: jolli180 (€2.13 in chips) 
Seat 2: caduceus369 (€4.13 in chips) 
Seat 3: stfuplzudonk (€3.39 in chips) 
Seat 4: Cruelplace84 (€2.27 in chips) 
Seat 5: SalahUbeen (€2.62 in chips) 
Seat 6: pylonstrip (€2.97 in chips) 
caduceus369: posts small blind €0.01
stfuplzudonk: posts big blind €0.02
*** HOLE CARDS ***
Dealt to caduceus369 [Ah 6c]
Cruelplace84: folds 
SalahUbeen: raises €0.03 to €0.05
pylonstrip: folds 
jolli180: calls €0.05
caduceus369: folds 
stfuplzudonk: calls €0.03
*** FLOP *** [8s 3h 9c]
stfuplzudonk: checks 
SalahUbeen: checks 
jolli180: checks 
*** TURN *** [8s 3h 9c] [Kc]
stfuplzudonk: checks 
SalahUbeen: checks 
jolli180: checks 
*** RIVER *** [8s 3h 9c Kc] [7d]
stfuplzudonk: bets €0.10
SalahUbeen: folds 
jolli180: folds 
Uncalled bet (€0.10) returned to stfuplzudonk
stfuplzudonk collected €0.16 from pot
stfuplzudonk: doesn't show hand 
*** SUMMARY ***
Total pot €0.16 | Rake €0 
Board [8s 3h 9c Kc 7d]
Seat 1: jolli180 (button) folded on the River
Seat 2: caduceus369 (small blind) folded before Flop
Seat 3: stfuplzudonk (big blind) collected (€0.16)
Seat 4: Cruelplace84 folded before Flop (didn't bet)
Seat 5: SalahUbeen folded on the River
Seat 6: pylonstrip folded before Flop (didn't bet)



PokerStars Zoom Hand #257984408345:  Hold'em No Limit (€0.01/€0.02) [ADM ID: M62BA304494E32ST] - 2025/10/03 18:54:41 CET [2025/10/03 12:54:41 ET]
Table 'Sirio' 6-max Seat #1 is the button
Seat 1: OSPREYSTORM (€2.60 in chips) 
Seat 2: SalahUbeen (€1.39 in chips) 
Seat 3: trillycata (€0.86 in chips) 
Seat 4: Cruelplace84 (€3.61 in chips) 
Seat 5: mariokart137 (€3.56 in chips) 
Seat 6: caduceus369 (€4.12 in chips) 
SalahUbeen: posts small blind €0.01
trillycata: posts big blind €0.02
*** HOLE CARDS ***
Dealt to caduceus369 [Ad Ac]
Cruelplace84: folds 
mariokart137: folds 
caduceus369: raises €0.02 to €0.04
OSPREYSTORM: folds 
SalahUbeen: calls €0.03
trillycata: calls €0.02
*** FLOP *** [5h 7c 6s]
SalahUbeen: checks 
trillycata: checks 
caduceus369: checks 
*** TURN *** [5h 7c 6s] [Kd]
SalahUbeen: checks 
trillycata: checks 
caduceus369: bets €0.04
SalahUbeen: folds 
trillycata: calls €0.04
*** RIVER *** [5h 7c 6s Kd] [4d]
trillycata: checks 
caduceus369: checks 
*** SHOW DOWN ***
trillycata: shows [2s Kh] (a pair of Kings)
caduceus369: shows [Ad Ac] (a pair of Aces)
caduceus369 collected €0.19 from pot
*** SUMMARY ***
Total pot €0.20 | Rake €0.01 
Board [5h 7c 6s Kd 4d]
Seat 1: OSPREYSTORM (button) folded before Flop (didn't bet)
Seat 2: SalahUbeen (small blind) folded on the Turn
Seat 3: trillycata (big blind) showed [2s Kh] and lost with a pair of Kings
Seat 4: Cruelplace84 folded before Flop (didn't bet)
Seat 5: mariokart137 folded before Flop (didn't bet)
Seat 6: caduceus369 showed [Ad Ac] and won (€0.19) with a pair of Aces



PokerStars Zoom Hand #257984415193:  Hold'em No Limit (€0.01/€0.02) [ADM ID: M62BA304494E32ST] - 2025/10/03 18:55:25 CET [2025/10/03 12:55:25 ET]
Table 'Sirio' 6-max Seat #1 is the button
Seat 1: LentaM3nte (€1.64 in chips) 
Seat 2: Gabrielefante (€2.32 in chips) 
Seat 3: caduceus369 (€4.23 in chips) 
Seat 4: SalahUbeen (€2.07 in chips) 
Seat 5: parker1318 (€1.96 in chips) 
Seat 6: Cruelplace84 (€3.58 in chips) 
Gabrielefante: posts small blind €0.01
caduceus369: posts big blind €0.02
*** HOLE CARDS ***
Dealt to caduceus369 [2h 7h]
SalahUbeen: raises €0.03 to €0.05
parker1318: folds 
Cruelplace84: raises €0.13 to €0.18
LentaM3nte: folds 
Gabrielefante: folds 
caduceus369: folds 
SalahUbeen: folds 
Uncalled bet (€0.13) returned to Cruelplace84
Cruelplace84 collected €0.13 from pot
Cruelplace84: doesn't show hand 
*** SUMMARY ***
Total pot €0.13 | Rake €0 
Seat 1: LentaM3nte (button) folded before Flop (didn't bet)
Seat 2: Gabrielefante (small blind) folded before Flop
Seat 3: caduceus369 (big blind) folded before Flop
Seat 4: SalahUbeen folded before Flop
Seat 5: parker1318 folded before Flop (didn't bet)
Seat 6: Cruelplace84 collected (€0.13)



PokerStars Zoom Hand #257984416616:  Hold'em No Limit (€0.01/€0.02) [ADM ID: M62BA304494E32ST] - 2025/10/03 18:55:35 CET [2025/10/03 12:55:35 ET]
Table 'Sirio' 6-max Seat #1 is the button
Seat 1: gege400 (€1.97 in chips) 
Seat 2: caduceus369 (€4.21 in chips) 
Seat 3: Catania838 (€2.04 in chips) 
Seat 4: LentaM3nte (€1.64 in chips) 
Seat 5: stfuplzudonk (€1.68 in chips) 
Seat 6: luchino74 (€4.50 in chips) 
caduceus369: posts small blind €0.01
Catania838: posts big blind €0.02
*** HOLE CARDS ***
Dealt to caduceus369 [Td 5d]
LentaM3nte: folds 
stfuplzudonk: raises €0.04 to €0.06
luchino74: folds 
gege400: folds 
caduceus369: folds 
Catania838: folds 
Uncalled bet (€0.04) returned to stfuplzudonk
stfuplzudonk collected €0.05 from pot
stfuplzudonk: doesn't show hand 
*** SUMMARY ***
Total pot €0.05 | Rake €0 
Seat 1: gege400 (button) folded before Flop (didn't bet)
Seat 2: caduceus369 (small blind) folded before Flop
Seat 3: Catania838 (big blind) folded before Flop
Seat 4: LentaM3nte folded before Flop (didn't bet)
Seat 5: stfuplzudonk collected (€0.05)
Seat 6: luchino74 folded before Flop (didn't bet)



PokerStars Zoom Hand #257984414815:  Hold'em No Limit (€0.01/€0.02) [ADM ID: M62BA304494E32ST] - 2025/10/03 18:55:22 CET [2025/10/03 12:55:22 ET]
Table 'Sirio' 6-max Seat #1 is the button
Seat 1: Cruelplace84 (€2.24 in chips) 
Seat 2: trillycata (€0.78 in chips) 
Seat 3: mariokart137 (€3.60 in chips) 
Seat 4: Gabrielefante (€2.32 in chips) 
Seat 5: caduceus369 (€4.23 in chips) 
Seat 6: GanchanS7 (€2.18 in chips) 
trillycata: posts small blind €0.01
mariokart137: posts big blind €0.02
*** HOLE CARDS ***
Dealt to caduceus369 [4h Jd]
Gabrielefante: folds 
caduceus369: folds 
GanchanS7: folds 
Cruelplace84: raises €0.03 to €0.05
trillycata: folds 
mariokart137: raises €0.13 to €0.18
Cruelplace84: calls €0.13
*** FLOP *** [3s 2d 2s]
mariokart137: checks 
Cruelplace84: checks 
*** TURN *** [3s 2d 2s] [5c]
mariokart137: bets €0.26
Cruelplace84: folds 
Uncalled bet (€0.26) returned to mariokart137
mariokart137 collected €0.35 from pot
mariokart137: doesn't show hand 
*** SUMMARY ***
Total pot €0.37 | Rake €0.02 
Board [3s 2d 2s 5c]
Seat 1: Cruelplace84 (button) folded on the Turn
Seat 2: trillycata (small blind) folded before Flop
Seat 3: mariokart137 (big blind) collected (€0.35)
Seat 4: Gabrielefante folded before Flop (didn't bet)
Seat 5: caduceus369 folded before Flop (didn't bet)
Seat 6: GanchanS7 folded before Flop (didn't bet)



PokerStars Zoom Hand #257984418841:  Hold'em No Limit (€0.01/€0.02) [ADM ID: M62BA304494E32ST] - 2025/10/03 18:55:51 CET [2025/10/03 12:55:51 ET]
Table 'Sirio' 6-max Seat #1 is the button
Seat 1: SalahUbeen (€2.54 in chips) 
Seat 2: nonnapapera3 (€0.87 in chips) 
Seat 3: Cruelplace84 (€2.73 in chips) 
Seat 4: luchino74 (€4.19 in chips) 
Seat 5: Catania838 (€1.65 in chips) 
Seat 6: caduceus369 (€4.20 in chips) 
nonnapapera3: posts small blind €0.01
Cruelplace84: posts big blind €0.02
*** HOLE CARDS ***
Dealt to caduceus369 [Ks 8c]
luchino74: folds 
Catania838: folds 
caduceus369: folds 
SalahUbeen: raises €0.04 to €0.06
nonnapapera3: folds 
Cruelplace84: folds 
Uncalled bet (€0.04) returned to SalahUbeen
SalahUbeen collected €0.05 from pot
SalahUbeen: doesn't show hand 
*** SUMMARY ***
Total pot €0.05 | Rake €0 
Seat 1: SalahUbeen (button) collected (€0.05)
Seat 2: nonnapapera3 (small blind) folded before Flop
Seat 3: Cruelplace84 (big blind) folded before Flop
Seat 4: luchino74 folded before Flop (didn't bet)
Seat 5: Catania838 folded before Flop (didn't bet)
Seat 6: caduceus369 folded before Flop (didn't bet)



PokerStars Zoom Hand #257984417847:  Hold'em No Limit (€0.01/€0.02) [ADM ID: M62BA304494E32ST] - 2025/10/03 18:55:44 CET [2025/10/03 12:55:44 ET]
Table 'Sirio' 6-max Seat #1 is the button
Seat 1: caduceus369 (€4.20 in chips) 
Seat 2: GanchanS7 (€2.01 in chips) 
Seat 3: Sararafusa11 (€3.21 in chips) 
Seat 4: LentaM3nte (€1.64 in chips) 
Seat 5: Catania838 (€2.02 in chips) 
Seat 6: SalahUbeen (€2.02 in chips) 
GanchanS7: posts small blind €0.01
Sararafusa11: posts big blind €0.02
*** HOLE CARDS ***
Dealt to caduceus369 [4d Ah]
LentaM3nte: folds 
Catania838: calls €0.02
SalahUbeen: folds 
caduceus369: folds 
GanchanS7: folds 
Sararafusa11: raises €0.06 to €0.08
Catania838: calls €0.06
*** FLOP *** [6h 5h 8h]
Sararafusa11: checks 
Catania838: checks 
*** TURN *** [6h 5h 8h] [4c]
Sararafusa11: bets €0.09
Catania838: folds 
Uncalled bet (€0.09) returned to Sararafusa11
Sararafusa11 collected €0.17 from pot
Sararafusa11: doesn't show hand 
*** SUMMARY ***
Total pot €0.17 | Rake €0 
Board [6h 5h 8h 4c]
Seat 1: caduceus369 (button) folded before Flop (didn't bet)
Seat 2: GanchanS7 (small blind) folded before Flop
Seat 3: Sararafusa11 (big blind) collected (€0.17)
Seat 4: LentaM3nte folded before Flop (didn't bet)
Seat 5: Catania838 folded on the Turn
Seat 6: SalahUbeen folded before Flop (didn't bet)



PokerStars Zoom Hand #257984419752:  Hold'em No Limit (€0.01/€0.02) [ADM ID: M62BA304494E32ST] - 2025/10/03 18:55:58 CET [2025/10/03 12:55:58 ET]
Table 'Sirio' 6-max Seat #1 is the button
Seat 1: stfuplzudonk (€3.49 in chips) 
Seat 2: Mary5issi (€1.98 in chips) 
Seat 3: Cruelplace84 (€2 in chips) 
Seat 4: caduceus369 (€4.20 in chips) 
Seat 5: Katymirax (€1.27 in chips) 
Seat 6: stagniarihd (€1.86 in chips) 
Mary5issi: posts small blind €0.01
Cruelplace84: posts big blind €0.02
*** HOLE CARDS ***
Dealt to caduceus369 [7s 6s]
caduceus369: raises €0.02 to €0.04
Katymirax: folds 
stagniarihd: calls €0.04
stfuplzudonk: folds 
Mary5issi: calls €0.03
Cruelplace84: folds 
*** FLOP *** [Td Tc 7h]
Mary5issi: checks 
caduceus369: bets €0.05
stagniarihd: folds 
Mary5issi: calls €0.05
*** TURN *** [Td Tc 7h] [Jh]
Mary5issi: checks 
caduceus369: checks 
*** RIVER *** [Td Tc 7h Jh] [8c]
Mary5issi: checks 
caduceus369: checks 
*** SHOW DOWN ***
Mary5issi: shows [5c 5h] (two pair, Tens and Fives)
caduceus369: shows [7s 6s] (two pair, Tens and Sevens)
caduceus369 collected €0.23 from pot
*** SUMMARY ***
Total pot €0.24 | Rake €0.01 
Board [Td Tc 7h Jh 8c]
Seat 1: stfuplzudonk (button) folded before Flop (didn't bet)
Seat 2: Mary5issi (small blind) showed [5c 5h] and lost with two pair, Tens and Fives
Seat 3: Cruelplace84 (big blind) folded before Flop
Seat 4: caduceus369 showed [7s 6s] and won (€0.23) with two pair, Tens and Sevens
Seat 5: Katymirax folded before Flop (didn't bet)
Seat 6: stagniarihd folded on the Flop



PokerStars Zoom Hand #257984429600:  Hold'em No Limit (€0.01/€0.02) [ADM ID: M62BA304494E32ST] - 2025/10/03 18:57:08 CET [2025/10/03 12:57:08 ET]
Table 'Sirio' 6-max Seat #1 is the button
Seat 1: Miele69409 (€1.29 in chips) 
Seat 2: GanchanS7 (€4.15 in chips) 
Seat 3: stfuplzudonk (€1.75 in chips) 
Seat 4: Gabrielefante (€2.25 in chips) 
Seat 5: caduceus369 (€4.34 in chips) 
Seat 6: Mary5issi (€1.87 in chips) 
GanchanS7: posts small blind €0.01
stfuplzudonk: posts big blind €0.02
*** HOLE CARDS ***
Dealt to caduceus369 [3c 3d]
Gabrielefante: folds 
caduceus369: calls €0.02
Mary5issi: raises €0.09 to €0.11
Miele69409: folds 
GanchanS7: folds 
stfuplzudonk: folds 
caduceus369: folds 
Uncalled bet (€0.09) returned to Mary5issi
Mary5issi collected €0.07 from pot
Mary5issi: doesn't show hand 
*** SUMMARY ***
Total pot €0.07 | Rake €0 
Seat 1: Miele69409 (button) folded before Flop (didn't bet)
Seat 2: GanchanS7 (small blind) folded before Flop
Seat 3: stfuplzudonk (big blind) folded before Flop
Seat 4: Gabrielefante folded before Flop (didn't bet)
Seat 5: caduceus369 folded before Flop
Seat 6: Mary5issi collected (€0.07)



PokerStars Zoom Hand #257984428855:  Hold'em No Limit (€0.01/€0.02) [ADM ID: M62BA304494E32ST] - 2025/10/03 18:57:03 CET [2025/10/03 12:57:03 ET]
Table 'Sirio' 6-max Seat #1 is the button
Seat 1: miaghi61 (€1.11 in chips) 
Seat 2: SalahUbeen (€1.35 in chips) 
Seat 3: Mary5issi (€1.89 in chips) 
Seat 4: potodds1979 (€2.51 in chips) 
Seat 5: caduceus369 (€4.34 in chips) 
Seat 6: jolli180 (€2.36 in chips) 
SalahUbeen: posts small blind €0.01
Mary5issi: posts big blind €0.02
*** HOLE CARDS ***
Dealt to caduceus369 [Ks 8d]
potodds1979: raises €0.04 to €0.06
caduceus369: folds 
jolli180: calls €0.06
miaghi61: calls €0.06
SalahUbeen: calls €0.05
Mary5issi: folds 
*** FLOP *** [9h 5h Ac]
SalahUbeen: checks 
potodds1979: checks 
jolli180: checks 
miaghi61: bets €1.05 and is all-in
SalahUbeen: folds 
potodds1979: folds 
jolli180: folds 
Uncalled bet (€1.05) returned to miaghi61
miaghi61 collected €0.25 from pot
miaghi61: doesn't show hand 
*** SUMMARY ***
Total pot €0.26 | Rake €0.01 
Board [9h 5h Ac]
Seat 1: miaghi61 (button) collected (€0.25)
Seat 2: SalahUbeen (small blind) folded on the Flop
Seat 3: Mary5issi (big blind) folded before Flop
Seat 4: potodds1979 folded on the Flop
Seat 5: caduceus369 folded before Flop (didn't bet)
Seat 6: jolli180 folded on the Flop



PokerStars Zoom Hand #257984432697:  Hold'em No Limit (€0.01/€0.02) [ADM ID: M62BA304494E32ST] - 2025/10/03 18:57:30 CET [2025/10/03 12:57:30 ET]
Table 'Sirio' 6-max Seat #1 is the button
Seat 1: Cruelplace84 (€3.65 in chips) 
Seat 2: potodds1979 (€2.45 in chips) 
Seat 3: caduceus369 (€4.32 in chips) 
Seat 4: OMGWOLFX (€4 in chips) 
Seat 5: luchino74 (€4.16 in chips) 
Seat 6: stfuplzudonk (€2.06 in chips) 
potodds1979: posts small blind €0.01
caduceus369: posts big blind €0.02
*** HOLE CARDS ***
Dealt to caduceus369 [4c 5c]
OMGWOLFX: folds 
luchino74: folds 
stfuplzudonk: folds 
Cruelplace84: folds 
potodds1979: folds 
Uncalled bet (€0.01) returned to caduceus369
caduceus369 collected €0.02 from pot
caduceus369: doesn't show hand 
*** SUMMARY ***
Total pot €0.02 | Rake €0 
Seat 1: Cruelplace84 (button) folded before Flop (didn't bet)
Seat 2: potodds1979 (small blind) folded before Flop
Seat 3: caduceus369 (big blind) collected (€0.02)
Seat 4: OMGWOLFX folded before Flop (didn't bet)
Seat 5: luchino74 folded before Flop (didn't bet)
Seat 6: stfuplzudonk folded before Flop (didn't bet)



PokerStars Zoom Hand #257984436800:  Hold'em No Limit (€0.01/€0.02) [ADM ID: M62BA304494E32ST] - 2025/10/03 18:57:59 CET [2025/10/03 12:57:59 ET]
Table 'Sirio' 6-max Seat #1 is the button
Seat 1: Cruelplace84 (€2.01 in chips) 
Seat 2: Catania838 (€1.76 in chips) 
Seat 3: stfuplzudonk (€1.73 in chips) 
Seat 4: ziogeppI (€1.16 in chips) 
Seat 5: pylonstrip (€3.02 in chips) 
Seat 6: caduceus369 (€4.32 in chips) 
Catania838: posts small blind €0.01
stfuplzudonk: posts big blind €0.02
*** HOLE CARDS ***
Dealt to caduceus369 [3d Jh]
ziogeppI: folds 
pylonstrip: folds 
caduceus369: folds 
Cruelplace84: folds 
Catania838: folds 
Uncalled bet (€0.01) returned to stfuplzudonk
stfuplzudonk collected €0.02 from pot
stfuplzudonk: doesn't show hand 
*** SUMMARY ***
Total pot €0.02 | Rake €0 
Seat 1: Cruelplace84 (button) folded before Flop (didn't bet)
Seat 2: Catania838 (small blind) folded before Flop
Seat 3: stfuplzudonk (big blind) collected (€0.02)
Seat 4: ziogeppI folded before Flop (didn't bet)
Seat 5: pylonstrip folded before Flop (didn't bet)
Seat 6: caduceus369 folded before Flop (didn't bet)



PokerStars Zoom Hand #257984434828:  Hold'em No Limit (€0.01/€0.02) [ADM ID: M62BA304494E32ST] - 2025/10/03 18:57:45 CET [2025/10/03 12:57:45 ET]
Table 'Sirio' 6-max Seat #1 is the button
Seat 1: marina41978 (€0.51 in chips) 
Seat 2: caduceus369 (€4.33 in chips) 
Seat 3: labronicus58 (€2.02 in chips) 
Seat 4: Sararafusa11 (€3.25 in chips) 
Seat 5: stfuplzudonk (€1.73 in chips) 
Seat 6: GanchanS7 (€4.14 in chips) 
caduceus369: posts small blind €0.01
labronicus58: posts big blind €0.02
*** HOLE CARDS ***
Dealt to caduceus369 [Js 5s]
Sararafusa11: folds 
stfuplzudonk: folds 
GanchanS7: raises €0.03 to €0.05
marina41978: calls €0.05
caduceus369: folds 
labronicus58: folds 
*** FLOP *** [2s 8c 3s]
GanchanS7: checks 
marina41978: checks 
*** TURN *** [2s 8c 3s] [5d]
GanchanS7: checks 
marina41978: checks 
*** RIVER *** [2s 8c 3s 5d] [7h]
GanchanS7: checks 
marina41978: checks 
*** SHOW DOWN ***
GanchanS7: shows [Jc Kh] (high card King)
marina41978: mucks hand 
GanchanS7 collected €0.13 from pot
*** SUMMARY ***
Total pot €0.13 | Rake €0 
Board [2s 8c 3s 5d 7h]
Seat 1: marina41978 (button) mucked [Td Qc]
Seat 2: caduceus369 (small blind) folded before Flop
Seat 3: labronicus58 (big blind) folded before Flop
Seat 4: Sararafusa11 folded before Flop (didn't bet)
Seat 5: stfuplzudonk folded before Flop (didn't bet)
Seat 6: GanchanS7 showed [Jc Kh] and won (€0.13) with high card King



PokerStars Zoom Hand #257984437371:  Hold'em No Limit (€0.01/€0.02) [ADM ID: M62BA304494E32ST] - 2025/10/03 18:58:03 CET [2025/10/03 12:58:03 ET]
Table 'Sirio' 6-max Seat #1 is the button
Seat 1: caduceus369 (€4.32 in chips) 
Seat 2: stfuplzudonk (€3.42 in chips) 
Seat 3: GanchanS7 (€2.18 in chips) 
Seat 4: shakthi (€2.15 in chips) 
Seat 5: ziogeppI (€1.16 in chips) 
Seat 6: Catania838 (€2.04 in chips) 
stfuplzudonk: posts small blind €0.01
GanchanS7: posts big blind €0.02
*** HOLE CARDS ***
Dealt to caduceus369 [8s Ts]
shakthi: folds 
ziogeppI: folds 
Catania838: folds 
caduceus369: raises €0.02 to €0.04
stfuplzudonk: folds 
GanchanS7: folds 
Uncalled bet (€0.02) returned to caduceus369
caduceus369 collected €0.05 from pot
caduceus369: doesn't show hand 
*** SUMMARY ***
Total pot €0.05 | Rake €0 
Seat 1: caduceus369 (button) collected (€0.05)
Seat 2: stfuplzudonk (small blind) folded before Flop
Seat 3: GanchanS7 (big blind) folded before Flop
Seat 4: shakthi folded before Flop (didn't bet)
Seat 5: ziogeppI folded before Flop (didn't bet)
Seat 6: Catania838 folded before Flop (didn't bet)



PokerStars Zoom Hand #257984440759:  Hold'em No Limit (€0.01/€0.02) [ADM ID: M62BA304494E32ST] - 2025/10/03 18:58:28 CET [2025/10/03 12:58:28 ET]
Table 'Sirio' 6-max Seat #1 is the button
Seat 1: GanchanS7 (€3.72 in chips) 
Seat 2: caduceus369 (€4.35 in chips) 
Seat 3: pistaKKio23 (€4.71 in chips) 
Seat 4: Cruelplace84 (€2 in chips) 
Seat 5: luchino74 (€4.42 in chips) 
Seat 6: Catania838 (€1.75 in chips) 
caduceus369: posts small blind €0.01
pistaKKio23: posts big blind €0.02
*** HOLE CARDS ***
Dealt to caduceus369 [Kc Ac]
Cruelplace84: folds 
luchino74: raises €0.02 to €0.04
Catania838: folds 
GanchanS7: folds 
caduceus369: raises €0.18 to €0.22
pistaKKio23: folds 
luchino74: folds 
Uncalled bet (€0.18) returned to caduceus369
caduceus369 collected €0.10 from pot
caduceus369: doesn't show hand 
*** SUMMARY ***
Total pot €0.10 | Rake €0 
Seat 1: GanchanS7 (button) folded before Flop (didn't bet)
Seat 2: caduceus369 (small blind) collected (€0.10)
Seat 3: pistaKKio23 (big blind) folded before Flop
Seat 4: Cruelplace84 folded before Flop (didn't bet)
Seat 5: luchino74 folded before Flop
Seat 6: Catania838 folded before Flop (didn't bet)



PokerStars Zoom Hand #257984445310:  Hold'em No Limit (€0.01/€0.02) [ADM ID: M62BA304494E32ST] - 2025/10/03 18:59:00 CET [2025/10/03 12:59:00 ET]
Table 'Sirio' 6-max Seat #1 is the button
Seat 1: luchino74 (€3.88 in chips) 
Seat 2: SalahUbeen (€1.30 in chips) 
Seat 3: Catania838 (€1.71 in chips) 
Seat 4: stfuplzudonk (€3.41 in chips) 
Seat 5: caduceus369 (€4.41 in chips) 
Seat 6: marina41978 (€0.62 in chips) 
SalahUbeen: posts small blind €0.01
Catania838: posts big blind €0.02
*** HOLE CARDS ***
Dealt to caduceus369 [As 6s]
stfuplzudonk: folds 
caduceus369: raises €0.02 to €0.04
marina41978: folds 
luchino74: folds 
SalahUbeen: folds 
Catania838: folds 
Uncalled bet (€0.02) returned to caduceus369
caduceus369 collected €0.05 from pot
caduceus369: doesn't show hand 
*** SUMMARY ***
Total pot €0.05 | Rake €0 
Seat 1: luchino74 (button) folded before Flop (didn't bet)
Seat 2: SalahUbeen (small blind) folded before Flop
Seat 3: Catania838 (big blind) folded before Flop
Seat 4: stfuplzudonk folded before Flop (didn't bet)
Seat 5: caduceus369 collected (€0.05)
Seat 6: marina41978 folded before Flop (didn't bet)



PokerStars Zoom Hand #257984449114:  Hold'em No Limit (€0.01/€0.02) [ADM ID: M62BA304494E32ST] - 2025/10/03 18:59:27 CET [2025/10/03 12:59:27 ET]
Table 'Sirio' 6-max Seat #1 is the button
Seat 1: caduceus369 (€4.44 in chips) 
Seat 2: OMGWOLFX (€10.56 in chips) 
Seat 3: GanchanS7 (€2.15 in chips) 
Seat 4: stfuplzudonk (€1.83 in chips) 
Seat 5: Cruelplace84 (€3.32 in chips) 
Seat 6: parker1318 (€2.55 in chips) 
OMGWOLFX: posts small blind €0.01
GanchanS7: posts big blind €0.02
*** HOLE CARDS ***
Dealt to caduceus369 [5h Ac]
stfuplzudonk: folds 
Cruelplace84: raises €0.03 to €0.05
parker1318: folds 
caduceus369: folds 
OMGWOLFX: folds 
GanchanS7: folds 
Uncalled bet (€0.03) returned to Cruelplace84
Cruelplace84 collected €0.05 from pot
Cruelplace84: doesn't show hand 
*** SUMMARY ***
Total pot €0.05 | Rake €0 
Seat 1: caduceus369 (button) folded before Flop (didn't bet)
Seat 2: OMGWOLFX (small blind) folded before Flop
Seat 3: GanchanS7 (big blind) folded before Flop
Seat 4: stfuplzudonk folded before Flop (didn't bet)
Seat 5: Cruelplace84 collected (€0.05)
Seat 6: parker1318 folded before Flop (didn't bet)



PokerStars Zoom Hand #257984449778:  Hold'em No Limit (€0.01/€0.02) [ADM ID: M62BA304494E32ST] - 2025/10/03 18:59:32 CET [2025/10/03 12:59:32 ET]
Table 'Sirio' 6-max Seat #1 is the button
Seat 1: Catania838 (€1.93 in chips) 
Seat 2: miaghi61 (€1.21 in chips) 
Seat 3: caduceus369 (€4.44 in chips) 
Seat 4: pistaKKio23 (€2.35 in chips) 
Seat 5: Mary5issi (€1.96 in chips) 
Seat 6: stfuplzudonk (€1.83 in chips) 
miaghi61: posts small blind €0.01
caduceus369: posts big blind €0.02
*** HOLE CARDS ***
Dealt to caduceus369 [3s 6s]
pistaKKio23: folds 
Mary5issi: folds 
stfuplzudonk: folds 
Catania838: folds 
miaghi61: calls €0.01
caduceus369: checks 
*** FLOP *** [5d 7h Ad]
miaghi61: checks 
caduceus369: bets €0.02
miaghi61: folds 
Uncalled bet (€0.02) returned to caduceus369
caduceus369 collected €0.04 from pot
caduceus369: doesn't show hand 
*** SUMMARY ***
Total pot €0.04 | Rake €0 
Board [5d 7h Ad]
Seat 1: Catania838 (button) folded before Flop (didn't bet)
Seat 2: miaghi61 (small blind) folded on the Flop
Seat 3: caduceus369 (big blind) collected (€0.04)
Seat 4: pistaKKio23 folded before Flop (didn't bet)
Seat 5: Mary5issi folded before Flop (didn't bet)
Seat 6: stfuplzudonk folded before Flop (didn't bet)



PokerStars Zoom Hand #257984453573:  Hold'em No Limit (€0.01/€0.02) [ADM ID: M62BA304494E32ST] - 2025/10/03 18:59:59 CET [2025/10/03 12:59:59 ET]
Table 'Sirio' 6-max Seat #1 is the button
Seat 1: marina41978 (€0.56 in chips) 
Seat 2: OSPREYSTORM (€2.46 in chips) 
Seat 3: labronicus58 (€2.01 in chips) 
Seat 4: caduceus369 (€4.46 in chips) 
Seat 5: Cruelplace84 (€3.56 in chips) 
Seat 6: pylonstrip (€3.28 in chips) 
OSPREYSTORM: posts small blind €0.01
labronicus58: posts big blind €0.02
*** HOLE CARDS ***
Dealt to caduceus369 [4s 4d]
caduceus369: calls €0.02
Cruelplace84: folds 
pylonstrip: folds 
marina41978: folds 
OSPREYSTORM: folds 
labronicus58: checks 
*** FLOP *** [Kh 3c 3h]
labronicus58: checks 
caduceus369: bets €0.02
labronicus58: calls €0.02
*** TURN *** [Kh 3c 3h] [Td]
labronicus58: checks 
caduceus369: checks 
*** RIVER *** [Kh 3c 3h Td] [3s]
labronicus58: bets €0.06
caduceus369: calls €0.06
*** SHOW DOWN ***
labronicus58: shows [Kc 2s] (a full house, Threes full of Kings)
caduceus369: mucks hand 
labronicus58 collected €0.20 from pot
*** SUMMARY ***
Total pot €0.21 | Rake €0.01 
Board [Kh 3c 3h Td 3s]
Seat 1: marina41978 (button) folded before Flop (didn't bet)
Seat 2: OSPREYSTORM (small blind) folded before Flop
Seat 3: labronicus58 (big blind) showed [Kc 2s] and won (€0.20) with a full house, Threes full of Kings
Seat 4: caduceus369 mucked [4s 4d]
Seat 5: Cruelplace84 folded before Flop (didn't bet)
Seat 6: pylonstrip folded before Flop (didn't bet)



PokerStars Zoom Hand #257984464042:  Hold'em No Limit (€0.01/€0.02) [ADM ID: M62BA304494E32ST] - 2025/10/03 19:01:05 CET [2025/10/03 13:01:05 ET]
Table 'Sirio' 6-max Seat #1 is the button
Seat 1: GanchanS7 (€2.12 in chips) 
Seat 2: parker1318 (€2.52 in chips) 
Seat 3: OMGWOLFX (€6.14 in chips) 
Seat 4: OSPREYSTORM (€2.43 in chips) 
Seat 5: caduceus369 (€4.36 in chips) 
Seat 6: Teriferro (€1 in chips) 
parker1318: posts small blind €0.01
OMGWOLFX: posts big blind €0.02
*** HOLE CARDS ***
Dealt to caduceus369 [9d Th]
OSPREYSTORM: folds 
caduceus369: folds 
Teriferro: raises €0.05 to €0.07
GanchanS7: folds 
parker1318: folds 
OMGWOLFX: folds 
Uncalled bet (€0.05) returned to Teriferro
Teriferro collected €0.05 from pot
Teriferro: doesn't show hand 
*** SUMMARY ***
Total pot €0.05 | Rake €0 
Seat 1: GanchanS7 (button) folded before Flop (didn't bet)
Seat 2: parker1318 (small blind) folded before Flop
Seat 3: OMGWOLFX (big blind) folded before Flop
Seat 4: OSPREYSTORM folded before Flop (didn't bet)
Seat 5: caduceus369 folded before Flop (didn't bet)
Seat 6: Teriferro collected (€0.05)



PokerStars Zoom Hand #257984464922:  Hold'em No Limit (€0.01/€0.02) [ADM ID: M62BA304494E32ST] - 2025/10/03 19:01:11 CET [2025/10/03 13:01:11 ET]
Table 'Sirio' 6-max Seat #1 is the button
Seat 1: caduceus369 (€4.36 in chips) 
Seat 2: ceramista17 (€0.82 in chips) 
Seat 3: pistaKKio23 (€4.71 in chips) 
Seat 4: cuzzi68 (€0.84 in chips) 
Seat 5: OSPREYSTORM (€2.10 in chips) 
Seat 6: nikolor (€2.02 in chips) 
ceramista17: posts small blind €0.01
pistaKKio23: posts big blind €0.02
*** HOLE CARDS ***
Dealt to caduceus369 [Qs 5d]
cuzzi68: calls €0.02
OSPREYSTORM: folds 
nikolor: raises €0.04 to €0.06
caduceus369: folds 
ceramista17: raises €0.76 to €0.82 and is all-in
pistaKKio23: folds 
cuzzi68: folds 
nikolor: folds 
Uncalled bet (€0.76) returned to ceramista17
ceramista17 collected €0.16 from pot
ceramista17: doesn't show hand 
*** SUMMARY ***
Total pot €0.16 | Rake €0 
Seat 1: caduceus369 (button) folded before Flop (didn't bet)
Seat 2: ceramista17 (small blind) collected (€0.16)
Seat 3: pistaKKio23 (big blind) folded before Flop
Seat 4: cuzzi68 folded before Flop
Seat 5: OSPREYSTORM folded before Flop (didn't bet)
Seat 6: nikolor folded before Flop



PokerStars Zoom Hand #257984465946:  Hold'em No Limit (€0.01/€0.02) [ADM ID: M62BA304494E32ST] - 2025/10/03 19:01:17 CET [2025/10/03 13:01:17 ET]
Table 'Sirio' 6-max Seat #1 is the button
Seat 1: OSPREYSTORM (€2.10 in chips) 
Seat 2: caduceus369 (€4.36 in chips) 
Seat 3: potodds1979 (€2 in chips) 
Seat 4: Sararafusa11 (€3.47 in chips) 
Seat 5: stfuplzudonk (€3.58 in chips) 
Seat 6: SalahUbeen (€1.20 in chips) 
caduceus369: posts small blind €0.01
potodds1979: posts big blind €0.02
*** HOLE CARDS ***
Dealt to caduceus369 [Jc 7s]
Sararafusa11: folds 
stfuplzudonk: folds 
SalahUbeen: raises €0.03 to €0.05
OSPREYSTORM: raises €0.13 to €0.18
caduceus369: folds 
potodds1979: folds 
SalahUbeen: folds 
Uncalled bet (€0.13) returned to OSPREYSTORM
OSPREYSTORM collected €0.13 from pot
OSPREYSTORM: doesn't show hand 
*** SUMMARY ***
Total pot €0.13 | Rake €0 
Seat 1: OSPREYSTORM (button) collected (€0.13)
Seat 2: caduceus369 (small blind) folded before Flop
Seat 3: potodds1979 (big blind) folded before Flop
Seat 4: Sararafusa11 folded before Flop (didn't bet)
Seat 5: stfuplzudonk folded before Flop (didn't bet)
Seat 6: SalahUbeen folded before Flop



PokerStars Zoom Hand #257984462618:  Hold'em No Limit (€0.01/€0.02) [ADM ID: M62BA304494E32ST] - 2025/10/03 19:00:57 CET [2025/10/03 13:00:57 ET]
Table 'Sirio' 6-max Seat #1 is the button
Seat 1: OSPREYSTORM (€2.43 in chips) 
Seat 2: pistaKKio23 (€2.31 in chips) 
Seat 3: Mary5issi (€1.88 in chips) 
Seat 4: caduceus369 (€4.36 in chips) 
Seat 5: labronicus58 (€2.11 in chips) 
Seat 6: mikelino47 (€0.77 in chips) 
pistaKKio23: posts small blind €0.01
Mary5issi: posts big blind €0.02
*** HOLE CARDS ***
Dealt to caduceus369 [Jh Qs]
caduceus369: folds 
labronicus58: folds 
mikelino47: calls €0.02
OSPREYSTORM: folds 
pistaKKio23: calls €0.01
Mary5issi: checks 
*** FLOP *** [8d 3c 4s]
pistaKKio23: checks 
Mary5issi: checks 
mikelino47: checks 
*** TURN *** [8d 3c 4s] [Qd]
pistaKKio23: checks 
Mary5issi: checks 
mikelino47: checks 
*** RIVER *** [8d 3c 4s Qd] [2h]
pistaKKio23: checks 
Mary5issi: bets €0.06
mikelino47: raises €0.69 to €0.75 and is all-in
pistaKKio23: folds 
Mary5issi: calls €0.69
*** SHOW DOWN ***
mikelino47: shows [Ad Ah] (a pair of Aces)
Mary5issi: shows [5d Ac] (a straight, Ace to Five)
Mary5issi collected €1.48 from pot
*** SUMMARY ***
Total pot €1.56 | Rake €0.08 
Board [8d 3c 4s Qd 2h]
Seat 1: OSPREYSTORM (button) folded before Flop (didn't bet)
Seat 2: pistaKKio23 (small blind) folded on the River
Seat 3: Mary5issi (big blind) showed [5d Ac] and won (€1.48) with a straight, Ace to Five
Seat 4: caduceus369 folded before Flop (didn't bet)
Seat 5: labronicus58 folded before Flop (didn't bet)
Seat 6: mikelino47 showed [Ad Ah] and lost with a pair of Aces



PokerStars Zoom Hand #257984469706:  Hold'em No Limit (€0.01/€0.02) [ADM ID: M62BA304494E32ST] - 2025/10/03 19:01:38 CET [2025/10/03 13:01:38 ET]
Table 'Sirio' 6-max Seat #1 is the button
Seat 1: GanchanS7 (€2.11 in chips) 
Seat 2: OMGWOLFX (€10.68 in chips) 
Seat 3: caduceus369 (€4.35 in chips) 
Seat 4: labronicus58 (€2.14 in chips) 
Seat 5: SalahUbeen (€1.15 in chips) 
Seat 6: pistaKKio23 (€6.30 in chips) 
OMGWOLFX: posts small blind €0.01
caduceus369: posts big blind €0.02
*** HOLE CARDS ***
Dealt to caduceus369 [9s Jc]
labronicus58: raises €0.03 to €0.05
SalahUbeen: folds 
pistaKKio23: folds 
GanchanS7: folds 
OMGWOLFX: folds 
caduceus369: folds 
Uncalled bet (€0.03) returned to labronicus58
labronicus58 collected €0.05 from pot
labronicus58: doesn't show hand 
*** SUMMARY ***
Total pot €0.05 | Rake €0 
Seat 1: GanchanS7 (button) folded before Flop (didn't bet)
Seat 2: OMGWOLFX (small blind) folded before Flop
Seat 3: caduceus369 (big blind) folded before Flop
Seat 4: labronicus58 collected (€0.05)
Seat 5: SalahUbeen folded before Flop (didn't bet)
Seat 6: pistaKKio23 folded before Flop (didn't bet)



PokerStars Zoom Hand #257984476171:  Hold'em No Limit (€0.01/€0.02) [ADM ID: M62BA304494E32ST] - 2025/10/03 19:02:11 CET [2025/10/03 13:02:11 ET]
Table 'Sirio' 6-max Seat #1 is the button
Seat 1: S'dj83 (€3.11 in chips) 
Seat 2: OSPREYSTORM (€2.34 in chips) 
Seat 3: parker1318 (€2.83 in chips) 
Seat 4: caduceus369 (€4.33 in chips) 
Seat 5: stfuplzudonk (€3.58 in chips) 
Seat 6: Sararafusa11 (€3.47 in chips) 
OSPREYSTORM: posts small blind €0.01
parker1318: posts big blind €0.02
*** HOLE CARDS ***
Dealt to caduceus369 [Jh 4d]
caduceus369: folds 
stfuplzudonk: folds 
Sararafusa11: folds 
S'dj83: folds 
OSPREYSTORM: folds 
Uncalled bet (€0.01) returned to parker1318
parker1318 collected €0.02 from pot
parker1318: doesn't show hand 
*** SUMMARY ***
Total pot €0.02 | Rake €0 
Seat 1: S'dj83 (button) folded before Flop (didn't bet)
Seat 2: OSPREYSTORM (small blind) folded before Flop
Seat 3: parker1318 (big blind) collected (€0.02)
Seat 4: caduceus369 folded before Flop (didn't bet)
Seat 5: stfuplzudonk folded before Flop (didn't bet)
Seat 6: Sararafusa11 folded before Flop (didn't bet)



PokerStars Zoom Hand #257984478572:  Hold'em No Limit (€0.01/€0.02) [ADM ID: M62BA304494E32ST] - 2025/10/03 19:02:24 CET [2025/10/03 13:02:24 ET]
Table 'Sirio' 6-max Seat #1 is the button
Seat 1: miaghi61 (€1.07 in chips) 
Seat 2: GanchanS7 (€2.12 in chips) 
Seat 3: Sararafusa11 (€3.47 in chips) 
Seat 4: Mary5issi (€2.58 in chips) 
Seat 5: caduceus369 (€4.33 in chips) 
Seat 6: stfuplzudonk (€3.58 in chips) 
GanchanS7: posts small blind €0.01
Sararafusa11: posts big blind €0.02
*** HOLE CARDS ***
Dealt to caduceus369 [5s 7d]
Mary5issi: folds 
caduceus369: folds 
stfuplzudonk: folds 
miaghi61: folds 
GanchanS7: folds 
Uncalled bet (€0.01) returned to Sararafusa11
Sararafusa11 collected €0.02 from pot
Sararafusa11: doesn't show hand 
*** SUMMARY ***
Total pot €0.02 | Rake €0 
Seat 1: miaghi61 (button) folded before Flop (didn't bet)
Seat 2: GanchanS7 (small blind) folded before Flop
Seat 3: Sararafusa11 (big blind) collected (€0.02)
Seat 4: Mary5issi folded before Flop (didn't bet)
Seat 5: caduceus369 folded before Flop (didn't bet)
Seat 6: stfuplzudonk folded before Flop (didn't bet)



PokerStars Zoom Hand #257984475434:  Hold'em No Limit (€0.01/€0.02) [ADM ID: M62BA304494E32ST] - 2025/10/03 19:02:07 CET [2025/10/03 13:02:07 ET]
Table 'Sirio' 6-max Seat #1 is the button
Seat 1: GanchanS7 (€2.12 in chips) 
Seat 2: Katymirax (€1.06 in chips) 
Seat 3: pistaKKio23 (€2.32 in chips) 
Seat 4: SalahUbeen (€1.15 in chips) 
Seat 5: stagniarihd (€1.61 in chips) 
Seat 6: caduceus369 (€4.33 in chips) 
Katymirax: posts small blind €0.01
pistaKKio23: posts big blind €0.02
*** HOLE CARDS ***
Dealt to caduceus369 [Ah 3c]
SalahUbeen: folds 
stagniarihd: raises €0.05 to €0.07
caduceus369: folds 
GanchanS7: folds 
Katymirax: calls €0.06
pistaKKio23: folds 
*** FLOP *** [6d 5d 4d]
Katymirax: checks 
stagniarihd: checks 
*** TURN *** [6d 5d 4d] [Qh]
Katymirax: checks 
stagniarihd: checks 
*** RIVER *** [6d 5d 4d Qh] [Td]
Katymirax: checks 
stagniarihd: checks 
*** SHOW DOWN ***
Katymirax: shows [As 7s] (high card Ace)
stagniarihd: shows [Ac Ks] (high card Ace - King kicker)
stagniarihd collected €0.16 from pot
*** SUMMARY ***
Total pot €0.16 | Rake €0 
Board [6d 5d 4d Qh Td]
Seat 1: GanchanS7 (button) folded before Flop (didn't bet)
Seat 2: Katymirax (small blind) showed [As 7s] and lost with high card Ace
Seat 3: pistaKKio23 (big blind) folded before Flop
Seat 4: SalahUbeen folded before Flop (didn't bet)
Seat 5: stagniarihd showed [Ac Ks] and won (€0.16) with high card Ace
Seat 6: caduceus369 folded before Flop (didn't bet)



PokerStars Zoom Hand #257984477153:  Hold'em No Limit (€0.01/€0.02) [ADM ID: M62BA304494E32ST] - 2025/10/03 19:02:16 CET [2025/10/03 13:02:16 ET]
Table 'Sirio' 6-max Seat #1 is the button
Seat 1: Teriferro (€0.94 in chips) 
Seat 2: pylonstrip (€3.37 in chips) 
Seat 3: SalahUbeen (€1.70 in chips) 
Seat 4: Mary5issi (€3.32 in chips) 
Seat 5: OSPREYSTORM (€2.33 in chips) 
Seat 6: caduceus369 (€4.33 in chips) 
pylonstrip: posts small blind €0.01
SalahUbeen: posts big blind €0.02
*** HOLE CARDS ***
Dealt to caduceus369 [6d 2h]
Mary5issi: folds 
OSPREYSTORM: raises €0.04 to €0.06
caduceus369: folds 
Teriferro: folds 
pylonstrip: calls €0.05
SalahUbeen: folds 
*** FLOP *** [9d 3d 3s]
pylonstrip: checks 
OSPREYSTORM: bets €0.03
pylonstrip: calls €0.03
*** TURN *** [9d 3d 3s] [Ac]
pylonstrip: checks 
OSPREYSTORM: checks 
*** RIVER *** [9d 3d 3s Ac] [Qh]
pylonstrip: bets €0.16
OSPREYSTORM: calls €0.16
*** SHOW DOWN ***
pylonstrip: shows [As Qd] (two pair, Aces and Queens)
OSPREYSTORM: mucks hand 
pylonstrip collected €0.50 from pot
*** SUMMARY ***
Total pot €0.52 | Rake €0.02 
Board [9d 3d 3s Ac Qh]
Seat 1: Teriferro (button) folded before Flop (didn't bet)
Seat 2: pylonstrip (small blind) showed [As Qd] and won (€0.50) with two pair, Aces and Queens
Seat 3: SalahUbeen (big blind) folded before Flop
Seat 4: Mary5issi folded before Flop (didn't bet)
Seat 5: OSPREYSTORM mucked [Kh Kc]
Seat 6: caduceus369 folded before Flop (didn't bet)



PokerStars Zoom Hand #257984479312:  Hold'em No Limit (€0.01/€0.02) [ADM ID: M62BA304494E32ST] - 2025/10/03 19:02:28 CET [2025/10/03 13:02:28 ET]
Table 'Sirio' 6-max Seat #1 is the button
Seat 1: stfuplzudonk (€3.58 in chips) 
Seat 2: caduceus369 (€4.33 in chips) 
Seat 3: labronicus58 (€2.20 in chips) 
Seat 4: miaghi61 (€1.07 in chips) 
Seat 5: Gabrielefante (€2.65 in chips) 
Seat 6: OMGWOLFX (€10.87 in chips) 
caduceus369: posts small blind €0.01
labronicus58: posts big blind €0.02
*** HOLE CARDS ***
Dealt to caduceus369 [3c Td]
miaghi61: folds 
Gabrielefante: raises €0.04 to €0.06
OMGWOLFX: folds 
stfuplzudonk: raises €0.15 to €0.21
caduceus369: folds 
labronicus58: folds 
Gabrielefante: calls €0.15
*** FLOP *** [Jh 7s 6h]
Gabrielefante: checks 
stfuplzudonk: bets €0.28
Gabrielefante: folds 
Uncalled bet (€0.28) returned to stfuplzudonk
stfuplzudonk collected €0.43 from pot
stfuplzudonk: doesn't show hand 
*** SUMMARY ***
Total pot €0.45 | Rake €0.02 
Board [Jh 7s 6h]
Seat 1: stfuplzudonk (button) collected (€0.43)
Seat 2: caduceus369 (small blind) folded before Flop
Seat 3: labronicus58 (big blind) folded before Flop
Seat 4: miaghi61 folded before Flop (didn't bet)
Seat 5: Gabrielefante folded on the Flop
Seat 6: OMGWOLFX folded before Flop (didn't bet)



PokerStars Zoom Hand #257984481137:  Hold'em No Limit (€0.01/€0.02) [ADM ID: M62BA304494E32ST] - 2025/10/03 19:02:38 CET [2025/10/03 13:02:38 ET]
Table 'Sirio' 6-max Seat #1 is the button
Seat 1: Sararafusa11 (€3.48 in chips) 
Seat 2: Teriferro (€0.94 in chips) 
Seat 3: caduceus369 (€4.32 in chips) 
Seat 4: pistaKKio23 (€4.72 in chips) 
Seat 5: OMGWOLFX (€10.87 in chips) 
Seat 6: GanchanS7 (€3.63 in chips) 
Teriferro: posts small blind €0.01
caduceus369: posts big blind €0.02
*** HOLE CARDS ***
Dealt to caduceus369 [2c 2s]
pistaKKio23: folds 
OMGWOLFX: folds 
GanchanS7: folds 
Sararafusa11: folds 
Teriferro: raises €0.04 to €0.06
caduceus369: calls €0.04
*** FLOP *** [6s Ks 9d]
Teriferro: checks 
caduceus369: checks 
*** TURN *** [6s Ks 9d] [Qc]
Teriferro: bets €0.04
caduceus369: folds 
Uncalled bet (€0.04) returned to Teriferro
Teriferro collected €0.12 from pot
Teriferro: doesn't show hand 
*** SUMMARY ***
Total pot €0.12 | Rake €0 
Board [6s Ks 9d Qc]
Seat 1: Sararafusa11 (button) folded before Flop (didn't bet)
Seat 2: Teriferro (small blind) collected (€0.12)
Seat 3: caduceus369 (big blind) folded on the Turn
Seat 4: pistaKKio23 folded before Flop (didn't bet)
Seat 5: OMGWOLFX folded before Flop (didn't bet)
Seat 6: GanchanS7 folded before Flop (didn't bet)



PokerStars Zoom Hand #257984491156:  Hold'em No Limit (€0.01/€0.02) [ADM ID: M62BA304494E32ST] - 2025/10/03 19:03:31 CET [2025/10/03 13:03:31 ET]
Table 'Sirio' 6-max Seat #1 is the button
Seat 1: caduceus369 (€4.26 in chips) 
Seat 2: Mary5issi (€3.37 in chips) 
Seat 3: OMGWOLFX (€6.34 in chips) 
Seat 4: SalahUbeen (€2 in chips) 
Seat 5: labronicus58 (€2.18 in chips) 
Seat 6: Gabrielefante (€2.41 in chips) 
Mary5issi: posts small blind €0.01
OMGWOLFX: posts big blind €0.02
*** HOLE CARDS ***
Dealt to caduceus369 [5s 4s]
SalahUbeen: folds 
labronicus58: folds 
Gabrielefante: folds 
caduceus369: raises €0.02 to €0.04
Mary5issi: calls €0.03
OMGWOLFX: raises €0.16 to €0.20
caduceus369: folds 
Mary5issi: folds 
Uncalled bet (€0.16) returned to OMGWOLFX
OMGWOLFX collected €0.12 from pot
OMGWOLFX: doesn't show hand 
*** SUMMARY ***
Total pot €0.12 | Rake €0 
Seat 1: caduceus369 (button) folded before Flop
Seat 2: Mary5issi (small blind) folded before Flop
Seat 3: OMGWOLFX (big blind) collected (€0.12)
Seat 4: SalahUbeen folded before Flop (didn't bet)
Seat 5: labronicus58 folded before Flop (didn't bet)
Seat 6: Gabrielefante folded before Flop (didn't bet)



PokerStars Zoom Hand #257984495538:  Hold'em No Limit (€0.01/€0.02) [ADM ID: M62BA304494E32ST] - 2025/10/03 19:03:54 CET [2025/10/03 13:03:54 ET]
Table 'Sirio' 6-max Seat #1 is the button
Seat 1: QUATTRODAME (€3.78 in chips) 
Seat 2: Mary5issi (€2.64 in chips) 
Seat 3: OSPREYSTORM (€6.72 in chips) 
Seat 4: caduceus369 (€4.22 in chips) 
Seat 5: GanchanS7 (€4.17 in chips) 
Seat 6: OMGWOLFX (€10.82 in chips) 
Mary5issi: posts small blind €0.01
OSPREYSTORM: posts big blind €0.02
*** HOLE CARDS ***
Dealt to caduceus369 [Tc Jd]
caduceus369: folds 
GanchanS7: folds 
OMGWOLFX: raises €0.02 to €0.04
QUATTRODAME: folds 
Mary5issi: calls €0.03
OSPREYSTORM: calls €0.02
*** FLOP *** [Qs 4s 5h]
Mary5issi: checks 
OSPREYSTORM: checks 
OMGWOLFX: bets €0.04
Mary5issi: folds 
OSPREYSTORM: raises €0.11 to €0.15
OMGWOLFX: calls €0.11
*** TURN *** [Qs 4s 5h] [9d]
OSPREYSTORM: checks 
OMGWOLFX: checks 
*** RIVER *** [Qs 4s 5h 9d] [Jc]
OSPREYSTORM: bets €0.24
OMGWOLFX: folds 
Uncalled bet (€0.24) returned to OSPREYSTORM
OSPREYSTORM collected €0.40 from pot
OSPREYSTORM: doesn't show hand 
*** SUMMARY ***
Total pot €0.42 | Rake €0.02 
Board [Qs 4s 5h 9d Jc]
Seat 1: QUATTRODAME (button) folded before Flop (didn't bet)
Seat 2: Mary5issi (small blind) folded on the Flop
Seat 3: OSPREYSTORM (big blind) collected (€0.40)
Seat 4: caduceus369 folded before Flop (didn't bet)
Seat 5: GanchanS7 folded before Flop (didn't bet)
Seat 6: OMGWOLFX folded on the River



PokerStars Zoom Hand #257984496906:  Hold'em No Limit (€0.01/€0.02) [ADM ID: M62BA304494E32ST] - 2025/10/03 19:04:01 CET [2025/10/03 13:04:01 ET]
Table 'Sirio' 6-max Seat #1 is the button
Seat 1: GanchanS7 (€4.17 in chips) 
Seat 2: nikolor (€1.78 in chips) 
Seat 3: caduceus369 (€4.22 in chips) 
Seat 4: Sararafusa11 (€3.48 in chips) 
Seat 5: OMGWOLFX (€6.42 in chips) 
Seat 6: SalahUbeen (€2.79 in chips) 
nikolor: posts small blind €0.01
caduceus369: posts big blind €0.02
*** HOLE CARDS ***
Dealt to caduceus369 [6s 6c]
Sararafusa11: raises €0.03 to €0.05
OMGWOLFX: calls €0.05
SalahUbeen: folds 
GanchanS7: folds 
nikolor: folds 
caduceus369: calls €0.03
*** FLOP *** [5c 9c 2d]
caduceus369: checks 
Sararafusa11: checks 
OMGWOLFX: bets €0.08
caduceus369: raises €0.10 to €0.18
Sararafusa11: folds 
OMGWOLFX: calls €0.10
*** TURN *** [5c 9c 2d] [9d]
caduceus369: checks 
OMGWOLFX: checks 
*** RIVER *** [5c 9c 2d 9d] [5d]
caduceus369: bets €0.15
OMGWOLFX: folds 
Uncalled bet (€0.15) returned to caduceus369
caduceus369 collected €0.50 from pot
caduceus369: doesn't show hand 
*** SUMMARY ***
Total pot €0.52 | Rake €0.02 
Board [5c 9c 2d 9d 5d]
Seat 1: GanchanS7 (button) folded before Flop (didn't bet)
Seat 2: nikolor (small blind) folded before Flop
Seat 3: caduceus369 (big blind) collected (€0.50)
Seat 4: Sararafusa11 folded on the Flop
Seat 5: OMGWOLFX folded on the River
Seat 6: SalahUbeen folded before Flop (didn't bet)



PokerStars Zoom Hand #257984514121:  Hold'em No Limit (€0.01/€0.02) [ADM ID: M62BA304494E32ST] - 2025/10/03 19:05:33 CET [2025/10/03 13:05:33 ET]
Table 'Sirio' 6-max Seat #1 is the button
Seat 1: Sararafusa11 (€3.43 in chips) 
Seat 2: ADRIAN0_MEIS (€2.03 in chips) 
Seat 3: GanchanS7 (€3.82 in chips) 
Seat 4: pistaKKio23 (€2.98 in chips) 
Seat 5: caduceus369 (€4.49 in chips) 
Seat 6: SalahUbeen (€1.94 in chips) 
ADRIAN0_MEIS: posts small blind €0.01
GanchanS7: posts big blind €0.02
*** HOLE CARDS ***
Dealt to caduceus369 [Qh 5h]
pistaKKio23: folds 
caduceus369: folds 
SalahUbeen: folds 
Sararafusa11: folds 
ADRIAN0_MEIS: folds 
Uncalled bet (€0.01) returned to GanchanS7
GanchanS7 collected €0.02 from pot
GanchanS7: doesn't show hand 
*** SUMMARY ***
Total pot €0.02 | Rake €0 
Seat 1: Sararafusa11 (button) folded before Flop (didn't bet)
Seat 2: ADRIAN0_MEIS (small blind) folded before Flop
Seat 3: GanchanS7 (big blind) collected (€0.02)
Seat 4: pistaKKio23 folded before Flop (didn't bet)
Seat 5: caduceus369 folded before Flop (didn't bet)
Seat 6: SalahUbeen folded before Flop (didn't bet)



PokerStars Zoom Hand #257984516386:  Hold'em No Limit (€0.01/€0.02) [ADM ID: M62BA304494E32ST] - 2025/10/03 19:05:45 CET [2025/10/03 13:05:45 ET]
Table 'Sirio' 6-max Seat #1 is the button
Seat 1: ADRIAN0_MEIS (€2.01 in chips) 
Seat 2: caduceus369 (€4.49 in chips) 
Seat 3: Gabrielefante (€2.39 in chips) 
Seat 4: SalahUbeen (€1.89 in chips) 
Seat 5: GanchanS7 (€2 in chips) 
Seat 6: Catania838 (€1.59 in chips) 
caduceus369: posts small blind €0.01
Gabrielefante: posts big blind €0.02
*** HOLE CARDS ***
Dealt to caduceus369 [Th Kh]
SalahUbeen: raises €0.03 to €0.05
GanchanS7: folds 
Catania838: raises €0.03 to €0.08
ADRIAN0_MEIS: folds 
caduceus369: folds 
Gabrielefante: folds 
SalahUbeen: calls €0.03
*** FLOP *** [Kd 7c 9d]
SalahUbeen: checks 
Catania838: bets €0.09
SalahUbeen: folds 
Uncalled bet (€0.09) returned to Catania838
Catania838 collected €0.18 from pot
Catania838: doesn't show hand 
*** SUMMARY ***
Total pot €0.19 | Rake €0.01 
Board [Kd 7c 9d]
Seat 1: ADRIAN0_MEIS (button) folded before Flop (didn't bet)
Seat 2: caduceus369 (small blind) folded before Flop
Seat 3: Gabrielefante (big blind) folded before Flop
Seat 4: SalahUbeen folded on the Flop
Seat 5: GanchanS7 folded before Flop (didn't bet)
Seat 6: Catania838 collected (€0.18)



PokerStars Zoom Hand #257984515362:  Hold'em No Limit (€0.01/€0.02) [ADM ID: M62BA304494E32ST] - 2025/10/03 19:05:39 CET [2025/10/03 13:05:39 ET]
Table 'Sirio' 6-max Seat #1 is the button
Seat 1: pistaKKio23 (€2.98 in chips) 
Seat 2: ADRIAN0_MEIS (€2.02 in chips) 
Seat 3: OSPREYSTORM (€2 in chips) 
Seat 4: nonnapapera3 (€1.35 in chips) 
Seat 5: stfuplzudonk (€2.28 in chips) 
Seat 6: caduceus369 (€4.49 in chips) 
ADRIAN0_MEIS: posts small blind €0.01
OSPREYSTORM: posts big blind €0.02
*** HOLE CARDS ***
Dealt to caduceus369 [5h 6s]
nonnapapera3: calls €0.02
stfuplzudonk: folds 
caduceus369: folds 
pistaKKio23: raises €0.07 to €0.09
ADRIAN0_MEIS: folds 
OSPREYSTORM: folds 
nonnapapera3: calls €0.07
*** FLOP *** [Ks Ts 6d]
nonnapapera3: checks 
pistaKKio23: bets €0.10
nonnapapera3: calls €0.10
*** TURN *** [Ks Ts 6d] [Kh]
nonnapapera3: checks 
pistaKKio23: bets €0.20
nonnapapera3: folds 
Uncalled bet (€0.20) returned to pistaKKio23
pistaKKio23 collected €0.39 from pot
pistaKKio23: doesn't show hand 
*** SUMMARY ***
Total pot €0.41 | Rake €0.02 
Board [Ks Ts 6d Kh]
Seat 1: pistaKKio23 (button) collected (€0.39)
Seat 2: ADRIAN0_MEIS (small blind) folded before Flop
Seat 3: OSPREYSTORM (big blind) folded before Flop
Seat 4: nonnapapera3 folded on the Turn
Seat 5: stfuplzudonk folded before Flop (didn't bet)
Seat 6: caduceus369 folded before Flop (didn't bet)



PokerStars Zoom Hand #257984519091:  Hold'em No Limit (€0.01/€0.02) [ADM ID: M62BA304494E32ST] - 2025/10/03 19:05:59 CET [2025/10/03 13:05:59 ET]
Table 'Sirio' 6-max Seat #1 is the button
Seat 1: caduceus369 (€4.48 in chips) 
Seat 2: LentaM3nte (€1.12 in chips) 
Seat 3: Teriferro (€1.10 in chips) 
Seat 4: pylonstrip (€3.56 in chips) 
Seat 5: Gabrielefante (€2.36 in chips) 
Seat 6: SalahUbeen (€2.26 in chips) 
LentaM3nte: posts small blind €0.01
Teriferro: posts big blind €0.02
*** HOLE CARDS ***
Dealt to caduceus369 [Ac 3c]
pylonstrip: folds 
Gabrielefante: calls €0.02
SalahUbeen: folds 
caduceus369: calls €0.02
LentaM3nte: folds 
Teriferro: raises €0.07 to €0.09
Gabrielefante: folds 
caduceus369: calls €0.07
*** FLOP *** [4h 9h 7d]
Teriferro: bets €0.10
caduceus369: folds 
Uncalled bet (€0.10) returned to Teriferro
Teriferro collected €0.20 from pot
Teriferro: doesn't show hand 
*** SUMMARY ***
Total pot €0.21 | Rake €0.01 
Board [4h 9h 7d]
Seat 1: caduceus369 (button) folded on the Flop
Seat 2: LentaM3nte (small blind) folded before Flop
Seat 3: Teriferro (big blind) collected (€0.20)
Seat 4: pylonstrip folded before Flop (didn't bet)
Seat 5: Gabrielefante folded before Flop
Seat 6: SalahUbeen folded before Flop (didn't bet)



PokerStars Zoom Hand #257984527045:  Hold'em No Limit (€0.01/€0.02) [ADM ID: M62BA304494E32ST] - 2025/10/03 19:06:40 CET [2025/10/03 13:06:40 ET]
Table 'Sirio' 6-max Seat #1 is the button
Seat 1: Catania838 (€1.63 in chips) 
Seat 2: stfuplzudonk (€0.11 in chips) 
Seat 3: pistaKKio23 (€2.20 in chips) 
Seat 4: nikolor (€4.13 in chips) 
Seat 5: caduceus369 (€4.39 in chips) 
Seat 6: SalahUbeen (€1.91 in chips) 
stfuplzudonk: posts small blind €0.01
pistaKKio23: posts big blind €0.02
*** HOLE CARDS ***
Dealt to caduceus369 [Ts 3s]
nikolor: folds 
caduceus369: folds 
SalahUbeen: folds 
Catania838: folds 
stfuplzudonk: raises €0.09 to €0.11 and is all-in
pistaKKio23: folds 
Uncalled bet (€0.09) returned to stfuplzudonk
stfuplzudonk collected €0.04 from pot
stfuplzudonk: doesn't show hand 
*** SUMMARY ***
Total pot €0.04 | Rake €0 
Seat 1: Catania838 (button) folded before Flop (didn't bet)
Seat 2: stfuplzudonk (small blind) collected (€0.04)
Seat 3: pistaKKio23 (big blind) folded before Flop
Seat 4: nikolor folded before Flop (didn't bet)
Seat 5: caduceus369 folded before Flop (didn't bet)
Seat 6: SalahUbeen folded before Flop (didn't bet)



PokerStars Zoom Hand #257984529643:  Hold'em No Limit (€0.01/€0.02) [ADM ID: M62BA304494E32ST] - 2025/10/03 19:06:54 CET [2025/10/03 13:06:54 ET]
Table 'Sirio' 6-max Seat #1 is the button
Seat 1: jolli180 (€2.15 in chips) 
Seat 2: caduceus369 (€4.39 in chips) 
Seat 3: ALUMIX (€3.19 in chips) 
Seat 4: Katymirax (€0.70 in chips) 
Seat 5: GanchanS7 (€2.14 in chips) 
Seat 6: cuzzi68 (€1.34 in chips) 
caduceus369: posts small blind €0.01
ALUMIX: posts big blind €0.02
*** HOLE CARDS ***
Dealt to caduceus369 [2d As]
Katymirax: folds 
GanchanS7: folds 
cuzzi68: folds 
jolli180: folds 
caduceus369: folds 
Uncalled bet (€0.01) returned to ALUMIX
ALUMIX collected €0.02 from pot
ALUMIX: doesn't show hand 
*** SUMMARY ***
Total pot €0.02 | Rake €0 
Seat 1: jolli180 (button) folded before Flop (didn't bet)
Seat 2: caduceus369 (small blind) folded before Flop
Seat 3: ALUMIX (big blind) collected (€0.02)
Seat 4: Katymirax folded before Flop (didn't bet)
Seat 5: GanchanS7 folded before Flop (didn't bet)
Seat 6: cuzzi68 folded before Flop (didn't bet)



PokerStars Zoom Hand #257984528152:  Hold'em No Limit (€0.01/€0.02) [ADM ID: M62BA304494E32ST] - 2025/10/03 19:06:46 CET [2025/10/03 13:06:46 ET]
Table 'Sirio' 6-max Seat #1 is the button
Seat 1: heitel (€2.15 in chips) 
Seat 2: GanchanS7 (€2.15 in chips) 
Seat 3: nikolor (€4.13 in chips) 
Seat 4: caduceus369 (€4.39 in chips) 
Seat 5: Catania838 (€1.63 in chips) 
Seat 6: OMGWOLFX (€10.89 in chips) 
GanchanS7: posts small blind €0.01
nikolor: posts big blind €0.02
*** HOLE CARDS ***
Dealt to caduceus369 [Js 5d]
caduceus369: folds 
Catania838: raises €0.02 to €0.04
OMGWOLFX: folds 
heitel: folds 
GanchanS7: folds 
nikolor: folds 
Uncalled bet (€0.02) returned to Catania838
Catania838 collected €0.05 from pot
Catania838: doesn't show hand 
*** SUMMARY ***
Total pot €0.05 | Rake €0 
Seat 1: heitel (button) folded before Flop (didn't bet)
Seat 2: GanchanS7 (small blind) folded before Flop
Seat 3: nikolor (big blind) folded before Flop
Seat 4: caduceus369 folded before Flop (didn't bet)
Seat 5: Catania838 collected (€0.05)
Seat 6: OMGWOLFX folded before Flop (didn't bet)



PokerStars Zoom Hand #257984530435:  Hold'em No Limit (€0.01/€0.02) [ADM ID: M62BA304494E32ST] - 2025/10/03 19:06:58 CET [2025/10/03 13:06:58 ET]
Table 'Sirio' 6-max Seat #1 is the button
Seat 1: Catania838 (€1.66 in chips) 
Seat 2: SalahUbeen (€1.91 in chips) 
Seat 3: caduceus369 (€4.38 in chips) 
Seat 4: QUATTRODAME (€3.76 in chips) 
Seat 5: ADRIAN0_MEIS (€2 in chips) 
Seat 6: heitel (€2.15 in chips) 
SalahUbeen: posts small blind €0.01
caduceus369: posts big blind €0.02
*** HOLE CARDS ***
Dealt to caduceus369 [Jd 7c]
QUATTRODAME: folds 
ADRIAN0_MEIS: raises €0.05 to €0.07
heitel: folds 
Catania838: folds 
SalahUbeen: folds 
caduceus369: folds 
Uncalled bet (€0.05) returned to ADRIAN0_MEIS
ADRIAN0_MEIS collected €0.05 from pot
ADRIAN0_MEIS: doesn't show hand 
*** SUMMARY ***
Total pot €0.05 | Rake €0 
Seat 1: Catania838 (button) folded before Flop (didn't bet)
Seat 2: SalahUbeen (small blind) folded before Flop
Seat 3: caduceus369 (big blind) folded before Flop
Seat 4: QUATTRODAME folded before Flop (didn't bet)
Seat 5: ADRIAN0_MEIS collected (€0.05)
Seat 6: heitel folded before Flop (didn't bet)



PokerStars Zoom Hand #257984528910:  Hold'em No Limit (€0.01/€0.02) [ADM ID: M62BA304494E32ST] - 2025/10/03 19:06:50 CET [2025/10/03 13:06:50 ET]
Table 'Sirio' 6-max Seat #1 is the button
Seat 1: ADRIAN0_MEIS (€2.02 in chips) 
Seat 2: Catania838 (€1.28 in chips) 
Seat 3: icerini (€1.33 in chips) 
Seat 4: nikolor (€2.12 in chips) 
Seat 5: alibabba101 (€1.91 in chips) 
Seat 6: caduceus369 (€4.39 in chips) 
Catania838: posts small blind €0.01
icerini: posts big blind €0.02
*** HOLE CARDS ***
Dealt to caduceus369 [3c Jc]
nikolor: folds 
alibabba101: folds 
caduceus369: folds 
ADRIAN0_MEIS: folds 
Catania838: raises €0.02 to €0.04
icerini: calls €0.02
*** FLOP *** [8d 8h Qs]
Catania838: checks 
icerini: checks 
*** TURN *** [8d 8h Qs] [Ks]
Catania838: checks 
icerini: bets €0.08
Catania838: folds 
Uncalled bet (€0.08) returned to icerini
icerini collected €0.08 from pot
icerini: doesn't show hand 
*** SUMMARY ***
Total pot €0.08 | Rake €0 
Board [8d 8h Qs Ks]
Seat 1: ADRIAN0_MEIS (button) folded before Flop (didn't bet)
Seat 2: Catania838 (small blind) folded on the Turn
Seat 3: icerini (big blind) collected (€0.08)
Seat 4: nikolor folded before Flop (didn't bet)
Seat 5: alibabba101 folded before Flop (didn't bet)
Seat 6: caduceus369 folded before Flop (didn't bet)



PokerStars Zoom Hand #257984534750:  Hold'em No Limit (€0.01/€0.02) [ADM ID: M62BA304494E32ST] - 2025/10/03 19:07:21 CET [2025/10/03 13:07:21 ET]
Table 'Sirio' 6-max Seat #1 is the button
Seat 1: ADRIAN0_MEIS (€2 in chips) 
Seat 2: nikolor (€2.12 in chips) 
Seat 3: OSPREYSTORM (€1.96 in chips) 
Seat 4: Catania838 (€1.65 in chips) 
Seat 5: caduceus369 (€4.36 in chips) 
Seat 6: GanchanS7 (€3.91 in chips) 
nikolor: posts small blind €0.01
OSPREYSTORM: posts big blind €0.02
*** HOLE CARDS ***
Dealt to caduceus369 [9s Kd]
Catania838: folds 
caduceus369: folds 
GanchanS7: folds 
ADRIAN0_MEIS: folds 
nikolor: raises €0.04 to €0.06
OSPREYSTORM: folds 
Uncalled bet (€0.04) returned to nikolor
nikolor collected €0.04 from pot
nikolor: doesn't show hand 
*** SUMMARY ***
Total pot €0.04 | Rake €0 
Seat 1: ADRIAN0_MEIS (button) folded before Flop (didn't bet)
Seat 2: nikolor (small blind) collected (€0.04)
Seat 3: OSPREYSTORM (big blind) folded before Flop
Seat 4: Catania838 folded before Flop (didn't bet)
Seat 5: caduceus369 folded before Flop (didn't bet)
Seat 6: GanchanS7 folded before Flop (didn't bet)



PokerStars Zoom Hand #257984535677:  Hold'em No Limit (€0.01/€0.02) [ADM ID: M62BA304494E32ST] - 2025/10/03 19:07:26 CET [2025/10/03 13:07:26 ET]
Table 'Sirio' 6-max Seat #1 is the button
Seat 1: Catania838 (€1.24 in chips) 
Seat 2: icerini (€1.37 in chips) 
Seat 3: SalahUbeen (€1.90 in chips) 
Seat 4: GanchanS7 (€2 in chips) 
Seat 5: cuzzi68 (€1.28 in chips) 
Seat 6: caduceus369 (€4.36 in chips) 
icerini: posts small blind €0.01
SalahUbeen: posts big blind €0.02
*** HOLE CARDS ***
Dealt to caduceus369 [Qd Th]
GanchanS7: folds 
cuzzi68: folds 
caduceus369: folds 
Catania838: folds 
icerini: folds 
Uncalled bet (€0.01) returned to SalahUbeen
SalahUbeen collected €0.02 from pot
SalahUbeen: doesn't show hand 
*** SUMMARY ***
Total pot €0.02 | Rake €0 
Seat 1: Catania838 (button) folded before Flop (didn't bet)
Seat 2: icerini (small blind) folded before Flop
Seat 3: SalahUbeen (big blind) collected (€0.02)
Seat 4: GanchanS7 folded before Flop (didn't bet)
Seat 5: cuzzi68 folded before Flop (didn't bet)
Seat 6: caduceus369 folded before Flop (didn't bet)



PokerStars Zoom Hand #257984533220:  Hold'em No Limit (€0.01/€0.02) [ADM ID: M62BA304494E32ST] - 2025/10/03 19:07:13 CET [2025/10/03 13:07:13 ET]
Table 'Sirio' 6-max Seat #1 is the button
Seat 1: caduceus369 (€4.36 in chips) 
Seat 2: stfuplzudonk (€2.61 in chips) 
Seat 3: GanchanS7 (€3.85 in chips) 
Seat 4: OMGWOLFX (€10.89 in chips) 
Seat 5: OSPREYSTORM (€1.96 in chips) 
Seat 6: nikolor (€2.12 in chips) 
stfuplzudonk: posts small blind €0.01
GanchanS7: posts big blind €0.02
*** HOLE CARDS ***
Dealt to caduceus369 [Ks 6s]
OMGWOLFX: raises €0.04 to €0.06
OSPREYSTORM: folds 
nikolor: folds 
caduceus369: folds 
stfuplzudonk: calls €0.05
GanchanS7: folds 
*** FLOP *** [2d 9c 3c]
stfuplzudonk: checks 
OMGWOLFX: bets €0.07
stfuplzudonk: folds 
Uncalled bet (€0.07) returned to OMGWOLFX
OMGWOLFX collected €0.14 from pot
OMGWOLFX: doesn't show hand 
*** SUMMARY ***
Total pot €0.14 | Rake €0 
Board [2d 9c 3c]
Seat 1: caduceus369 (button) folded before Flop (didn't bet)
Seat 2: stfuplzudonk (small blind) folded on the Flop
Seat 3: GanchanS7 (big blind) folded before Flop
Seat 4: OMGWOLFX collected (€0.14)
Seat 5: OSPREYSTORM folded before Flop (didn't bet)
Seat 6: nikolor folded before Flop (didn't bet)



PokerStars Zoom Hand #257984538178:  Hold'em No Limit (€0.01/€0.02) [ADM ID: M62BA304494E32ST] - 2025/10/03 19:07:39 CET [2025/10/03 13:07:39 ET]
Table 'Sirio' 6-max Seat #1 is the button
Seat 1: Mary5issi (€2.44 in chips) 
Seat 2: caduceus369 (€4.36 in chips) 
Seat 3: nikolor (€2.14 in chips) 
Seat 4: ADRIAN0_MEIS (€2.01 in chips) 
Seat 5: SalahUbeen (€2.41 in chips) 
Seat 6: alibabba101 (€1.88 in chips) 
caduceus369: posts small blind €0.01
nikolor: posts big blind €0.02
*** HOLE CARDS ***
Dealt to caduceus369 [Jc 7h]
ADRIAN0_MEIS: folds 
SalahUbeen: raises €0.03 to €0.05
alibabba101: folds 
Mary5issi: raises €0.19 to €0.24
caduceus369: folds 
nikolor: folds 
SalahUbeen: folds 
Uncalled bet (€0.19) returned to Mary5issi
Mary5issi collected €0.13 from pot
Mary5issi: doesn't show hand 
*** SUMMARY ***
Total pot €0.13 | Rake €0 
Seat 1: Mary5issi (button) collected (€0.13)
Seat 2: caduceus369 (small blind) folded before Flop
Seat 3: nikolor (big blind) folded before Flop
Seat 4: ADRIAN0_MEIS folded before Flop (didn't bet)
Seat 5: SalahUbeen folded before Flop
Seat 6: alibabba101 folded before Flop (didn't bet)



PokerStars Zoom Hand #257984542644:  Hold'em No Limit (€0.01/€0.02) [ADM ID: M62BA304494E32ST] - 2025/10/03 19:08:03 CET [2025/10/03 13:08:03 ET]
Table 'Sirio' 6-max Seat #1 is the button
Seat 1: heitel (€2.15 in chips) 
Seat 2: GanchanS7 (€3.86 in chips) 
Seat 3: caduceus369 (€4.35 in chips) 
Seat 4: trillycata (€1.90 in chips) 
Seat 5: Teriferro (€1.22 in chips) 
Seat 6: OMGWOLFX (€10.95 in chips) 
GanchanS7: posts small blind €0.01
caduceus369: posts big blind €0.02
*** HOLE CARDS ***
Dealt to caduceus369 [8c Qs]
trillycata: folds 
Teriferro: raises €0.04 to €0.06
OMGWOLFX: calls €0.06
heitel: folds 
GanchanS7: folds 
caduceus369: calls €0.04
*** FLOP *** [3d Kc As]
caduceus369: checks 
Teriferro: checks 
OMGWOLFX: bets €0.09
caduceus369: folds 
Teriferro: folds 
Uncalled bet (€0.09) returned to OMGWOLFX
OMGWOLFX collected €0.18 from pot
OMGWOLFX: doesn't show hand 
*** SUMMARY ***
Total pot €0.19 | Rake €0.01 
Board [3d Kc As]
Seat 1: heitel (button) folded before Flop (didn't bet)
Seat 2: GanchanS7 (small blind) folded before Flop
Seat 3: caduceus369 (big blind) folded on the Flop
Seat 4: trillycata folded before Flop (didn't bet)
Seat 5: Teriferro folded on the Flop
Seat 6: OMGWOLFX collected (€0.18)



PokerStars Zoom Hand #257984548492:  Hold'em No Limit (€0.01/€0.02) [ADM ID: M62BA304494E32ST] - 2025/10/03 19:08:34 CET [2025/10/03 13:08:34 ET]
Table 'Sirio' 6-max Seat #1 is the button
Seat 1: caduceus369 (€4.29 in chips) 
Seat 2: OSPREYSTORM (€7.48 in chips) 
Seat 3: ziogeppI (€1.15 in chips) 
Seat 4: GanchanS7 (€2.11 in chips) 
Seat 5: S'dj83 (€4.18 in chips) 
Seat 6: haithem3o21 (€2.61 in chips) 
OSPREYSTORM: posts small blind €0.01
ziogeppI: posts big blind €0.02
*** HOLE CARDS ***
Dealt to caduceus369 [Td Ts]
GanchanS7: folds 
S'dj83: raises €0.04 to €0.06
haithem3o21: calls €0.06
caduceus369: raises €0.22 to €0.28
OSPREYSTORM: folds 
ziogeppI: folds 
S'dj83: calls €0.22
haithem3o21: calls €0.22
*** FLOP *** [As Ks 3d]
S'dj83: checks 
haithem3o21: checks 
caduceus369: bets €0.26
S'dj83: calls €0.26
haithem3o21: calls €0.26
*** TURN *** [As Ks 3d] [9c]
S'dj83: checks 
haithem3o21: bets €0.14
caduceus369: folds 
S'dj83: calls €0.14
*** RIVER *** [As Ks 3d 9c] [3c]
S'dj83: checks 
haithem3o21: bets €0.18
S'dj83: calls €0.18
*** SHOW DOWN ***
haithem3o21: shows [Jd Tc] (a pair of Threes)
S'dj83: shows [Kh Qc] (two pair, Kings and Threes)
S'dj83 collected €2.17 from pot
*** SUMMARY ***
Total pot €2.29 | Rake €0.12 
Board [As Ks 3d 9c 3c]
Seat 1: caduceus369 (button) folded on the Turn
Seat 2: OSPREYSTORM (small blind) folded before Flop
Seat 3: ziogeppI (big blind) folded before Flop
Seat 4: GanchanS7 folded before Flop (didn't bet)
Seat 5: S'dj83 showed [Kh Qc] and won (€2.17) with two pair, Kings and Threes
Seat 6: haithem3o21 showed [Jd Tc] and lost with a pair of Threes



PokerStars Zoom Hand #257984562741:  Hold'em No Limit (€0.01/€0.02) [ADM ID: M62BA304494E32ST] - 2025/10/03 19:09:51 CET [2025/10/03 13:09:51 ET]
Table 'Sirio' 6-max Seat #1 is the button
Seat 1: OSPREYSTORM (€1.97 in chips) 
Seat 2: icerini (€1.66 in chips) 
Seat 3: Sium12302 (€2 in chips) 
Seat 4: caduceus369 (€3.75 in chips) 
Seat 5: SalahUbeen (€2.75 in chips) 
Seat 6: GanchanS7 (€2.04 in chips) 
icerini: posts small blind €0.01
Sium12302: posts big blind €0.02
*** HOLE CARDS ***
Dealt to caduceus369 [Jd 9s]
caduceus369: folds 
SalahUbeen: folds 
GanchanS7: folds 
OSPREYSTORM: folds 
icerini: raises €0.02 to €0.04
Sium12302: folds 
Uncalled bet (€0.02) returned to icerini
icerini collected €0.04 from pot
icerini: doesn't show hand 
*** SUMMARY ***
Total pot €0.04 | Rake €0 
Seat 1: OSPREYSTORM (button) folded before Flop (didn't bet)
Seat 2: icerini (small blind) collected (€0.04)
Seat 3: Sium12302 (big blind) folded before Flop
Seat 4: caduceus369 folded before Flop (didn't bet)
Seat 5: SalahUbeen folded before Flop (didn't bet)
Seat 6: GanchanS7 folded before Flop (didn't bet)



PokerStars Zoom Hand #257984561392:  Hold'em No Limit (€0.01/€0.02) [ADM ID: M62BA304494E32ST] - 2025/10/03 19:09:44 CET [2025/10/03 13:09:44 ET]
Table 'Sirio' 6-max Seat #1 is the button
Seat 1: haithem3o21 (€1.75 in chips) 
Seat 2: OSPREYSTORM (€2.06 in chips) 
Seat 3: S'dj83 (€5.49 in chips) 
Seat 4: ziogeppI (€1.28 in chips) 
Seat 5: caduceus369 (€3.75 in chips) 
Seat 6: Catania838 (€3.03 in chips) 
OSPREYSTORM: posts small blind €0.01
S'dj83: posts big blind €0.02
*** HOLE CARDS ***
Dealt to caduceus369 [7s 5h]
ziogeppI: calls €0.02
caduceus369: folds 
Catania838: calls €0.02
haithem3o21: raises €0.20 to €0.22
OSPREYSTORM: folds 
S'dj83: folds 
ziogeppI: folds 
Catania838: folds 
Uncalled bet (€0.20) returned to haithem3o21
haithem3o21 collected €0.09 from pot
haithem3o21: doesn't show hand 
*** SUMMARY ***
Total pot €0.09 | Rake €0 
Seat 1: haithem3o21 (button) collected (€0.09)
Seat 2: OSPREYSTORM (small blind) folded before Flop
Seat 3: S'dj83 (big blind) folded before Flop
Seat 4: ziogeppI folded before Flop
Seat 5: caduceus369 folded before Flop (didn't bet)
Seat 6: Catania838 folded before Flop



PokerStars Zoom Hand #257984565416:  Hold'em No Limit (€0.01/€0.02) [ADM ID: M62BA304494E32ST] - 2025/10/03 19:10:05 CET [2025/10/03 13:10:05 ET]
Table 'Sirio' 6-max Seat #1 is the button
Seat 1: LentaM3nte (€1.41 in chips) 
Seat 2: caduceus369 (€3.75 in chips) 
Seat 3: OSPREYSTORM (€1.97 in chips) 
Seat 4: stagniarihd (€1.84 in chips) 
Seat 5: pylonstrip (€2.91 in chips) 
Seat 6: Gabrielefante (€2.30 in chips) 
caduceus369: posts small blind €0.01
OSPREYSTORM: posts big blind €0.02
*** HOLE CARDS ***
Dealt to caduceus369 [9h Ks]
stagniarihd: folds 
pylonstrip: folds 
Gabrielefante: folds 
LentaM3nte: folds 
caduceus369: folds 
Uncalled bet (€0.01) returned to OSPREYSTORM
OSPREYSTORM collected €0.02 from pot
OSPREYSTORM: doesn't show hand 
*** SUMMARY ***
Total pot €0.02 | Rake €0 
Seat 1: LentaM3nte (button) folded before Flop (didn't bet)
Seat 2: caduceus369 (small blind) folded before Flop
Seat 3: OSPREYSTORM (big blind) collected (€0.02)
Seat 4: stagniarihd folded before Flop (didn't bet)
Seat 5: pylonstrip folded before Flop (didn't bet)
Seat 6: Gabrielefante folded before Flop (didn't bet)



PokerStars Zoom Hand #257984563390:  Hold'em No Limit (€0.01/€0.02) [ADM ID: M62BA304494E32ST] - 2025/10/03 19:09:54 CET [2025/10/03 13:09:54 ET]
Table 'Sirio' 6-max Seat #1 is the button
Seat 1: pistaKKio23 (€3.28 in chips) 
Seat 2: GanchanS7 (€3.92 in chips) 
Seat 3: OSPREYSTORM (€7.44 in chips) 
Seat 4: caduceus369 (€3.75 in chips) 
Seat 5: Gabrielefante (€2.30 in chips) 
Seat 6: ADRIAN0_MEIS (€2.21 in chips) 
GanchanS7: posts small blind €0.01
OSPREYSTORM: posts big blind €0.02
*** HOLE CARDS ***
Dealt to caduceus369 [2c 3c]
caduceus369: folds 
Gabrielefante: folds 
ADRIAN0_MEIS: folds 
pistaKKio23: folds 
GanchanS7: folds 
Uncalled bet (€0.01) returned to OSPREYSTORM
OSPREYSTORM collected €0.02 from pot
OSPREYSTORM: doesn't show hand 
*** SUMMARY ***
Total pot €0.02 | Rake €0 
Seat 1: pistaKKio23 (button) folded before Flop (didn't bet)
Seat 2: GanchanS7 (small blind) folded before Flop
Seat 3: OSPREYSTORM (big blind) collected (€0.02)
Seat 4: caduceus369 folded before Flop (didn't bet)
Seat 5: Gabrielefante folded before Flop (didn't bet)
Seat 6: ADRIAN0_MEIS folded before Flop (didn't bet)



PokerStars Zoom Hand #257984566219:  Hold'em No Limit (€0.01/€0.02) [ADM ID: M62BA304494E32ST] - 2025/10/03 19:10:09 CET [2025/10/03 13:10:09 ET]
Table 'Sirio' 6-max Seat #1 is the button
Seat 1: stfuplzudonk (€2.82 in chips) 
Seat 2: stagniarihd (€1.84 in chips) 
Seat 3: caduceus369 (€3.74 in chips) 
Seat 4: S'dj83 (€5.47 in chips) 
Seat 5: haithem3o21 (€1.82 in chips) 
Seat 6: LentaM3nte (€1.41 in chips) 
stagniarihd: posts small blind €0.01
caduceus369: posts big blind €0.02
*** HOLE CARDS ***
Dealt to caduceus369 [8d 3c]
S'dj83: folds 
haithem3o21: raises €0.02 to €0.04
LentaM3nte: folds 
stfuplzudonk: folds 
stagniarihd: calls €0.03
caduceus369: folds 
*** FLOP *** [Td Ts 3h]
stagniarihd: checks 
haithem3o21: bets €0.04
stagniarihd: folds 
Uncalled bet (€0.04) returned to haithem3o21
haithem3o21 collected €0.10 from pot
haithem3o21: doesn't show hand 
*** SUMMARY ***
Total pot €0.10 | Rake €0 
Board [Td Ts 3h]
Seat 1: stfuplzudonk (button) folded before Flop (didn't bet)
Seat 2: stagniarihd (small blind) folded on the Flop
Seat 3: caduceus369 (big blind) folded before Flop
Seat 4: S'dj83 folded before Flop (didn't bet)
Seat 5: haithem3o21 collected (€0.10)
Seat 6: LentaM3nte folded before Flop (didn't bet)



PokerStars Zoom Hand #257984571060:  Hold'em No Limit (€0.01/€0.02) [ADM ID: M62BA304494E32ST] - 2025/10/03 19:10:35 CET [2025/10/03 13:10:35 ET]
Table 'Sirio' 6-max Seat #1 is the button
Seat 1: caduceus369 (€3.72 in chips) 
Seat 2: ziogeppI (€1.07 in chips) 
Seat 3: labronicus58 (€2.21 in chips) 
Seat 4: Sararafusa11 (€3.70 in chips) 
Seat 5: OSPREYSTORM (€1.97 in chips) 
Seat 6: Sium12302 (€2.03 in chips) 
ziogeppI: posts small blind €0.01
labronicus58: posts big blind €0.02
*** HOLE CARDS ***
Dealt to caduceus369 [Qd 8d]
Sararafusa11: folds 
OSPREYSTORM: folds 
Sium12302: folds 
caduceus369: folds 
ziogeppI: folds 
Uncalled bet (€0.01) returned to labronicus58
labronicus58 collected €0.02 from pot
labronicus58: doesn't show hand 
*** SUMMARY ***
Total pot €0.02 | Rake €0 
Seat 1: caduceus369 (button) folded before Flop (didn't bet)
Seat 2: ziogeppI (small blind) folded before Flop
Seat 3: labronicus58 (big blind) collected (€0.02)
Seat 4: Sararafusa11 folded before Flop (didn't bet)
Seat 5: OSPREYSTORM folded before Flop (didn't bet)
Seat 6: Sium12302 folded before Flop (didn't bet)



PokerStars Zoom Hand #257984564432:  Hold'em No Limit (€0.01/€0.02) [ADM ID: M62BA304494E32ST] - 2025/10/03 19:09:59 CET [2025/10/03 13:09:59 ET]
Table 'Sirio' 6-max Seat #1 is the button
Seat 1: S'dj83 (€5.47 in chips) 
Seat 2: Sium12302 (€2 in chips) 
Seat 3: pistaKKio23 (€6.33 in chips) 
Seat 4: stfuplzudonk (€1.79 in chips) 
Seat 5: GanchanS7 (€2.04 in chips) 
Seat 6: caduceus369 (€3.75 in chips) 
Sium12302: posts small blind €0.01
pistaKKio23: posts big blind €0.02
*** HOLE CARDS ***
Dealt to caduceus369 [3h Qc]
stfuplzudonk: folds 
GanchanS7: raises €0.03 to €0.05
caduceus369: folds 
S'dj83: folds 
Sium12302: calls €0.04
pistaKKio23: calls €0.03
*** FLOP *** [Jd 4s Th]
Sium12302: checks 
pistaKKio23: checks 
GanchanS7: bets €0.12
Sium12302: folds 
pistaKKio23: folds 
Uncalled bet (€0.12) returned to GanchanS7
GanchanS7 collected €0.15 from pot
GanchanS7: doesn't show hand 
*** SUMMARY ***
Total pot €0.15 | Rake €0 
Board [Jd 4s Th]
Seat 1: S'dj83 (button) folded before Flop (didn't bet)
Seat 2: Sium12302 (small blind) folded on the Flop
Seat 3: pistaKKio23 (big blind) folded on the Flop
Seat 4: stfuplzudonk folded before Flop (didn't bet)
Seat 5: GanchanS7 collected (€0.15)
Seat 6: caduceus369 folded before Flop (didn't bet)



PokerStars Zoom Hand #257984573597:  Hold'em No Limit (€0.01/€0.02) [ADM ID: M62BA304494E32ST] - 2025/10/03 19:10:48 CET [2025/10/03 13:10:48 ET]
Table 'Sirio' 6-max Seat #1 is the button
Seat 1: trillycata (€1.65 in chips) 
Seat 2: Gabrielefante (€2.27 in chips) 
Seat 3: Catania838 (€2.98 in chips) 
Seat 4: Sium12302 (€2.03 in chips) 
Seat 5: caduceus369 (€3.72 in chips) 
Seat 6: nikolor (€2.25 in chips) 
Gabrielefante: posts small blind €0.01
Catania838: posts big blind €0.02
*** HOLE CARDS ***
Dealt to caduceus369 [2h Ts]
Sium12302: folds 
caduceus369: folds 
nikolor: folds 
trillycata: folds 
Gabrielefante: calls €0.01
Catania838: checks 
*** FLOP *** [2c 2s Jh]
Gabrielefante: bets €0.02
Catania838: folds 
Uncalled bet (€0.02) returned to Gabrielefante
Gabrielefante collected €0.04 from pot
Gabrielefante: doesn't show hand 
*** SUMMARY ***
Total pot €0.04 | Rake €0 
Board [2c 2s Jh]
Seat 1: trillycata (button) folded before Flop (didn't bet)
Seat 2: Gabrielefante (small blind) collected (€0.04)
Seat 3: Catania838 (big blind) folded on the Flop
Seat 4: Sium12302 folded before Flop (didn't bet)
Seat 5: caduceus369 folded before Flop (didn't bet)
Seat 6: nikolor folded before Flop (didn't bet)



PokerStars Zoom Hand #257984574455:  Hold'em No Limit (€0.01/€0.02) [ADM ID: M62BA304494E32ST] - 2025/10/03 19:10:52 CET [2025/10/03 13:10:52 ET]
Table 'Sirio' 6-max Seat #1 is the button
Seat 1: pistaKKio23 (€5.34 in chips) 
Seat 2: stfuplzudonk (€2.83 in chips) 
Seat 3: SalahUbeen (€2.74 in chips) 
Seat 4: GanchanS7 (€3.86 in chips) 
Seat 5: caduceus369 (€3.72 in chips) 
Seat 6: Sium12302 (€2 in chips) 
stfuplzudonk: posts small blind €0.01
SalahUbeen: posts big blind €0.02
*** HOLE CARDS ***
Dealt to caduceus369 [Ts 9s]
GanchanS7: folds 
caduceus369: folds 
Sium12302: folds 
pistaKKio23: folds 
stfuplzudonk: folds 
Uncalled bet (€0.01) returned to SalahUbeen
SalahUbeen collected €0.02 from pot
SalahUbeen: doesn't show hand 
*** SUMMARY ***
Total pot €0.02 | Rake €0 
Seat 1: pistaKKio23 (button) folded before Flop (didn't bet)
Seat 2: stfuplzudonk (small blind) folded before Flop
Seat 3: SalahUbeen (big blind) collected (€0.02)
Seat 4: GanchanS7 folded before Flop (didn't bet)
Seat 5: caduceus369 folded before Flop (didn't bet)
Seat 6: Sium12302 folded before Flop (didn't bet)



PokerStars Zoom Hand #257984568894:  Hold'em No Limit (€0.01/€0.02) [ADM ID: M62BA304494E32ST] - 2025/10/03 19:10:23 CET [2025/10/03 13:10:23 ET]
Table 'Sirio' 6-max Seat #1 is the button
Seat 1: OSPREYSTORM (€2.02 in chips) 
Seat 2: trillycata (€1.68 in chips) 
Seat 3: ADRIAN0_MEIS (€2.01 in chips) 
Seat 4: caduceus369 (€3.72 in chips) 
Seat 5: nikolor (€3.59 in chips) 
Seat 6: Mary5issi (€2.59 in chips) 
trillycata: posts small blind €0.01
ADRIAN0_MEIS: posts big blind €0.02
*** HOLE CARDS ***
Dealt to caduceus369 [4s Jd]
caduceus369: folds 
nikolor: folds 
Mary5issi: raises €0.02 to €0.04
OSPREYSTORM: raises €0.10 to €0.14
trillycata: folds 
ADRIAN0_MEIS: folds 
Mary5issi: calls €0.10
*** FLOP *** [2c 8d Ah]
Mary5issi: checks 
OSPREYSTORM: bets €0.10
Mary5issi: folds 
Uncalled bet (€0.10) returned to OSPREYSTORM
OSPREYSTORM collected €0.30 from pot
OSPREYSTORM: doesn't show hand 
*** SUMMARY ***
Total pot €0.31 | Rake €0.01 
Board [2c 8d Ah]
Seat 1: OSPREYSTORM (button) collected (€0.30)
Seat 2: trillycata (small blind) folded before Flop
Seat 3: ADRIAN0_MEIS (big blind) folded before Flop
Seat 4: caduceus369 folded before Flop (didn't bet)
Seat 5: nikolor folded before Flop (didn't bet)
Seat 6: Mary5issi folded on the Flop



PokerStars Zoom Hand #257984576069:  Hold'em No Limit (€0.01/€0.02) [ADM ID: M62BA304494E32ST] - 2025/10/03 19:11:01 CET [2025/10/03 13:11:01 ET]
Table 'Sirio' 6-max Seat #1 is the button
Seat 1: OSPREYSTORM (€1.99 in chips) 
Seat 2: caduceus369 (€3.72 in chips) 
Seat 3: ADRIAN0_MEIS (€2.56 in chips) 
Seat 4: Catania838 (€1.54 in chips) 
Seat 5: parker1318 (€2.80 in chips) 
Seat 6: labronicus58 (€2.22 in chips) 
caduceus369: posts small blind €0.01
ADRIAN0_MEIS: posts big blind €0.02
*** HOLE CARDS ***
Dealt to caduceus369 [Ac Qs]
Catania838: calls €0.02
parker1318: folds 
labronicus58: folds 
OSPREYSTORM: folds 
caduceus369: calls €0.01
ADRIAN0_MEIS: raises €0.06 to €0.08
Catania838: folds 
caduceus369: calls €0.06
*** FLOP *** [3s 2s 8d]
caduceus369: checks 
ADRIAN0_MEIS: bets €0.14
caduceus369: folds 
Uncalled bet (€0.14) returned to ADRIAN0_MEIS
ADRIAN0_MEIS collected €0.18 from pot
ADRIAN0_MEIS: doesn't show hand 
*** SUMMARY ***
Total pot €0.18 | Rake €0 
Board [3s 2s 8d]
Seat 1: OSPREYSTORM (button) folded before Flop (didn't bet)
Seat 2: caduceus369 (small blind) folded on the Flop
Seat 3: ADRIAN0_MEIS (big blind) collected (€0.18)
Seat 4: Catania838 folded before Flop
Seat 5: parker1318 folded before Flop (didn't bet)
Seat 6: labronicus58 folded before Flop (didn't bet)



PokerStars Zoom Hand #257984583383:  Hold'em No Limit (€0.01/€0.02) [ADM ID: M62BA304494E32ST] - 2025/10/03 19:11:38 CET [2025/10/03 13:11:38 ET]
Table 'Sirio' 6-max Seat #1 is the button
Seat 1: SalahUbeen (€2.81 in chips) 
Seat 2: OMGWOLFX (€11.40 in chips) 
Seat 3: caduceus369 (€3.64 in chips) 
Seat 4: QUATTRODAME (€3.62 in chips) 
Seat 5: pistaKKio23 (€2.06 in chips) 
Seat 6: parker1318 (€2.73 in chips) 
OMGWOLFX: posts small blind €0.01
caduceus369: posts big blind €0.02
*** HOLE CARDS ***
Dealt to caduceus369 [4s 6h]
QUATTRODAME: folds 
pistaKKio23: folds 
parker1318: folds 
SalahUbeen: raises €0.04 to €0.06
OMGWOLFX: folds 
caduceus369: folds 
Uncalled bet (€0.04) returned to SalahUbeen
SalahUbeen collected €0.05 from pot
SalahUbeen: doesn't show hand 
*** SUMMARY ***
Total pot €0.05 | Rake €0 
Seat 1: SalahUbeen (button) collected (€0.05)
Seat 2: OMGWOLFX (small blind) folded before Flop
Seat 3: caduceus369 (big blind) folded before Flop
Seat 4: QUATTRODAME folded before Flop (didn't bet)
Seat 5: pistaKKio23 folded before Flop (didn't bet)
Seat 6: parker1318 folded before Flop (didn't bet)



PokerStars Zoom Hand #257984589754:  Hold'em No Limit (€0.01/€0.02) [ADM ID: M62BA304494E32ST] - 2025/10/03 19:12:11 CET [2025/10/03 13:12:11 ET]
Table 'Sirio' 6-max Seat #1 is the button
Seat 1: icerini (€1.93 in chips) 
Seat 2: labronicus58 (€2.25 in chips) 
Seat 3: pistaKKio23 (€3.95 in chips) 
Seat 4: OMGWOLFX (€4.79 in chips) 
Seat 5: stfuplzudonk (€2 in chips) 
Seat 6: caduceus369 (€3.62 in chips) 
labronicus58: posts small blind €0.01
pistaKKio23: posts big blind €0.02
*** HOLE CARDS ***
Dealt to caduceus369 [Jh 2h]
OMGWOLFX: raises €0.04 to €0.06
stfuplzudonk: folds 
caduceus369: folds 
icerini: folds 
labronicus58: folds 
pistaKKio23: folds 
Uncalled bet (€0.04) returned to OMGWOLFX
OMGWOLFX collected €0.05 from pot
OMGWOLFX: doesn't show hand 
*** SUMMARY ***
Total pot €0.05 | Rake €0 
Seat 1: icerini (button) folded before Flop (didn't bet)
Seat 2: labronicus58 (small blind) folded before Flop
Seat 3: pistaKKio23 (big blind) folded before Flop
Seat 4: OMGWOLFX collected (€0.05)
Seat 5: stfuplzudonk folded before Flop (didn't bet)
Seat 6: caduceus369 folded before Flop (didn't bet)



PokerStars Zoom Hand #257984586282:  Hold'em No Limit (€0.01/€0.02) [ADM ID: M62BA304494E32ST] - 2025/10/03 19:11:53 CET [2025/10/03 13:11:53 ET]
Table 'Sirio' 6-max Seat #1 is the button
Seat 1: caduceus369 (€3.62 in chips) 
Seat 2: Sium12302 (€2.12 in chips) 
Seat 3: pistaKKio23 (€5.33 in chips) 
Seat 4: ADRIAN0_MEIS (€2.65 in chips) 
Seat 5: stfuplzudonk (€1.68 in chips) 
Seat 6: GanchanS7 (€3.83 in chips) 
Sium12302: posts small blind €0.01
pistaKKio23: posts big blind €0.02
*** HOLE CARDS ***
Dealt to caduceus369 [Qc Tc]
ADRIAN0_MEIS: raises €0.04 to €0.06
stfuplzudonk: folds 
GanchanS7: folds 
caduceus369: folds 
Sium12302: folds 
pistaKKio23: calls €0.04
*** FLOP *** [8h As 2c]
pistaKKio23: checks 
ADRIAN0_MEIS: checks 
*** TURN *** [8h As 2c] [Jc]
pistaKKio23: bets €0.07
ADRIAN0_MEIS: folds 
Uncalled bet (€0.07) returned to pistaKKio23
pistaKKio23 collected €0.13 from pot
pistaKKio23: doesn't show hand 
*** SUMMARY ***
Total pot €0.13 | Rake €0 
Board [8h As 2c Jc]
Seat 1: caduceus369 (button) folded before Flop (didn't bet)
Seat 2: Sium12302 (small blind) folded before Flop
Seat 3: pistaKKio23 (big blind) collected (€0.13)
Seat 4: ADRIAN0_MEIS folded on the Turn
Seat 5: stfuplzudonk folded before Flop (didn't bet)
Seat 6: GanchanS7 folded before Flop (didn't bet)



PokerStars Zoom Hand #257984593491:  Hold'em No Limit (€0.01/€0.02) [ADM ID: M62BA304494E32ST] - 2025/10/03 19:12:30 CET [2025/10/03 13:12:30 ET]
Table 'Sirio' 6-max Seat #1 is the button
Seat 1: Sium12302 (€2.08 in chips) 
Seat 2: parker1318 (€2.82 in chips) 
Seat 3: irenuccia33 (€1.92 in chips) 
Seat 4: Teriferro (€0.86 in chips) 
Seat 5: OSPREYSTORM (€7.62 in chips) 
Seat 6: caduceus369 (€3.61 in chips) 
parker1318: posts small blind €0.01
irenuccia33: posts big blind €0.02
*** HOLE CARDS ***
Dealt to caduceus369 [Kh 5s]
Teriferro: folds 
OSPREYSTORM: folds 
caduceus369: folds 
Sium12302: folds 
parker1318: folds 
Uncalled bet (€0.01) returned to irenuccia33
irenuccia33 collected €0.02 from pot
irenuccia33: doesn't show hand 
*** SUMMARY ***
Total pot €0.02 | Rake €0 
Seat 1: Sium12302 (button) folded before Flop (didn't bet)
Seat 2: parker1318 (small blind) folded before Flop
Seat 3: irenuccia33 (big blind) collected (€0.02)
Seat 4: Teriferro folded before Flop (didn't bet)
Seat 5: OSPREYSTORM folded before Flop (didn't bet)
Seat 6: caduceus369 folded before Flop (didn't bet)



PokerStars Zoom Hand #257984594083:  Hold'em No Limit (€0.01/€0.02) [ADM ID: M62BA304494E32ST] - 2025/10/03 19:12:33 CET [2025/10/03 13:12:33 ET]
Table 'Sirio' 6-max Seat #1 is the button
Seat 1: SalahUbeen (€4.03 in chips) 
Seat 2: Gabrielefante (€2.18 in chips) 
Seat 3: caduceus369 (€3.61 in chips) 
Seat 4: OSPREYSTORM (€7.62 in chips) 
Seat 5: S'dj83 (€7.59 in chips) 
Seat 6: parker1318 (€2.81 in chips) 
Gabrielefante: posts small blind €0.01
caduceus369: posts big blind €0.02
*** HOLE CARDS ***
Dealt to caduceus369 [8c Ac]
OSPREYSTORM: folds 
S'dj83: folds 
parker1318: folds 
SalahUbeen: folds 
Gabrielefante: folds 
Uncalled bet (€0.01) returned to caduceus369
caduceus369 collected €0.02 from pot
caduceus369: doesn't show hand 
*** SUMMARY ***
Total pot €0.02 | Rake €0 
Seat 1: SalahUbeen (button) folded before Flop (didn't bet)
Seat 2: Gabrielefante (small blind) folded before Flop
Seat 3: caduceus369 (big blind) collected (€0.02)
Seat 4: OSPREYSTORM folded before Flop (didn't bet)
Seat 5: S'dj83 folded before Flop (didn't bet)
Seat 6: parker1318 folded before Flop (didn't bet)



PokerStars Zoom Hand #257984590940:  Hold'em No Limit (€0.01/€0.02) [ADM ID: M62BA304494E32ST] - 2025/10/03 19:12:17 CET [2025/10/03 13:12:17 ET]
Table 'Sirio' 6-max Seat #1 is the button
Seat 1: Katymirax (€1.20 in chips) 
Seat 2: caduceus369 (€3.62 in chips) 
Seat 3: enrico197163 (€1.18 in chips) 
Seat 4: Sium12302 (€2.10 in chips) 
Seat 5: Mary5issi (€3.22 in chips) 
Seat 6: GanchanS7 (€3.64 in chips) 
caduceus369: posts small blind €0.01
enrico197163: posts big blind €0.02
*** HOLE CARDS ***
Dealt to caduceus369 [Th Kd]
Sium12302: folds 
Mary5issi: raises €0.02 to €0.04
GanchanS7: calls €0.04
Katymirax: folds 
caduceus369: folds 
enrico197163: folds 
*** FLOP *** [As Js Ac]
Mary5issi: checks 
GanchanS7: checks 
*** TURN *** [As Js Ac] [Qh]
Mary5issi: checks 
GanchanS7: bets €0.07
Mary5issi: folds 
Uncalled bet (€0.07) returned to GanchanS7
GanchanS7 collected €0.11 from pot
GanchanS7: doesn't show hand 
*** SUMMARY ***
Total pot €0.11 | Rake €0 
Board [As Js Ac Qh]
Seat 1: Katymirax (button) folded before Flop (didn't bet)
Seat 2: caduceus369 (small blind) folded before Flop
Seat 3: enrico197163 (big blind) folded before Flop
Seat 4: Sium12302 folded before Flop (didn't bet)
Seat 5: Mary5issi folded on the Turn
Seat 6: GanchanS7 collected (€0.11)



PokerStars Zoom Hand #257984596824:  Hold'em No Limit (€0.01/€0.02) [ADM ID: M62BA304494E32ST] - 2025/10/03 19:12:47 CET [2025/10/03 13:12:47 ET]
Table 'Sirio' 6-max Seat #1 is the button
Seat 1: caduceus369 (€3.62 in chips) 
Seat 2: pistaKKio23 (€5.40 in chips) 
Seat 3: cuzzi68 (€1.12 in chips) 
Seat 4: ADRIAN0_MEIS (€2.22 in chips) 
Seat 5: ceramista17 (€0.96 in chips) 
Seat 6: Sium12302 (€2.08 in chips) 
pistaKKio23: posts small blind €0.01
cuzzi68: posts big blind €0.02
*** HOLE CARDS ***
Dealt to caduceus369 [9d 6c]
ADRIAN0_MEIS: folds 
ceramista17: folds 
Sium12302: folds 
caduceus369: folds 
pistaKKio23: calls €0.01
cuzzi68: raises €0.06 to €0.08
pistaKKio23: folds 
Uncalled bet (€0.06) returned to cuzzi68
cuzzi68 collected €0.04 from pot
cuzzi68: doesn't show hand 
*** SUMMARY ***
Total pot €0.04 | Rake €0 
Seat 1: caduceus369 (button) folded before Flop (didn't bet)
Seat 2: pistaKKio23 (small blind) folded before Flop
Seat 3: cuzzi68 (big blind) collected (€0.04)
Seat 4: ADRIAN0_MEIS folded before Flop (didn't bet)
Seat 5: ceramista17 folded before Flop (didn't bet)
Seat 6: Sium12302 folded before Flop (didn't bet)



PokerStars Zoom Hand #257984601434:  Hold'em No Limit (€0.01/€0.02) [ADM ID: M62BA304494E32ST] - 2025/10/03 19:13:11 CET [2025/10/03 13:13:11 ET]
Table 'Sirio' 6-max Seat #1 is the button
Seat 1: Sium12302 (€2.56 in chips) 
Seat 2: caduceus369 (€3.62 in chips) 
Seat 3: Mary5issi (€3.17 in chips) 
Seat 4: GanchanS7 (€4.14 in chips) 
Seat 5: irenuccia33 (€1.96 in chips) 
Seat 6: Teriferro (€0.83 in chips) 
caduceus369: posts small blind €0.01
Mary5issi: posts big blind €0.02
*** HOLE CARDS ***
Dealt to caduceus369 [7s 3h]
GanchanS7: folds 
irenuccia33: folds 
Teriferro: raises €0.05 to €0.07
Sium12302: folds 
caduceus369: folds 
Mary5issi: folds 
Uncalled bet (€0.05) returned to Teriferro
Teriferro collected €0.05 from pot
Teriferro: doesn't show hand 
*** SUMMARY ***
Total pot €0.05 | Rake €0 
Seat 1: Sium12302 (button) folded before Flop (didn't bet)
Seat 2: caduceus369 (small blind) folded before Flop
Seat 3: Mary5issi (big blind) folded before Flop
Seat 4: GanchanS7 folded before Flop (didn't bet)
Seat 5: irenuccia33 folded before Flop (didn't bet)
Seat 6: Teriferro collected (€0.05)



PokerStars Zoom Hand #257984604398:  Hold'em No Limit (€0.01/€0.02) [ADM ID: M62BA304494E32ST] - 2025/10/03 19:13:26 CET [2025/10/03 13:13:26 ET]
Table 'Sirio' 6-max Seat #1 is the button
Seat 1: OMGWOLFX (€11.81 in chips) 
Seat 2: potodds1979 (€2.13 in chips) 
Seat 3: icerini (€1.42 in chips) 
Seat 4: eleonora50 (€0.84 in chips) 
Seat 5: GanchanS7 (€2.21 in chips) 
Seat 6: caduceus369 (€3.61 in chips) 
potodds1979: posts small blind €0.01
icerini: posts big blind €0.02
*** HOLE CARDS ***
Dealt to caduceus369 [5s 6c]
eleonora50: folds 
GanchanS7: folds 
caduceus369: folds 
OMGWOLFX: folds 
potodds1979: raises €0.04 to €0.06
icerini: folds 
Uncalled bet (€0.04) returned to potodds1979
potodds1979 collected €0.04 from pot
potodds1979: doesn't show hand 
*** SUMMARY ***
Total pot €0.04 | Rake €0 
Seat 1: OMGWOLFX (button) folded before Flop (didn't bet)
Seat 2: potodds1979 (small blind) collected (€0.04)
Seat 3: icerini (big blind) folded before Flop
Seat 4: eleonora50 folded before Flop (didn't bet)
Seat 5: GanchanS7 folded before Flop (didn't bet)
Seat 6: caduceus369 folded before Flop (didn't bet)



PokerStars Zoom Hand #257984602432:  Hold'em No Limit (€0.01/€0.02) [ADM ID: M62BA304494E32ST] - 2025/10/03 19:13:16 CET [2025/10/03 13:13:16 ET]
Table 'Sirio' 6-max Seat #1 is the button
Seat 1: parker1318 (€2.84 in chips) 
Seat 2: icerini (€1.43 in chips) 
Seat 3: Sium12302 (€2.07 in chips) 
Seat 4: pylonstrip (€3.13 in chips) 
Seat 5: caduceus369 (€3.61 in chips) 
Seat 6: cuzzi68 (€1.14 in chips) 
icerini: posts small blind €0.01
Sium12302: posts big blind €0.02
*** HOLE CARDS ***
Dealt to caduceus369 [3h Jc]
pylonstrip: folds 
caduceus369: folds 
cuzzi68: calls €0.02
parker1318: folds 
icerini: folds 
Sium12302: checks 
*** FLOP *** [6h 8c 6c]
Sium12302: checks 
cuzzi68: checks 
*** TURN *** [6h 8c 6c] [9d]
Sium12302: checks 
cuzzi68: checks 
*** RIVER *** [6h 8c 6c 9d] [4d]
Sium12302: checks 
cuzzi68: checks 
*** SHOW DOWN ***
Sium12302: shows [Th Kh] (a pair of Sixes)
cuzzi68: shows [Ac 3s] (a pair of Sixes - Ace kicker)
cuzzi68 collected €0.05 from pot
*** SUMMARY ***
Total pot €0.05 | Rake €0 
Board [6h 8c 6c 9d 4d]
Seat 1: parker1318 (button) folded before Flop (didn't bet)
Seat 2: icerini (small blind) folded before Flop
Seat 3: Sium12302 (big blind) showed [Th Kh] and lost with a pair of Sixes
Seat 4: pylonstrip folded before Flop (didn't bet)
Seat 5: caduceus369 folded before Flop (didn't bet)
Seat 6: cuzzi68 showed [Ac 3s] and won (€0.05) with a pair of Sixes



PokerStars Zoom Hand #257984604999:  Hold'em No Limit (€0.01/€0.02) [ADM ID: M62BA304494E32ST] - 2025/10/03 19:13:29 CET [2025/10/03 13:13:29 ET]
Table 'Sirio' 6-max Seat #1 is the button
Seat 1: caduceus369 (€3.61 in chips) 
Seat 2: pylonstrip (€3.13 in chips) 
Seat 3: tanocrivello (€1.20 in chips) 
Seat 4: S'dj83 (€7.42 in chips) 
Seat 5: stfuplzudonk (€2.96 in chips) 
Seat 6: ADRIAN0_MEIS (€2.56 in chips) 
pylonstrip: posts small blind €0.01
tanocrivello: posts big blind €0.02
*** HOLE CARDS ***
Dealt to caduceus369 [Td 4h]
S'dj83: folds 
stfuplzudonk: folds 
ADRIAN0_MEIS: folds 
caduceus369: folds 
pylonstrip: folds 
Uncalled bet (€0.01) returned to tanocrivello
tanocrivello collected €0.02 from pot
tanocrivello: doesn't show hand 
*** SUMMARY ***
Total pot €0.02 | Rake €0 
Seat 1: caduceus369 (button) folded before Flop (didn't bet)
Seat 2: pylonstrip (small blind) folded before Flop
Seat 3: tanocrivello (big blind) collected (€0.02)
Seat 4: S'dj83 folded before Flop (didn't bet)
Seat 5: stfuplzudonk folded before Flop (didn't bet)
Seat 6: ADRIAN0_MEIS folded before Flop (didn't bet)



PokerStars Zoom Hand #257984600798:  Hold'em No Limit (€0.01/€0.02) [ADM ID: M62BA304494E32ST] - 2025/10/03 19:13:07 CET [2025/10/03 13:13:07 ET]
Table 'Sirio' 6-max Seat #1 is the button
Seat 1: nikolor (€2.05 in chips) 
Seat 2: ziogeppI (€0.85 in chips) 
Seat 3: ADRIAN0_MEIS (€2.21 in chips) 
Seat 4: caduceus369 (€3.62 in chips) 
Seat 5: Sium12302 (€2.56 in chips) 
Seat 6: Mary5issi (€2.22 in chips) 
ziogeppI: posts small blind €0.01
ADRIAN0_MEIS: posts big blind €0.02
*** HOLE CARDS ***
Dealt to caduceus369 [3h Kh]
caduceus369: folds 
Sium12302: folds 
Mary5issi: folds 
nikolor: folds 
ziogeppI: calls €0.01
ADRIAN0_MEIS: checks 
*** FLOP *** [6s Tc Js]
ziogeppI: checks 
ADRIAN0_MEIS: checks 
*** TURN *** [6s Tc Js] [Jc]
ziogeppI: checks 
ADRIAN0_MEIS: checks 
*** RIVER *** [6s Tc Js Jc] [Ac]
ziogeppI: checks 
ADRIAN0_MEIS: checks 
*** SHOW DOWN ***
ziogeppI: shows [3s 4c] (a pair of Jacks)
ADRIAN0_MEIS: shows [5s 9s] (a pair of Jacks - Ace+Ten+Nine kicker)
ADRIAN0_MEIS collected €0.04 from pot
*** SUMMARY ***
Total pot €0.04 | Rake €0 
Board [6s Tc Js Jc Ac]
Seat 1: nikolor (button) folded before Flop (didn't bet)
Seat 2: ziogeppI (small blind) showed [3s 4c] and lost with a pair of Jacks
Seat 3: ADRIAN0_MEIS (big blind) showed [5s 9s] and won (€0.04) with a pair of Jacks
Seat 4: caduceus369 folded before Flop (didn't bet)
Seat 5: Sium12302 folded before Flop (didn't bet)
Seat 6: Mary5issi folded before Flop (didn't bet)



PokerStars Zoom Hand #257984599744:  Hold'em No Limit (€0.01/€0.02) [ADM ID: M62BA304494E32ST] - 2025/10/03 19:13:02 CET [2025/10/03 13:13:02 ET]
Table 'Sirio' 6-max Seat #1 is the button
Seat 1: pistaKKio23 (€3.92 in chips) 
Seat 2: GanchanS7 (€3.71 in chips) 
Seat 3: stfuplzudonk (€1.88 in chips) 
Seat 4: Mary5issi (€2.22 in chips) 
Seat 5: caduceus369 (€3.62 in chips) 
Seat 6: LuBrunu (€1.35 in chips) 
GanchanS7: posts small blind €0.01
stfuplzudonk: posts big blind €0.02
*** HOLE CARDS ***
Dealt to caduceus369 [5s Jd]
Mary5issi: folds 
caduceus369: folds 
LuBrunu: calls €0.02
pistaKKio23: folds 
GanchanS7: folds 
stfuplzudonk: checks 
*** FLOP *** [Jc 3s 4h]
stfuplzudonk: checks 
LuBrunu: bets €0.05
stfuplzudonk: calls €0.05
*** TURN *** [Jc 3s 4h] [Js]
stfuplzudonk: bets €0.08
LuBrunu: raises €0.16 to €0.24
stfuplzudonk: calls €0.16
*** RIVER *** [Jc 3s 4h Js] [5c]
stfuplzudonk: checks 
LuBrunu: bets €0.28
stfuplzudonk: folds 
Uncalled bet (€0.28) returned to LuBrunu
LuBrunu collected €0.60 from pot
LuBrunu: doesn't show hand 
*** SUMMARY ***
Total pot €0.63 | Rake €0.03 
Board [Jc 3s 4h Js 5c]
Seat 1: pistaKKio23 (button) folded before Flop (didn't bet)
Seat 2: GanchanS7 (small blind) folded before Flop
Seat 3: stfuplzudonk (big blind) folded on the River
Seat 4: Mary5issi folded before Flop (didn't bet)
Seat 5: caduceus369 folded before Flop (didn't bet)
Seat 6: LuBrunu collected (€0.60)



PokerStars Zoom Hand #257984603190:  Hold'em No Limit (€0.01/€0.02) [ADM ID: M62BA304494E32ST] - 2025/10/03 19:13:20 CET [2025/10/03 13:13:20 ET]
Table 'Sirio' 6-max Seat #1 is the button
Seat 1: ADRIAN0_MEIS (€2.56 in chips) 
Seat 2: jolli180 (€1.78 in chips) 
Seat 3: stfuplzudonk (€1.96 in chips) 
Seat 4: caduceus369 (€3.61 in chips) 
Seat 5: OMGWOLFX (€4.74 in chips) 
Seat 6: Sium12302 (€2.56 in chips) 
jolli180: posts small blind €0.01
stfuplzudonk: posts big blind €0.02
*** HOLE CARDS ***
Dealt to caduceus369 [Ah 7c]
caduceus369: folds 
OMGWOLFX: folds 
Sium12302: raises €0.04 to €0.06
ADRIAN0_MEIS: folds 
jolli180: calls €0.05
stfuplzudonk: calls €0.04
*** FLOP *** [9h 5s Jh]
jolli180: checks 
stfuplzudonk: checks 
Sium12302: bets €0.06
jolli180: folds 
stfuplzudonk: calls €0.06
*** TURN *** [9h 5s Jh] [Kc]
stfuplzudonk: checks 
Sium12302: bets €0.15
stfuplzudonk: raises €0.33 to €0.48
Sium12302: calls €0.33
*** RIVER *** [9h 5s Jh Kc] [Tc]
stfuplzudonk: bets €1.20
Sium12302: folds 
Uncalled bet (€1.20) returned to stfuplzudonk
stfuplzudonk collected €1.20 from pot
stfuplzudonk: doesn't show hand 
*** SUMMARY ***
Total pot €1.26 | Rake €0.06 
Board [9h 5s Jh Kc Tc]
Seat 1: ADRIAN0_MEIS (button) folded before Flop (didn't bet)
Seat 2: jolli180 (small blind) folded on the Flop
Seat 3: stfuplzudonk (big blind) collected (€1.20)
Seat 4: caduceus369 folded before Flop (didn't bet)
Seat 5: OMGWOLFX folded before Flop (didn't bet)
Seat 6: Sium12302 folded on the River



PokerStars Zoom Hand #257984605808:  Hold'em No Limit (€0.01/€0.02) [ADM ID: M62BA304494E32ST] - 2025/10/03 19:13:33 CET [2025/10/03 13:13:33 ET]
Table 'Sirio' 6-max Seat #1 is the button
Seat 1: GanchanS7 (€3.70 in chips) 
Seat 2: Gabrielefante (€2.19 in chips) 
Seat 3: caduceus369 (€3.61 in chips) 
Seat 4: S'dj83 (€7.42 in chips) 
Seat 5: pylonstrip (€3.12 in chips) 
Seat 6: OMGWOLFX (€6.23 in chips) 
Gabrielefante: posts small blind €0.01
caduceus369: posts big blind €0.02
*** HOLE CARDS ***
Dealt to caduceus369 [9d Ac]
S'dj83: folds 
pylonstrip: folds 
OMGWOLFX: folds 
GanchanS7: raises €0.02 to €0.04
Gabrielefante: folds 
caduceus369: calls €0.02
*** FLOP *** [8d 5s Qs]
caduceus369: checks 
GanchanS7: checks 
*** TURN *** [8d 5s Qs] [Ah]
caduceus369: checks 
GanchanS7: checks 
*** RIVER *** [8d 5s Qs Ah] [Js]
caduceus369: bets €0.02
GanchanS7: raises €0.09 to €0.11
caduceus369: folds 
Uncalled bet (€0.09) returned to GanchanS7
GanchanS7 collected €0.13 from pot
GanchanS7: doesn't show hand 
*** SUMMARY ***
Total pot €0.13 | Rake €0 
Board [8d 5s Qs Ah Js]
Seat 1: GanchanS7 (button) collected (€0.13)
Seat 2: Gabrielefante (small blind) folded before Flop
Seat 3: caduceus369 (big blind) folded on the River
Seat 4: S'dj83 folded before Flop (didn't bet)
Seat 5: pylonstrip folded before Flop (didn't bet)
Seat 6: OMGWOLFX folded before Flop (didn't bet)



PokerStars Zoom Hand #257984622285:  Hold'em No Limit (€0.01/€0.02) [ADM ID: M62BA304494E32ST] - 2025/10/03 19:14:57 CET [2025/10/03 13:14:57 ET]
Table 'Sirio' 6-max Seat #1 is the button
Seat 1: juzam01 (€1.97 in chips) 
Seat 2: pistaKKio23 (€6.08 in chips) 
Seat 3: Sium12302 (€2.19 in chips) 
Seat 4: kroll219 (€3.47 in chips) 
Seat 5: mastromarty (€1.96 in chips) 
Seat 6: caduceus369 (€3.55 in chips) 
pistaKKio23: posts small blind €0.01
Sium12302: posts big blind €0.02
*** HOLE CARDS ***
Dealt to caduceus369 [9h Td]
kroll219: raises €0.02 to €0.04
mastromarty: folds 
caduceus369: folds 
juzam01: folds 
pistaKKio23: folds 
Sium12302: folds 
Uncalled bet (€0.02) returned to kroll219
kroll219 collected €0.05 from pot
kroll219: doesn't show hand 
*** SUMMARY ***
Total pot €0.05 | Rake €0 
Seat 1: juzam01 (button) folded before Flop (didn't bet)
Seat 2: pistaKKio23 (small blind) folded before Flop
Seat 3: Sium12302 (big blind) folded before Flop
Seat 4: kroll219 collected (€0.05)
Seat 5: mastromarty folded before Flop (didn't bet)
Seat 6: caduceus369 folded before Flop (didn't bet)



PokerStars Zoom Hand #257984623386:  Hold'em No Limit (€0.01/€0.02) [ADM ID: M62BA304494E32ST] - 2025/10/03 19:15:03 CET [2025/10/03 13:15:03 ET]
Table 'Sirio' 6-max Seat #1 is the button
Seat 1: Gabrielefante (€2.08 in chips) 
Seat 2: Katymirax (€1.21 in chips) 
Seat 3: caduceus369 (€3.55 in chips) 
Seat 4: ceramista17 (€0.77 in chips) 
Seat 5: nikolor (€3.53 in chips) 
Seat 6: parker1318 (€2.64 in chips) 
Katymirax: posts small blind €0.01
caduceus369: posts big blind €0.02
*** HOLE CARDS ***
Dealt to caduceus369 [6d 9c]
ceramista17: calls €0.02
nikolor: folds 
parker1318: folds 
Gabrielefante: folds 
Katymirax: calls €0.01
caduceus369: checks 
*** FLOP *** [Js 2h 7c]
Katymirax: checks 
caduceus369: checks 
ceramista17: bets €0.06
Katymirax: folds 
caduceus369: folds 
Uncalled bet (€0.06) returned to ceramista17
ceramista17 collected €0.06 from pot
ceramista17: doesn't show hand 
*** SUMMARY ***
Total pot €0.06 | Rake €0 
Board [Js 2h 7c]
Seat 1: Gabrielefante (button) folded before Flop (didn't bet)
Seat 2: Katymirax (small blind) folded on the Flop
Seat 3: caduceus369 (big blind) folded on the Flop
Seat 4: ceramista17 collected (€0.06)
Seat 5: nikolor folded before Flop (didn't bet)
Seat 6: parker1318 folded before Flop (didn't bet)



PokerStars Zoom Hand #257984620048:  Hold'em No Limit (€0.01/€0.02) [ADM ID: M62BA304494E32ST] - 2025/10/03 19:14:46 CET [2025/10/03 13:14:46 ET]
Table 'Sirio' 6-max Seat #1 is the button
Seat 1: OSPREYSTORM (€7.41 in chips) 
Seat 2: QUATTRODAME (€3.53 in chips) 
Seat 3: S'dj83 (€7.39 in chips) 
Seat 4: caduceus369 (€3.55 in chips) 
Seat 5: kroll219 (€3.47 in chips) 
Seat 6: Gabrielefante (€2.09 in chips) 
QUATTRODAME: posts small blind €0.01
S'dj83: posts big blind €0.02
*** HOLE CARDS ***
Dealt to caduceus369 [Ad 6c]
caduceus369: folds 
kroll219: folds 
Gabrielefante: folds 
OSPREYSTORM: raises €0.04 to €0.06
QUATTRODAME: folds 
S'dj83: calls €0.04
*** FLOP *** [3c Qh 6s]
S'dj83: checks 
OSPREYSTORM: checks 
*** TURN *** [3c Qh 6s] [4d]
S'dj83: bets €0.09
OSPREYSTORM: calls €0.09
*** RIVER *** [3c Qh 6s 4d] [4c]
S'dj83: bets €0.20
OSPREYSTORM: raises €0.43 to €0.63
S'dj83: folds 
Uncalled bet (€0.43) returned to OSPREYSTORM
OSPREYSTORM collected €0.68 from pot
OSPREYSTORM: doesn't show hand 
*** SUMMARY ***
Total pot €0.71 | Rake €0.03 
Board [3c Qh 6s 4d 4c]
Seat 1: OSPREYSTORM (button) collected (€0.68)
Seat 2: QUATTRODAME (small blind) folded before Flop
Seat 3: S'dj83 (big blind) folded on the River
Seat 4: caduceus369 folded before Flop (didn't bet)
Seat 5: kroll219 folded before Flop (didn't bet)
Seat 6: Gabrielefante folded before Flop (didn't bet)



PokerStars Zoom Hand #257984630059:  Hold'em No Limit (€0.01/€0.02) [ADM ID: M62BA304494E32ST] - 2025/10/03 19:15:37 CET [2025/10/03 13:15:37 ET]
Table 'Sirio' 6-max Seat #1 is the button
Seat 1: caduceus369 (€3.52 in chips) 
Seat 2: juzam01 (€1.97 in chips) 
Seat 3: stfuplzudonk (€1.68 in chips) 
Seat 4: parker1318 (€2.61 in chips) 
Seat 5: Maur2507 (€1 in chips) 
Seat 6: irenuccia33 (€2.02 in chips) 
juzam01: posts small blind €0.01
stfuplzudonk: posts big blind €0.02
*** HOLE CARDS ***
Dealt to caduceus369 [Jh 3h]
parker1318: folds 
Maur2507: folds 
irenuccia33: folds 
caduceus369: folds 
juzam01: folds 
Uncalled bet (€0.01) returned to stfuplzudonk
stfuplzudonk collected €0.02 from pot
stfuplzudonk: doesn't show hand 
*** SUMMARY ***
Total pot €0.02 | Rake €0 
Seat 1: caduceus369 (button) folded before Flop (didn't bet)
Seat 2: juzam01 (small blind) folded before Flop
Seat 3: stfuplzudonk (big blind) collected (€0.02)
Seat 4: parker1318 folded before Flop (didn't bet)
Seat 5: Maur2507 folded before Flop (didn't bet)
Seat 6: irenuccia33 folded before Flop (didn't bet)



PokerStars Zoom Hand #257984629332:  Hold'em No Limit (€0.01/€0.02) [ADM ID: M62BA304494E32ST] - 2025/10/03 19:15:33 CET [2025/10/03 13:15:33 ET]
Table 'Sirio' 6-max Seat #1 is the button
Seat 1: pistaKKio23 (€2.29 in chips) 
Seat 2: caduceus369 (€3.53 in chips) 
Seat 3: ADRIAN0_MEIS (€2.44 in chips) 
Seat 4: alibabba101 (€1.60 in chips) 
Seat 5: QUATTRODAME (€3.50 in chips) 
Seat 6: Gabrielefante (€2.06 in chips) 
caduceus369: posts small blind €0.01
ADRIAN0_MEIS: posts big blind €0.02
*** HOLE CARDS ***
Dealt to caduceus369 [5c Qc]
alibabba101: folds 
QUATTRODAME: folds 
Gabrielefante: folds 
pistaKKio23: folds 
caduceus369: folds 
Uncalled bet (€0.01) returned to ADRIAN0_MEIS
ADRIAN0_MEIS collected €0.02 from pot
ADRIAN0_MEIS: doesn't show hand 
*** SUMMARY ***
Total pot €0.02 | Rake €0 
Seat 1: pistaKKio23 (button) folded before Flop (didn't bet)
Seat 2: caduceus369 (small blind) folded before Flop
Seat 3: ADRIAN0_MEIS (big blind) collected (€0.02)
Seat 4: alibabba101 folded before Flop (didn't bet)
Seat 5: QUATTRODAME folded before Flop (didn't bet)
Seat 6: Gabrielefante folded before Flop (didn't bet)



PokerStars Zoom Hand #257984631469:  Hold'em No Limit (€0.01/€0.02) [ADM ID: M62BA304494E32ST] - 2025/10/03 19:15:44 CET [2025/10/03 13:15:44 ET]
Table 'Sirio' 6-max Seat #1 is the button
Seat 1: GanchanS7 (€3.74 in chips) 
Seat 2: OSPREYSTORM (€2.09 in chips) 
Seat 3: QUATTRODAME (€3.50 in chips) 
Seat 4: Gabrielefante (€2.06 in chips) 
Seat 5: Sium12302 (€2.02 in chips) 
Seat 6: caduceus369 (€3.52 in chips) 
OSPREYSTORM: posts small blind €0.01
QUATTRODAME: posts big blind €0.02
*** HOLE CARDS ***
Dealt to caduceus369 [Jc Ts]
Gabrielefante: folds 
Sium12302: folds 
caduceus369: raises €0.02 to €0.04
GanchanS7: folds 
OSPREYSTORM: folds 
QUATTRODAME: folds 
Uncalled bet (€0.02) returned to caduceus369
caduceus369 collected €0.05 from pot
caduceus369: doesn't show hand 
*** SUMMARY ***
Total pot €0.05 | Rake €0 
Seat 1: GanchanS7 (button) folded before Flop (didn't bet)
Seat 2: OSPREYSTORM (small blind) folded before Flop
Seat 3: QUATTRODAME (big blind) folded before Flop
Seat 4: Gabrielefante folded before Flop (didn't bet)
Seat 5: Sium12302 folded before Flop (didn't bet)
Seat 6: caduceus369 collected (€0.05)



PokerStars Zoom Hand #257984621394:  Hold'em No Limit (€0.01/€0.02) [ADM ID: M62BA304494E32ST] - 2025/10/03 19:14:52 CET [2025/10/03 13:14:52 ET]
Table 'Sirio' 6-max Seat #1 is the button
Seat 1: nikolor (€2.23 in chips) 
Seat 2: juzam01 (€1.98 in chips) 
Seat 3: tanocrivello (€1.08 in chips) 
Seat 4: cuzzi68 (€1.22 in chips) 
Seat 5: caduceus369 (€3.55 in chips) 
Seat 6: ADRIAN0_MEIS (€2.18 in chips) 
juzam01: posts small blind €0.01
tanocrivello: posts big blind €0.02
*** HOLE CARDS ***
Dealt to caduceus369 [Kc 4d]
cuzzi68: calls €0.02
caduceus369: folds 
ADRIAN0_MEIS: folds 
nikolor: raises €0.04 to €0.06
juzam01: folds 
tanocrivello: calls €0.04
cuzzi68: calls €0.04
*** FLOP *** [9s Ah 4h]
tanocrivello: bets €0.02
cuzzi68: folds 
nikolor: raises €0.14 to €0.16
tanocrivello: calls €0.14
*** TURN *** [9s Ah 4h] [4c]
tanocrivello: checks 
nikolor: bets €0.28
tanocrivello: calls €0.28
*** RIVER *** [9s Ah 4h 4c] [8c]
tanocrivello: checks 
nikolor: bets €0.51
tanocrivello: calls €0.51
*** SHOW DOWN ***
nikolor: shows [6s Ac] (two pair, Aces and Fours)
tanocrivello: shows [2s As] (two pair, Aces and Fours)
tanocrivello collected €0.99 from pot
nikolor collected €0.99 from pot
*** SUMMARY ***
Total pot €2.09 | Rake €0.11 
Board [9s Ah 4h 4c 8c]
Seat 1: nikolor (button) showed [6s Ac] and won (€0.99) with two pair, Aces and Fours
Seat 2: juzam01 (small blind) folded before Flop
Seat 3: tanocrivello (big blind) showed [2s As] and won (€0.99) with two pair, Aces and Fours
Seat 4: cuzzi68 folded on the Flop
Seat 5: caduceus369 folded before Flop (didn't bet)
Seat 6: ADRIAN0_MEIS folded before Flop (didn't bet)



PokerStars Zoom Hand #257984635132:  Hold'em No Limit (€0.01/€0.02) [ADM ID: M62BA304494E32ST] - 2025/10/03 19:16:03 CET [2025/10/03 13:16:03 ET]
Table 'Sirio' 6-max Seat #1 is the button
Seat 1: Maur2507 (€1.07 in chips) 
Seat 2: GanchanS7 (€2.26 in chips) 
Seat 3: mastromarty (€1.75 in chips) 
Seat 4: OSPREYSTORM (€2.08 in chips) 
Seat 5: caduceus369 (€3.55 in chips) 
Seat 6: kroll219 (€3.55 in chips) 
GanchanS7: posts small blind €0.01
mastromarty: posts big blind €0.02
*** HOLE CARDS ***
Dealt to caduceus369 [3d Qd]
OSPREYSTORM: folds 
caduceus369: folds 
kroll219: raises €0.04 to €0.06
Maur2507: folds 
GanchanS7: folds 
mastromarty: folds 
Uncalled bet (€0.04) returned to kroll219
kroll219 collected €0.05 from pot
kroll219: doesn't show hand 
*** SUMMARY ***
Total pot €0.05 | Rake €0 
Seat 1: Maur2507 (button) folded before Flop (didn't bet)
Seat 2: GanchanS7 (small blind) folded before Flop
Seat 3: mastromarty (big blind) folded before Flop
Seat 4: OSPREYSTORM folded before Flop (didn't bet)
Seat 5: caduceus369 folded before Flop (didn't bet)
Seat 6: kroll219 collected (€0.05)



PokerStars Zoom Hand #257984636011:  Hold'em No Limit (€0.01/€0.02) [ADM ID: M62BA304494E32ST] - 2025/10/03 19:16:08 CET [2025/10/03 13:16:08 ET]
Table 'Sirio' 6-max Seat #1 is the button
Seat 1: caduceus369 (€3.55 in chips) 
Seat 2: pistaKKio23 (€6.08 in chips) 
Seat 3: OSPREYSTORM (€2.08 in chips) 
Seat 4: alibabba101 (€1.58 in chips) 
Seat 5: Mary5issi (€2.95 in chips) 
Seat 6: juzam01 (€3.40 in chips) 
pistaKKio23: posts small blind €0.01
OSPREYSTORM: posts big blind €0.02
*** HOLE CARDS ***
Dealt to caduceus369 [5d 3d]
alibabba101: folds 
Mary5issi: folds 
juzam01: raises €0.03 to €0.05
caduceus369: folds 
pistaKKio23: folds 
OSPREYSTORM: folds 
Uncalled bet (€0.03) returned to juzam01
juzam01 collected €0.05 from pot
juzam01: doesn't show hand 
*** SUMMARY ***
Total pot €0.05 | Rake €0 
Seat 1: caduceus369 (button) folded before Flop (didn't bet)
Seat 2: pistaKKio23 (small blind) folded before Flop
Seat 3: OSPREYSTORM (big blind) folded before Flop
Seat 4: alibabba101 folded before Flop (didn't bet)
Seat 5: Mary5issi folded before Flop (didn't bet)
Seat 6: juzam01 collected (€0.05)



PokerStars Zoom Hand #257984634308:  Hold'em No Limit (€0.01/€0.02) [ADM ID: M62BA304494E32ST] - 2025/10/03 19:15:59 CET [2025/10/03 13:15:59 ET]
Table 'Sirio' 6-max Seat #1 is the button
Seat 1: juzam01 (€1.30 in chips) 
Seat 2: OSPREYSTORM (€2.14 in chips) 
Seat 3: ADRIAN0_MEIS (€2.57 in chips) 
Seat 4: caduceus369 (€3.55 in chips) 
Seat 5: GanchanS7 (€3.74 in chips) 
Seat 6: LuBrunu (€1.45 in chips) 
OSPREYSTORM: posts small blind €0.01
ADRIAN0_MEIS: posts big blind €0.02
*** HOLE CARDS ***
Dealt to caduceus369 [4d As]
caduceus369: folds 
GanchanS7: folds 
LuBrunu: calls €0.02
juzam01: folds 
OSPREYSTORM: folds 
ADRIAN0_MEIS: checks 
*** FLOP *** [Ad 6d 4s]
ADRIAN0_MEIS: checks 
LuBrunu: bets €0.02
ADRIAN0_MEIS: folds 
Uncalled bet (€0.02) returned to LuBrunu
LuBrunu collected €0.05 from pot
LuBrunu: doesn't show hand 
*** SUMMARY ***
Total pot €0.05 | Rake €0 
Board [Ad 6d 4s]
Seat 1: juzam01 (button) folded before Flop (didn't bet)
Seat 2: OSPREYSTORM (small blind) folded before Flop
Seat 3: ADRIAN0_MEIS (big blind) folded on the Flop
Seat 4: caduceus369 folded before Flop (didn't bet)
Seat 5: GanchanS7 folded before Flop (didn't bet)
Seat 6: LuBrunu collected (€0.05)



PokerStars Zoom Hand #257984641416:  Hold'em No Limit (€0.01/€0.02) [ADM ID: M62BA304494E32ST] - 2025/10/03 19:16:36 CET [2025/10/03 13:16:36 ET]
Table 'Sirio' 6-max Seat #1 is the button
Seat 1: stfuplzudonk (€2.08 in chips) 
Seat 2: caduceus369 (€3.53 in chips) 
Seat 3: pistaKKio23 (€4.08 in chips) 
Seat 4: SKERZA (€1.96 in chips) 
Seat 5: GanchanS7 (€3.72 in chips) 
Seat 6: OMGWOLFX (€6.51 in chips) 
caduceus369: posts small blind €0.01
pistaKKio23: posts big blind €0.02
*** HOLE CARDS ***
Dealt to caduceus369 [Jd Ac]
SKERZA: folds 
GanchanS7: folds 
OMGWOLFX: raises €0.04 to €0.06
stfuplzudonk: folds 
caduceus369: raises €0.22 to €0.28
pistaKKio23: folds 
OMGWOLFX: folds 
Uncalled bet (€0.22) returned to caduceus369
caduceus369 collected €0.14 from pot
caduceus369: doesn't show hand 
*** SUMMARY ***
Total pot €0.14 | Rake €0 
Seat 1: stfuplzudonk (button) folded before Flop (didn't bet)
Seat 2: caduceus369 (small blind) collected (€0.14)
Seat 3: pistaKKio23 (big blind) folded before Flop
Seat 4: SKERZA folded before Flop (didn't bet)
Seat 5: GanchanS7 folded before Flop (didn't bet)
Seat 6: OMGWOLFX folded before Flop



PokerStars Zoom Hand #257984637178:  Hold'em No Limit (€0.01/€0.02) [ADM ID: M62BA304494E32ST] - 2025/10/03 19:16:14 CET [2025/10/03 13:16:14 ET]
Table 'Sirio' 6-max Seat #1 is the button
Seat 1: Sium12302 (€2 in chips) 
Seat 2: tanocrivello (€1.06 in chips) 
Seat 3: caduceus369 (€3.55 in chips) 
Seat 4: GanchanS7 (€2.25 in chips) 
Seat 5: stagniarihd (€2 in chips) 
Seat 6: Maur2507 (€1.06 in chips) 
tanocrivello: posts small blind €0.01
caduceus369: posts big blind €0.02
*** HOLE CARDS ***
Dealt to caduceus369 [7d 5h]
GanchanS7: folds 
stagniarihd: folds 
Maur2507: calls €0.02
Sium12302: raises €0.04 to €0.06
tanocrivello: calls €0.05
caduceus369: folds 
Maur2507: calls €0.04
*** FLOP *** [6d 4d 8d]
tanocrivello: checks 
Maur2507: checks 
Sium12302: bets €0.06
tanocrivello: calls €0.06
Maur2507: folds 
*** TURN *** [6d 4d 8d] [Td]
tanocrivello: checks 
Sium12302: bets €0.20
tanocrivello: folds 
Uncalled bet (€0.20) returned to Sium12302
Sium12302 collected €0.31 from pot
Sium12302: doesn't show hand 
*** SUMMARY ***
Total pot €0.32 | Rake €0.01 
Board [6d 4d 8d Td]
Seat 1: Sium12302 (button) collected (€0.31)
Seat 2: tanocrivello (small blind) folded on the Turn
Seat 3: caduceus369 (big blind) folded before Flop
Seat 4: GanchanS7 folded before Flop (didn't bet)
Seat 5: stagniarihd folded before Flop (didn't bet)
Seat 6: Maur2507 folded on the Flop



PokerStars Zoom Hand #257984646503:  Hold'em No Limit (€0.01/€0.02) [ADM ID: M62BA304494E32ST] - 2025/10/03 19:17:03 CET [2025/10/03 13:17:03 ET]
Table 'Sirio' 6-max Seat #1 is the button
Seat 1: GanchanS7 (€2.21 in chips) 
Seat 2: OSPREYSTORM (€2.15 in chips) 
Seat 3: juzam01 (€1.35 in chips) 
Seat 4: stfuplzudonk (€4.79 in chips) 
Seat 5: caduceus369 (€3.61 in chips) 
Seat 6: ADRIAN0_MEIS (€2 in chips) 
OSPREYSTORM: posts small blind €0.01
juzam01: posts big blind €0.02
*** HOLE CARDS ***
Dealt to caduceus369 [6d Ah]
stfuplzudonk: raises €0.04 to €0.06
caduceus369: folds 
ADRIAN0_MEIS: folds 
GanchanS7: folds 
OSPREYSTORM: folds 
juzam01: folds 
Uncalled bet (€0.04) returned to stfuplzudonk
stfuplzudonk collected €0.05 from pot
stfuplzudonk: doesn't show hand 
*** SUMMARY ***
Total pot €0.05 | Rake €0 
Seat 1: GanchanS7 (button) folded before Flop (didn't bet)
Seat 2: OSPREYSTORM (small blind) folded before Flop
Seat 3: juzam01 (big blind) folded before Flop
Seat 4: stfuplzudonk collected (€0.05)
Seat 5: caduceus369 folded before Flop (didn't bet)
Seat 6: ADRIAN0_MEIS folded before Flop (didn't bet)



PokerStars Zoom Hand #257984647520:  Hold'em No Limit (€0.01/€0.02) [ADM ID: M62BA304494E32ST] - 2025/10/03 19:17:09 CET [2025/10/03 13:17:09 ET]
Table 'Sirio' 6-max Seat #1 is the button
Seat 1: OSPREYSTORM (€2.14 in chips) 
Seat 2: ziogeppI (€1.43 in chips) 
Seat 3: parker1318 (€2.67 in chips) 
Seat 4: alibabba101 (€1.43 in chips) 
Seat 5: ceramista17 (€0.98 in chips) 
Seat 6: caduceus369 (€3.61 in chips) 
ziogeppI: posts small blind €0.01
parker1318: posts big blind €0.02
*** HOLE CARDS ***
Dealt to caduceus369 [5c Jd]
alibabba101: folds 
ceramista17: raises €0.04 to €0.06
caduceus369: folds 
OSPREYSTORM: folds 
ziogeppI: calls €0.05
parker1318: folds 
*** FLOP *** [4s 5d 3c]
ziogeppI: checks 
ceramista17: bets €0.04
ziogeppI: calls €0.04
*** TURN *** [4s 5d 3c] [7s]
ziogeppI: checks 
ceramista17: bets €0.21
ziogeppI: folds 
Uncalled bet (€0.21) returned to ceramista17
ceramista17 collected €0.21 from pot
ceramista17: doesn't show hand 
*** SUMMARY ***
Total pot €0.22 | Rake €0.01 
Board [4s 5d 3c 7s]
Seat 1: OSPREYSTORM (button) folded before Flop (didn't bet)
Seat 2: ziogeppI (small blind) folded on the Turn
Seat 3: parker1318 (big blind) folded before Flop
Seat 4: alibabba101 folded before Flop (didn't bet)
Seat 5: ceramista17 collected (€0.21)
Seat 6: caduceus369 folded before Flop (didn't bet)



PokerStars Zoom Hand #257984648681:  Hold'em No Limit (€0.01/€0.02) [ADM ID: M62BA304494E32ST] - 2025/10/03 19:17:15 CET [2025/10/03 13:17:15 ET]
Table 'Sirio' 6-max Seat #1 is the button
Seat 1: OMGWOLFX (€6.43 in chips) 
Seat 2: parker1318 (€2.65 in chips) 
Seat 3: Gabrielefante (€2.36 in chips) 
Seat 4: caduceus369 (€3.61 in chips) 
Seat 5: GanchanS7 (€2.20 in chips) 
Seat 6: OSPREYSTORM (€2.14 in chips) 
parker1318: posts small blind €0.01
Gabrielefante: posts big blind €0.02
*** HOLE CARDS ***
Dealt to caduceus369 [Ks Kh]
caduceus369: raises €0.02 to €0.04
GanchanS7: folds 
OSPREYSTORM: folds 
OMGWOLFX: folds 
parker1318: calls €0.03
Gabrielefante: folds 
*** FLOP *** [Ac Qc 3c]
parker1318: checks 
caduceus369: checks 
*** TURN *** [Ac Qc 3c] [4s]
parker1318: checks 
caduceus369: bets €0.03
parker1318: calls €0.03
*** RIVER *** [Ac Qc 3c 4s] [2d]
parker1318: checks 
caduceus369: checks 
*** SHOW DOWN ***
parker1318: shows [5c 5h] (a straight, Ace to Five)
caduceus369: mucks hand 
parker1318 collected €0.16 from pot
*** SUMMARY ***
Total pot €0.16 | Rake €0 
Board [Ac Qc 3c 4s 2d]
Seat 1: OMGWOLFX (button) folded before Flop (didn't bet)
Seat 2: parker1318 (small blind) showed [5c 5h] and won (€0.16) with a straight, Ace to Five
Seat 3: Gabrielefante (big blind) folded before Flop
Seat 4: caduceus369 mucked [Ks Kh]
Seat 5: GanchanS7 folded before Flop (didn't bet)
Seat 6: OSPREYSTORM folded before Flop (didn't bet)



PokerStars Zoom Hand #257984655642:  Hold'em No Limit (€0.01/€0.02) [ADM ID: M62BA304494E32ST] - 2025/10/03 19:17:50 CET [2025/10/03 13:17:50 ET]
Table 'Sirio' 6-max Seat #1 is the button
Seat 1: parker1318 (€2.74 in chips) 
Seat 2: caduceus369 (€3.54 in chips) 
Seat 3: Ceribelli1705 (€0.71 in chips) 
Seat 4: eleonora50 (€0.73 in chips) 
Seat 5: OSPREYSTORM (€2.02 in chips) 
Seat 6: pistaKKio23 (€2.32 in chips) 
caduceus369: posts small blind €0.01
Ceribelli1705: posts big blind €0.02
*** HOLE CARDS ***
Dealt to caduceus369 [Td 8s]
eleonora50: folds 
OSPREYSTORM: folds 
pistaKKio23: folds 
parker1318: folds 
caduceus369: folds 
Uncalled bet (€0.01) returned to Ceribelli1705
Ceribelli1705 collected €0.02 from pot
Ceribelli1705: doesn't show hand 
*** SUMMARY ***
Total pot €0.02 | Rake €0 
Seat 1: parker1318 (button) folded before Flop (didn't bet)
Seat 2: caduceus369 (small blind) folded before Flop
Seat 3: Ceribelli1705 (big blind) collected (€0.02)
Seat 4: eleonora50 folded before Flop (didn't bet)
Seat 5: OSPREYSTORM folded before Flop (didn't bet)
Seat 6: pistaKKio23 folded before Flop (didn't bet)



PokerStars Zoom Hand #257984659560:  Hold'em No Limit (€0.01/€0.02) [ADM ID: M62BA304494E32ST] - 2025/10/03 19:18:10 CET [2025/10/03 13:18:10 ET]
Table 'Sirio' 6-max Seat #1 is the button
Seat 1: ADRIAN0_MEIS (€2.52 in chips) 
Seat 2: Mary5issi (€3.08 in chips) 
Seat 3: caduceus369 (€3.53 in chips) 
Seat 4: OSPREYSTORM (€2.11 in chips) 
Seat 5: GanchanS7 (€3.95 in chips) 
Seat 6: Sium12302 (€2.22 in chips) 
Mary5issi: posts small blind €0.01
caduceus369: posts big blind €0.02
*** HOLE CARDS ***
Dealt to caduceus369 [4d 9c]
OSPREYSTORM: folds 
GanchanS7: folds 
Sium12302: folds 
ADRIAN0_MEIS: folds 
Mary5issi: raises €0.02 to €0.04
caduceus369: folds 
Uncalled bet (€0.02) returned to Mary5issi
Mary5issi collected €0.04 from pot
Mary5issi: doesn't show hand 
*** SUMMARY ***
Total pot €0.04 | Rake €0 
Seat 1: ADRIAN0_MEIS (button) folded before Flop (didn't bet)
Seat 2: Mary5issi (small blind) collected (€0.04)
Seat 3: caduceus369 (big blind) folded before Flop
Seat 4: OSPREYSTORM folded before Flop (didn't bet)
Seat 5: GanchanS7 folded before Flop (didn't bet)
Seat 6: Sium12302 folded before Flop (didn't bet)



PokerStars Zoom Hand #257984658828:  Hold'em No Limit (€0.01/€0.02) [ADM ID: M62BA304494E32ST] - 2025/10/03 19:18:06 CET [2025/10/03 13:18:06 ET]
Table 'Sirio' 6-max Seat #1 is the button
Seat 1: juzam01 (€2.45 in chips) 
Seat 2: alibabba101 (€1.48 in chips) 
Seat 3: pylonstrip (€3.08 in chips) 
Seat 4: caduceus369 (€3.53 in chips) 
Seat 5: trillycata (€1.92 in chips) 
Seat 6: OSPREYSTORM (€2.11 in chips) 
alibabba101: posts small blind €0.01
pylonstrip: posts big blind €0.02
*** HOLE CARDS ***
Dealt to caduceus369 [Qs 8d]
caduceus369: folds 
trillycata: folds 
OSPREYSTORM: folds 
juzam01: raises €0.03 to €0.05
alibabba101: calls €0.04
pylonstrip: folds 
*** FLOP *** [9d Kh Kc]
alibabba101: checks 
juzam01: checks 
*** TURN *** [9d Kh Kc] [3c]
alibabba101: bets €0.02
juzam01: calls €0.02
*** RIVER *** [9d Kh Kc 3c] [Jc]
alibabba101: checks 
juzam01: bets €0.06
alibabba101: folds 
Uncalled bet (€0.06) returned to juzam01
juzam01 collected €0.16 from pot
juzam01: doesn't show hand 
*** SUMMARY ***
Total pot €0.16 | Rake €0 
Board [9d Kh Kc 3c Jc]
Seat 1: juzam01 (button) collected (€0.16)
Seat 2: alibabba101 (small blind) folded on the River
Seat 3: pylonstrip (big blind) folded before Flop
Seat 4: caduceus369 folded before Flop (didn't bet)
Seat 5: trillycata folded before Flop (didn't bet)
Seat 6: OSPREYSTORM folded before Flop (didn't bet)



PokerStars Zoom Hand #257984662120:  Hold'em No Limit (€0.01/€0.02) [ADM ID: M62BA304494E32ST] - 2025/10/03 19:18:23 CET [2025/10/03 13:18:23 ET]
Table 'Sirio' 6-max Seat #1 is the button
Seat 1: caduceus369 (€3.51 in chips) 
Seat 2: ADRIAN0_MEIS (€2.13 in chips) 
Seat 3: Sium12302 (€2.19 in chips) 
Seat 4: Maur2507 (€0.93 in chips) 
Seat 5: SKERZA (€2.42 in chips) 
Seat 6: pylonstrip (€3.05 in chips) 
ADRIAN0_MEIS: posts small blind €0.01
Sium12302: posts big blind €0.02
*** HOLE CARDS ***
Dealt to caduceus369 [3s 6h]
Maur2507: folds 
SKERZA: raises €0.03 to €0.05
pylonstrip: folds 
caduceus369: folds 
ADRIAN0_MEIS: folds 
Sium12302: folds 
Uncalled bet (€0.03) returned to SKERZA
SKERZA collected €0.05 from pot
SKERZA: doesn't show hand 
*** SUMMARY ***
Total pot €0.05 | Rake €0 
Seat 1: caduceus369 (button) folded before Flop (didn't bet)
Seat 2: ADRIAN0_MEIS (small blind) folded before Flop
Seat 3: Sium12302 (big blind) folded before Flop
Seat 4: Maur2507 folded before Flop (didn't bet)
Seat 5: SKERZA collected (€0.05)
Seat 6: pylonstrip folded before Flop (didn't bet)



PokerStars Zoom Hand #257984663579:  Hold'em No Limit (€0.01/€0.02) [ADM ID: M62BA304494E32ST] - 2025/10/03 19:18:30 CET [2025/10/03 13:18:30 ET]
Table 'Sirio' 6-max Seat #1 is the button
Seat 1: stfuplzudonk (€2.80 in chips) 
Seat 2: Sium12302 (€2.23 in chips) 
Seat 3: GanchanS7 (€3.72 in chips) 
Seat 4: pistaKKio23 (€5.36 in chips) 
Seat 5: caduceus369 (€3.51 in chips) 
Seat 6: cuzzi68 (€0.70 in chips) 
Sium12302: posts small blind €0.01
GanchanS7: posts big blind €0.02
*** HOLE CARDS ***
Dealt to caduceus369 [As 2s]
pistaKKio23: folds 
caduceus369 has timed out
caduceus369: folds 
cuzzi68: raises €0.10 to €0.12
stfuplzudonk: raises €0.18 to €0.30
Sium12302: folds 
GanchanS7: folds 
cuzzi68: raises €0.40 to €0.70 and is all-in
stfuplzudonk: calls €0.40
*** FLOP *** [Qc 4s 4h]
*** TURN *** [Qc 4s 4h] [3s]
*** RIVER *** [Qc 4s 4h 3s] [9s]
*** SHOW DOWN ***
cuzzi68: shows [4d Ad] (three of a kind, Fours)
stfuplzudonk: shows [Th Tc] (two pair, Tens and Fours)
cuzzi68 collected €1.36 from pot
*** SUMMARY ***
Total pot €1.43 | Rake €0.07 
Board [Qc 4s 4h 3s 9s]
Seat 1: stfuplzudonk (button) showed [Th Tc] and lost with two pair, Tens and Fours
Seat 2: Sium12302 (small blind) folded before Flop
Seat 3: GanchanS7 (big blind) folded before Flop
Seat 4: pistaKKio23 folded before Flop (didn't bet)
Seat 5: caduceus369 folded before Flop (didn't bet)
Seat 6: cuzzi68 showed [4d Ad] and won (€1.36) with three of a kind, Fours



PokerStars Zoom Hand #257984672184:  Hold'em No Limit (€0.01/€0.02) [ADM ID: M62BA304494E32ST] - 2025/10/03 19:19:14 CET [2025/10/03 13:19:14 ET]
Table 'Sirio' 6-max Seat #1 is the button
Seat 1: pistaKKio23 (€4 in chips) 
Seat 2: juzam01 (€2.41 in chips) 
Seat 3: SKERZA (€2.77 in chips) 
Seat 4: stagniarihd (€1.71 in chips) 
Seat 5: GanchanS7 (€2.15 in chips) 
Seat 6: caduceus369 (€3.49 in chips) 
juzam01: posts small blind €0.01
SKERZA: posts big blind €0.02
*** HOLE CARDS ***
Dealt to caduceus369 [3h Jd]
stagniarihd: folds 
GanchanS7: folds 
caduceus369: folds 
pistaKKio23: folds 
juzam01: raises €0.03 to €0.05
SKERZA: folds 
Uncalled bet (€0.03) returned to juzam01
juzam01 collected €0.04 from pot
juzam01: doesn't show hand 
*** SUMMARY ***
Total pot €0.04 | Rake €0 
Seat 1: pistaKKio23 (button) folded before Flop (didn't bet)
Seat 2: juzam01 (small blind) collected (€0.04)
Seat 3: SKERZA (big blind) folded before Flop
Seat 4: stagniarihd folded before Flop (didn't bet)
Seat 5: GanchanS7 folded before Flop (didn't bet)
Seat 6: caduceus369 folded before Flop (didn't bet)



PokerStars Zoom Hand #257984668273:  Hold'em No Limit (€0.01/€0.02) [ADM ID: M62BA304494E32ST] - 2025/10/03 19:18:54 CET [2025/10/03 13:18:54 ET]
Table 'Sirio' 6-max Seat #1 is the button
Seat 1: stfuplzudonk (€2.18 in chips) 
Seat 2: kroll219 (€3.49 in chips) 
Seat 3: caduceus369 (€3.51 in chips) 
Seat 4: eleonora50 (€0.75 in chips) 
Seat 5: juzam01 (€1.19 in chips) 
Seat 6: GanchanS7 (€2.15 in chips) 
kroll219: posts small blind €0.01
caduceus369: posts big blind €0.02
*** HOLE CARDS ***
Dealt to caduceus369 [Js 8c]
eleonora50: folds 
juzam01: folds 
GanchanS7: folds 
stfuplzudonk: raises €0.02 to €0.04
kroll219: raises €0.10 to €0.14
caduceus369: folds 
stfuplzudonk: calls €0.10
*** FLOP *** [9s Qs 2h]
kroll219: checks 
stfuplzudonk: checks 
*** TURN *** [9s Qs 2h] [5h]
kroll219: checks 
stfuplzudonk: checks 
*** RIVER *** [9s Qs 2h 5h] [5d]
kroll219: checks 
stfuplzudonk: checks 
*** SHOW DOWN ***
kroll219: shows [Ac Kd] (a pair of Fives)
stfuplzudonk: shows [4s 4c] (two pair, Fives and Fours)
stfuplzudonk collected €0.29 from pot
*** SUMMARY ***
Total pot €0.30 | Rake €0.01 
Board [9s Qs 2h 5h 5d]
Seat 1: stfuplzudonk (button) showed [4s 4c] and won (€0.29) with two pair, Fives and Fours
Seat 2: kroll219 (small blind) showed [Ac Kd] and lost with a pair of Fives
Seat 3: caduceus369 (big blind) folded before Flop
Seat 4: eleonora50 folded before Flop (didn't bet)
Seat 5: juzam01 folded before Flop (didn't bet)
Seat 6: GanchanS7 folded before Flop (didn't bet)



PokerStars Zoom Hand #257984673600:  Hold'em No Limit (€0.01/€0.02) [ADM ID: M62BA304494E32ST] - 2025/10/03 19:19:21 CET [2025/10/03 13:19:21 ET]
Table 'Sirio' 6-max Seat #1 is the button
Seat 1: caduceus369 (€3.49 in chips) 
Seat 2: GanchanS7 (€2.15 in chips) 
Seat 3: Teriferro (€0.75 in chips) 
Seat 4: pistaKKio23 (€2.59 in chips) 
Seat 5: stfuplzudonk (€4.97 in chips) 
Seat 6: juzam01 (€1.22 in chips) 
GanchanS7: posts small blind €0.01
Teriferro: posts big blind €0.02
*** HOLE CARDS ***
Dealt to caduceus369 [5d Ad]
pistaKKio23: folds 
stfuplzudonk: folds 
juzam01: folds 
caduceus369: raises €0.02 to €0.04
GanchanS7: folds 
Teriferro: calls €0.02
*** FLOP *** [Kc 5c Tc]
Teriferro: bets €0.02
caduceus369: calls €0.02
*** TURN *** [Kc 5c Tc] [Qs]
Teriferro: bets €0.06
caduceus369: folds 
Uncalled bet (€0.06) returned to Teriferro
Teriferro collected €0.13 from pot
Teriferro: doesn't show hand 
*** SUMMARY ***
Total pot €0.13 | Rake €0 
Board [Kc 5c Tc Qs]
Seat 1: caduceus369 (button) folded on the Turn
Seat 2: GanchanS7 (small blind) folded before Flop
Seat 3: Teriferro (big blind) collected (€0.13)
Seat 4: pistaKKio23 folded before Flop (didn't bet)
Seat 5: stfuplzudonk folded before Flop (didn't bet)
Seat 6: juzam01 folded before Flop (didn't bet)



PokerStars Zoom Hand #257984683152:  Hold'em No Limit (€0.01/€0.02) [ADM ID: M62BA304494E32ST] - 2025/10/03 19:20:11 CET [2025/10/03 13:20:11 ET]
Table 'Sirio' 6-max Seat #1 is the button
Seat 1: Ceribelli1705 (€0.69 in chips) 
Seat 2: caduceus369 (€3.43 in chips) 
Seat 3: pylonstrip (€3.55 in chips) 
Seat 4: GanchanS7 (€2.12 in chips) 
Seat 5: Mary5issi (€4.50 in chips) 
Seat 6: stfuplzudonk (€2.07 in chips) 
caduceus369: posts small blind €0.01
pylonstrip: posts big blind €0.02
*** HOLE CARDS ***
Dealt to caduceus369 [Ts Kh]
GanchanS7: folds 
Mary5issi: folds 
stfuplzudonk: folds 
Ceribelli1705: folds 
caduceus369: calls €0.01
pylonstrip: checks 
*** FLOP *** [9d 3h 7h]
caduceus369: checks 
pylonstrip: bets €0.04
caduceus369: calls €0.04
*** TURN *** [9d 3h 7h] [3d]
caduceus369: checks 
pylonstrip: bets €0.12
caduceus369: folds 
Uncalled bet (€0.12) returned to pylonstrip
pylonstrip collected €0.12 from pot
pylonstrip: doesn't show hand 
*** SUMMARY ***
Total pot €0.12 | Rake €0 
Board [9d 3h 7h 3d]
Seat 1: Ceribelli1705 (button) folded before Flop (didn't bet)
Seat 2: caduceus369 (small blind) folded on the Turn
Seat 3: pylonstrip (big blind) collected (€0.12)
Seat 4: GanchanS7 folded before Flop (didn't bet)
Seat 5: Mary5issi folded before Flop (didn't bet)
Seat 6: stfuplzudonk folded before Flop (didn't bet)



PokerStars Zoom Hand #257984693134:  Hold'em No Limit (€0.01/€0.02) [ADM ID: M62BA304494E32ST] - 2025/10/03 19:21:01 CET [2025/10/03 13:21:01 ET]
Table 'Sirio' 6-max Seat #1 is the button
Seat 1: RRgalp (€5.36 in chips) 
Seat 2: GanchanS7 (€3.78 in chips) 
Seat 3: pistaKKio23 (€5.47 in chips) 
Seat 4: caduceus369 (€3.37 in chips) 
Seat 5: kroll219 (€3.33 in chips) 
Seat 6: OMGWOLFX (€5.06 in chips) 
GanchanS7: posts small blind €0.01
pistaKKio23: posts big blind €0.02
*** HOLE CARDS ***
Dealt to caduceus369 [Jd 5d]
caduceus369: folds 
kroll219: folds 
OMGWOLFX: folds 
RRgalp: folds 
GanchanS7: folds 
Uncalled bet (€0.01) returned to pistaKKio23
pistaKKio23 collected €0.02 from pot
pistaKKio23: doesn't show hand 
*** SUMMARY ***
Total pot €0.02 | Rake €0 
Seat 1: RRgalp (button) folded before Flop (didn't bet)
Seat 2: GanchanS7 (small blind) folded before Flop
Seat 3: pistaKKio23 (big blind) collected (€0.02)
Seat 4: caduceus369 folded before Flop (didn't bet)
Seat 5: kroll219 folded before Flop (didn't bet)
Seat 6: OMGWOLFX folded before Flop (didn't bet)



PokerStars Zoom Hand #257984692306:  Hold'em No Limit (€0.01/€0.02) [ADM ID: M62BA304494E32ST] - 2025/10/03 19:20:57 CET [2025/10/03 13:20:57 ET]
Table 'Sirio' 6-max Seat #1 is the button
Seat 1: OMGWOLFX (€6.39 in chips) 
Seat 2: enrico197163 (€1.12 in chips) 
Seat 3: OSPREYSTORM (€1.85 in chips) 
Seat 4: ADRIAN0_MEIS (€2.06 in chips) 
Seat 5: caduceus369 (€3.37 in chips) 
Seat 6: stfuplzudonk (€4.73 in chips) 
enrico197163: posts small blind €0.01
OSPREYSTORM: posts big blind €0.02
*** HOLE CARDS ***
Dealt to caduceus369 [8c 2s]
ADRIAN0_MEIS: folds 
caduceus369: folds 
stfuplzudonk: raises €0.04 to €0.06
OMGWOLFX: folds 
enrico197163: calls €0.05
OSPREYSTORM: folds 
*** FLOP *** [6s Td 5h]
enrico197163: checks 
stfuplzudonk: checks 
*** TURN *** [6s Td 5h] [9s]
enrico197163: checks 
stfuplzudonk: checks 
*** RIVER *** [6s Td 5h 9s] [7s]
enrico197163: checks 
stfuplzudonk: checks 
*** SHOW DOWN ***
enrico197163: shows [Kh As] (high card Ace)
stfuplzudonk: mucks hand 
enrico197163 collected €0.14 from pot
*** SUMMARY ***
Total pot €0.14 | Rake €0 
Board [6s Td 5h 9s 7s]
Seat 1: OMGWOLFX (button) folded before Flop (didn't bet)
Seat 2: enrico197163 (small blind) showed [Kh As] and won (€0.14) with high card Ace
Seat 3: OSPREYSTORM (big blind) folded before Flop
Seat 4: ADRIAN0_MEIS folded before Flop (didn't bet)
Seat 5: caduceus369 folded before Flop (didn't bet)
Seat 6: stfuplzudonk mucked [4c Ac]



PokerStars Zoom Hand #257984691541:  Hold'em No Limit (€0.01/€0.02) [ADM ID: M62BA304494E32ST] - 2025/10/03 19:20:53 CET [2025/10/03 13:20:53 ET]
Table 'Sirio' 6-max Seat #1 is the button
Seat 1: alibabba101 (€1.20 in chips) 
Seat 2: Ceribelli1705 (€0.68 in chips) 
Seat 3: Mary5issi (€3.23 in chips) 
Seat 4: pistaKKio23 (€5.47 in chips) 
Seat 5: ADRIAN0_MEIS (€2.59 in chips) 
Seat 6: caduceus369 (€3.37 in chips) 
Ceribelli1705: posts small blind €0.01
Mary5issi: posts big blind €0.02
*** HOLE CARDS ***
Dealt to caduceus369 [9c 3c]
pistaKKio23: folds 
ADRIAN0_MEIS: folds 
caduceus369: folds 
alibabba101: calls €0.02
Ceribelli1705: calls €0.01
Mary5issi: checks 
*** FLOP *** [Js Ts Qs]
Ceribelli1705: checks 
Mary5issi: checks 
alibabba101: checks 
*** TURN *** [Js Ts Qs] [9h]
Ceribelli1705: checks 
Mary5issi: checks 
alibabba101: checks 
*** RIVER *** [Js Ts Qs 9h] [Jd]
Ceribelli1705: checks 
Mary5issi: checks 
alibabba101: bets €0.02
Ceribelli1705: folds 
Mary5issi: folds 
Uncalled bet (€0.02) returned to alibabba101
alibabba101 collected €0.06 from pot
alibabba101: doesn't show hand 
*** SUMMARY ***
Total pot €0.06 | Rake €0 
Board [Js Ts Qs 9h Jd]
Seat 1: alibabba101 (button) collected (€0.06)
Seat 2: Ceribelli1705 (small blind) folded on the River
Seat 3: Mary5issi (big blind) folded on the River
Seat 4: pistaKKio23 folded before Flop (didn't bet)
Seat 5: ADRIAN0_MEIS folded before Flop (didn't bet)
Seat 6: caduceus369 folded before Flop (didn't bet)



PokerStars Zoom Hand #257984694087:  Hold'em No Limit (€0.01/€0.02) [ADM ID: M62BA304494E32ST] - 2025/10/03 19:21:06 CET [2025/10/03 13:21:06 ET]
Table 'Sirio' 6-max Seat #1 is the button
Seat 1: ADRIAN0_MEIS (€3.67 in chips) 
Seat 2: OSPREYSTORM (€1.83 in chips) 
Seat 3: caduceus369 (€3.37 in chips) 
Seat 4: kroll219 (€3.33 in chips) 
Seat 5: OMGWOLFX (€6.39 in chips) 
Seat 6: GanchanS7 (€2.12 in chips) 
OSPREYSTORM: posts small blind €0.01
caduceus369: posts big blind €0.02
*** HOLE CARDS ***
Dealt to caduceus369 [6s 5c]
kroll219: folds 
OMGWOLFX: folds 
GanchanS7: folds 
ADRIAN0_MEIS: raises €0.03 to €0.05
OSPREYSTORM: folds 
caduceus369: calls €0.03
*** FLOP *** [Kh Qs Td]
caduceus369: checks 
ADRIAN0_MEIS: bets €0.06
caduceus369: folds 
Uncalled bet (€0.06) returned to ADRIAN0_MEIS
ADRIAN0_MEIS collected €0.11 from pot
ADRIAN0_MEIS: doesn't show hand 
*** SUMMARY ***
Total pot €0.11 | Rake €0 
Board [Kh Qs Td]
Seat 1: ADRIAN0_MEIS (button) collected (€0.11)
Seat 2: OSPREYSTORM (small blind) folded before Flop
Seat 3: caduceus369 (big blind) folded on the Flop
Seat 4: kroll219 folded before Flop (didn't bet)
Seat 5: OMGWOLFX folded before Flop (didn't bet)
Seat 6: GanchanS7 folded before Flop (didn't bet)



PokerStars Zoom Hand #257984700189:  Hold'em No Limit (€0.01/€0.02) [ADM ID: M62BA304494E32ST] - 2025/10/03 19:21:37 CET [2025/10/03 13:21:37 ET]
Table 'Sirio' 6-max Seat #1 is the button
Seat 1: pistaKKio23 (€2.35 in chips) 
Seat 2: caduceus369 (€3.32 in chips) 
Seat 3: GanchanS7 (€3.76 in chips) 
Seat 4: rosanero674 (€1.97 in chips) 
Seat 5: nikolor (€3.43 in chips) 
Seat 6: Gabrielefante (€3.29 in chips) 
caduceus369: posts small blind €0.01
GanchanS7: posts big blind €0.02
*** HOLE CARDS ***
Dealt to caduceus369 [4h 5s]
rosanero674: folds 
nikolor: folds 
Gabrielefante: folds 
pistaKKio23: folds 
caduceus369: folds 
Uncalled bet (€0.01) returned to GanchanS7
GanchanS7 collected €0.02 from pot
GanchanS7: doesn't show hand 
*** SUMMARY ***
Total pot €0.02 | Rake €0 
Seat 1: pistaKKio23 (button) folded before Flop (didn't bet)
Seat 2: caduceus369 (small blind) folded before Flop
Seat 3: GanchanS7 (big blind) collected (€0.02)
Seat 4: rosanero674 folded before Flop (didn't bet)
Seat 5: nikolor folded before Flop (didn't bet)
Seat 6: Gabrielefante folded before Flop (didn't bet)



PokerStars Zoom Hand #257984701865:  Hold'em No Limit (€0.01/€0.02) [ADM ID: M62BA304494E32ST] - 2025/10/03 19:21:45 CET [2025/10/03 13:21:45 ET]
Table 'Sirio' 6-max Seat #1 is the button
Seat 1: caduceus369 (€3.31 in chips) 
Seat 2: nikolor (€3.43 in chips) 
Seat 3: pylonstrip (€3.67 in chips) 
Seat 4: Gabrielefante (€3.29 in chips) 
Seat 5: OMGWOLFX (€5.15 in chips) 
Seat 6: ADRIAN0_MEIS (€2.72 in chips) 
nikolor: posts small blind €0.01
pylonstrip: posts big blind €0.02
*** HOLE CARDS ***
Dealt to caduceus369 [6c Ad]
Gabrielefante: folds 
OMGWOLFX: folds 
ADRIAN0_MEIS: folds 
caduceus369: raises €0.02 to €0.04
nikolor: folds 
pylonstrip: folds 
Uncalled bet (€0.02) returned to caduceus369
caduceus369 collected €0.05 from pot
caduceus369: doesn't show hand 
*** SUMMARY ***
Total pot €0.05 | Rake €0 
Seat 1: caduceus369 (button) collected (€0.05)
Seat 2: nikolor (small blind) folded before Flop
Seat 3: pylonstrip (big blind) folded before Flop
Seat 4: Gabrielefante folded before Flop (didn't bet)
Seat 5: OMGWOLFX folded before Flop (didn't bet)
Seat 6: ADRIAN0_MEIS folded before Flop (didn't bet)



PokerStars Zoom Hand #257984706132:  Hold'em No Limit (€0.01/€0.02) [ADM ID: M62BA304494E32ST] - 2025/10/03 19:22:07 CET [2025/10/03 13:22:07 ET]
Table 'Sirio' 6-max Seat #1 is the button
Seat 1: pylonstrip (€3.65 in chips) 
Seat 2: pistaKKio23 (€2.35 in chips) 
Seat 3: Mary5issi (€3.14 in chips) 
Seat 4: OMGWOLFX (€12.37 in chips) 
Seat 5: nikolor (€2.44 in chips) 
Seat 6: caduceus369 (€3.34 in chips) 
pistaKKio23: posts small blind €0.01
Mary5issi: posts big blind €0.02
*** HOLE CARDS ***
Dealt to caduceus369 [8s Ad]
OMGWOLFX: folds 
nikolor: folds 
caduceus369: folds 
pylonstrip: folds 
pistaKKio23: calls €0.01
Mary5issi: checks 
*** FLOP *** [As Ks Qh]
pistaKKio23: checks 
Mary5issi: checks 
*** TURN *** [As Ks Qh] [9h]
pistaKKio23: checks 
Mary5issi: checks 
*** RIVER *** [As Ks Qh 9h] [Th]
pistaKKio23: bets €0.04
Mary5issi: folds 
Uncalled bet (€0.04) returned to pistaKKio23
pistaKKio23 collected €0.04 from pot
pistaKKio23: doesn't show hand 
*** SUMMARY ***
Total pot €0.04 | Rake €0 
Board [As Ks Qh 9h Th]
Seat 1: pylonstrip (button) folded before Flop (didn't bet)
Seat 2: pistaKKio23 (small blind) collected (€0.04)
Seat 3: Mary5issi (big blind) folded on the River
Seat 4: OMGWOLFX folded before Flop (didn't bet)
Seat 5: nikolor folded before Flop (didn't bet)
Seat 6: caduceus369 folded before Flop (didn't bet)



PokerStars Zoom Hand #257984709430:  Hold'em No Limit (€0.01/€0.02) [ADM ID: M62BA304494E32ST] - 2025/10/03 19:22:24 CET [2025/10/03 13:22:24 ET]
Table 'Sirio' 6-max Seat #1 is the button
Seat 1: OSPREYSTORM (€1.95 in chips) 
Seat 2: ADRIAN0_MEIS (€3.71 in chips) 
Seat 3: GanchanS7 (€2 in chips) 
Seat 4: caduceus369 (€3.34 in chips) 
Seat 5: pistaKKio23 (€3.16 in chips) 
Seat 6: stfuplzudonk (€1.79 in chips) 
ADRIAN0_MEIS: posts small blind €0.01
GanchanS7: posts big blind €0.02
*** HOLE CARDS ***
Dealt to caduceus369 [Kd Th]
caduceus369: folds 
pistaKKio23: folds 
stfuplzudonk: folds 
OSPREYSTORM: folds 
ADRIAN0_MEIS: raises €0.03 to €0.05
GanchanS7: folds 
Uncalled bet (€0.03) returned to ADRIAN0_MEIS
ADRIAN0_MEIS collected €0.04 from pot
ADRIAN0_MEIS: doesn't show hand 
*** SUMMARY ***
Total pot €0.04 | Rake €0 
Seat 1: OSPREYSTORM (button) folded before Flop (didn't bet)
Seat 2: ADRIAN0_MEIS (small blind) collected (€0.04)
Seat 3: GanchanS7 (big blind) folded before Flop
Seat 4: caduceus369 folded before Flop (didn't bet)
Seat 5: pistaKKio23 folded before Flop (didn't bet)
Seat 6: stfuplzudonk folded before Flop (didn't bet)



PokerStars Zoom Hand #257984708465:  Hold'em No Limit (€0.01/€0.02) [ADM ID: M62BA304494E32ST] - 2025/10/03 19:22:19 CET [2025/10/03 13:22:19 ET]
Table 'Sirio' 6-max Seat #1 is the button
Seat 1: stfuplzudonk (€4.74 in chips) 
Seat 2: rosanero674 (€1.95 in chips) 
Seat 3: OMGWOLFX (€12.37 in chips) 
Seat 4: enrico197163 (€1.12 in chips) 
Seat 5: caduceus369 (€3.34 in chips) 
Seat 6: OSPREYSTORM (€7.80 in chips) 
rosanero674: posts small blind €0.01
OMGWOLFX: posts big blind €0.02
*** HOLE CARDS ***
Dealt to caduceus369 [Jd 3s]
enrico197163: calls €0.02
caduceus369: folds 
OSPREYSTORM: folds 
stfuplzudonk: raises €0.06 to €0.08
rosanero674: calls €0.07
OMGWOLFX: folds 
enrico197163: calls €0.06
*** FLOP *** [3c Qd 3h]
rosanero674: checks 
enrico197163: checks 
stfuplzudonk: checks 
*** TURN *** [3c Qd 3h] [Qs]
rosanero674: checks 
enrico197163: checks 
stfuplzudonk: checks 
*** RIVER *** [3c Qd 3h Qs] [7s]
rosanero674: checks 
enrico197163: checks 
stfuplzudonk: checks 
*** SHOW DOWN ***
rosanero674: shows [6s 6d] (two pair, Queens and Sixes)
enrico197163: mucks hand 
stfuplzudonk: mucks hand 
rosanero674 collected €0.25 from pot
*** SUMMARY ***
Total pot €0.26 | Rake €0.01 
Board [3c Qd 3h Qs 7s]
Seat 1: stfuplzudonk (button) mucked [As Jc]
Seat 2: rosanero674 (small blind) showed [6s 6d] and won (€0.25) with two pair, Queens and Sixes
Seat 3: OMGWOLFX (big blind) folded before Flop
Seat 4: enrico197163 mucked [Kh 5s]
Seat 5: caduceus369 folded before Flop (didn't bet)
Seat 6: OSPREYSTORM folded before Flop (didn't bet)



PokerStars Zoom Hand #257984711139:  Hold'em No Limit (€0.01/€0.02) [ADM ID: M62BA304494E32ST] - 2025/10/03 19:22:33 CET [2025/10/03 13:22:33 ET]
Table 'Sirio' 6-max Seat #1 is the button
Seat 1: OMGWOLFX (€5.83 in chips) 
Seat 2: Maur2507 (€0.97 in chips) 
Seat 3: caduceus369 (€3.34 in chips) 
Seat 4: trillycata (€1.88 in chips) 
Seat 5: Katymirax (€0.53 in chips) 
Seat 6: OSPREYSTORM (€1.95 in chips) 
Maur2507: posts small blind €0.01
caduceus369: posts big blind €0.02
*** HOLE CARDS ***
Dealt to caduceus369 [8h 9c]
trillycata: folds 
Katymirax: folds 
OSPREYSTORM: folds 
OMGWOLFX: folds 
Maur2507: calls €0.01
caduceus369: checks 
*** FLOP *** [Ad Kc Ah]
Maur2507: checks 
caduceus369: bets €0.02
Maur2507: calls €0.02
*** TURN *** [Ad Kc Ah] [3s]
Maur2507: checks 
caduceus369: checks 
*** RIVER *** [Ad Kc Ah 3s] [4d]
Maur2507: checks 
caduceus369: bets €0.03
Maur2507: folds 
Uncalled bet (€0.03) returned to caduceus369
caduceus369 collected €0.08 from pot
caduceus369: doesn't show hand 
*** SUMMARY ***
Total pot €0.08 | Rake €0 
Board [Ad Kc Ah 3s 4d]
Seat 1: OMGWOLFX (button) folded before Flop (didn't bet)
Seat 2: Maur2507 (small blind) folded on the River
Seat 3: caduceus369 (big blind) collected (€0.08)
Seat 4: trillycata folded before Flop (didn't bet)
Seat 5: Katymirax folded before Flop (didn't bet)
Seat 6: OSPREYSTORM folded before Flop (didn't bet)



PokerStars Zoom Hand #257984722046:  Hold'em No Limit (€0.01/€0.02) [ADM ID: M62BA304494E32ST] - 2025/10/03 19:23:28 CET [2025/10/03 13:23:28 ET]
Table 'Sirio' 6-max Seat #1 is the button
Seat 1: Gabrielefante (€3.47 in chips) 
Seat 2: stfuplzudonk (€4.66 in chips) 
Seat 3: GanchanS7 (€3.62 in chips) 
Seat 4: pistaKKio23 (€5.45 in chips) 
Seat 5: OSPREYSTORM (€1.89 in chips) 
Seat 6: caduceus369 (€3.38 in chips) 
stfuplzudonk: posts small blind €0.01
GanchanS7: posts big blind €0.02
*** HOLE CARDS ***
Dealt to caduceus369 [4s Ac]
pistaKKio23: folds 
OSPREYSTORM: folds 
caduceus369: folds 
Gabrielefante: folds 
stfuplzudonk: folds 
Uncalled bet (€0.01) returned to GanchanS7
GanchanS7 collected €0.02 from pot
GanchanS7: doesn't show hand 
*** SUMMARY ***
Total pot €0.02 | Rake €0 
Seat 1: Gabrielefante (button) folded before Flop (didn't bet)
Seat 2: stfuplzudonk (small blind) folded before Flop
Seat 3: GanchanS7 (big blind) collected (€0.02)
Seat 4: pistaKKio23 folded before Flop (didn't bet)
Seat 5: OSPREYSTORM folded before Flop (didn't bet)
Seat 6: caduceus369 folded before Flop (didn't bet)



PokerStars Zoom Hand #257984724188:  Hold'em No Limit (€0.01/€0.02) [ADM ID: M62BA304494E32ST] - 2025/10/03 19:23:39 CET [2025/10/03 13:23:39 ET]
Table 'Sirio' 6-max Seat #1 is the button
Seat 1: pistaKKio23 (€5.45 in chips) 
Seat 2: caduceus369 (€3.38 in chips) 
Seat 3: OSPREYSTORM (€2.15 in chips) 
Seat 4: Gabrielefante (€3.47 in chips) 
Seat 5: Redpunch1978 (€1.13 in chips) 
Seat 6: alibabba101 (€1.96 in chips) 
caduceus369: posts small blind €0.01
OSPREYSTORM: posts big blind €0.02
*** HOLE CARDS ***
Dealt to caduceus369 [Jd As]
Gabrielefante: folds 
Redpunch1978: folds 
alibabba101: folds 
pistaKKio23: raises €0.04 to €0.06
caduceus369: calls €0.05
OSPREYSTORM: raises €0.24 to €0.30
pistaKKio23: folds 
caduceus369: folds 
Uncalled bet (€0.24) returned to OSPREYSTORM
OSPREYSTORM collected €0.18 from pot
OSPREYSTORM: doesn't show hand 
*** SUMMARY ***
Total pot €0.18 | Rake €0 
Seat 1: pistaKKio23 (button) folded before Flop
Seat 2: caduceus369 (small blind) folded before Flop
Seat 3: OSPREYSTORM (big blind) collected (€0.18)
Seat 4: Gabrielefante folded before Flop (didn't bet)
Seat 5: Redpunch1978 folded before Flop (didn't bet)
Seat 6: alibabba101 folded before Flop (didn't bet)



PokerStars Zoom Hand #257984732129:  Hold'em No Limit (€0.01/€0.02) [ADM ID: M62BA304494E32ST] - 2025/10/03 19:24:20 CET [2025/10/03 13:24:20 ET]
Table 'Sirio' 6-max Seat #1 is the button
Seat 1: caduceus369 (€3.32 in chips) 
Seat 2: stfuplzudonk (€2.03 in chips) 
Seat 3: GanchanS7 (€3.70 in chips) 
Seat 4: ADRIAN0_MEIS (€2.24 in chips) 
Seat 5: RRgalp (€5.22 in chips) 
Seat 6: Ceribelli1705 (€0.81 in chips) 
stfuplzudonk: posts small blind €0.01
GanchanS7: posts big blind €0.02
*** HOLE CARDS ***
Dealt to caduceus369 [2d 6c]
ADRIAN0_MEIS: folds 
RRgalp: folds 
Ceribelli1705: raises €0.02 to €0.04
caduceus369: folds 
stfuplzudonk: raises €0.12 to €0.16
GanchanS7: folds 
Ceribelli1705: folds 
Uncalled bet (€0.12) returned to stfuplzudonk
stfuplzudonk collected €0.10 from pot
stfuplzudonk: doesn't show hand 
*** SUMMARY ***
Total pot €0.10 | Rake €0 
Seat 1: caduceus369 (button) folded before Flop (didn't bet)
Seat 2: stfuplzudonk (small blind) collected (€0.10)
Seat 3: GanchanS7 (big blind) folded before Flop
Seat 4: ADRIAN0_MEIS folded before Flop (didn't bet)
Seat 5: RRgalp folded before Flop (didn't bet)
Seat 6: Ceribelli1705 folded before Flop



PokerStars Zoom Hand #257984733946:  Hold'em No Limit (€0.01/€0.02) [ADM ID: M62BA304494E32ST] - 2025/10/03 19:24:29 CET [2025/10/03 13:24:29 ET]
Table 'Sirio' 6-max Seat #1 is the button
Seat 1: pylonstrip (€3.45 in chips) 
Seat 2: ValenTom25 (€2 in chips) 
Seat 3: alibabba101 (€1.95 in chips) 
Seat 4: denali1108 (€1.56 in chips) 
Seat 5: caduceus369 (€3.32 in chips) 
Seat 6: Mary5issi (€3.04 in chips) 
ValenTom25: posts small blind €0.01
alibabba101: posts big blind €0.02
*** HOLE CARDS ***
Dealt to caduceus369 [7h Ts]
denali1108: folds 
caduceus369: folds 
Mary5issi: folds 
pylonstrip: raises €0.04 to €0.06
ValenTom25: calls €0.05
alibabba101: calls €0.04
*** FLOP *** [4h Jh 8s]
ValenTom25: bets €0.18
alibabba101: folds 
pylonstrip: folds 
Uncalled bet (€0.18) returned to ValenTom25
ValenTom25 collected €0.18 from pot
ValenTom25: doesn't show hand 
*** SUMMARY ***
Total pot €0.18 | Rake €0 
Board [4h Jh 8s]
Seat 1: pylonstrip (button) folded on the Flop
Seat 2: ValenTom25 (small blind) collected (€0.18)
Seat 3: alibabba101 (big blind) folded on the Flop
Seat 4: denali1108 folded before Flop (didn't bet)
Seat 5: caduceus369 folded before Flop (didn't bet)
Seat 6: Mary5issi folded before Flop (didn't bet)



PokerStars Zoom Hand #257984730393:  Hold'em No Limit (€0.01/€0.02) [ADM ID: M62BA304494E32ST] - 2025/10/03 19:24:11 CET [2025/10/03 13:24:11 ET]
Table 'Sirio' 6-max Seat #1 is the button
Seat 1: eleonora50 (€0.97 in chips) 
Seat 2: ADRIAN0_MEIS (€2.25 in chips) 
Seat 3: Mary5issi (€4.39 in chips) 
Seat 4: caduceus369 (€3.32 in chips) 
Seat 5: GanchanS7 (€3.70 in chips) 
Seat 6: kroll219 (€3.32 in chips) 
ADRIAN0_MEIS: posts small blind €0.01
Mary5issi: posts big blind €0.02
*** HOLE CARDS ***
Dealt to caduceus369 [Ad 3s]
caduceus369: folds 
GanchanS7: folds 
kroll219: folds 
eleonora50: calls €0.02
ADRIAN0_MEIS: folds 
Mary5issi: checks 
*** FLOP *** [7c 6c Jc]
Mary5issi: checks 
eleonora50: checks 
*** TURN *** [7c 6c Jc] [5d]
Mary5issi: checks 
eleonora50: checks 
*** RIVER *** [7c 6c Jc 5d] [Kh]
Mary5issi: checks 
eleonora50: bets €0.02
Mary5issi: folds 
Uncalled bet (€0.02) returned to eleonora50
eleonora50 collected €0.05 from pot
eleonora50: doesn't show hand 
*** SUMMARY ***
Total pot €0.05 | Rake €0 
Board [7c 6c Jc 5d Kh]
Seat 1: eleonora50 (button) collected (€0.05)
Seat 2: ADRIAN0_MEIS (small blind) folded before Flop
Seat 3: Mary5issi (big blind) folded on the River
Seat 4: caduceus369 folded before Flop (didn't bet)
Seat 5: GanchanS7 folded before Flop (didn't bet)
Seat 6: kroll219 folded before Flop (didn't bet)



PokerStars Zoom Hand #257984734676:  Hold'em No Limit (€0.01/€0.02) [ADM ID: M62BA304494E32ST] - 2025/10/03 19:24:33 CET [2025/10/03 13:24:33 ET]
Table 'Sirio' 6-max Seat #1 is the button
Seat 1: ADRIAN0_MEIS (€2.81 in chips) 
Seat 2: jolli180 (€1.48 in chips) 
Seat 3: denali1108 (€1.56 in chips) 
Seat 4: caduceus369 (€3.32 in chips) 
Seat 5: Mary5issi (€3.04 in chips) 
Seat 6: nikolor (€3.43 in chips) 
jolli180: posts small blind €0.01
denali1108: posts big blind €0.02
*** HOLE CARDS ***
Dealt to caduceus369 [8h Jc]
caduceus369: folds 
Mary5issi: raises €0.02 to €0.04
nikolor: raises €0.11 to €0.15
ADRIAN0_MEIS: calls €0.15
jolli180: folds 
denali1108: folds 
Mary5issi: calls €0.11
*** FLOP *** [2c 8s 5c]
Mary5issi: checks 
nikolor: bets €0.46
ADRIAN0_MEIS: folds 
Mary5issi: folds 
Uncalled bet (€0.46) returned to nikolor
nikolor collected €0.46 from pot
nikolor: doesn't show hand 
*** SUMMARY ***
Total pot €0.48 | Rake €0.02 
Board [2c 8s 5c]
Seat 1: ADRIAN0_MEIS (button) folded on the Flop
Seat 2: jolli180 (small blind) folded before Flop
Seat 3: denali1108 (big blind) folded before Flop
Seat 4: caduceus369 folded before Flop (didn't bet)
Seat 5: Mary5issi folded on the Flop
Seat 6: nikolor collected (€0.46)



PokerStars Zoom Hand #257984735733:  Hold'em No Limit (€0.01/€0.02) [ADM ID: M62BA304494E32ST] - 2025/10/03 19:24:38 CET [2025/10/03 13:24:38 ET]
Table 'Sirio' 6-max Seat #1 is the button
Seat 1: Redpunch1978 (€1.11 in chips) 
Seat 2: franky65124 (€1.66 in chips) 
Seat 3: caduceus369 (€3.32 in chips) 
Seat 4: trillycata (€2.06 in chips) 
Seat 5: stfuplzudonk (€1.34 in chips) 
Seat 6: OSPREYSTORM (€2.30 in chips) 
franky65124: posts small blind €0.01
caduceus369: posts big blind €0.02
*** HOLE CARDS ***
Dealt to caduceus369 [9h 7s]
trillycata: folds 
stfuplzudonk: folds 
OSPREYSTORM: folds 
Redpunch1978: raises €0.02 to €0.04
franky65124: calls €0.03
caduceus369: calls €0.02
*** FLOP *** [9s 7h 2d]
franky65124: checks 
caduceus369: checks 
Redpunch1978: bets €0.06
franky65124: folds 
caduceus369: raises €0.06 to €0.12
Redpunch1978: calls €0.06
*** TURN *** [9s 7h 2d] [6c]
caduceus369: checks 
Redpunch1978: bets €0.18
caduceus369: calls €0.18
*** RIVER *** [9s 7h 2d 6c] [2s]
caduceus369: bets €0.35
Redpunch1978: folds 
Uncalled bet (€0.35) returned to caduceus369
caduceus369 collected €0.69 from pot
caduceus369: doesn't show hand 
*** SUMMARY ***
Total pot €0.72 | Rake €0.03 
Board [9s 7h 2d 6c 2s]
Seat 1: Redpunch1978 (button) folded on the River
Seat 2: franky65124 (small blind) folded on the Flop
Seat 3: caduceus369 (big blind) collected (€0.69)
Seat 4: trillycata folded before Flop (didn't bet)
Seat 5: stfuplzudonk folded before Flop (didn't bet)
Seat 6: OSPREYSTORM folded before Flop (didn't bet)



PokerStars Zoom Hand #257984751729:  Hold'em No Limit (€0.01/€0.02) [ADM ID: M62BA304494E32ST] - 2025/10/03 19:26:00 CET [2025/10/03 13:26:00 ET]
Table 'Sirio' 6-max Seat #1 is the button
Seat 1: caduceus369 (€3.66 in chips) 
Seat 2: RRgalp (€5.34 in chips) 
Seat 3: stfuplzudonk (€1.20 in chips) 
Seat 4: eleonora50 (€0.97 in chips) 
Seat 5: pistaKKio23 (€3.30 in chips) 
Seat 6: pylonstrip (€3.14 in chips) 
RRgalp: posts small blind €0.01
stfuplzudonk: posts big blind €0.02
*** HOLE CARDS ***
Dealt to caduceus369 [6h 4c]
eleonora50: calls €0.02
pistaKKio23 has timed out
pistaKKio23: folds 
pylonstrip: folds 
caduceus369: folds 
RRgalp: folds 
stfuplzudonk: checks 
*** FLOP *** [5d Qs Td]
stfuplzudonk: checks 
eleonora50: bets €0.02
stfuplzudonk: folds 
Uncalled bet (€0.02) returned to eleonora50
eleonora50 collected €0.05 from pot
eleonora50: doesn't show hand 
*** SUMMARY ***
Total pot €0.05 | Rake €0 
Board [5d Qs Td]
Seat 1: caduceus369 (button) folded before Flop (didn't bet)
Seat 2: RRgalp (small blind) folded before Flop
Seat 3: stfuplzudonk (big blind) folded on the Flop
Seat 4: eleonora50 collected (€0.05)
Seat 5: pistaKKio23 folded before Flop (didn't bet)
Seat 6: pylonstrip folded before Flop (didn't bet)



PokerStars Zoom Hand #257984752457:  Hold'em No Limit (€0.01/€0.02) [ADM ID: M62BA304494E32ST] - 2025/10/03 19:26:04 CET [2025/10/03 13:26:04 ET]
Table 'Sirio' 6-max Seat #1 is the button
Seat 1: GanchanS7 (€2 in chips) 
Seat 2: Ceribelli1705 (€0.65 in chips) 
Seat 3: rosanero674 (€2.29 in chips) 
Seat 4: caduceus369 (€3.66 in chips) 
Seat 5: ADRIAN0_MEIS (€3.92 in chips) 
Seat 6: RRgalp (€5.33 in chips) 
Ceribelli1705: posts small blind €0.01
rosanero674: posts big blind €0.02
*** HOLE CARDS ***
Dealt to caduceus369 [4c 2h]
caduceus369: folds 
ADRIAN0_MEIS: folds 
RRgalp: folds 
GanchanS7: raises €0.02 to €0.04
Ceribelli1705: calls €0.03
rosanero674: folds 
*** FLOP *** [Ad Tc Th]
Ceribelli1705: checks 
GanchanS7: checks 
*** TURN *** [Ad Tc Th] [Qh]
Ceribelli1705: bets €0.06
GanchanS7: raises €0.19 to €0.25
Ceribelli1705: calls €0.19
*** RIVER *** [Ad Tc Th Qh] [Kh]
Ceribelli1705: bets €0.20
GanchanS7: folds 
Uncalled bet (€0.20) returned to Ceribelli1705
Ceribelli1705 collected €0.57 from pot
Ceribelli1705: doesn't show hand 
*** SUMMARY ***
Total pot €0.60 | Rake €0.03 
Board [Ad Tc Th Qh Kh]
Seat 1: GanchanS7 (button) folded on the River
Seat 2: Ceribelli1705 (small blind) collected (€0.57)
Seat 3: rosanero674 (big blind) folded before Flop
Seat 4: caduceus369 folded before Flop (didn't bet)
Seat 5: ADRIAN0_MEIS folded before Flop (didn't bet)
Seat 6: RRgalp folded before Flop (didn't bet)



PokerStars Zoom Hand #257984749879:  Hold'em No Limit (€0.01/€0.02) [ADM ID: M62BA304494E32ST] - 2025/10/03 19:25:50 CET [2025/10/03 13:25:50 ET]
Table 'Sirio' 6-max Seat #1 is the button
Seat 1: kroll219 (€3.16 in chips) 
Seat 2: caduceus369 (€3.67 in chips) 
Seat 3: OSPREYSTORM (€2.30 in chips) 
Seat 4: Redpunch1978 (€0.76 in chips) 
Seat 5: Teriferro (€0.79 in chips) 
Seat 6: denali1108 (€1.71 in chips) 
caduceus369: posts small blind €0.01
OSPREYSTORM: posts big blind €0.02
*** HOLE CARDS ***
Dealt to caduceus369 [3h 4h]
Redpunch1978: folds 
Teriferro: folds 
denali1108: folds 
kroll219: raises €0.02 to €0.04
caduceus369: folds 
OSPREYSTORM: calls €0.02
*** FLOP *** [Kc 9h 5h]
OSPREYSTORM: checks 
kroll219: checks 
*** TURN *** [Kc 9h 5h] [2s]
OSPREYSTORM: bets €0.05
kroll219: folds 
Uncalled bet (€0.05) returned to OSPREYSTORM
OSPREYSTORM collected €0.09 from pot
OSPREYSTORM: doesn't show hand 
*** SUMMARY ***
Total pot €0.09 | Rake €0 
Board [Kc 9h 5h 2s]
Seat 1: kroll219 (button) folded on the Turn
Seat 2: caduceus369 (small blind) folded before Flop
Seat 3: OSPREYSTORM (big blind) collected (€0.09)
Seat 4: Redpunch1978 folded before Flop (didn't bet)
Seat 5: Teriferro folded before Flop (didn't bet)
Seat 6: denali1108 folded before Flop (didn't bet)



PokerStars Zoom Hand #257984759089:  Hold'em No Limit (€0.01/€0.02) [ADM ID: M62BA304494E32ST] - 2025/10/03 19:26:38 CET [2025/10/03 13:26:38 ET]
Table 'Sirio' 6-max Seat #1 is the button
Seat 1: caduceus369 (€3.65 in chips) 
Seat 2: eleonora50 (€1 in chips) 
Seat 3: Redpunch1978 (€0.73 in chips) 
Seat 4: ADRIAN0_MEIS (€3.91 in chips) 
Seat 5: pistaKKio23 (€3.30 in chips) 
Seat 6: GanchanS7 (€3.63 in chips) 
eleonora50: posts small blind €0.01
Redpunch1978: posts big blind €0.02
*** HOLE CARDS ***
Dealt to caduceus369 [Qh 7h]
ADRIAN0_MEIS: folds 
pistaKKio23: raises €0.02 to €0.04
GanchanS7: folds 
caduceus369: folds 
eleonora50: folds 
Redpunch1978: folds 
Uncalled bet (€0.02) returned to pistaKKio23
pistaKKio23 collected €0.05 from pot
pistaKKio23: doesn't show hand 
*** SUMMARY ***
Total pot €0.05 | Rake €0 
Seat 1: caduceus369 (button) folded before Flop (didn't bet)
Seat 2: eleonora50 (small blind) folded before Flop
Seat 3: Redpunch1978 (big blind) folded before Flop
Seat 4: ADRIAN0_MEIS folded before Flop (didn't bet)
Seat 5: pistaKKio23 collected (€0.05)
Seat 6: GanchanS7 folded before Flop (didn't bet)



PokerStars Zoom Hand #257984761368:  Hold'em No Limit (€0.01/€0.02) [ADM ID: M62BA304494E32ST] - 2025/10/03 19:26:50 CET [2025/10/03 13:26:50 ET]
Table 'Sirio' 6-max Seat #1 is the button
Seat 1: ADRIAN0_MEIS (€2 in chips) 
Seat 2: Mary5issi (€2.94 in chips) 
Seat 3: GanchanS7 (€3.63 in chips) 
Seat 4: pistaKKio23 (€5.17 in chips) 
Seat 5: caduceus369 (€3.65 in chips) 
Seat 6: Katymirax (€1.12 in chips) 
Mary5issi: posts small blind €0.01
GanchanS7: posts big blind €0.02
*** HOLE CARDS ***
Dealt to caduceus369 [Td Qd]
pistaKKio23: folds 
caduceus369: raises €0.04 to €0.06
Katymirax: folds 
ADRIAN0_MEIS: folds 
Mary5issi: folds 
GanchanS7: folds 
Uncalled bet (€0.04) returned to caduceus369
caduceus369 collected €0.05 from pot
caduceus369: doesn't show hand 
*** SUMMARY ***
Total pot €0.05 | Rake €0 
Seat 1: ADRIAN0_MEIS (button) folded before Flop (didn't bet)
Seat 2: Mary5issi (small blind) folded before Flop
Seat 3: GanchanS7 (big blind) folded before Flop
Seat 4: pistaKKio23 folded before Flop (didn't bet)
Seat 5: caduceus369 collected (€0.05)
Seat 6: Katymirax folded before Flop (didn't bet)



PokerStars Zoom Hand #257984753445:  Hold'em No Limit (€0.01/€0.02) [ADM ID: M62BA304494E32ST] - 2025/10/03 19:26:09 CET [2025/10/03 13:26:09 ET]
Table 'Sirio' 6-max Seat #1 is the button
Seat 1: ADRIAN0_MEIS (€2.34 in chips) 
Seat 2: ValenTom25 (€2.10 in chips) 
Seat 3: ceramista17 (€1.66 in chips) 
Seat 4: nikolor (€4.13 in chips) 
Seat 5: OSPREYSTORM (€2.22 in chips) 
Seat 6: caduceus369 (€3.66 in chips) 
ValenTom25: posts small blind €0.01
ceramista17: posts big blind €0.02
*** HOLE CARDS ***
Dealt to caduceus369 [Qh 3h]
nikolor: folds 
OSPREYSTORM: raises €0.04 to €0.06
caduceus369: folds 
ADRIAN0_MEIS: folds 
ValenTom25: folds 
ceramista17: calls €0.04
*** FLOP *** [7s 2d 8h]
ceramista17: bets €0.06
OSPREYSTORM: calls €0.06
*** TURN *** [7s 2d 8h] [8d]
ceramista17: bets €0.06
OSPREYSTORM: calls €0.06
*** RIVER *** [7s 2d 8h 8d] [9s]
ceramista17: bets €0.08
OSPREYSTORM: raises €0.22 to €0.30
ceramista17: calls €0.22
*** SHOW DOWN ***
OSPREYSTORM: shows [8c Ac] (three of a kind, Eights)
ceramista17: mucks hand 
OSPREYSTORM collected €0.92 from pot
*** SUMMARY ***
Total pot €0.97 | Rake €0.05 
Board [7s 2d 8h 8d 9s]
Seat 1: ADRIAN0_MEIS (button) folded before Flop (didn't bet)
Seat 2: ValenTom25 (small blind) folded before Flop
Seat 3: ceramista17 (big blind) mucked [9d 7c]
Seat 4: nikolor folded before Flop (didn't bet)
Seat 5: OSPREYSTORM showed [8c Ac] and won (€0.92) with three of a kind, Eights
Seat 6: caduceus369 folded before Flop (didn't bet)



PokerStars Zoom Hand #257984755611:  Hold'em No Limit (€0.01/€0.02) [ADM ID: M62BA304494E32ST] - 2025/10/03 19:26:20 CET [2025/10/03 13:26:20 ET]
Table 'Sirio' 6-max Seat #1 is the button
Seat 1: pistaKKio23 (€3.79 in chips) 
Seat 2: caduceus369 (€3.66 in chips) 
Seat 3: franky65124 (€1.88 in chips) 
Seat 4: trillycata (€2.20 in chips) 
Seat 5: Redpunch1978 (€0.70 in chips) 
Seat 6: nikolor (€4.13 in chips) 
caduceus369: posts small blind €0.01
franky65124: posts big blind €0.02
*** HOLE CARDS ***
Dealt to caduceus369 [9c Kc]
trillycata: calls €0.02
Redpunch1978: folds 
nikolor: raises €0.04 to €0.06
pistaKKio23: raises €0.17 to €0.23
caduceus369: folds 
franky65124: calls €0.21
trillycata: calls €0.21
nikolor: folds 
*** FLOP *** [7h 2h Td]
franky65124: checks 
trillycata: bets €0.22
pistaKKio23: raises €3.34 to €3.56 and is all-in
franky65124: calls €1.65 and is all-in
trillycata: calls €1.75 and is all-in
Uncalled bet (€1.59) returned to pistaKKio23
*** TURN *** [7h 2h Td] [Jh]
*** RIVER *** [7h 2h Td Jh] [6s]
*** SHOW DOWN ***
trillycata: shows [Qd Qc] (a pair of Queens)
pistaKKio23: shows [Ac Ad] (a pair of Aces)
pistaKKio23 collected €0.61 from side pot
franky65124: shows [Ah As] (a pair of Aces)
franky65124 collected €2.70 from main pot
pistaKKio23 collected €2.70 from main pot
*** SUMMARY ***
Total pot €6.35 Main pot €5.40. Side pot €0.61. | Rake €0.34 
Board [7h 2h Td Jh 6s]
Seat 1: pistaKKio23 (button) showed [Ac Ad] and won (€3.31) with a pair of Aces
Seat 2: caduceus369 (small blind) folded before Flop
Seat 3: franky65124 (big blind) showed [Ah As] and won (€2.70) with a pair of Aces
Seat 4: trillycata showed [Qd Qc] and lost with a pair of Queens
Seat 5: Redpunch1978 folded before Flop (didn't bet)
Seat 6: nikolor folded before Flop



PokerStars Zoom Hand #257984764346:  Hold'em No Limit (€0.01/€0.02) [ADM ID: M62BA304494E32ST] - 2025/10/03 19:27:05 CET [2025/10/03 13:27:05 ET]
Table 'Sirio' 6-max Seat #1 is the button
Seat 1: denali1108 (€2 in chips) 
Seat 2: Gabrielefante (€3.37 in chips) 
Seat 3: caduceus369 (€3.68 in chips) 
Seat 4: OSPREYSTORM (€8.33 in chips) 
Seat 5: ADRIAN0_MEIS (€2 in chips) 
Seat 6: Lelesssss (€1.97 in chips) 
Gabrielefante: posts small blind €0.01
caduceus369: posts big blind €0.02
*** HOLE CARDS ***
Dealt to caduceus369 [6h 3c]
OSPREYSTORM: folds 
ADRIAN0_MEIS: folds 
Lelesssss: folds 
denali1108: raises €0.02 to €0.04
Gabrielefante: calls €0.03
caduceus369: folds 
*** FLOP *** [2d 5c 7s]
Gabrielefante: checks 
denali1108: bets €0.04
Gabrielefante: calls €0.04
*** TURN *** [2d 5c 7s] [3h]
Gabrielefante: checks 
denali1108: bets €0.09
Gabrielefante: folds 
Uncalled bet (€0.09) returned to denali1108
denali1108 collected €0.18 from pot
denali1108: doesn't show hand 
*** SUMMARY ***
Total pot €0.18 | Rake €0 
Board [2d 5c 7s 3h]
Seat 1: denali1108 (button) collected (€0.18)
Seat 2: Gabrielefante (small blind) folded on the Turn
Seat 3: caduceus369 (big blind) folded before Flop
Seat 4: OSPREYSTORM folded before Flop (didn't bet)
Seat 5: ADRIAN0_MEIS folded before Flop (didn't bet)
Seat 6: Lelesssss folded before Flop (didn't bet)



PokerStars Zoom Hand #257984768090:  Hold'em No Limit (€0.01/€0.02) [ADM ID: M62BA304494E32ST] - 2025/10/03 19:27:24 CET [2025/10/03 13:27:24 ET]
Table 'Sirio' 6-max Seat #1 is the button
Seat 1: rosanero674 (€2.19 in chips) 
Seat 2: Maur2507 (€0.88 in chips) 
Seat 3: ADRIAN0_MEIS (€2.35 in chips) 
Seat 4: caduceus369 (€3.66 in chips) 
Seat 5: eleonora50 (€1.02 in chips) 
Seat 6: GanchanS7 (€3.62 in chips) 
Maur2507: posts small blind €0.01
ADRIAN0_MEIS: posts big blind €0.02
*** HOLE CARDS ***
Dealt to caduceus369 [6h Ah]
caduceus369: folds 
eleonora50: folds 
GanchanS7: folds 
rosanero674: folds 
Maur2507: calls €0.01
ADRIAN0_MEIS: raises €0.05 to €0.07
Maur2507: calls €0.05
*** FLOP *** [2s Ac Td]
Maur2507: checks 
ADRIAN0_MEIS: bets €0.08
Maur2507: folds 
Uncalled bet (€0.08) returned to ADRIAN0_MEIS
ADRIAN0_MEIS collected €0.14 from pot
ADRIAN0_MEIS: doesn't show hand 
*** SUMMARY ***
Total pot €0.14 | Rake €0 
Board [2s Ac Td]
Seat 1: rosanero674 (button) folded before Flop (didn't bet)
Seat 2: Maur2507 (small blind) folded on the Flop
Seat 3: ADRIAN0_MEIS (big blind) collected (€0.14)
Seat 4: caduceus369 folded before Flop (didn't bet)
Seat 5: eleonora50 folded before Flop (didn't bet)
Seat 6: GanchanS7 folded before Flop (didn't bet)



PokerStars Zoom Hand #257984767147:  Hold'em No Limit (€0.01/€0.02) [ADM ID: M62BA304494E32ST] - 2025/10/03 19:27:19 CET [2025/10/03 13:27:19 ET]
Table 'Sirio' 6-max Seat #1 is the button
Seat 1: GanchanS7 (€3.62 in chips) 
Seat 2: stagniarihd (€1.53 in chips) 
Seat 3: alibabba101 (€1.88 in chips) 
Seat 4: Ceribelli1705 (€0.93 in chips) 
Seat 5: OSPREYSTORM (€8.33 in chips) 
Seat 6: caduceus369 (€3.66 in chips) 
stagniarihd: posts small blind €0.01
alibabba101: posts big blind €0.02
*** HOLE CARDS ***
Dealt to caduceus369 [5c 3s]
Ceribelli1705 is disconnected 
Ceribelli1705 has timed out while disconnected
Ceribelli1705: folds 
OSPREYSTORM: raises €0.04 to €0.06
caduceus369: folds 
GanchanS7: folds 
stagniarihd: folds 
alibabba101: calls €0.04
*** FLOP *** [2h 9d 2d]
alibabba101: checks 
OSPREYSTORM: checks 
*** TURN *** [2h 9d 2d] [Ts]
alibabba101: checks 
OSPREYSTORM: checks 
*** RIVER *** [2h 9d 2d Ts] [3c]
alibabba101: bets €0.02
OSPREYSTORM: folds 
Uncalled bet (€0.02) returned to alibabba101
alibabba101 collected €0.13 from pot
alibabba101: doesn't show hand 
*** SUMMARY ***
Total pot €0.13 | Rake €0 
Board [2h 9d 2d Ts 3c]
Seat 1: GanchanS7 (button) folded before Flop (didn't bet)
Seat 2: stagniarihd (small blind) folded before Flop
Seat 3: alibabba101 (big blind) collected (€0.13)
Seat 4: Ceribelli1705 folded before Flop (didn't bet)
Seat 5: OSPREYSTORM folded on the River
Seat 6: caduceus369 folded before Flop (didn't bet)



PokerStars Zoom Hand #257984769607:  Hold'em No Limit (€0.01/€0.02) [ADM ID: M62BA304494E32ST] - 2025/10/03 19:27:32 CET [2025/10/03 13:27:32 ET]
Table 'Sirio' 6-max Seat #1 is the button
Seat 1: eleonora50 (€1.02 in chips) 
Seat 2: jolli180 (€1.69 in chips) 
Seat 3: caduceus369 (€3.66 in chips) 
Seat 4: Katymirax (€1.06 in chips) 
Seat 5: GanchanS7 (€2.07 in chips) 
Seat 6: pistaKKio23 (€4.90 in chips) 
jolli180: posts small blind €0.01
caduceus369: posts big blind €0.02
*** HOLE CARDS ***
Dealt to caduceus369 [7h 7d]
Katymirax: folds 
GanchanS7: folds 
pistaKKio23: raises €0.02 to €0.04
eleonora50: folds 
jolli180: folds 
caduceus369: calls €0.02
*** FLOP *** [Qd 4h 9c]
caduceus369: checks 
pistaKKio23: bets €0.09
caduceus369: folds 
Uncalled bet (€0.09) returned to pistaKKio23
pistaKKio23 collected €0.09 from pot
pistaKKio23: doesn't show hand 
*** SUMMARY ***
Total pot €0.09 | Rake €0 
Board [Qd 4h 9c]
Seat 1: eleonora50 (button) folded before Flop (didn't bet)
Seat 2: jolli180 (small blind) folded before Flop
Seat 3: caduceus369 (big blind) folded on the Flop
Seat 4: Katymirax folded before Flop (didn't bet)
Seat 5: GanchanS7 folded before Flop (didn't bet)
Seat 6: pistaKKio23 collected (€0.09)



PokerStars Zoom Hand #257984776625:  Hold'em No Limit (€0.01/€0.02) [ADM ID: M62BA304494E32ST] - 2025/10/03 19:28:08 CET [2025/10/03 13:28:08 ET]
Table 'Sirio' 6-max Seat #1 is the button
Seat 1: ceramista17 (€1.15 in chips) 
Seat 2: stfuplzudonk (€1.19 in chips) 
Seat 3: eleonora50 (€1 in chips) 
Seat 4: pylonstrip (€3.04 in chips) 
Seat 5: caduceus369 (€3.62 in chips) 
Seat 6: pistaKKio23 (€3.30 in chips) 
stfuplzudonk: posts small blind €0.01
eleonora50: posts big blind €0.02
*** HOLE CARDS ***
Dealt to caduceus369 [5c Jh]
pylonstrip: folds 
caduceus369: folds 
pistaKKio23: folds 
ceramista17: raises €0.05 to €0.07
stfuplzudonk: folds 
eleonora50: folds 
Uncalled bet (€0.05) returned to ceramista17
ceramista17 collected €0.05 from pot
ceramista17: doesn't show hand 
*** SUMMARY ***
Total pot €0.05 | Rake €0 
Seat 1: ceramista17 (button) collected (€0.05)
Seat 2: stfuplzudonk (small blind) folded before Flop
Seat 3: eleonora50 (big blind) folded before Flop
Seat 4: pylonstrip folded before Flop (didn't bet)
Seat 5: caduceus369 folded before Flop (didn't bet)
Seat 6: pistaKKio23 folded before Flop (didn't bet)



PokerStars Zoom Hand #257984777396:  Hold'em No Limit (€0.01/€0.02) [ADM ID: M62BA304494E32ST] - 2025/10/03 19:28:12 CET [2025/10/03 13:28:12 ET]
Table 'Sirio' 6-max Seat #1 is the button
Seat 1: pistaKKio23 (€5.17 in chips) 
Seat 2: caduceus369 (€3.62 in chips) 
Seat 3: ValenTom25 (€1.94 in chips) 
Seat 4: Sararafusa11 (€3.59 in chips) 
Seat 5: ADRIAN0_MEIS (€2.42 in chips) 
Seat 6: OSPREYSTORM (€8.25 in chips) 
caduceus369: posts small blind €0.01
ValenTom25: posts big blind €0.02
*** HOLE CARDS ***
Dealt to caduceus369 [6h 4c]
Sararafusa11: folds 
ADRIAN0_MEIS: folds 
OSPREYSTORM: folds 
pistaKKio23: folds 
caduceus369: folds 
Uncalled bet (€0.01) returned to ValenTom25
ValenTom25 collected €0.02 from pot
ValenTom25: doesn't show hand 
*** SUMMARY ***
Total pot €0.02 | Rake €0 
Seat 1: pistaKKio23 (button) folded before Flop (didn't bet)
Seat 2: caduceus369 (small blind) folded before Flop
Seat 3: ValenTom25 (big blind) collected (€0.02)
Seat 4: Sararafusa11 folded before Flop (didn't bet)
Seat 5: ADRIAN0_MEIS folded before Flop (didn't bet)
Seat 6: OSPREYSTORM folded before Flop (didn't bet)



PokerStars Zoom Hand #257984779907:  Hold'em No Limit (€0.01/€0.02) [ADM ID: M62BA304494E32ST] - 2025/10/03 19:28:25 CET [2025/10/03 13:28:25 ET]
Table 'Sirio' 6-max Seat #1 is the button
Seat 1: mastromarty (€3.73 in chips) 
Seat 2: stfuplzudonk (€4.76 in chips) 
Seat 3: QUATTRODAME (€1.51 in chips) 
Seat 4: buscofan (€2 in chips) 
Seat 5: pistaKKio23 (€5.17 in chips) 
Seat 6: caduceus369 (€3.61 in chips) 
stfuplzudonk: posts small blind €0.01
QUATTRODAME: posts big blind €0.02
*** HOLE CARDS ***
Dealt to caduceus369 [6h Th]
buscofan: folds 
pistaKKio23: folds 
caduceus369: folds 
mastromarty: folds 
stfuplzudonk: raises €0.04 to €0.06
QUATTRODAME: folds 
Uncalled bet (€0.04) returned to stfuplzudonk
stfuplzudonk collected €0.04 from pot
stfuplzudonk: doesn't show hand 
*** SUMMARY ***
Total pot €0.04 | Rake €0 
Seat 1: mastromarty (button) folded before Flop (didn't bet)
Seat 2: stfuplzudonk (small blind) collected (€0.04)
Seat 3: QUATTRODAME (big blind) folded before Flop
Seat 4: buscofan folded before Flop (didn't bet)
Seat 5: pistaKKio23 folded before Flop (didn't bet)
Seat 6: caduceus369 folded before Flop (didn't bet)



PokerStars Zoom Hand #257984781166:  Hold'em No Limit (€0.01/€0.02) [ADM ID: M62BA304494E32ST] - 2025/10/03 19:28:31 CET [2025/10/03 13:28:31 ET]
Table 'Sirio' 6-max Seat #1 is the button
Seat 1: alibabba101 (€1.98 in chips) 
Seat 2: Lelesssss (€1.88 in chips) 
Seat 3: Teriferro (€1.01 in chips) 
Seat 4: OSPREYSTORM (€2.67 in chips) 
Seat 5: caduceus369 (€3.61 in chips) 
Seat 6: GanchanS7 (€2.05 in chips) 
Lelesssss: posts small blind €0.01
Teriferro: posts big blind €0.02
*** HOLE CARDS ***
Dealt to caduceus369 [Ah Kc]
OSPREYSTORM: folds 
caduceus369: raises €0.04 to €0.06
GanchanS7: folds 
alibabba101: folds 
Lelesssss: folds 
Teriferro: calls €0.04
*** FLOP *** [5h 7c 4s]
Teriferro: checks 
caduceus369: bets €0.04
Teriferro: calls €0.04
*** TURN *** [5h 7c 4s] [8c]
Teriferro: checks 
caduceus369: checks 
*** RIVER *** [5h 7c 4s 8c] [Kd]
Teriferro: checks 
caduceus369: bets €0.12
Teriferro: folds 
Uncalled bet (€0.12) returned to caduceus369
caduceus369 collected €0.20 from pot
caduceus369: doesn't show hand 
*** SUMMARY ***
Total pot €0.21 | Rake €0.01 
Board [5h 7c 4s 8c Kd]
Seat 1: alibabba101 (button) folded before Flop (didn't bet)
Seat 2: Lelesssss (small blind) folded before Flop
Seat 3: Teriferro (big blind) folded on the River
Seat 4: OSPREYSTORM folded before Flop (didn't bet)
Seat 5: caduceus369 collected (€0.20)
Seat 6: GanchanS7 folded before Flop (didn't bet)



PokerStars Zoom Hand #257984775844:  Hold'em No Limit (€0.01/€0.02) [ADM ID: M62BA304494E32ST] - 2025/10/03 19:28:04 CET [2025/10/03 13:28:04 ET]
Table 'Sirio' 6-max Seat #1 is the button
Seat 1: caduceus369 (€3.62 in chips) 
Seat 2: franky65124 (€2.68 in chips) 
Seat 3: ADRIAN0_MEIS (€2.02 in chips) 
Seat 4: jolli180 (€1.68 in chips) 
Seat 5: eleonora50 (€1 in chips) 
Seat 6: GanchanS7 (€3.69 in chips) 
franky65124: posts small blind €0.01
ADRIAN0_MEIS: posts big blind €0.02
*** HOLE CARDS ***
Dealt to caduceus369 [Js 4s]
jolli180: raises €0.02 to €0.04
eleonora50: folds 
GanchanS7: folds 
caduceus369: folds 
franky65124: calls €0.03
ADRIAN0_MEIS: raises €0.12 to €0.16
jolli180: calls €0.12
franky65124: folds 
*** FLOP *** [Td Qs 3s]
ADRIAN0_MEIS: bets €0.19
jolli180: calls €0.19
*** TURN *** [Td Qs 3s] [Th]
ADRIAN0_MEIS: checks 
jolli180: checks 
*** RIVER *** [Td Qs 3s Th] [6h]
ADRIAN0_MEIS: checks 
jolli180: bets €0.10
ADRIAN0_MEIS: calls €0.10
*** SHOW DOWN ***
jolli180: shows [Ac Jd] (a pair of Tens)
ADRIAN0_MEIS: shows [7c 7s] (two pair, Tens and Sevens)
ADRIAN0_MEIS collected €0.89 from pot
*** SUMMARY ***
Total pot €0.94 | Rake €0.05 
Board [Td Qs 3s Th 6h]
Seat 1: caduceus369 (button) folded before Flop (didn't bet)
Seat 2: franky65124 (small blind) folded before Flop
Seat 3: ADRIAN0_MEIS (big blind) showed [7c 7s] and won (€0.89) with two pair, Tens and Sevens
Seat 4: jolli180 showed [Ac Jd] and lost with a pair of Tens
Seat 5: eleonora50 folded before Flop (didn't bet)
Seat 6: GanchanS7 folded before Flop (didn't bet)



PokerStars Zoom Hand #257984788875:  Hold'em No Limit (€0.01/€0.02) [ADM ID: M62BA304494E32ST] - 2025/10/03 19:29:10 CET [2025/10/03 13:29:10 ET]
Table 'Sirio' 6-max Seat #1 is the button
Seat 1: Teriferro (€0.91 in chips) 
Seat 2: IKARO_3 (€1.98 in chips) 
Seat 3: Lelesssss (€1.87 in chips) 
Seat 4: caduceus369 (€3.71 in chips) 
Seat 5: Redpunch1978 (€0.53 in chips) 
Seat 6: franky65124 (€2.69 in chips) 
IKARO_3: posts small blind €0.01
Lelesssss: posts big blind €0.02
*** HOLE CARDS ***
Dealt to caduceus369 [7s 6s]
caduceus369: folds 
Redpunch1978: folds 
franky65124: calls €0.02
Teriferro: folds 
IKARO_3: folds 
Lelesssss: checks 
*** FLOP *** [8h 4s 9d]
Lelesssss: checks 
franky65124: checks 
*** TURN *** [8h 4s 9d] [6d]
Lelesssss: checks 
franky65124: checks 
*** RIVER *** [8h 4s 9d 6d] [9h]
Lelesssss: checks 
franky65124: checks 
*** SHOW DOWN ***
Lelesssss: shows [3s Qs] (a pair of Nines)
franky65124: shows [5h Qd] (a pair of Nines)
Lelesssss collected €0.03 from pot
franky65124 collected €0.02 from pot
*** SUMMARY ***
Total pot €0.05 | Rake €0 
Board [8h 4s 9d 6d 9h]
Seat 1: Teriferro (button) folded before Flop (didn't bet)
Seat 2: IKARO_3 (small blind) folded before Flop
Seat 3: Lelesssss (big blind) showed [3s Qs] and won (€0.03) with a pair of Nines
Seat 4: caduceus369 folded before Flop (didn't bet)
Seat 5: Redpunch1978 folded before Flop (didn't bet)
Seat 6: franky65124 showed [5h Qd] and won (€0.02) with a pair of Nines



PokerStars Zoom Hand #257984791659:  Hold'em No Limit (€0.01/€0.02) [ADM ID: M62BA304494E32ST] - 2025/10/03 19:29:25 CET [2025/10/03 13:29:25 ET]
Table 'Sirio' 6-max Seat #1 is the button
Seat 1: Redpunch1978 (€0.51 in chips) 
Seat 2: OSPREYSTORM (€8.30 in chips) 
Seat 3: caduceus369 (€3.71 in chips) 
Seat 4: GanchanS7 (€3.70 in chips) 
Seat 5: QUATTRODAME (€1.47 in chips) 
Seat 6: buscofan (€2.03 in chips) 
OSPREYSTORM: posts small blind €0.01
caduceus369: posts big blind €0.02
*** HOLE CARDS ***
Dealt to caduceus369 [8c Jd]
GanchanS7: folds 
QUATTRODAME: folds 
buscofan: raises €0.04 to €0.06
Redpunch1978: folds 
OSPREYSTORM: raises €0.18 to €0.24
caduceus369: folds 
buscofan: folds 
Uncalled bet (€0.18) returned to OSPREYSTORM
OSPREYSTORM collected €0.14 from pot
OSPREYSTORM: doesn't show hand 
*** SUMMARY ***
Total pot €0.14 | Rake €0 
Seat 1: Redpunch1978 (button) folded before Flop (didn't bet)
Seat 2: OSPREYSTORM (small blind) collected (€0.14)
Seat 3: caduceus369 (big blind) folded before Flop
Seat 4: GanchanS7 folded before Flop (didn't bet)
Seat 5: QUATTRODAME folded before Flop (didn't bet)
Seat 6: buscofan folded before Flop



PokerStars Zoom Hand #257984791136:  Hold'em No Limit (€0.01/€0.02) [ADM ID: M62BA304494E32ST] - 2025/10/03 19:29:22 CET [2025/10/03 13:29:22 ET]
Table 'Sirio' 6-max Seat #1 is the button
Seat 1: IKARO_3 (€1.97 in chips) 
Seat 2: ceramista17 (€1.14 in chips) 
Seat 3: rosanero674 (€2.02 in chips) 
Seat 4: Gabrielefante (€3.31 in chips) 
Seat 5: caduceus369 (€3.71 in chips) 
Seat 6: alibabba101 (€1.95 in chips) 
ceramista17: posts small blind €0.01
rosanero674: posts big blind €0.02
*** HOLE CARDS ***
Dealt to caduceus369 [5d Tc]
Gabrielefante: folds 
caduceus369: folds 
alibabba101: calls €0.02
IKARO_3: folds 
ceramista17: folds 
rosanero674: checks 
*** FLOP *** [5c Qd As]
rosanero674: checks 
alibabba101: checks 
*** TURN *** [5c Qd As] [6d]
rosanero674: checks 
alibabba101: checks 
*** RIVER *** [5c Qd As 6d] [2c]
rosanero674: checks 
alibabba101: checks 
*** SHOW DOWN ***
rosanero674: shows [Jh Ts] (high card Ace)
alibabba101: shows [9d Kd] (high card Ace - King kicker)
alibabba101 collected €0.05 from pot
*** SUMMARY ***
Total pot €0.05 | Rake €0 
Board [5c Qd As 6d 2c]
Seat 1: IKARO_3 (button) folded before Flop (didn't bet)
Seat 2: ceramista17 (small blind) folded before Flop
Seat 3: rosanero674 (big blind) showed [Jh Ts] and lost with high card Ace
Seat 4: Gabrielefante folded before Flop (didn't bet)
Seat 5: caduceus369 folded before Flop (didn't bet)
Seat 6: alibabba101 showed [9d Kd] and won (€0.05) with high card Ace



PokerStars Zoom Hand #257984794330:  Hold'em No Limit (€0.01/€0.02) [ADM ID: M62BA304494E32ST] - 2025/10/03 19:29:39 CET [2025/10/03 13:29:39 ET]
Table 'Sirio' 6-max Seat #1 is the button
Seat 1: IKARO_3 (€1.97 in chips) 
Seat 2: caduceus369 (€3.69 in chips) 
Seat 3: GanchanS7 (€2.04 in chips) 
Seat 4: franky65124 (€2.69 in chips) 
Seat 5: ValenTom25 (€1.87 in chips) 
Seat 6: Lelesssss (€1.88 in chips) 
caduceus369: posts small blind €0.01
GanchanS7: posts big blind €0.02
*** HOLE CARDS ***
Dealt to caduceus369 [8h Jh]
franky65124: calls €0.02
ValenTom25: raises €0.07 to €0.09
Lelesssss: folds 
IKARO_3: folds 
caduceus369: folds 
GanchanS7: folds 
franky65124: folds 
Uncalled bet (€0.07) returned to ValenTom25
ValenTom25 collected €0.07 from pot
ValenTom25: doesn't show hand 
*** SUMMARY ***
Total pot €0.07 | Rake €0 
Seat 1: IKARO_3 (button) folded before Flop (didn't bet)
Seat 2: caduceus369 (small blind) folded before Flop
Seat 3: GanchanS7 (big blind) folded before Flop
Seat 4: franky65124 folded before Flop
Seat 5: ValenTom25 collected (€0.07)
Seat 6: Lelesssss folded before Flop (didn't bet)



PokerStars Zoom Hand #257984796275:  Hold'em No Limit (€0.01/€0.02) [ADM ID: M62BA304494E32ST] - 2025/10/03 19:29:48 CET [2025/10/03 13:29:48 ET]
Table 'Sirio' 6-max Seat #1 is the button
Seat 1: caduceus369 (€3.68 in chips) 
Seat 2: Lelesssss (€1.88 in chips) 
Seat 3: kroll219 (€2.92 in chips) 
Seat 4: Redpunch1978 (€0.50 in chips) 
Seat 5: Katymirax (€1.05 in chips) 
Seat 6: GIacius (€2.05 in chips) 
Lelesssss: posts small blind €0.01
kroll219: posts big blind €0.02
*** HOLE CARDS ***
Dealt to caduceus369 [Ac 9c]
Redpunch1978: raises €0.04 to €0.06
Katymirax: folds 
GIacius: folds 
caduceus369: folds 
Lelesssss: folds 
kroll219: folds 
Uncalled bet (€0.04) returned to Redpunch1978
Redpunch1978 collected €0.05 from pot
Redpunch1978: doesn't show hand 
*** SUMMARY ***
Total pot €0.05 | Rake €0 
Seat 1: caduceus369 (button) folded before Flop (didn't bet)
Seat 2: Lelesssss (small blind) folded before Flop
Seat 3: kroll219 (big blind) folded before Flop
Seat 4: Redpunch1978 collected (€0.05)
Seat 5: Katymirax folded before Flop (didn't bet)
Seat 6: GIacius folded before Flop (didn't bet)



PokerStars Zoom Hand #257984800106:  Hold'em No Limit (€0.01/€0.02) [ADM ID: M62BA304494E32ST] - 2025/10/03 19:30:07 CET [2025/10/03 13:30:07 ET]
Table 'Sirio' 6-max Seat #1 is the button
Seat 1: GIacius (€2.03 in chips) 
Seat 2: rosanero674 (€2 in chips) 
Seat 3: GanchanS7 (€3.57 in chips) 
Seat 4: ADRIAN0_MEIS (€2.55 in chips) 
Seat 5: denali1108 (€1.91 in chips) 
Seat 6: caduceus369 (€3.68 in chips) 
rosanero674: posts small blind €0.01
GanchanS7: posts big blind €0.02
*** HOLE CARDS ***
Dealt to caduceus369 [6s 7c]
ADRIAN0_MEIS: folds 
denali1108: folds 
caduceus369: folds 
GIacius: folds 
rosanero674: folds 
Uncalled bet (€0.01) returned to GanchanS7
GanchanS7 collected €0.02 from pot
GanchanS7: doesn't show hand 
*** SUMMARY ***
Total pot €0.02 | Rake €0 
Seat 1: GIacius (button) folded before Flop (didn't bet)
Seat 2: rosanero674 (small blind) folded before Flop
Seat 3: GanchanS7 (big blind) collected (€0.02)
Seat 4: ADRIAN0_MEIS folded before Flop (didn't bet)
Seat 5: denali1108 folded before Flop (didn't bet)
Seat 6: caduceus369 folded before Flop (didn't bet)



PokerStars Zoom Hand #257984800759:  Hold'em No Limit (€0.01/€0.02) [ADM ID: M62BA304494E32ST] - 2025/10/03 19:30:10 CET [2025/10/03 13:30:10 ET]
Table 'Sirio' 6-max Seat #1 is the button
Seat 1: OSPREYSTORM (€8.39 in chips) 
Seat 2: GIacius (€2.03 in chips) 
Seat 3: caduceus369 (€3.68 in chips) 
Seat 4: IKARO_3 (€1.91 in chips) 
Seat 5: stfuplzudonk (€2.74 in chips) 
Seat 6: pistaKKio23 (€4.96 in chips) 
GIacius: posts small blind €0.01
caduceus369: posts big blind €0.02
*** HOLE CARDS ***
Dealt to caduceus369 [5h Th]
IKARO_3: folds 
stfuplzudonk: folds 
pistaKKio23: folds 
OSPREYSTORM: raises €0.04 to €0.06
GIacius: folds 
caduceus369: folds 
Uncalled bet (€0.04) returned to OSPREYSTORM
OSPREYSTORM collected €0.05 from pot
OSPREYSTORM: doesn't show hand 
*** SUMMARY ***
Total pot €0.05 | Rake €0 
Seat 1: OSPREYSTORM (button) collected (€0.05)
Seat 2: GIacius (small blind) folded before Flop
Seat 3: caduceus369 (big blind) folded before Flop
Seat 4: IKARO_3 folded before Flop (didn't bet)
Seat 5: stfuplzudonk folded before Flop (didn't bet)
Seat 6: pistaKKio23 folded before Flop (didn't bet)



PokerStars Zoom Hand #257984806485:  Hold'em No Limit (€0.01/€0.02) [ADM ID: M62BA304494E32ST] - 2025/10/03 19:30:39 CET [2025/10/03 13:30:39 ET]
Table 'Sirio' 6-max Seat #1 is the button
Seat 1: GanchanS7 (€3.58 in chips) 
Seat 2: IKARO_3 (€1.97 in chips) 
Seat 3: SidneyPrescott (€2 in chips) 
Seat 4: ADRIAN0_MEIS (€2.58 in chips) 
Seat 5: caduceus369 (€3.66 in chips) 
Seat 6: buscofan (€2.01 in chips) 
IKARO_3: posts small blind €0.01
SidneyPrescott: posts big blind €0.02
*** HOLE CARDS ***
Dealt to caduceus369 [Ad 2d]
ADRIAN0_MEIS: folds 
caduceus369: folds 
buscofan: raises €0.04 to €0.06
GanchanS7: folds 
IKARO_3: folds 
SidneyPrescott: folds 
Uncalled bet (€0.04) returned to buscofan
buscofan collected €0.05 from pot
buscofan: doesn't show hand 
*** SUMMARY ***
Total pot €0.05 | Rake €0 
Seat 1: GanchanS7 (button) folded before Flop (didn't bet)
Seat 2: IKARO_3 (small blind) folded before Flop
Seat 3: SidneyPrescott (big blind) folded before Flop
Seat 4: ADRIAN0_MEIS folded before Flop (didn't bet)
Seat 5: caduceus369 folded before Flop (didn't bet)
Seat 6: buscofan collected (€0.05)



PokerStars Zoom Hand #257984809191:  Hold'em No Limit (€0.01/€0.02) [ADM ID: M62BA304494E32ST] - 2025/10/03 19:30:52 CET [2025/10/03 13:30:52 ET]
Table 'Sirio' 6-max Seat #1 is the button
Seat 1: rosanero674 (€1.99 in chips) 
Seat 2: caduceus369 (€3.66 in chips) 
Seat 3: ADRIAN0_MEIS (€3.89 in chips) 
Seat 4: IKARO_3 (€1.89 in chips) 
Seat 5: pistaKKio23 (€3.33 in chips) 
Seat 6: denali1108 (€1.90 in chips) 
caduceus369: posts small blind €0.01
ADRIAN0_MEIS: posts big blind €0.02
*** HOLE CARDS ***
Dealt to caduceus369 [3c 5h]
IKARO_3: folds 
pistaKKio23: folds 
denali1108: folds 
rosanero674: raises €0.04 to €0.06
caduceus369: folds 
ADRIAN0_MEIS: folds 
Uncalled bet (€0.04) returned to rosanero674
rosanero674 collected €0.05 from pot
rosanero674: doesn't show hand 
*** SUMMARY ***
Total pot €0.05 | Rake €0 
Seat 1: rosanero674 (button) collected (€0.05)
Seat 2: caduceus369 (small blind) folded before Flop
Seat 3: ADRIAN0_MEIS (big blind) folded before Flop
Seat 4: IKARO_3 folded before Flop (didn't bet)
Seat 5: pistaKKio23 folded before Flop (didn't bet)
Seat 6: denali1108 folded before Flop (didn't bet)



PokerStars Zoom Hand #257984810089:  Hold'em No Limit (€0.01/€0.02) [ADM ID: M62BA304494E32ST] - 2025/10/03 19:30:57 CET [2025/10/03 13:30:57 ET]
Table 'Sirio' 6-max Seat #1 is the button
Seat 1: eleonora50 (€0.80 in chips) 
Seat 2: Teriferro (€0.85 in chips) 
Seat 3: LentaM3nte (€2.51 in chips) 
Seat 4: caduceus369 (€3.65 in chips) 
Seat 5: Lelesssss (€1.95 in chips) 
Seat 6: stfuplzudonk (€1.23 in chips) 
Teriferro: posts small blind €0.01
LentaM3nte: posts big blind €0.02
*** HOLE CARDS ***
Dealt to caduceus369 [7s Th]
caduceus369: folds 
Lelesssss: folds 
stfuplzudonk: raises €0.04 to €0.06
eleonora50: folds 
Teriferro: folds 
LentaM3nte: calls €0.04
*** FLOP *** [Kc Ac 7d]
LentaM3nte: bets €0.07
stfuplzudonk: folds 
Uncalled bet (€0.07) returned to LentaM3nte
LentaM3nte collected €0.13 from pot
LentaM3nte: doesn't show hand 
*** SUMMARY ***
Total pot €0.13 | Rake €0 
Board [Kc Ac 7d]
Seat 1: eleonora50 (button) folded before Flop (didn't bet)
Seat 2: Teriferro (small blind) folded before Flop
Seat 3: LentaM3nte (big blind) collected (€0.13)
Seat 4: caduceus369 folded before Flop (didn't bet)
Seat 5: Lelesssss folded before Flop (didn't bet)
Seat 6: stfuplzudonk folded on the Flop



PokerStars Zoom Hand #257984810881:  Hold'em No Limit (€0.01/€0.02) [ADM ID: M62BA304494E32ST] - 2025/10/03 19:31:01 CET [2025/10/03 13:31:01 ET]
Table 'Sirio' 6-max Seat #1 is the button
Seat 1: ValenTom25 (€0.94 in chips) 
Seat 2: OSPREYSTORM (€8.42 in chips) 
Seat 3: GanchanS7 (€3.58 in chips) 
Seat 4: caduceus369 (€3.65 in chips) 
Seat 5: denali1108 (€1.90 in chips) 
Seat 6: eleonora50 (€0.80 in chips) 
OSPREYSTORM: posts small blind €0.01
GanchanS7: posts big blind €0.02
*** HOLE CARDS ***
Dealt to caduceus369 [5s 8d]
caduceus369: folds 
denali1108: folds 
eleonora50: calls €0.02
ValenTom25: folds 
OSPREYSTORM: folds 
GanchanS7: checks 
*** FLOP *** [2s 4h Ks]
GanchanS7: checks 
eleonora50: checks 
*** TURN *** [2s 4h Ks] [6h]
GanchanS7: checks 
eleonora50: checks 
*** RIVER *** [2s 4h Ks 6h] [2c]
GanchanS7: checks 
eleonora50: checks 
*** SHOW DOWN ***
GanchanS7: shows [5d 7d] (a pair of Deuces)
eleonora50: shows [Tc Qs] (a pair of Deuces - King+Queen kicker)
eleonora50 collected €0.05 from pot
*** SUMMARY ***
Total pot €0.05 | Rake €0 
Board [2s 4h Ks 6h 2c]
Seat 1: ValenTom25 (button) folded before Flop (didn't bet)
Seat 2: OSPREYSTORM (small blind) folded before Flop
Seat 3: GanchanS7 (big blind) showed [5d 7d] and lost with a pair of Deuces
Seat 4: caduceus369 folded before Flop (didn't bet)
Seat 5: denali1108 folded before Flop (didn't bet)
Seat 6: eleonora50 showed [Tc Qs] and won (€0.05) with a pair of Deuces



PokerStars Zoom Hand #257984807867:  Hold'em No Limit (€0.01/€0.02) [ADM ID: M62BA304494E32ST] - 2025/10/03 19:30:46 CET [2025/10/03 13:30:46 ET]
Table 'Sirio' 6-max Seat #1 is the button
Seat 1: caduceus369 (€3.66 in chips) 
Seat 2: SidneyPrescott (€2.01 in chips) 
Seat 3: LuBrunu (€1.95 in chips) 
Seat 4: GIacius (€2.02 in chips) 
Seat 5: Gabrielefante (€3.42 in chips) 
Seat 6: GanchanS7 (€3.70 in chips) 
SidneyPrescott: posts small blind €0.01
LuBrunu: posts big blind €0.02
*** HOLE CARDS ***
Dealt to caduceus369 [Td 3s]
GIacius: raises €0.02 to €0.04
Gabrielefante: folds 
GanchanS7: folds 
caduceus369: folds 
SidneyPrescott: folds 
LuBrunu: calls €0.02
*** FLOP *** [7d 3h 2h]
LuBrunu: checks 
GIacius: checks 
*** TURN *** [7d 3h 2h] [8s]
LuBrunu: checks 
GIacius: bets €0.07
LuBrunu: folds 
Uncalled bet (€0.07) returned to GIacius
GIacius collected €0.09 from pot
GIacius: doesn't show hand 
*** SUMMARY ***
Total pot €0.09 | Rake €0 
Board [7d 3h 2h 8s]
Seat 1: caduceus369 (button) folded before Flop (didn't bet)
Seat 2: SidneyPrescott (small blind) folded before Flop
Seat 3: LuBrunu (big blind) folded on the Turn
Seat 4: GIacius collected (€0.09)
Seat 5: Gabrielefante folded before Flop (didn't bet)
Seat 6: GanchanS7 folded before Flop (didn't bet)



PokerStars Zoom Hand #257984812331:  Hold'em No Limit (€0.01/€0.02) [ADM ID: M62BA304494E32ST] - 2025/10/03 19:31:08 CET [2025/10/03 13:31:08 ET]
Table 'Sirio' 6-max Seat #1 is the button
Seat 1: SidneyPrescott (€2 in chips) 
Seat 2: ADRIAN0_MEIS (€2.58 in chips) 
Seat 3: trillycata (€0.87 in chips) 
Seat 4: caduceus369 (€3.65 in chips) 
Seat 5: OSPREYSTORM (€2.90 in chips) 
Seat 6: Teriferro (€0.84 in chips) 
ADRIAN0_MEIS: posts small blind €0.01
trillycata: posts big blind €0.02
*** HOLE CARDS ***
Dealt to caduceus369 [7c 8d]
caduceus369: folds 
OSPREYSTORM: folds 
Teriferro: raises €0.04 to €0.06
SidneyPrescott: folds 
ADRIAN0_MEIS: folds 
trillycata: calls €0.04
*** FLOP *** [Ts Ad 6h]
trillycata: checks 
Teriferro: bets €0.06
trillycata: folds 
Uncalled bet (€0.06) returned to Teriferro
Teriferro collected €0.13 from pot
Teriferro: doesn't show hand 
*** SUMMARY ***
Total pot €0.13 | Rake €0 
Board [Ts Ad 6h]
Seat 1: SidneyPrescott (button) folded before Flop (didn't bet)
Seat 2: ADRIAN0_MEIS (small blind) folded before Flop
Seat 3: trillycata (big blind) folded on the Flop
Seat 4: caduceus369 folded before Flop (didn't bet)
Seat 5: OSPREYSTORM folded before Flop (didn't bet)
Seat 6: Teriferro collected (€0.13)



PokerStars Zoom Hand #257984811691:  Hold'em No Limit (€0.01/€0.02) [ADM ID: M62BA304494E32ST] - 2025/10/03 19:31:05 CET [2025/10/03 13:31:05 ET]
Table 'Sirio' 6-max Seat #1 is the button
Seat 1: stfuplzudonk (€2.51 in chips) 
Seat 2: ValenTom25 (€0.94 in chips) 
Seat 3: denali1108 (€1.90 in chips) 
Seat 4: juzam01 (€1.97 in chips) 
Seat 5: GIacius (€2.20 in chips) 
Seat 6: caduceus369 (€3.65 in chips) 
ValenTom25: posts small blind €0.01
denali1108: posts big blind €0.02
*** HOLE CARDS ***
Dealt to caduceus369 [6d Js]
juzam01: folds 
GIacius: folds 
caduceus369: folds 
stfuplzudonk: raises €0.02 to €0.04
ValenTom25: calls €0.03
denali1108: calls €0.02
*** FLOP *** [2s 2d Kd]
ValenTom25: checks 
denali1108: checks 
stfuplzudonk: bets €0.06
ValenTom25: raises €0.12 to €0.18
denali1108: folds 
stfuplzudonk: folds 
Uncalled bet (€0.12) returned to ValenTom25
ValenTom25 collected €0.23 from pot
ValenTom25: doesn't show hand 
*** SUMMARY ***
Total pot €0.24 | Rake €0.01 
Board [2s 2d Kd]
Seat 1: stfuplzudonk (button) folded on the Flop
Seat 2: ValenTom25 (small blind) collected (€0.23)
Seat 3: denali1108 (big blind) folded on the Flop
Seat 4: juzam01 folded before Flop (didn't bet)
Seat 5: GIacius folded before Flop (didn't bet)
Seat 6: caduceus369 folded before Flop (didn't bet)



PokerStars Zoom Hand #257984812896:  Hold'em No Limit (€0.01/€0.02) [ADM ID: M62BA304494E32ST] - 2025/10/03 19:31:11 CET [2025/10/03 13:31:11 ET]
Table 'Sirio' 6-max Seat #1 is the button
Seat 1: SidneyPrescott (€2 in chips) 
Seat 2: ADRIAN0_MEIS (€3.87 in chips) 
Seat 3: caduceus369 (€3.65 in chips) 
Seat 4: Gabrielefante (€3.41 in chips) 
Seat 5: kroll219 (€2.95 in chips) 
Seat 6: GIacius (€2.08 in chips) 
ADRIAN0_MEIS: posts small blind €0.01
caduceus369: posts big blind €0.02
*** HOLE CARDS ***
Dealt to caduceus369 [6s 3d]
Gabrielefante: folds 
kroll219: folds 
GIacius: folds 
SidneyPrescott: raises €0.04 to €0.06
ADRIAN0_MEIS: calls €0.05
caduceus369: folds 
*** FLOP *** [4h 2s 7s]
ADRIAN0_MEIS: checks 
SidneyPrescott: bets €0.07
ADRIAN0_MEIS: folds 
Uncalled bet (€0.07) returned to SidneyPrescott
SidneyPrescott collected €0.14 from pot
SidneyPrescott: doesn't show hand 
*** SUMMARY ***
Total pot €0.14 | Rake €0 
Board [4h 2s 7s]
Seat 1: SidneyPrescott (button) collected (€0.14)
Seat 2: ADRIAN0_MEIS (small blind) folded on the Flop
Seat 3: caduceus369 (big blind) folded before Flop
Seat 4: Gabrielefante folded before Flop (didn't bet)
Seat 5: kroll219 folded before Flop (didn't bet)
Seat 6: GIacius folded before Flop (didn't bet)



PokerStars Zoom Hand #257984815305:  Hold'em No Limit (€0.01/€0.02) [ADM ID: M62BA304494E32ST] - 2025/10/03 19:31:23 CET [2025/10/03 13:31:23 ET]
Table 'Sirio' 6-max Seat #1 is the button
Seat 1: pistaKKio23 (€4.94 in chips) 
Seat 2: caduceus369 (€3.63 in chips) 
Seat 3: juzam01 (€2.02 in chips) 
Seat 4: RRgalp (€4.85 in chips) 
Seat 5: IKARO_3 (€1.94 in chips) 
Seat 6: GanchanS7 (€2.03 in chips) 
caduceus369: posts small blind €0.01
juzam01: posts big blind €0.02
*** HOLE CARDS ***
Dealt to caduceus369 [Ts Kd]
RRgalp: folds 
IKARO_3: folds 
GanchanS7: folds 
pistaKKio23: folds 
caduceus369: calls €0.01
juzam01: checks 
*** FLOP *** [6c 2c Qs]
caduceus369: checks 
juzam01: checks 
*** TURN *** [6c 2c Qs] [4c]
caduceus369: bets €0.02
juzam01: calls €0.02
*** RIVER *** [6c 2c Qs 4c] [3h]
caduceus369: bets €0.46
juzam01: folds 
Uncalled bet (€0.46) returned to caduceus369
caduceus369 collected €0.08 from pot
caduceus369: doesn't show hand 
*** SUMMARY ***
Total pot €0.08 | Rake €0 
Board [6c 2c Qs 4c 3h]
Seat 1: pistaKKio23 (button) folded before Flop (didn't bet)
Seat 2: caduceus369 (small blind) collected (€0.08)
Seat 3: juzam01 (big blind) folded on the River
Seat 4: RRgalp folded before Flop (didn't bet)
Seat 5: IKARO_3 folded before Flop (didn't bet)
Seat 6: GanchanS7 folded before Flop (didn't bet)



PokerStars Zoom Hand #257984828648:  Hold'em No Limit (€0.01/€0.02) [ADM ID: M62BA304494E32ST] - 2025/10/03 19:32:29 CET [2025/10/03 13:32:29 ET]
Table 'Sirio' 6-max Seat #1 is the button
Seat 1: ADRIAN0_MEIS (€2.66 in chips) 
Seat 2: QUATTRODAME (€1.51 in chips) 
Seat 3: OSPREYSTORM (€2.78 in chips) 
Seat 4: TurboMuletto (€1.95 in chips) 
Seat 5: caduceus369 (€3.67 in chips) 
Seat 6: RRgalp (€4.91 in chips) 
QUATTRODAME: posts small blind €0.01
OSPREYSTORM: posts big blind €0.02
*** HOLE CARDS ***
Dealt to caduceus369 [Jd Jc]
TurboMuletto: folds 
caduceus369: raises €0.04 to €0.06
RRgalp: folds 
ADRIAN0_MEIS: folds 
QUATTRODAME: folds 
OSPREYSTORM: folds 
Uncalled bet (€0.04) returned to caduceus369
caduceus369 collected €0.05 from pot
caduceus369: doesn't show hand 
*** SUMMARY ***
Total pot €0.05 | Rake €0 
Seat 1: ADRIAN0_MEIS (button) folded before Flop (didn't bet)
Seat 2: QUATTRODAME (small blind) folded before Flop
Seat 3: OSPREYSTORM (big blind) folded before Flop
Seat 4: TurboMuletto folded before Flop (didn't bet)
Seat 5: caduceus369 collected (€0.05)
Seat 6: RRgalp folded before Flop (didn't bet)



PokerStars Zoom Hand #257984826654:  Hold'em No Limit (€0.01/€0.02) [ADM ID: M62BA304494E32ST] - 2025/10/03 19:32:19 CET [2025/10/03 13:32:19 ET]
Table 'Sirio' 6-max Seat #1 is the button
Seat 1: caduceus369 (€3.67 in chips) 
Seat 2: OSPREYSTORM (€2.85 in chips) 
Seat 3: juzam01 (€1.96 in chips) 
Seat 4: mastromarty (€3.51 in chips) 
Seat 5: RRgalp (€4.91 in chips) 
Seat 6: Maur2507 (€0.05 in chips) 
OSPREYSTORM: posts small blind €0.01
juzam01: posts big blind €0.02
*** HOLE CARDS ***
Dealt to caduceus369 [8s 7h]
mastromarty: folds 
RRgalp: folds 
Maur2507: folds 
caduceus369: folds 
OSPREYSTORM: raises €0.04 to €0.06
juzam01: raises €0.04 to €0.10
OSPREYSTORM: raises €0.12 to €0.22
juzam01: calls €0.12
*** FLOP *** [Ks 3h Jh]
OSPREYSTORM: checks 
juzam01: checks 
*** TURN *** [Ks 3h Jh] [4h]
OSPREYSTORM: bets €0.23
juzam01: folds 
Uncalled bet (€0.23) returned to OSPREYSTORM
OSPREYSTORM collected €0.42 from pot
OSPREYSTORM: doesn't show hand 
*** SUMMARY ***
Total pot €0.44 | Rake €0.02 
Board [Ks 3h Jh 4h]
Seat 1: caduceus369 (button) folded before Flop (didn't bet)
Seat 2: OSPREYSTORM (small blind) collected (€0.42)
Seat 3: juzam01 (big blind) folded on the Turn
Seat 4: mastromarty folded before Flop (didn't bet)
Seat 5: RRgalp folded before Flop (didn't bet)
Seat 6: Maur2507 folded before Flop (didn't bet)



PokerStars Zoom Hand #257984827666:  Hold'em No Limit (€0.01/€0.02) [ADM ID: M62BA304494E32ST] - 2025/10/03 19:32:24 CET [2025/10/03 13:32:24 ET]
Table 'Sirio' 6-max Seat #1 is the button
Seat 1: Sararafusa11 (€3.55 in chips) 
Seat 2: franky65124 (€2.39 in chips) 
Seat 3: mastromarty (€3.51 in chips) 
Seat 4: RRgalp (€4.91 in chips) 
Seat 5: GanchanS7 (€3.53 in chips) 
Seat 6: caduceus369 (€3.67 in chips) 
franky65124: posts small blind €0.01
mastromarty: posts big blind €0.02
*** HOLE CARDS ***
Dealt to caduceus369 [2c 6h]
RRgalp: folds 
GanchanS7: folds 
caduceus369: folds 
Sararafusa11: raises €0.03 to €0.05
franky65124: folds 
mastromarty: calls €0.03
*** FLOP *** [Qd 7s 6d]
mastromarty: checks 
Sararafusa11: checks 
*** TURN *** [Qd 7s 6d] [3d]
mastromarty: bets €0.02
Sararafusa11: folds 
Uncalled bet (€0.02) returned to mastromarty
mastromarty collected €0.11 from pot
mastromarty: doesn't show hand 
*** SUMMARY ***
Total pot €0.11 | Rake €0 
Board [Qd 7s 6d 3d]
Seat 1: Sararafusa11 (button) folded on the Turn
Seat 2: franky65124 (small blind) folded before Flop
Seat 3: mastromarty (big blind) collected (€0.11)
Seat 4: RRgalp folded before Flop (didn't bet)
Seat 5: GanchanS7 folded before Flop (didn't bet)
Seat 6: caduceus369 folded before Flop (didn't bet)



PokerStars Zoom Hand #257984833254:  Hold'em No Limit (€0.01/€0.02) [ADM ID: M62BA304494E32ST] - 2025/10/03 19:32:52 CET [2025/10/03 13:32:52 ET]
Table 'Sirio' 6-max Seat #1 is the button
Seat 1: OSPREYSTORM (€3.05 in chips) 
Seat 2: SidneyPrescott (€2.20 in chips) 
Seat 3: caduceus369 (€3.70 in chips) 
Seat 4: juzam01 (€2.06 in chips) 
Seat 5: TurboMuletto (€1.93 in chips) 
Seat 6: GIacius (€2 in chips) 
SidneyPrescott: posts small blind €0.01
caduceus369: posts big blind €0.02
*** HOLE CARDS ***
Dealt to caduceus369 [3s 4h]
juzam01: folds 
TurboMuletto: folds 
GIacius: folds 
OSPREYSTORM: folds 
SidneyPrescott: folds 
Uncalled bet (€0.01) returned to caduceus369
caduceus369 collected €0.02 from pot
caduceus369: doesn't show hand 
*** SUMMARY ***
Total pot €0.02 | Rake €0 
Seat 1: OSPREYSTORM (button) folded before Flop (didn't bet)
Seat 2: SidneyPrescott (small blind) folded before Flop
Seat 3: caduceus369 (big blind) collected (€0.02)
Seat 4: juzam01 folded before Flop (didn't bet)
Seat 5: TurboMuletto folded before Flop (didn't bet)
Seat 6: GIacius folded before Flop (didn't bet)



PokerStars Zoom Hand #257984832408:  Hold'em No Limit (€0.01/€0.02) [ADM ID: M62BA304494E32ST] - 2025/10/03 19:32:48 CET [2025/10/03 13:32:48 ET]
Table 'Sirio' 6-max Seat #1 is the button
Seat 1: caduceus369 (€3.70 in chips) 
Seat 2: IKARO_3 (€2.09 in chips) 
Seat 3: ceramista17 (€0.94 in chips) 
Seat 4: ADRIAN0_MEIS (€2.67 in chips) 
Seat 5: OSPREYSTORM (€8.54 in chips) 
Seat 6: stfuplzudonk (€2.29 in chips) 
IKARO_3: posts small blind €0.01
ceramista17: posts big blind €0.02
*** HOLE CARDS ***
Dealt to caduceus369 [5c 6h]
ADRIAN0_MEIS: folds 
OSPREYSTORM: folds 
stfuplzudonk: raises €0.02 to €0.04
caduceus369: folds 
IKARO_3: folds 
ceramista17: folds 
Uncalled bet (€0.02) returned to stfuplzudonk
stfuplzudonk collected €0.05 from pot
stfuplzudonk: doesn't show hand 
*** SUMMARY ***
Total pot €0.05 | Rake €0 
Seat 1: caduceus369 (button) folded before Flop (didn't bet)
Seat 2: IKARO_3 (small blind) folded before Flop
Seat 3: ceramista17 (big blind) folded before Flop
Seat 4: ADRIAN0_MEIS folded before Flop (didn't bet)
Seat 5: OSPREYSTORM folded before Flop (didn't bet)
Seat 6: stfuplzudonk collected (€0.05)



PokerStars Zoom Hand #257984831660:  Hold'em No Limit (€0.01/€0.02) [ADM ID: M62BA304494E32ST] - 2025/10/03 19:32:44 CET [2025/10/03 13:32:44 ET]
Table 'Sirio' 6-max Seat #1 is the button
Seat 1: jolli180 (€1.84 in chips) 
Seat 2: GanchanS7 (€2.01 in chips) 
Seat 3: QUATTRODAME (€1.50 in chips) 
Seat 4: caduceus369 (€3.70 in chips) 
Seat 5: GIacius (€2.16 in chips) 
Seat 6: ceramista17 (€0.94 in chips) 
GanchanS7: posts small blind €0.01
QUATTRODAME: posts big blind €0.02
*** HOLE CARDS ***
Dealt to caduceus369 [As 6c]
caduceus369: folds 
GIacius: folds 
ceramista17: folds 
jolli180: raises €0.02 to €0.04
GanchanS7: folds 
QUATTRODAME: calls €0.02
*** FLOP *** [Ah 9c Tc]
QUATTRODAME: checks 
jolli180: bets €0.04
QUATTRODAME: calls €0.04
*** TURN *** [Ah 9c Tc] [Jc]
QUATTRODAME: bets €0.17
jolli180: calls €0.17
*** RIVER *** [Ah 9c Tc Jc] [Kh]
QUATTRODAME: checks 
jolli180: checks 
*** SHOW DOWN ***
QUATTRODAME: shows [7c 8h] (a straight, Seven to Jack)
jolli180: mucks hand 
QUATTRODAME collected €0.49 from pot
*** SUMMARY ***
Total pot €0.51 | Rake €0.02 
Board [Ah 9c Tc Jc Kh]
Seat 1: jolli180 (button) mucked [Ac Td]
Seat 2: GanchanS7 (small blind) folded before Flop
Seat 3: QUATTRODAME (big blind) showed [7c 8h] and won (€0.49) with a straight, Seven to Jack
Seat 4: caduceus369 folded before Flop (didn't bet)
Seat 5: GIacius folded before Flop (didn't bet)
Seat 6: ceramista17 folded before Flop (didn't bet)



PokerStars Zoom Hand #257984838558:  Hold'em No Limit (€0.01/€0.02) [ADM ID: M62BA304494E32ST] - 2025/10/03 19:33:18 CET [2025/10/03 13:33:18 ET]
Table 'Sirio' 6-max Seat #1 is the button
Seat 1: OSPREYSTORM (€8.51 in chips) 
Seat 2: GanchanS7 (€3.56 in chips) 
Seat 3: ADRIAN0_MEIS (€3.88 in chips) 
Seat 4: trillycata (€0.72 in chips) 
Seat 5: caduceus369 (€3.70 in chips) 
Seat 6: eleonora50 (€0.75 in chips) 
GanchanS7: posts small blind €0.01
ADRIAN0_MEIS: posts big blind €0.02
*** HOLE CARDS ***
Dealt to caduceus369 [4c 3c]
trillycata: folds 
caduceus369: folds 
eleonora50: raises €0.73 to €0.75 and is all-in
OSPREYSTORM: folds 
GanchanS7: folds 
ADRIAN0_MEIS: folds 
Uncalled bet (€0.73) returned to eleonora50
eleonora50 collected €0.05 from pot
eleonora50: doesn't show hand 
*** SUMMARY ***
Total pot €0.05 | Rake €0 
Seat 1: OSPREYSTORM (button) folded before Flop (didn't bet)
Seat 2: GanchanS7 (small blind) folded before Flop
Seat 3: ADRIAN0_MEIS (big blind) folded before Flop
Seat 4: trillycata folded before Flop (didn't bet)
Seat 5: caduceus369 folded before Flop (didn't bet)
Seat 6: eleonora50 collected (€0.05)



PokerStars Zoom Hand #257984837924:  Hold'em No Limit (€0.01/€0.02) [ADM ID: M62BA304494E32ST] - 2025/10/03 19:33:15 CET [2025/10/03 13:33:15 ET]
Table 'Sirio' 6-max Seat #1 is the button
Seat 1: buscofan (€2.17 in chips) 
Seat 2: IKARO_3 (€1.89 in chips) 
Seat 3: ADRIAN0_MEIS (€2.02 in chips) 
Seat 4: caduceus369 (€3.70 in chips) 
Seat 5: stfuplzudonk (€1.16 in chips) 
Seat 6: franky65124 (€2.36 in chips) 
IKARO_3: posts small blind €0.01
ADRIAN0_MEIS: posts big blind €0.02
*** HOLE CARDS ***
Dealt to caduceus369 [Td 4d]
caduceus369: folds 
stfuplzudonk: raises €0.02 to €0.04
franky65124: folds 
buscofan: folds 
IKARO_3: folds 
ADRIAN0_MEIS: folds 
Uncalled bet (€0.02) returned to stfuplzudonk
stfuplzudonk collected €0.05 from pot
stfuplzudonk: doesn't show hand 
*** SUMMARY ***
Total pot €0.05 | Rake €0 
Seat 1: buscofan (button) folded before Flop (didn't bet)
Seat 2: IKARO_3 (small blind) folded before Flop
Seat 3: ADRIAN0_MEIS (big blind) folded before Flop
Seat 4: caduceus369 folded before Flop (didn't bet)
Seat 5: stfuplzudonk collected (€0.05)
Seat 6: franky65124 folded before Flop (didn't bet)



PokerStars Zoom Hand #257984835704:  Hold'em No Limit (€0.01/€0.02) [ADM ID: M62BA304494E32ST] - 2025/10/03 19:33:04 CET [2025/10/03 13:33:04 ET]
Table 'Sirio' 6-max Seat #1 is the button
Seat 1: Lelesssss (€2.27 in chips) 
Seat 2: OSPREYSTORM (€8.52 in chips) 
Seat 3: stagniarihd (€4.66 in chips) 
Seat 4: GanchanS7 (€3.56 in chips) 
Seat 5: ADRIAN0_MEIS (€2.67 in chips) 
Seat 6: caduceus369 (€3.71 in chips) 
OSPREYSTORM: posts small blind €0.01
stagniarihd: posts big blind €0.02
*** HOLE CARDS ***
Dealt to caduceus369 [Qc 7h]
GanchanS7 has timed out
GanchanS7: folds 
ADRIAN0_MEIS: folds 
caduceus369: folds 
Lelesssss: raises €0.04 to €0.06
OSPREYSTORM: folds 
stagniarihd: calls €0.04
*** FLOP *** [Ts 2s 2d]
stagniarihd: checks 
Lelesssss: bets €0.04
stagniarihd: folds 
Uncalled bet (€0.04) returned to Lelesssss
Lelesssss collected €0.13 from pot
Lelesssss: doesn't show hand 
*** SUMMARY ***
Total pot €0.13 | Rake €0 
Board [Ts 2s 2d]
Seat 1: Lelesssss (button) collected (€0.13)
Seat 2: OSPREYSTORM (small blind) folded before Flop
Seat 3: stagniarihd (big blind) folded on the Flop
Seat 4: GanchanS7 folded before Flop (didn't bet)
Seat 5: ADRIAN0_MEIS folded before Flop (didn't bet)
Seat 6: caduceus369 folded before Flop (didn't bet)



PokerStars Zoom Hand #257984839718:  Hold'em No Limit (€0.01/€0.02) [ADM ID: M62BA304494E32ST] - 2025/10/03 19:33:24 CET [2025/10/03 13:33:24 ET]
Table 'Sirio' 6-max Seat #1 is the button
Seat 1: Teriferro (€0.82 in chips) 
Seat 2: SKERZA (€1.98 in chips) 
Seat 3: caduceus369 (€3.70 in chips) 
Seat 4: SidneyPrescott (€2.16 in chips) 
Seat 5: kroll219 (€2.97 in chips) 
Seat 6: GIacius (€2.35 in chips) 
SKERZA: posts small blind €0.01
caduceus369: posts big blind €0.02
*** HOLE CARDS ***
Dealt to caduceus369 [8c 4d]
SidneyPrescott: folds 
kroll219: folds 
GIacius: folds 
Teriferro: folds 
SKERZA: folds 
Uncalled bet (€0.01) returned to caduceus369
caduceus369 collected €0.02 from pot
caduceus369: doesn't show hand 
*** SUMMARY ***
Total pot €0.02 | Rake €0 
Seat 1: Teriferro (button) folded before Flop (didn't bet)
Seat 2: SKERZA (small blind) folded before Flop
Seat 3: caduceus369 (big blind) collected (€0.02)
Seat 4: SidneyPrescott folded before Flop (didn't bet)
Seat 5: kroll219 folded before Flop (didn't bet)
Seat 6: GIacius folded before Flop (didn't bet)



PokerStars Zoom Hand #257984836360:  Hold'em No Limit (€0.01/€0.02) [ADM ID: M62BA304494E32ST] - 2025/10/03 19:33:07 CET [2025/10/03 13:33:07 ET]
Table 'Sirio' 6-max Seat #1 is the button
Seat 1: TurboMuletto (€1.91 in chips) 
Seat 2: caduceus369 (€3.71 in chips) 
Seat 3: SKERZA (€2 in chips) 
Seat 4: juzam01 (€2.06 in chips) 
Seat 5: ValenTom25 (€1.25 in chips) 
Seat 6: Gabrielefante (€3.25 in chips) 
caduceus369: posts small blind €0.01
SKERZA: posts big blind €0.02
*** HOLE CARDS ***
Dealt to caduceus369 [8s 2h]
juzam01: folds 
ValenTom25: calls €0.02
Gabrielefante: calls €0.02
TurboMuletto: folds 
caduceus369: folds 
SKERZA: checks 
*** FLOP *** [4c Jh Kh]
SKERZA: checks 
ValenTom25: bets €0.07
Gabrielefante: calls €0.07
SKERZA: folds 
*** TURN *** [4c Jh Kh] [Qc]
ValenTom25: checks 
Gabrielefante: checks 
*** RIVER *** [4c Jh Kh Qc] [3c]
ValenTom25: bets €0.10
Gabrielefante: folds 
Uncalled bet (€0.10) returned to ValenTom25
ValenTom25 collected €0.20 from pot
ValenTom25: doesn't show hand 
*** SUMMARY ***
Total pot €0.21 | Rake €0.01 
Board [4c Jh Kh Qc 3c]
Seat 1: TurboMuletto (button) folded before Flop (didn't bet)
Seat 2: caduceus369 (small blind) folded before Flop
Seat 3: SKERZA (big blind) folded on the Flop
Seat 4: juzam01 folded before Flop (didn't bet)
Seat 5: ValenTom25 collected (€0.20)
Seat 6: Gabrielefante folded on the River



PokerStars Zoom Hand #257984842618:  Hold'em No Limit (€0.01/€0.02) [ADM ID: M62BA304494E32ST] - 2025/10/03 19:33:39 CET [2025/10/03 13:33:39 ET]
Table 'Sirio' 6-max Seat #1 is the button
Seat 1: stfuplzudonk (€4.99 in chips) 
Seat 2: caduceus369 (€3.71 in chips) 
Seat 3: GIacius (€2.02 in chips) 
Seat 4: ADRIAN0_MEIS (€2 in chips) 
Seat 5: RRgalp (€4.86 in chips) 
Seat 6: OSPREYSTORM (€2.56 in chips) 
caduceus369: posts small blind €0.01
GIacius: posts big blind €0.02
*** HOLE CARDS ***
Dealt to caduceus369 [2s 7h]
ADRIAN0_MEIS: folds 
RRgalp: raises €0.04 to €0.06
OSPREYSTORM: folds 
stfuplzudonk: folds 
caduceus369: folds 
GIacius: folds 
Uncalled bet (€0.04) returned to RRgalp
RRgalp collected €0.05 from pot
RRgalp: doesn't show hand 
*** SUMMARY ***
Total pot €0.05 | Rake €0 
Seat 1: stfuplzudonk (button) folded before Flop (didn't bet)
Seat 2: caduceus369 (small blind) folded before Flop
Seat 3: GIacius (big blind) folded before Flop
Seat 4: ADRIAN0_MEIS folded before Flop (didn't bet)
Seat 5: RRgalp collected (€0.05)
Seat 6: OSPREYSTORM folded before Flop (didn't bet)



PokerStars Zoom Hand #257984846281:  Hold'em No Limit (€0.01/€0.02) [ADM ID: M62BA304494E32ST] - 2025/10/03 19:33:57 CET [2025/10/03 13:33:57 ET]
Table 'Sirio' 6-max Seat #1 is the button
Seat 1: GIacius (€2 in chips) 
Seat 2: buscofan (€2 in chips) 
Seat 3: RRgalp (€4.89 in chips) 
Seat 4: ADRIAN0_MEIS (€2.69 in chips) 
Seat 5: rosanero674 (€1.80 in chips) 
Seat 6: caduceus369 (€3.70 in chips) 
buscofan: posts small blind €0.01
RRgalp: posts big blind €0.02
*** HOLE CARDS ***
Dealt to caduceus369 [7h 6c]
ADRIAN0_MEIS: folds 
rosanero674: folds 
caduceus369: folds 
GIacius: raises €0.03 to €0.05
buscofan: folds 
RRgalp: folds 
Uncalled bet (€0.03) returned to GIacius
GIacius collected €0.05 from pot
GIacius: doesn't show hand 
*** SUMMARY ***
Total pot €0.05 | Rake €0 
Seat 1: GIacius (button) collected (€0.05)
Seat 2: buscofan (small blind) folded before Flop
Seat 3: RRgalp (big blind) folded before Flop
Seat 4: ADRIAN0_MEIS folded before Flop (didn't bet)
Seat 5: rosanero674 folded before Flop (didn't bet)
Seat 6: caduceus369 folded before Flop (didn't bet)



PokerStars Zoom Hand #257984847084:  Hold'em No Limit (€0.01/€0.02) [ADM ID: M62BA304494E32ST] - 2025/10/03 19:34:01 CET [2025/10/03 13:34:01 ET]
Table 'Sirio' 6-max Seat #1 is the button
Seat 1: OSPREYSTORM (€8.48 in chips) 
Seat 2: SidneyPrescott (€2.19 in chips) 
Seat 3: juzam01 (€1.79 in chips) 
Seat 4: QUATTRODAME (€1.77 in chips) 
Seat 5: caduceus369 (€3.70 in chips) 
Seat 6: GanchanS7 (€3.55 in chips) 
SidneyPrescott: posts small blind €0.01
juzam01: posts big blind €0.02
*** HOLE CARDS ***
Dealt to caduceus369 [8h 8c]
QUATTRODAME: folds 
caduceus369: raises €0.04 to €0.06
GanchanS7: folds 
OSPREYSTORM: folds 
SidneyPrescott: folds 
juzam01: folds 
Uncalled bet (€0.04) returned to caduceus369
caduceus369 collected €0.05 from pot
caduceus369: doesn't show hand 
*** SUMMARY ***
Total pot €0.05 | Rake €0 
Seat 1: OSPREYSTORM (button) folded before Flop (didn't bet)
Seat 2: SidneyPrescott (small blind) folded before Flop
Seat 3: juzam01 (big blind) folded before Flop
Seat 4: QUATTRODAME folded before Flop (didn't bet)
Seat 5: caduceus369 collected (€0.05)
Seat 6: GanchanS7 folded before Flop (didn't bet)



PokerStars Zoom Hand #257984850897:  Hold'em No Limit (€0.01/€0.02) [ADM ID: M62BA304494E32ST] - 2025/10/03 19:34:20 CET [2025/10/03 13:34:20 ET]
Table 'Sirio' 6-max Seat #1 is the button
Seat 1: OSPREYSTORM (€2.53 in chips) 
Seat 2: ADRIAN0_MEIS (€2 in chips) 
Seat 3: GanchanS7 (€3.55 in chips) 
Seat 4: caduceus369 (€3.73 in chips) 
Seat 5: SKERZA (€1.76 in chips) 
Seat 6: GIacius (€2.03 in chips) 
ADRIAN0_MEIS: posts small blind €0.01
GanchanS7: posts big blind €0.02
*** HOLE CARDS ***
Dealt to caduceus369 [Kc 8h]
caduceus369: folds 
SKERZA: folds 
GIacius: folds 
OSPREYSTORM: raises €0.04 to €0.06
ADRIAN0_MEIS: folds 
GanchanS7: folds 
Uncalled bet (€0.04) returned to OSPREYSTORM
OSPREYSTORM collected €0.05 from pot
OSPREYSTORM: doesn't show hand 
*** SUMMARY ***
Total pot €0.05 | Rake €0 
Seat 1: OSPREYSTORM (button) collected (€0.05)
Seat 2: ADRIAN0_MEIS (small blind) folded before Flop
Seat 3: GanchanS7 (big blind) folded before Flop
Seat 4: caduceus369 folded before Flop (didn't bet)
Seat 5: SKERZA folded before Flop (didn't bet)
Seat 6: GIacius folded before Flop (didn't bet)



PokerStars Zoom Hand #257984844222:  Hold'em No Limit (€0.01/€0.02) [ADM ID: M62BA304494E32ST] - 2025/10/03 19:33:46 CET [2025/10/03 13:33:46 ET]
Table 'Sirio' 6-max Seat #1 is the button
Seat 1: caduceus369 (€3.70 in chips) 
Seat 2: stagniarihd (€4.60 in chips) 
Seat 3: GanchanS7 (€2 in chips) 
Seat 4: OSPREYSTORM (€3.08 in chips) 
Seat 5: mastromarty (€3.65 in chips) 
Seat 6: SidneyPrescott (€2.20 in chips) 
stagniarihd: posts small blind €0.01
GanchanS7: posts big blind €0.02
*** HOLE CARDS ***
Dealt to caduceus369 [7s Jh]
OSPREYSTORM: raises €0.04 to €0.06
mastromarty: folds 
SidneyPrescott: calls €0.06
caduceus369: folds 
stagniarihd: folds 
GanchanS7: folds 
*** FLOP *** [Kc Ks Tc]
OSPREYSTORM: checks 
SidneyPrescott: bets €0.08
OSPREYSTORM: calls €0.08
*** TURN *** [Kc Ks Tc] [4c]
OSPREYSTORM: checks 
SidneyPrescott: bets €0.24
OSPREYSTORM: calls €0.24
*** RIVER *** [Kc Ks Tc 4c] [Js]
OSPREYSTORM: checks 
SidneyPrescott: bets €0.60
OSPREYSTORM: calls €0.60
*** SHOW DOWN ***
SidneyPrescott: shows [7c 6c] (a flush, King high)
OSPREYSTORM: shows [9c Ac] (a flush, Ace high)
OSPREYSTORM collected €1.89 from pot
*** SUMMARY ***
Total pot €1.99 | Rake €0.10 
Board [Kc Ks Tc 4c Js]
Seat 1: caduceus369 (button) folded before Flop (didn't bet)
Seat 2: stagniarihd (small blind) folded before Flop
Seat 3: GanchanS7 (big blind) folded before Flop
Seat 4: OSPREYSTORM showed [9c Ac] and won (€1.89) with a flush, Ace high
Seat 5: mastromarty folded before Flop (didn't bet)
Seat 6: SidneyPrescott showed [7c 6c] and lost with a flush, King high



PokerStars Zoom Hand #257984851911:  Hold'em No Limit (€0.01/€0.02) [ADM ID: M62BA304494E32ST] - 2025/10/03 19:34:25 CET [2025/10/03 13:34:25 ET]
Table 'Sirio' 6-max Seat #1 is the button
Seat 1: Gabrielefante (€3.16 in chips) 
Seat 2: stfuplzudonk (€4.99 in chips) 
Seat 3: ceramista17 (€1.23 in chips) 
Seat 4: caduceus369 (€3.73 in chips) 
Seat 5: GIacius (€2.03 in chips) 
Seat 6: ADRIAN0_MEIS (€3.85 in chips) 
stfuplzudonk: posts small blind €0.01
ceramista17: posts big blind €0.02
*** HOLE CARDS ***
Dealt to caduceus369 [6s 6c]
caduceus369: calls €0.02
GIacius: folds 
ADRIAN0_MEIS: folds 
Gabrielefante: folds 
stfuplzudonk: calls €0.01
ceramista17: checks 
*** FLOP *** [Td 9c 2h]
stfuplzudonk: bets €4.97 and is all-in
ceramista17: folds 
caduceus369: folds 
Uncalled bet (€4.97) returned to stfuplzudonk
stfuplzudonk collected €0.06 from pot
stfuplzudonk: doesn't show hand 
*** SUMMARY ***
Total pot €0.06 | Rake €0 
Board [Td 9c 2h]
Seat 1: Gabrielefante (button) folded before Flop (didn't bet)
Seat 2: stfuplzudonk (small blind) collected (€0.06)
Seat 3: ceramista17 (big blind) folded on the Flop
Seat 4: caduceus369 folded on the Flop
Seat 5: GIacius folded before Flop (didn't bet)
Seat 6: ADRIAN0_MEIS folded before Flop (didn't bet)



PokerStars Zoom Hand #257984857976:  Hold'em No Limit (€0.01/€0.02) [ADM ID: M62BA304494E32ST] - 2025/10/03 19:34:54 CET [2025/10/03 13:34:54 ET]
Table 'Sirio' 6-max Seat #1 is the button
Seat 1: GanchanS7 (€3.52 in chips) 
Seat 2: rosanero674 (€1.80 in chips) 
Seat 3: caduceus369 (€3.71 in chips) 
Seat 4: stfuplzudonk (€0.71 in chips) 
Seat 5: OSPREYSTORM (€8.48 in chips) 
Seat 6: GIacius (€2 in chips) 
rosanero674: posts small blind €0.01
caduceus369: posts big blind €0.02
*** HOLE CARDS ***
Dealt to caduceus369 [6h Td]
stfuplzudonk: calls €0.02
OSPREYSTORM: folds 
GIacius: folds 
GanchanS7: folds 
rosanero674: folds 
caduceus369: checks 
*** FLOP *** [4c 3d 3h]
caduceus369: checks 
stfuplzudonk: checks 
*** TURN *** [4c 3d 3h] [7s]
caduceus369: bets €0.03
stfuplzudonk: calls €0.03
*** RIVER *** [4c 3d 3h 7s] [Qs]
caduceus369: bets €0.05
stfuplzudonk: raises €0.15 to €0.20
caduceus369: folds 
Uncalled bet (€0.15) returned to stfuplzudonk
stfuplzudonk collected €0.20 from pot
stfuplzudonk: doesn't show hand 
*** SUMMARY ***
Total pot €0.21 | Rake €0.01 
Board [4c 3d 3h 7s Qs]
Seat 1: GanchanS7 (button) folded before Flop (didn't bet)
Seat 2: rosanero674 (small blind) folded before Flop
Seat 3: caduceus369 (big blind) folded on the River
Seat 4: stfuplzudonk collected (€0.20)
Seat 5: OSPREYSTORM folded before Flop (didn't bet)
Seat 6: GIacius folded before Flop (didn't bet)



PokerStars Zoom Hand #257984865495:  Hold'em No Limit (€0.01/€0.02) [ADM ID: M62BA304494E32ST] - 2025/10/03 19:35:32 CET [2025/10/03 13:35:32 ET]
Table 'Sirio' 6-max Seat #1 is the button
Seat 1: caduceus369 (€3.61 in chips) 
Seat 2: stfuplzudonk (€4.44 in chips) 
Seat 3: RRgalp (€4.69 in chips) 
Seat 4: GIacius (€2.09 in chips) 
Seat 5: TurboMuletto (€1.79 in chips) 
Seat 6: buscofan (€2.24 in chips) 
stfuplzudonk: posts small blind €0.01
RRgalp: posts big blind €0.02
*** HOLE CARDS ***
Dealt to caduceus369 [8c 9s]
GIacius: raises €0.02 to €0.04
TurboMuletto: folds 
buscofan: folds 
caduceus369: folds 
stfuplzudonk: calls €0.03
RRgalp: raises €0.06 to €0.10
GIacius: calls €0.06
stfuplzudonk: calls €0.06
*** FLOP *** [6c 6h 2c]
stfuplzudonk: checks 
RRgalp: bets €0.29
GIacius: folds 
stfuplzudonk: folds 
Uncalled bet (€0.29) returned to RRgalp
RRgalp collected €0.29 from pot
RRgalp: doesn't show hand 
*** SUMMARY ***
Total pot €0.30 | Rake €0.01 
Board [6c 6h 2c]
Seat 1: caduceus369 (button) folded before Flop (didn't bet)
Seat 2: stfuplzudonk (small blind) folded on the Flop
Seat 3: RRgalp (big blind) collected (€0.29)
Seat 4: GIacius folded on the Flop
Seat 5: TurboMuletto folded before Flop (didn't bet)
Seat 6: buscofan folded before Flop (didn't bet)



PokerStars Zoom Hand #257984866519:  Hold'em No Limit (€0.01/€0.02) [ADM ID: M62BA304494E32ST] - 2025/10/03 19:35:37 CET [2025/10/03 13:35:37 ET]
Table 'Sirio' 6-max Seat #1 is the button
Seat 1: TurboMuletto (€1.79 in chips) 
Seat 2: caduceus369 (€3.61 in chips) 
Seat 3: rosanero674 (€1.76 in chips) 
Seat 4: SKERZA (€1.58 in chips) 
Seat 5: juzam01 (€2.68 in chips) 
Seat 6: buscofan (€2 in chips) 
caduceus369: posts small blind €0.01
rosanero674: posts big blind €0.02
*** HOLE CARDS ***
Dealt to caduceus369 [Jh Kh]
SKERZA: folds 
juzam01: folds 
buscofan: folds 
TurboMuletto: folds 
caduceus369: calls €0.01
rosanero674: checks 
*** FLOP *** [As Jc 2c]
caduceus369: checks 
rosanero674: checks 
*** TURN *** [As Jc 2c] [9d]
caduceus369: checks 
rosanero674: bets €0.04
caduceus369: calls €0.04
*** RIVER *** [As Jc 2c 9d] [2s]
caduceus369: checks 
rosanero674: checks 
*** SHOW DOWN ***
caduceus369: shows [Jh Kh] (two pair, Jacks and Deuces)
rosanero674: mucks hand 
caduceus369 collected €0.12 from pot
*** SUMMARY ***
Total pot €0.12 | Rake €0 
Board [As Jc 2c 9d 2s]
Seat 1: TurboMuletto (button) folded before Flop (didn't bet)
Seat 2: caduceus369 (small blind) showed [Jh Kh] and won (€0.12) with two pair, Jacks and Deuces
Seat 3: rosanero674 (big blind) mucked [Tc Qs]
Seat 4: SKERZA folded before Flop (didn't bet)
Seat 5: juzam01 folded before Flop (didn't bet)
Seat 6: buscofan folded before Flop (didn't bet)



PokerStars Zoom Hand #257984877577:  Hold'em No Limit (€0.01/€0.02) [ADM ID: M62BA304494E32ST] - 2025/10/03 19:36:32 CET [2025/10/03 13:36:32 ET]
Table 'Sirio' 6-max Seat #1 is the button
Seat 1: GanchanS7 (€2.13 in chips) 
Seat 2: juzam01 (€2 in chips) 
Seat 3: ADRIAN0_MEIS (€4.11 in chips) 
Seat 4: IKARO_3 (€1.16 in chips) 
Seat 5: stfuplzudonk (€4.35 in chips) 
Seat 6: caduceus369 (€3.67 in chips) 
juzam01: posts small blind €0.01
ADRIAN0_MEIS: posts big blind €0.02
*** HOLE CARDS ***
Dealt to caduceus369 [9s 5h]
IKARO_3: folds 
stfuplzudonk: folds 
caduceus369: folds 
GanchanS7: folds 
juzam01: folds 
Uncalled bet (€0.01) returned to ADRIAN0_MEIS
ADRIAN0_MEIS collected €0.02 from pot
ADRIAN0_MEIS: doesn't show hand 
*** SUMMARY ***
Total pot €0.02 | Rake €0 
Seat 1: GanchanS7 (button) folded before Flop (didn't bet)
Seat 2: juzam01 (small blind) folded before Flop
Seat 3: ADRIAN0_MEIS (big blind) collected (€0.02)
Seat 4: IKARO_3 folded before Flop (didn't bet)
Seat 5: stfuplzudonk folded before Flop (didn't bet)
Seat 6: caduceus369 folded before Flop (didn't bet)



PokerStars Zoom Hand #257984879235:  Hold'em No Limit (€0.01/€0.02) [ADM ID: M62BA304494E32ST] - 2025/10/03 19:36:40 CET [2025/10/03 13:36:40 ET]
Table 'Sirio' 6-max Seat #1 is the button
Seat 1: SidneyPrescott (€2.57 in chips) 
Seat 2: stfuplzudonk (€4.35 in chips) 
Seat 3: SKERZA (€1.60 in chips) 
Seat 4: GanchanS7 (€2.13 in chips) 
Seat 5: caduceus369 (€3.67 in chips) 
Seat 6: GIacius (€2.18 in chips) 
stfuplzudonk: posts small blind €0.01
SKERZA: posts big blind €0.02
*** HOLE CARDS ***
Dealt to caduceus369 [6c Jc]
GanchanS7: folds 
caduceus369: folds 
GIacius: folds 
SidneyPrescott: raises €0.04 to €0.06
stfuplzudonk: raises €0.14 to €0.20
SKERZA: folds 
SidneyPrescott: calls €0.14
*** FLOP *** [4h 7h 3d]
stfuplzudonk: bets €0.28
SidneyPrescott: folds 
Uncalled bet (€0.28) returned to stfuplzudonk
stfuplzudonk collected €0.40 from pot
stfuplzudonk: doesn't show hand 
*** SUMMARY ***
Total pot €0.42 | Rake €0.02 
Board [4h 7h 3d]
Seat 1: SidneyPrescott (button) folded on the Flop
Seat 2: stfuplzudonk (small blind) collected (€0.40)
Seat 3: SKERZA (big blind) folded before Flop
Seat 4: GanchanS7 folded before Flop (didn't bet)
Seat 5: caduceus369 folded before Flop (didn't bet)
Seat 6: GIacius folded before Flop (didn't bet)



PokerStars Zoom Hand #257984880037:  Hold'em No Limit (€0.01/€0.02) [ADM ID: M62BA304494E32ST] - 2025/10/03 19:36:44 CET [2025/10/03 13:36:44 ET]
Table 'Sirio' 6-max Seat #1 is the button
Seat 1: eleonora50 (€0.78 in chips) 
Seat 2: stfuplzudonk (€1.71 in chips) 
Seat 3: OSPREYSTORM (€2.21 in chips) 
Seat 4: caduceus369 (€3.67 in chips) 
Seat 5: kroll219 (€2.19 in chips) 
Seat 6: OMGWOLFX (€12.35 in chips) 
stfuplzudonk: posts small blind €0.01
OSPREYSTORM: posts big blind €0.02
*** HOLE CARDS ***
Dealt to caduceus369 [3s Ad]
caduceus369: folds 
kroll219: folds 
OMGWOLFX: folds 
eleonora50: folds 
stfuplzudonk: folds 
Uncalled bet (€0.01) returned to OSPREYSTORM
OSPREYSTORM collected €0.02 from pot
OSPREYSTORM: doesn't show hand 
*** SUMMARY ***
Total pot €0.02 | Rake €0 
Seat 1: eleonora50 (button) folded before Flop (didn't bet)
Seat 2: stfuplzudonk (small blind) folded before Flop
Seat 3: OSPREYSTORM (big blind) collected (€0.02)
Seat 4: caduceus369 folded before Flop (didn't bet)
Seat 5: kroll219 folded before Flop (didn't bet)
Seat 6: OMGWOLFX folded before Flop (didn't bet)



PokerStars Zoom Hand #257984880868:  Hold'em No Limit (€0.01/€0.02) [ADM ID: M62BA304494E32ST] - 2025/10/03 19:36:48 CET [2025/10/03 13:36:48 ET]
Table 'Sirio' 6-max Seat #1 is the button
Seat 1: Teriferro (€0.54 in chips) 
Seat 2: OMGWOLFX (€5.86 in chips) 
Seat 3: caduceus369 (€3.67 in chips) 
Seat 4: GIacius (€2.18 in chips) 
Seat 5: ADRIAN0_MEIS (€4.12 in chips) 
Seat 6: QUATTRODAME (€2.01 in chips) 
OMGWOLFX: posts small blind €0.01
caduceus369: posts big blind €0.02
*** HOLE CARDS ***
Dealt to caduceus369 [8c Qs]
GIacius: folds 
ADRIAN0_MEIS: folds 
QUATTRODAME: folds 
Teriferro: folds 
OMGWOLFX: raises €0.02 to €0.04
caduceus369: calls €0.02
*** FLOP *** [4d 8d 4c]
OMGWOLFX: bets €0.04
caduceus369: raises €0.06 to €0.10
OMGWOLFX: folds 
Uncalled bet (€0.06) returned to caduceus369
caduceus369 collected €0.16 from pot
caduceus369: doesn't show hand 
*** SUMMARY ***
Total pot €0.16 | Rake €0 
Board [4d 8d 4c]
Seat 1: Teriferro (button) folded before Flop (didn't bet)
Seat 2: OMGWOLFX (small blind) folded on the Flop
Seat 3: caduceus369 (big blind) collected (€0.16)
Seat 4: GIacius folded before Flop (didn't bet)
Seat 5: ADRIAN0_MEIS folded before Flop (didn't bet)
Seat 6: QUATTRODAME folded before Flop (didn't bet)



PokerStars Zoom Hand #257984894951:  Hold'em No Limit (€0.01/€0.02) [ADM ID: M62BA304494E32ST] - 2025/10/03 19:37:56 CET [2025/10/03 13:37:56 ET]
Table 'Sirio' 6-max Seat #1 is the button
Seat 1: caduceus369 (€3.74 in chips) 
Seat 2: IKARO_3 (€2 in chips) 
Seat 3: Sararafusa11 (€3.47 in chips) 
Seat 4: Lelesssss (€1.78 in chips) 
Seat 5: ADRIAN0_MEIS (€2.43 in chips) 
Seat 6: alibabba101 (€1.75 in chips) 
IKARO_3: posts small blind €0.01
Sararafusa11: posts big blind €0.02
*** HOLE CARDS ***
Dealt to caduceus369 [5h 4s]
Lelesssss: raises €0.04 to €0.06
ADRIAN0_MEIS: folds 
alibabba101: folds 
caduceus369: folds 
IKARO_3: folds 
Sararafusa11: folds 
Uncalled bet (€0.04) returned to Lelesssss
Lelesssss collected €0.05 from pot
Lelesssss: doesn't show hand 
*** SUMMARY ***
Total pot €0.05 | Rake €0 
Seat 1: caduceus369 (button) folded before Flop (didn't bet)
Seat 2: IKARO_3 (small blind) folded before Flop
Seat 3: Sararafusa11 (big blind) folded before Flop
Seat 4: Lelesssss collected (€0.05)
Seat 5: ADRIAN0_MEIS folded before Flop (didn't bet)
Seat 6: alibabba101 folded before Flop (didn't bet)



PokerStars Zoom Hand #257984896008:  Hold'em No Limit (€0.01/€0.02) [ADM ID: M62BA304494E32ST] - 2025/10/03 19:38:01 CET [2025/10/03 13:38:01 ET]
Table 'Sirio' 6-max Seat #1 is the button
Seat 1: Gabrielefante (€3.01 in chips) 
Seat 2: GIacius (€2.14 in chips) 
Seat 3: buscofan (€2.20 in chips) 
Seat 4: alibabba101 (€1.75 in chips) 
Seat 5: caduceus369 (€3.74 in chips) 
Seat 6: ADRIAN0_MEIS (€4.12 in chips) 
GIacius: posts small blind €0.01
buscofan: posts big blind €0.02
*** HOLE CARDS ***
Dealt to caduceus369 [As Kd]
alibabba101: folds 
caduceus369: raises €0.04 to €0.06
ADRIAN0_MEIS: folds 
Gabrielefante: folds 
GIacius: folds 
buscofan: folds 
Uncalled bet (€0.04) returned to caduceus369
caduceus369 collected €0.05 from pot
caduceus369: doesn't show hand 
*** SUMMARY ***
Total pot €0.05 | Rake €0 
Seat 1: Gabrielefante (button) folded before Flop (didn't bet)
Seat 2: GIacius (small blind) folded before Flop
Seat 3: buscofan (big blind) folded before Flop
Seat 4: alibabba101 folded before Flop (didn't bet)
Seat 5: caduceus369 collected (€0.05)
Seat 6: ADRIAN0_MEIS folded before Flop (didn't bet)



PokerStars Zoom Hand #257984894108:  Hold'em No Limit (€0.01/€0.02) [ADM ID: M62BA304494E32ST] - 2025/10/03 19:37:52 CET [2025/10/03 13:37:52 ET]
Table 'Sirio' 6-max Seat #1 is the button
Seat 1: alibabba101 (€1.75 in chips) 
Seat 2: caduceus369 (€3.75 in chips) 
Seat 3: rosanero674 (€1.50 in chips) 
Seat 4: jolli180 (€2.24 in chips) 
Seat 5: Plutonia72 (€1.97 in chips) 
Seat 6: stfuplzudonk (€5.56 in chips) 
caduceus369: posts small blind €0.01
rosanero674: posts big blind €0.02
*** HOLE CARDS ***
Dealt to caduceus369 [Tc 3h]
jolli180: calls €0.02
Plutonia72: folds 
stfuplzudonk: folds 
alibabba101: folds 
caduceus369: folds 
rosanero674: checks 
*** FLOP *** [Qs Jc 4h]
rosanero674: checks 
jolli180: checks 
*** TURN *** [Qs Jc 4h] [3s]
rosanero674: checks 
jolli180: checks 
*** RIVER *** [Qs Jc 4h 3s] [8h]
rosanero674: checks 
jolli180: bets €0.02
rosanero674: folds 
Uncalled bet (€0.02) returned to jolli180
jolli180 collected €0.05 from pot
jolli180: doesn't show hand 
*** SUMMARY ***
Total pot €0.05 | Rake €0 
Board [Qs Jc 4h 3s 8h]
Seat 1: alibabba101 (button) folded before Flop (didn't bet)
Seat 2: caduceus369 (small blind) folded before Flop
Seat 3: rosanero674 (big blind) folded on the River
Seat 4: jolli180 collected (€0.05)
Seat 5: Plutonia72 folded before Flop (didn't bet)
Seat 6: stfuplzudonk folded before Flop (didn't bet)



PokerStars Zoom Hand #257984900158:  Hold'em No Limit (€0.01/€0.02) [ADM ID: M62BA304494E32ST] - 2025/10/03 19:38:21 CET [2025/10/03 13:38:21 ET]
Table 'Sirio' 6-max Seat #1 is the button
Seat 1: caduceus369 (€3.77 in chips) 
Seat 2: IKARO_3 (€1.98 in chips) 
Seat 3: jolli180 (€2.27 in chips) 
Seat 4: TurboMuletto (€1.64 in chips) 
Seat 5: Lelesssss (€1.81 in chips) 
Seat 6: RRgalp (€4.93 in chips) 
IKARO_3: posts small blind €0.01
jolli180: posts big blind €0.02
*** HOLE CARDS ***
Dealt to caduceus369 [Qs 3c]
TurboMuletto: folds 
Lelesssss: folds 
RRgalp: folds 
caduceus369: folds 
IKARO_3: raises €0.04 to €0.06
jolli180: folds 
Uncalled bet (€0.04) returned to IKARO_3
IKARO_3 collected €0.04 from pot
IKARO_3: doesn't show hand 
*** SUMMARY ***
Total pot €0.04 | Rake €0 
Seat 1: caduceus369 (button) folded before Flop (didn't bet)
Seat 2: IKARO_3 (small blind) collected (€0.04)
Seat 3: jolli180 (big blind) folded before Flop
Seat 4: TurboMuletto folded before Flop (didn't bet)
Seat 5: Lelesssss folded before Flop (didn't bet)
Seat 6: RRgalp folded before Flop (didn't bet)



PokerStars Zoom Hand #257984900945:  Hold'em No Limit (€0.01/€0.02) [ADM ID: M62BA304494E32ST] - 2025/10/03 19:38:25 CET [2025/10/03 13:38:25 ET]
Table 'Sirio' 6-max Seat #1 is the button
Seat 1: Teriferro (€0.58 in chips) 
Seat 2: SKERZA (€1.43 in chips) 
Seat 3: Lelesssss (€1.81 in chips) 
Seat 4: stfuplzudonk (€1.56 in chips) 
Seat 5: OMGWOLFX (€12.38 in chips) 
Seat 6: caduceus369 (€3.77 in chips) 
SKERZA: posts small blind €0.01
Lelesssss: posts big blind €0.02
*** HOLE CARDS ***
Dealt to caduceus369 [4c 3s]
stfuplzudonk: folds 
OMGWOLFX: folds 
caduceus369: folds 
Teriferro: raises €0.04 to €0.06
SKERZA: calls €0.05
Lelesssss: folds 
*** FLOP *** [8d 7c 2h]
SKERZA: bets €0.08
Teriferro: folds 
Uncalled bet (€0.08) returned to SKERZA
SKERZA collected €0.14 from pot
SKERZA: doesn't show hand 
*** SUMMARY ***
Total pot €0.14 | Rake €0 
Board [8d 7c 2h]
Seat 1: Teriferro (button) folded on the Flop
Seat 2: SKERZA (small blind) collected (€0.14)
Seat 3: Lelesssss (big blind) folded before Flop
Seat 4: stfuplzudonk folded before Flop (didn't bet)
Seat 5: OMGWOLFX folded before Flop (didn't bet)
Seat 6: caduceus369 folded before Flop (didn't bet)



PokerStars Zoom Hand #257984903848:  Hold'em No Limit (€0.01/€0.02) [ADM ID: M62BA304494E32ST] - 2025/10/03 19:38:39 CET [2025/10/03 13:38:39 ET]
Table 'Sirio' 6-max Seat #1 is the button
Seat 1: IKARO_3 (€1.97 in chips) 
Seat 2: caduceus369 (€3.75 in chips) 
Seat 3: RRgalp (€4.92 in chips) 
Seat 4: buscofan (€2.28 in chips) 
Seat 5: QUATTRODAME (€1.97 in chips) 
Seat 6: Gabrielefante (€2.98 in chips) 
caduceus369: posts small blind €0.01
RRgalp: posts big blind €0.02
*** HOLE CARDS ***
Dealt to caduceus369 [3c 5s]
buscofan: folds 
QUATTRODAME: folds 
Gabrielefante: folds 
IKARO_3: folds 
caduceus369: folds 
Uncalled bet (€0.01) returned to RRgalp
RRgalp collected €0.02 from pot
RRgalp: doesn't show hand 
*** SUMMARY ***
Total pot €0.02 | Rake €0 
Seat 1: IKARO_3 (button) folded before Flop (didn't bet)
Seat 2: caduceus369 (small blind) folded before Flop
Seat 3: RRgalp (big blind) collected (€0.02)
Seat 4: buscofan folded before Flop (didn't bet)
Seat 5: QUATTRODAME folded before Flop (didn't bet)
Seat 6: Gabrielefante folded before Flop (didn't bet)



PokerStars Zoom Hand #257984901771:  Hold'em No Limit (€0.01/€0.02) [ADM ID: M62BA304494E32ST] - 2025/10/03 19:38:29 CET [2025/10/03 13:38:29 ET]
Table 'Sirio' 6-max Seat #1 is the button
Seat 1: GanchanS7 (€3.40 in chips) 
Seat 2: juzam01 (€1.85 in chips) 
Seat 3: kroll219 (€2.28 in chips) 
Seat 4: GIacius (€2.24 in chips) 
Seat 5: caduceus369 (€3.77 in chips) 
Seat 6: ADRIAN0_MEIS (€3.78 in chips) 
juzam01: posts small blind €0.01
kroll219: posts big blind €0.02
*** HOLE CARDS ***
Dealt to caduceus369 [Js 4d]
GIacius: folds 
caduceus369: folds 
ADRIAN0_MEIS: folds 
GanchanS7: folds 
juzam01: raises €0.04 to €0.06
kroll219: calls €0.04
*** FLOP *** [Ad 5c Jh]
juzam01: bets €0.10
kroll219: folds 
Uncalled bet (€0.10) returned to juzam01
juzam01 collected €0.12 from pot
juzam01: doesn't show hand 
*** SUMMARY ***
Total pot €0.12 | Rake €0 
Board [Ad 5c Jh]
Seat 1: GanchanS7 (button) folded before Flop (didn't bet)
Seat 2: juzam01 (small blind) collected (€0.12)
Seat 3: kroll219 (big blind) folded on the Flop
Seat 4: GIacius folded before Flop (didn't bet)
Seat 5: caduceus369 folded before Flop (didn't bet)
Seat 6: ADRIAN0_MEIS folded before Flop (didn't bet)



PokerStars Zoom Hand #257984902616:  Hold'em No Limit (€0.01/€0.02) [ADM ID: M62BA304494E32ST] - 2025/10/03 19:38:33 CET [2025/10/03 13:38:33 ET]
Table 'Sirio' 6-max Seat #1 is the button
Seat 1: stfuplzudonk (€5.55 in chips) 
Seat 2: jolli180 (€2.25 in chips) 
Seat 3: caduceus369 (€3.77 in chips) 
Seat 4: stagniarihd (€4.36 in chips) 
Seat 5: TurboMuletto (€1.63 in chips) 
Seat 6: OSPREYSTORM (€4.36 in chips) 
jolli180: posts small blind €0.01
caduceus369: posts big blind €0.02
*** HOLE CARDS ***
Dealt to caduceus369 [3h 7s]
stagniarihd: folds 
TurboMuletto: raises €0.04 to €0.06
OSPREYSTORM: folds 
stfuplzudonk: calls €0.06
jolli180: folds 
caduceus369: folds 
*** FLOP *** [8s 9s 9h]
TurboMuletto: bets €0.08
stfuplzudonk: folds 
Uncalled bet (€0.08) returned to TurboMuletto
TurboMuletto collected €0.15 from pot
TurboMuletto: doesn't show hand 
*** SUMMARY ***
Total pot €0.15 | Rake €0 
Board [8s 9s 9h]
Seat 1: stfuplzudonk (button) folded on the Flop
Seat 2: jolli180 (small blind) folded before Flop
Seat 3: caduceus369 (big blind) folded before Flop
Seat 4: stagniarihd folded before Flop (didn't bet)
Seat 5: TurboMuletto collected (€0.15)
Seat 6: OSPREYSTORM folded before Flop (didn't bet)



PokerStars Zoom Hand #257984904661:  Hold'em No Limit (€0.01/€0.02) [ADM ID: M62BA304494E32ST] - 2025/10/03 19:38:43 CET [2025/10/03 13:38:43 ET]
Table 'Sirio' 6-max Seat #1 is the button
Seat 1: trillycata (€1.01 in chips) 
Seat 2: stagniarihd (€4.34 in chips) 
Seat 3: larapida1 (€1.60 in chips) 
Seat 4: GanchanS7 (€2 in chips) 
Seat 5: jolli180 (€2.24 in chips) 
Seat 6: caduceus369 (€3.74 in chips) 
stagniarihd: posts small blind €0.01
larapida1: posts big blind €0.02
*** HOLE CARDS ***
Dealt to caduceus369 [Jc Qc]
GanchanS7: folds 
jolli180: folds 
caduceus369: raises €0.04 to €0.06
trillycata: folds 
stagniarihd: calls €0.05
larapida1: calls €0.04
*** FLOP *** [2d 3c 5c]
stagniarihd: bets €0.02
larapida1: calls €0.02
caduceus369: raises €0.08 to €0.10
stagniarihd: calls €0.08
larapida1: calls €0.08
*** TURN *** [2d 3c 5c] [6c]
stagniarihd: checks 
larapida1: bets €1.44 and is all-in
caduceus369: calls €1.44
stagniarihd: calls €1.44
*** RIVER *** [2d 3c 5c 6c] [2c]
stagniarihd: checks 
caduceus369: bets €2.14 and is all-in
stagniarihd: folds 
Uncalled bet (€2.14) returned to caduceus369
*** SHOW DOWN ***
caduceus369: shows [Jc Qc] (a flush, Queen high)
larapida1: shows [2h 6h] (a full house, Deuces full of Sixes)
larapida1 collected €4.54 from pot
*** SUMMARY ***
Total pot €4.80 | Rake €0.26 
Board [2d 3c 5c 6c 2c]
Seat 1: trillycata (button) folded before Flop (didn't bet)
Seat 2: stagniarihd (small blind) folded on the River
Seat 3: larapida1 (big blind) showed [2h 6h] and won (€4.54) with a full house, Deuces full of Sixes
Seat 4: GanchanS7 folded before Flop (didn't bet)
Seat 5: jolli180 folded before Flop (didn't bet)
Seat 6: caduceus369 showed [Jc Qc] and lost with a flush, Queen high



PokerStars Zoom Hand #257984917219:  Hold'em No Limit (€0.01/€0.02) [ADM ID: M62BA304494E32ST] - 2025/10/03 19:39:43 CET [2025/10/03 13:39:43 ET]
Table 'Sirio' 6-max Seat #1 is the button
Seat 1: GanchanS7 (€2.04 in chips) 
Seat 2: EasyToRule (€2 in chips) 
Seat 3: SidneyPrescott (€2.02 in chips) 
Seat 4: caduceus369 (€2.14 in chips) 
Seat 5: OSPREYSTORM (€2.42 in chips) 
Seat 6: stfuplzudonk (€4.64 in chips) 
EasyToRule: posts small blind €0.01
SidneyPrescott: posts big blind €0.02
*** HOLE CARDS ***
Dealt to caduceus369 [7h Ks]
caduceus369: folds 
OSPREYSTORM: folds 
stfuplzudonk: raises €0.04 to €0.06
GanchanS7: folds 
EasyToRule: folds 
SidneyPrescott: raises €0.14 to €0.20
stfuplzudonk: calls €0.14
*** FLOP *** [Jh 2d Ah]
SidneyPrescott: bets €0.20
stfuplzudonk: calls €0.20
*** TURN *** [Jh 2d Ah] [Ad]
SidneyPrescott: bets €0.24
stfuplzudonk: calls €0.24
*** RIVER *** [Jh 2d Ah Ad] [2c]
SidneyPrescott: checks 
stfuplzudonk: bets €0.98
SidneyPrescott: calls €0.98
*** SHOW DOWN ***
stfuplzudonk: shows [Qs As] (a full house, Aces full of Deuces)
SidneyPrescott: mucks hand 
stfuplzudonk collected €3.08 from pot
*** SUMMARY ***
Total pot €3.25 | Rake €0.17 
Board [Jh 2d Ah Ad 2c]
Seat 1: GanchanS7 (button) folded before Flop (didn't bet)
Seat 2: EasyToRule (small blind) folded before Flop
Seat 3: SidneyPrescott (big blind) mucked [Js Kd]
Seat 4: caduceus369 folded before Flop (didn't bet)
Seat 5: OSPREYSTORM folded before Flop (didn't bet)
Seat 6: stfuplzudonk showed [Qs As] and won (€3.08) with a full house, Aces full of Deuces



