PokerStars Zoom Hand #257987710250:  Hold'em No Limit (€0.01/€0.02) [ADM ID: M62BA304494E32ST] - 2025/10/03 23:09:38 CET [2025/10/03 17:09:38 ET]
Table 'Sirio' 6-max Seat #1 is the button
Seat 1: robertoH2O (€2.06 in chips) 
Seat 2: SidneyPrescott (€4.03 in chips) 
Seat 3: caduceus369 (€2 in chips) 
Seat 4: KindRonin (€1.19 in chips) 
Seat 5: AlwaisToRun (€0.73 in chips) 
Seat 6: Neroonciolina (€2.56 in chips) 
SidneyPrescott: posts small blind €0.01
caduceus369: posts big blind €0.02
*** HOLE CARDS ***
Dealt to caduceus369 [4d Kc]
KindRonin: folds 
AlwaisToRun: calls €0.02
Neroonciolina: calls €0.02
robertoH2O: folds 
SidneyPrescott: calls €0.01
caduceus369: checks 
*** FLOP *** [8h 3c Th]
SidneyPrescott: checks 
caduceus369: checks 
AlwaisToRun: checks 
Neroonciolina: checks 
*** TURN *** [8h 3c Th] [9d]
SidneyPrescott: checks 
caduceus369: checks 
AlwaisToRun: checks 
Neroonciolina: checks 
*** RIVER *** [8h 3c Th 9d] [5s]
SidneyPrescott: checks 
caduceus369: bets €0.02
AlwaisToRun: folds 
Neroonciolina: calls €0.02
SidneyPrescott: calls €0.02
*** SHOW DOWN ***
caduceus369: shows [4d Kc] (high card King)
Neroonciolina: mucks hand 
SidneyPrescott: shows [6s Ks] (high card King - Ten+Nine+Eight+Six kicker)
SidneyPrescott collected €0.14 from pot
*** SUMMARY ***
Total pot €0.14 | Rake €0 
Board [8h 3c Th 9d 5s]
Seat 1: robertoH2O (button) folded before Flop (didn't bet)
Seat 2: SidneyPrescott (small blind) showed [6s Ks] and won (€0.14) with high card King
Seat 3: caduceus369 (big blind) showed [4d Kc] and lost with high card King
Seat 4: KindRonin folded before Flop (didn't bet)
Seat 5: AlwaisToRun folded on the River
Seat 6: Neroonciolina mucked [Qc 7s]



PokerStars Zoom Hand #257987730724:  Hold'em No Limit (€0.01/€0.02) [ADM ID: M62BA304494E32ST] - 2025/10/03 23:11:00 CET [2025/10/03 17:11:00 ET]
Table 'Sirio' 6-max Seat #1 is the button
Seat 1: Lion080890 (€2.95 in chips) 
Seat 2: caduceus369 (€1.96 in chips) 
Seat 3: Mr_Frost02 (€1.72 in chips) 
Seat 4: H.Quinn.1987 (€3.98 in chips) 
Seat 5: Neroonciolina (€2.52 in chips) 
Seat 6: SidneyPrescott (€4.13 in chips) 
caduceus369: posts small blind €0.01
Mr_Frost02: posts big blind €0.02
*** HOLE CARDS ***
Dealt to caduceus369 [Td 4h]
H.Quinn.1987: raises €0.04 to €0.06
Neroonciolina: calls €0.06
SidneyPrescott: folds 
Lion080890: calls €0.06
caduceus369: folds 
Mr_Frost02: raises €0.08 to €0.14
H.Quinn.1987: calls €0.08
Neroonciolina: calls €0.08
Lion080890: calls €0.08
*** FLOP *** [Js 2c 2s]
Mr_Frost02: checks 
H.Quinn.1987: checks 
Neroonciolina: bets €0.06
Lion080890: raises €2.75 to €2.81 and is all-in
Mr_Frost02: folds 
H.Quinn.1987: folds 
Neroonciolina: folds 
Uncalled bet (€2.75) returned to Lion080890
Lion080890 collected €0.66 from pot
Lion080890: doesn't show hand 
*** SUMMARY ***
Total pot €0.69 | Rake €0.03 
Board [Js 2c 2s]
Seat 1: Lion080890 (button) collected (€0.66)
Seat 2: caduceus369 (small blind) folded before Flop
Seat 3: Mr_Frost02 (big blind) folded on the Flop
Seat 4: H.Quinn.1987 folded on the Flop
Seat 5: Neroonciolina folded on the Flop
Seat 6: SidneyPrescott folded before Flop (didn't bet)



PokerStars Zoom Hand #257987734962:  Hold'em No Limit (€0.01/€0.02) [ADM ID: M62BA304494E32ST] - 2025/10/03 23:11:17 CET [2025/10/03 17:11:17 ET]
Table 'Sirio' 6-max Seat #1 is the button
Seat 1: caduceus369 (€1.95 in chips) 
Seat 2: ivano747 (€4.92 in chips) 
Seat 3: macchia1010 (€1.76 in chips) 
Seat 4: CacciatoreAA (€2.37 in chips) 
Seat 5: father2008 (€4.04 in chips) 
Seat 6: stfuplzudonk (€2.28 in chips) 
ivano747: posts small blind €0.01
macchia1010: posts big blind €0.02
*** HOLE CARDS ***
Dealt to caduceus369 [Jc Ac]
CacciatoreAA: folds 
father2008: raises €0.05 to €0.07
stfuplzudonk: folds 
caduceus369: calls €0.07
ivano747: folds 
macchia1010: folds 
*** FLOP *** [7s 5d 6c]
father2008: checks 
caduceus369: checks 
*** TURN *** [7s 5d 6c] [Ad]
father2008: bets €0.09
caduceus369: calls €0.09
*** RIVER *** [7s 5d 6c Ad] [5h]
father2008: bets €0.17
caduceus369: raises €0.31 to €0.48
father2008: folds 
Uncalled bet (€0.31) returned to caduceus369
caduceus369 collected €0.66 from pot
caduceus369: doesn't show hand 
*** SUMMARY ***
Total pot €0.69 | Rake €0.03 
Board [7s 5d 6c Ad 5h]
Seat 1: caduceus369 (button) collected (€0.66)
Seat 2: ivano747 (small blind) folded before Flop
Seat 3: macchia1010 (big blind) folded before Flop
Seat 4: CacciatoreAA folded before Flop (didn't bet)
Seat 5: father2008 folded on the River
Seat 6: stfuplzudonk folded before Flop (didn't bet)



PokerStars Zoom Hand #257987751755:  Hold'em No Limit (€0.01/€0.02) [ADM ID: M62BA304494E32ST] - 2025/10/03 23:12:25 CET [2025/10/03 17:12:25 ET]
Table 'Sirio' 6-max Seat #1 is the button
Seat 1: skynet0308 (€0.69 in chips) 
Seat 2: MOLDAVO1069 (€8.80 in chips) 
Seat 3: robertoH2O (€2.54 in chips) 
Seat 4: ivano747 (€4.91 in chips) 
Seat 5: stfuplzudonk (€3.68 in chips) 
Seat 6: caduceus369 (€2.28 in chips) 
MOLDAVO1069: posts small blind €0.01
robertoH2O: posts big blind €0.02
*** HOLE CARDS ***
Dealt to caduceus369 [Qh 5c]
ivano747: folds 
stfuplzudonk: folds 
caduceus369: folds 
skynet0308: raises €0.04 to €0.06
MOLDAVO1069: folds 
robertoH2O: folds 
Uncalled bet (€0.04) returned to skynet0308
skynet0308 collected €0.05 from pot
skynet0308: doesn't show hand 
*** SUMMARY ***
Total pot €0.05 | Rake €0 
Seat 1: skynet0308 (button) collected (€0.05)
Seat 2: MOLDAVO1069 (small blind) folded before Flop
Seat 3: robertoH2O (big blind) folded before Flop
Seat 4: ivano747 folded before Flop (didn't bet)
Seat 5: stfuplzudonk folded before Flop (didn't bet)
Seat 6: caduceus369 folded before Flop (didn't bet)



PokerStars Zoom Hand #257987753449:  Hold'em No Limit (€0.01/€0.02) [ADM ID: M62BA304494E32ST] - 2025/10/03 23:12:32 CET [2025/10/03 17:12:32 ET]
Table 'Sirio' 6-max Seat #1 is the button
Seat 1: SidneyPrescott (€4.72 in chips) 
Seat 2: fantaasso (€1.85 in chips) 
Seat 3: IKARO_3 (€1.88 in chips) 
Seat 4: MOLDAVO1069 (€2.65 in chips) 
Seat 5: caduceus369 (€2.28 in chips) 
Seat 6: ivano747 (€3.68 in chips) 
fantaasso: posts small blind €0.01
IKARO_3: posts big blind €0.02
*** HOLE CARDS ***
Dealt to caduceus369 [7s 7d]
MOLDAVO1069: folds 
caduceus369: calls €0.02
ivano747: folds 
SidneyPrescott: raises €0.06 to €0.08
fantaasso: folds 
IKARO_3: folds 
caduceus369: calls €0.06
*** FLOP *** [8h 2d Qh]
caduceus369: checks 
SidneyPrescott: bets €0.08
caduceus369: folds 
Uncalled bet (€0.08) returned to SidneyPrescott
SidneyPrescott collected €0.18 from pot
SidneyPrescott: doesn't show hand 
*** SUMMARY ***
Total pot €0.19 | Rake €0.01 
Board [8h 2d Qh]
Seat 1: SidneyPrescott (button) collected (€0.18)
Seat 2: fantaasso (small blind) folded before Flop
Seat 3: IKARO_3 (big blind) folded before Flop
Seat 4: MOLDAVO1069 folded before Flop (didn't bet)
Seat 5: caduceus369 folded on the Flop
Seat 6: ivano747 folded before Flop (didn't bet)



PokerStars Zoom Hand #257987764359:  Hold'em No Limit (€0.01/€0.02) [ADM ID: M62BA304494E32ST] - 2025/10/03 23:13:16 CET [2025/10/03 17:13:16 ET]
Table 'Sirio' 6-max Seat #1 is the button
Seat 1: Ghost2773 (€3.59 in chips) 
Seat 2: Neroonciolina (€2.31 in chips) 
Seat 3: caduceus369 (€2.20 in chips) 
Seat 4: robertoH2O (€2.51 in chips) 
Seat 5: gs0097 (€0.30 in chips) 
Seat 6: rounders121282 (€6.19 in chips) 
Neroonciolina: posts small blind €0.01
caduceus369: posts big blind €0.02
*** HOLE CARDS ***
Dealt to caduceus369 [9s Ac]
robertoH2O: folds 
gs0097: raises €0.05 to €0.07
rounders121282: folds 
Ghost2773: folds 
Neroonciolina: folds 
caduceus369: folds 
Uncalled bet (€0.05) returned to gs0097
gs0097 collected €0.05 from pot
gs0097: doesn't show hand 
*** SUMMARY ***
Total pot €0.05 | Rake €0 
Seat 1: Ghost2773 (button) folded before Flop (didn't bet)
Seat 2: Neroonciolina (small blind) folded before Flop
Seat 3: caduceus369 (big blind) folded before Flop
Seat 4: robertoH2O folded before Flop (didn't bet)
Seat 5: gs0097 collected (€0.05)
Seat 6: rounders121282 folded before Flop (didn't bet)



PokerStars Zoom Hand #257987762146:  Hold'em No Limit (€0.01/€0.02) [ADM ID: M62BA304494E32ST] - 2025/10/03 23:13:07 CET [2025/10/03 17:13:07 ET]
Table 'Sirio' 6-max Seat #1 is the button
Seat 1: stfuplzudonk (€3.66 in chips) 
Seat 2: EasyToRule (€2.50 in chips) 
Seat 3: Generalexx (€1.64 in chips) 
Seat 4: caduceus369 (€2.20 in chips) 
Seat 5: robertoH2O (€2.51 in chips) 
Seat 6: ADRIAN0_MEIS (€12.59 in chips) 
EasyToRule: posts small blind €0.01
Generalexx: posts big blind €0.02
*** HOLE CARDS ***
Dealt to caduceus369 [9d Td]
caduceus369: folds 
robertoH2O: folds 
ADRIAN0_MEIS: raises €0.04 to €0.06
stfuplzudonk: folds 
EasyToRule: folds 
Generalexx: calls €0.04
*** FLOP *** [8d 7s 4s]
Generalexx: checks 
ADRIAN0_MEIS is disconnected 
ADRIAN0_MEIS: checks 
*** TURN *** [8d 7s 4s] [2d]
Generalexx: checks 
ADRIAN0_MEIS: checks 
*** RIVER *** [8d 7s 4s 2d] [9c]
Generalexx: checks 
ADRIAN0_MEIS: checks 
*** SHOW DOWN ***
Generalexx: shows [As Ts] (high card Ace)
ADRIAN0_MEIS: mucks hand 
Generalexx collected €0.13 from pot
*** SUMMARY ***
Total pot €0.13 | Rake €0 
Board [8d 7s 4s 2d 9c]
Seat 1: stfuplzudonk (button) folded before Flop (didn't bet)
Seat 2: EasyToRule (small blind) folded before Flop
Seat 3: Generalexx (big blind) showed [As Ts] and won (€0.13) with high card Ace
Seat 4: caduceus369 folded before Flop (didn't bet)
Seat 5: robertoH2O folded before Flop (didn't bet)
Seat 6: ADRIAN0_MEIS mucked [Qh Kc]



PokerStars Zoom Hand #257987771515:  Hold'em No Limit (€0.01/€0.02) [ADM ID: M62BA304494E32ST] - 2025/10/03 23:13:48 CET [2025/10/03 17:13:48 ET]
Table 'Sirio' 6-max Seat #1 is the button
Seat 1: caduceus369 (€2.18 in chips) 
Seat 2: EasyToRule (€2.09 in chips) 
Seat 3: stfuplzudonk (€2.33 in chips) 
Seat 4: Neroonciolina (€2.28 in chips) 
Seat 5: Ghost2773 (€3.53 in chips) 
Seat 6: KindRonin (€1.10 in chips) 
EasyToRule: posts small blind €0.01
stfuplzudonk: posts big blind €0.02
*** HOLE CARDS ***
Dealt to caduceus369 [8c As]
Neroonciolina: raises €0.02 to €0.04
Ghost2773: folds 
KindRonin: folds 
caduceus369: folds 
EasyToRule: folds 
stfuplzudonk: calls €0.02
*** FLOP *** [3c Tc 2c]
stfuplzudonk: checks 
Neroonciolina: bets €0.02
stfuplzudonk: folds 
Uncalled bet (€0.02) returned to Neroonciolina
Neroonciolina collected €0.09 from pot
Neroonciolina: doesn't show hand 
*** SUMMARY ***
Total pot €0.09 | Rake €0 
Board [3c Tc 2c]
Seat 1: caduceus369 (button) folded before Flop (didn't bet)
Seat 2: EasyToRule (small blind) folded before Flop
Seat 3: stfuplzudonk (big blind) folded on the Flop
Seat 4: Neroonciolina collected (€0.09)
Seat 5: Ghost2773 folded before Flop (didn't bet)
Seat 6: KindRonin folded before Flop (didn't bet)



PokerStars Zoom Hand #257987774538:  Hold'em No Limit (€0.01/€0.02) [ADM ID: M62BA304494E32ST] - 2025/10/03 23:14:01 CET [2025/10/03 17:14:01 ET]
Table 'Sirio' 6-max Seat #1 is the button
Seat 1: trillycata (€3.82 in chips) 
Seat 2: fantaasso (€1.85 in chips) 
Seat 3: lucpri (€2.37 in chips) 
Seat 4: Sium12302 (€2 in chips) 
Seat 5: Ghost2773 (€3.53 in chips) 
Seat 6: caduceus369 (€2.17 in chips) 
fantaasso: posts small blind €0.01
lucpri: posts big blind €0.02
*** HOLE CARDS ***
Dealt to caduceus369 [8s 3s]
Sium12302: folds 
Ghost2773: folds 
caduceus369: folds 
trillycata: calls €0.02
fantaasso: folds 
lucpri: checks 
*** FLOP *** [5d 2s Qh]
lucpri: checks 
trillycata: bets €0.03
lucpri: folds 
Uncalled bet (€0.03) returned to trillycata
trillycata collected €0.05 from pot
trillycata: doesn't show hand 
*** SUMMARY ***
Total pot €0.05 | Rake €0 
Board [5d 2s Qh]
Seat 1: trillycata (button) collected (€0.05)
Seat 2: fantaasso (small blind) folded before Flop
Seat 3: lucpri (big blind) folded on the Flop
Seat 4: Sium12302 folded before Flop (didn't bet)
Seat 5: Ghost2773 folded before Flop (didn't bet)
Seat 6: caduceus369 folded before Flop (didn't bet)



PokerStars Zoom Hand #257987773597:  Hold'em No Limit (€0.01/€0.02) [ADM ID: M62BA304494E32ST] - 2025/10/03 23:13:57 CET [2025/10/03 17:13:57 ET]
Table 'Sirio' 6-max Seat #1 is the button
Seat 1: stfuplzudonk (€2.40 in chips) 
Seat 2: caduceus369 (€2.18 in chips) 
Seat 3: J.S.Somers (€3.42 in chips) 
Seat 4: IKARO_3 (€1.98 in chips) 
Seat 5: fantaasso (€1.85 in chips) 
Seat 6: MOLDAVO1069 (€8.80 in chips) 
caduceus369: posts small blind €0.01
J.S.Somers: posts big blind €0.02
*** HOLE CARDS ***
Dealt to caduceus369 [4c 5d]
IKARO_3: folds 
fantaasso: folds 
MOLDAVO1069: raises €0.03 to €0.05
stfuplzudonk: folds 
caduceus369: folds 
J.S.Somers: calls €0.03
*** FLOP *** [7d Qs Ad]
J.S.Somers: bets €0.10
MOLDAVO1069: calls €0.10
*** TURN *** [7d Qs Ad] [4s]
J.S.Somers: bets €0.34
MOLDAVO1069: calls €0.34
*** RIVER *** [7d Qs Ad 4s] [4d]
J.S.Somers: checks 
MOLDAVO1069: checks 
*** SHOW DOWN ***
J.S.Somers: shows [7s Ah] (two pair, Aces and Sevens)
MOLDAVO1069: shows [Qh As] (two pair, Aces and Queens)
MOLDAVO1069 collected €0.94 from pot
*** SUMMARY ***
Total pot €0.99 | Rake €0.05 
Board [7d Qs Ad 4s 4d]
Seat 1: stfuplzudonk (button) folded before Flop (didn't bet)
Seat 2: caduceus369 (small blind) folded before Flop
Seat 3: J.S.Somers (big blind) showed [7s Ah] and lost with two pair, Aces and Sevens
Seat 4: IKARO_3 folded before Flop (didn't bet)
Seat 5: fantaasso folded before Flop (didn't bet)
Seat 6: MOLDAVO1069 showed [Qh As] and won (€0.94) with two pair, Aces and Queens



PokerStars Zoom Hand #257987775533:  Hold'em No Limit (€0.01/€0.02) [ADM ID: M62BA304494E32ST] - 2025/10/03 23:14:05 CET [2025/10/03 17:14:05 ET]
Table 'Sirio' 6-max Seat #1 is the button
Seat 1: bruciapelo (€1.94 in chips) 
Seat 2: IKARO_3 (€2.59 in chips) 
Seat 3: pia1256 (€0.97 in chips) 
Seat 4: caduceus369 (€2.17 in chips) 
Seat 5: TripInter (€1.57 in chips) 
Seat 6: rounders121282 (€6.14 in chips) 
IKARO_3: posts small blind €0.01
pia1256: posts big blind €0.02
*** HOLE CARDS ***
Dealt to caduceus369 [Jc Qs]
caduceus369: raises €0.04 to €0.06
TripInter: folds 
rounders121282: calls €0.06
bruciapelo: folds 
IKARO_3: folds 
pia1256: calls €0.04
*** FLOP *** [Kh 8h 7d]
pia1256: checks 
caduceus369: bets €0.06
rounders121282: calls €0.06
pia1256: folds 
*** TURN *** [Kh 8h 7d] [Jh]
caduceus369: checks 
rounders121282: bets €0.15
caduceus369: folds 
Uncalled bet (€0.15) returned to rounders121282
rounders121282 collected €0.30 from pot
rounders121282: doesn't show hand 
*** SUMMARY ***
Total pot €0.31 | Rake €0.01 
Board [Kh 8h 7d Jh]
Seat 1: bruciapelo (button) folded before Flop (didn't bet)
Seat 2: IKARO_3 (small blind) folded before Flop
Seat 3: pia1256 (big blind) folded on the Flop
Seat 4: caduceus369 folded on the Turn
Seat 5: TripInter folded before Flop (didn't bet)
Seat 6: rounders121282 collected (€0.30)



PokerStars Zoom Hand #257987788655:  Hold'em No Limit (€0.01/€0.02) [ADM ID: M62BA304494E32ST] - 2025/10/03 23:14:58 CET [2025/10/03 17:14:58 ET]
Table 'Sirio' 6-max Seat #1 is the button
Seat 1: robertoH2O (€2.90 in chips) 
Seat 2: TripInter (€1.53 in chips) 
Seat 3: Catania838 (€1.57 in chips) 
Seat 4: SidneyPrescott (€4.86 in chips) 
Seat 5: caduceus369 (€2.05 in chips) 
Seat 6: CacciatoreAA (€2.37 in chips) 
TripInter: posts small blind €0.01
Catania838: posts big blind €0.02
*** HOLE CARDS ***
Dealt to caduceus369 [5d 8s]
SidneyPrescott: folds 
caduceus369: folds 
CacciatoreAA: folds 
robertoH2O: folds 
TripInter: folds 
Uncalled bet (€0.01) returned to Catania838
Catania838 collected €0.02 from pot
Catania838: doesn't show hand 
*** SUMMARY ***
Total pot €0.02 | Rake €0 
Seat 1: robertoH2O (button) folded before Flop (didn't bet)
Seat 2: TripInter (small blind) folded before Flop
Seat 3: Catania838 (big blind) collected (€0.02)
Seat 4: SidneyPrescott folded before Flop (didn't bet)
Seat 5: caduceus369 folded before Flop (didn't bet)
Seat 6: CacciatoreAA folded before Flop (didn't bet)



PokerStars Zoom Hand #257987790212:  Hold'em No Limit (€0.01/€0.02) [ADM ID: M62BA304494E32ST] - 2025/10/03 23:15:04 CET [2025/10/03 17:15:04 ET]
Table 'Sirio' 6-max Seat #1 is the button
Seat 1: H.Quinn.1987 (€2.86 in chips) 
Seat 2: trillycata (€3.86 in chips) 
Seat 3: caduceus369 (€2.05 in chips) 
Seat 4: montemeru (€1.73 in chips) 
Seat 5: IKARO_3 (€2.77 in chips) 
Seat 6: stfuplzudonk (€2.21 in chips) 
trillycata: posts small blind €0.01
caduceus369: posts big blind €0.02
*** HOLE CARDS ***
Dealt to caduceus369 [Qs 6h]
montemeru: folds 
IKARO_3: folds 
stfuplzudonk: folds 
H.Quinn.1987: folds 
trillycata: calls €0.01
caduceus369: checks 
*** FLOP *** [7c 2d 5s]
trillycata: checks 
caduceus369: checks 
*** TURN *** [7c 2d 5s] [8h]
trillycata: checks 
caduceus369: bets €0.02
trillycata: folds 
Uncalled bet (€0.02) returned to caduceus369
caduceus369 collected €0.04 from pot
caduceus369: doesn't show hand 
*** SUMMARY ***
Total pot €0.04 | Rake €0 
Board [7c 2d 5s 8h]
Seat 1: H.Quinn.1987 (button) folded before Flop (didn't bet)
Seat 2: trillycata (small blind) folded on the Turn
Seat 3: caduceus369 (big blind) collected (€0.04)
Seat 4: montemeru folded before Flop (didn't bet)
Seat 5: IKARO_3 folded before Flop (didn't bet)
Seat 6: stfuplzudonk folded before Flop (didn't bet)



PokerStars Zoom Hand #257987800157:  Hold'em No Limit (€0.01/€0.02) [ADM ID: M62BA304494E32ST] - 2025/10/03 23:15:44 CET [2025/10/03 17:15:44 ET]
Table 'Sirio' 6-max Seat #1 is the button
Seat 1: caduceus369 (€2.07 in chips) 
Seat 2: lucpri (€2.39 in chips) 
Seat 3: robertoH2O (€2.64 in chips) 
Seat 4: CacciatoreAA (€2.24 in chips) 
Seat 5: Lion080890 (€1.34 in chips) 
Seat 6: Catania838 (€1.57 in chips) 
lucpri: posts small blind €0.01
robertoH2O: posts big blind €0.02
*** HOLE CARDS ***
Dealt to caduceus369 [Ah 5d]
CacciatoreAA: raises €0.06 to €0.08
Lion080890: raises €1.26 to €1.34 and is all-in
Catania838: folds 
caduceus369: folds 
lucpri: folds 
robertoH2O: folds 
CacciatoreAA: calls €1.26
*** FLOP *** [8s Js Kh]
*** TURN *** [8s Js Kh] [5s]
*** RIVER *** [8s Js Kh 5s] [2c]
*** SHOW DOWN ***
CacciatoreAA: shows [As Qs] (a flush, Ace high)
Lion080890: shows [Qh 7s] (high card King)
CacciatoreAA collected €2.57 from pot
*** SUMMARY ***
Total pot €2.71 | Rake €0.14 
Board [8s Js Kh 5s 2c]
Seat 1: caduceus369 (button) folded before Flop (didn't bet)
Seat 2: lucpri (small blind) folded before Flop
Seat 3: robertoH2O (big blind) folded before Flop
Seat 4: CacciatoreAA showed [As Qs] and won (€2.57) with a flush, Ace high
Seat 5: Lion080890 showed [Qh 7s] and lost with high card King
Seat 6: Catania838 folded before Flop (didn't bet)



PokerStars Zoom Hand #257987802693:  Hold'em No Limit (€0.01/€0.02) [ADM ID: M62BA304494E32ST] - 2025/10/03 23:15:54 CET [2025/10/03 17:15:54 ET]
Table 'Sirio' 6-max Seat #1 is the button
Seat 1: trillycata (€3.84 in chips) 
Seat 2: caduceus369 (€2.07 in chips) 
Seat 3: Sium12302 (€2.03 in chips) 
Seat 4: Catania838 (€1.57 in chips) 
Seat 5: H.Quinn.1987 (€3.98 in chips) 
Seat 6: TripInter (€1.43 in chips) 
caduceus369: posts small blind €0.01
Sium12302: posts big blind €0.02
*** HOLE CARDS ***
Dealt to caduceus369 [As 9d]
Catania838: calls €0.02
H.Quinn.1987: folds 
TripInter: calls €0.02
trillycata: folds 
caduceus369: folds 
Sium12302: checks 
*** FLOP *** [Jd Qd 8h]
Sium12302: checks 
Catania838: bets €0.04
TripInter: calls €0.04
Sium12302: folds 
*** TURN *** [Jd Qd 8h] [2c]
Catania838: bets €0.15
TripInter: folds 
Uncalled bet (€0.15) returned to Catania838
Catania838 collected €0.15 from pot
Catania838: doesn't show hand 
*** SUMMARY ***
Total pot €0.15 | Rake €0 
Board [Jd Qd 8h 2c]
Seat 1: trillycata (button) folded before Flop (didn't bet)
Seat 2: caduceus369 (small blind) folded before Flop
Seat 3: Sium12302 (big blind) folded on the Flop
Seat 4: Catania838 collected (€0.15)
Seat 5: H.Quinn.1987 folded before Flop (didn't bet)
Seat 6: TripInter folded on the Turn



PokerStars Zoom Hand #257987806340:  Hold'em No Limit (€0.01/€0.02) [ADM ID: M62BA304494E32ST] - 2025/10/03 23:16:09 CET [2025/10/03 17:16:09 ET]
Table 'Sirio' 6-max Seat #1 is the button
Seat 1: CacciatoreAA (€3.47 in chips) 
Seat 2: robertoH2O (€2.62 in chips) 
Seat 3: cartoonbest (€0.90 in chips) 
Seat 4: H.Quinn.1987 (€3.98 in chips) 
Seat 5: father2008 (€6.28 in chips) 
Seat 6: caduceus369 (€2.06 in chips) 
robertoH2O: posts small blind €0.01
cartoonbest: posts big blind €0.02
*** HOLE CARDS ***
Dealt to caduceus369 [8c 6h]
H.Quinn.1987: folds 
father2008: raises €0.05 to €0.07
caduceus369: folds 
CacciatoreAA: folds 
robertoH2O: folds 
cartoonbest: folds 
Uncalled bet (€0.05) returned to father2008
father2008 collected €0.05 from pot
father2008: doesn't show hand 
*** SUMMARY ***
Total pot €0.05 | Rake €0 
Seat 1: CacciatoreAA (button) folded before Flop (didn't bet)
Seat 2: robertoH2O (small blind) folded before Flop
Seat 3: cartoonbest (big blind) folded before Flop
Seat 4: H.Quinn.1987 folded before Flop (didn't bet)
Seat 5: father2008 collected (€0.05)
Seat 6: caduceus369 folded before Flop (didn't bet)



PokerStars Zoom Hand #257987810861:  Hold'em No Limit (€0.01/€0.02) [ADM ID: M62BA304494E32ST] - 2025/10/03 23:16:27 CET [2025/10/03 17:16:27 ET]
Table 'Sirio' 6-max Seat #1 is the button
Seat 1: bruciapelo (€2.26 in chips) 
Seat 2: stfuplzudonk (€3.25 in chips) 
Seat 3: caduceus369 (€2.06 in chips) 
Seat 4: MOLDAVO1069 (€2.39 in chips) 
Seat 5: SidneyPrescott (€3.62 in chips) 
Seat 6: montemeru (€2.10 in chips) 
stfuplzudonk: posts small blind €0.01
caduceus369: posts big blind €0.02
*** HOLE CARDS ***
Dealt to caduceus369 [6d Qd]
MOLDAVO1069: folds 
SidneyPrescott: folds 
montemeru: raises €0.04 to €0.06
bruciapelo: folds 
stfuplzudonk: folds 
caduceus369: folds 
Uncalled bet (€0.04) returned to montemeru
montemeru collected €0.05 from pot
montemeru: doesn't show hand 
*** SUMMARY ***
Total pot €0.05 | Rake €0 
Seat 1: bruciapelo (button) folded before Flop (didn't bet)
Seat 2: stfuplzudonk (small blind) folded before Flop
Seat 3: caduceus369 (big blind) folded before Flop
Seat 4: MOLDAVO1069 folded before Flop (didn't bet)
Seat 5: SidneyPrescott folded before Flop (didn't bet)
Seat 6: montemeru collected (€0.05)



PokerStars Zoom Hand #257987814431:  Hold'em No Limit (€0.01/€0.02) [ADM ID: M62BA304494E32ST] - 2025/10/03 23:16:41 CET [2025/10/03 17:16:41 ET]
Table 'Sirio' 6-max Seat #1 is the button
Seat 1: AIA427 (€1.39 in chips) 
Seat 2: ivano747 (€4.65 in chips) 
Seat 3: trillycata (€3.96 in chips) 
Seat 4: H.Quinn.1987 (€3.69 in chips) 
Seat 5: caduceus369 (€2.04 in chips) 
Seat 6: Catania838 (€1.63 in chips) 
ivano747: posts small blind €0.01
trillycata: posts big blind €0.02
*** HOLE CARDS ***
Dealt to caduceus369 [7h 4c]
H.Quinn.1987: folds 
caduceus369: folds 
Catania838: calls €0.02
AIA427: raises €1.37 to €1.39 and is all-in
ivano747: folds 
trillycata: folds 
Catania838: folds 
Uncalled bet (€1.37) returned to AIA427
AIA427 collected €0.07 from pot
AIA427: doesn't show hand 
*** SUMMARY ***
Total pot €0.07 | Rake €0 
Seat 1: AIA427 (button) collected (€0.07)
Seat 2: ivano747 (small blind) folded before Flop
Seat 3: trillycata (big blind) folded before Flop
Seat 4: H.Quinn.1987 folded before Flop (didn't bet)
Seat 5: caduceus369 folded before Flop (didn't bet)
Seat 6: Catania838 folded before Flop



PokerStars Zoom Hand #257987815659:  Hold'em No Limit (€0.01/€0.02) [ADM ID: M62BA304494E32ST] - 2025/10/03 23:16:46 CET [2025/10/03 17:16:46 ET]
Table 'Sirio' 6-max Seat #1 is the button
Seat 1: macchia1010 (€1.09 in chips) 
Seat 2: caduceus369 (€2.04 in chips) 
Seat 3: rounders121282 (€5.98 in chips) 
Seat 4: ivano747 (€4.64 in chips) 
Seat 5: J.S.Somers (€1.44 in chips) 
Seat 6: father2008 (€6.28 in chips) 
caduceus369: posts small blind €0.01
rounders121282: posts big blind €0.02
*** HOLE CARDS ***
Dealt to caduceus369 [2s 9h]
ivano747: folds 
J.S.Somers: folds 
father2008: folds 
macchia1010: calls €0.02
caduceus369: folds 
rounders121282: checks 
*** FLOP *** [Ac 9d 6s]
rounders121282: checks 
macchia1010: bets €0.06
rounders121282: folds 
Uncalled bet (€0.06) returned to macchia1010
macchia1010 collected €0.05 from pot
macchia1010: doesn't show hand 
*** SUMMARY ***
Total pot €0.05 | Rake €0 
Board [Ac 9d 6s]
Seat 1: macchia1010 (button) collected (€0.05)
Seat 2: caduceus369 (small blind) folded before Flop
Seat 3: rounders121282 (big blind) folded on the Flop
Seat 4: ivano747 folded before Flop (didn't bet)
Seat 5: J.S.Somers folded before Flop (didn't bet)
Seat 6: father2008 folded before Flop (didn't bet)



PokerStars Zoom Hand #257987819040:  Hold'em No Limit (€0.01/€0.02) [ADM ID: M62BA304494E32ST] - 2025/10/03 23:17:00 CET [2025/10/03 17:17:00 ET]
Table 'Sirio' 6-max Seat #1 is the button
Seat 1: caduceus369 (€2.03 in chips) 
Seat 2: SidneyPrescott (€3.60 in chips) 
Seat 3: lucpri (€2.35 in chips) 
Seat 4: robertoH2O (€2.56 in chips) 
Seat 5: gs0097 (€0.49 in chips) 
Seat 6: ivano747 (€3.03 in chips) 
SidneyPrescott: posts small blind €0.01
lucpri: posts big blind €0.02
*** HOLE CARDS ***
Dealt to caduceus369 [8h 3d]
robertoH2O: folds 
gs0097: folds 
ivano747: folds 
caduceus369: folds 
SidneyPrescott: folds 
Uncalled bet (€0.01) returned to lucpri
lucpri collected €0.02 from pot
lucpri: doesn't show hand 
*** SUMMARY ***
Total pot €0.02 | Rake €0 
Seat 1: caduceus369 (button) folded before Flop (didn't bet)
Seat 2: SidneyPrescott (small blind) folded before Flop
Seat 3: lucpri (big blind) collected (€0.02)
Seat 4: robertoH2O folded before Flop (didn't bet)
Seat 5: gs0097 folded before Flop (didn't bet)
Seat 6: ivano747 folded before Flop (didn't bet)



PokerStars Zoom Hand #257987820135:  Hold'em No Limit (€0.01/€0.02) [ADM ID: M62BA304494E32ST] - 2025/10/03 23:17:05 CET [2025/10/03 17:17:05 ET]
Table 'Sirio' 6-max Seat #1 is the button
Seat 1: Catania838 (€1.61 in chips) 
Seat 2: MOLDAVO1069 (€2.37 in chips) 
Seat 3: stfuplzudonk (€2.01 in chips) 
Seat 4: robertoH2O (€2.56 in chips) 
Seat 5: caduceus369 (€2.03 in chips) 
Seat 6: ivano747 (€4.62 in chips) 
MOLDAVO1069: posts small blind €0.01
stfuplzudonk: posts big blind €0.02
*** HOLE CARDS ***
Dealt to caduceus369 [7d Ts]
robertoH2O: folds 
caduceus369: folds 
ivano747: folds 
Catania838: folds 
MOLDAVO1069: raises €0.04 to €0.06
stfuplzudonk: calls €0.04
*** FLOP *** [8d 4h 5s]
MOLDAVO1069: bets €0.05
stfuplzudonk: folds 
Uncalled bet (€0.05) returned to MOLDAVO1069
MOLDAVO1069 collected €0.12 from pot
MOLDAVO1069: doesn't show hand 
*** SUMMARY ***
Total pot €0.12 | Rake €0 
Board [8d 4h 5s]
Seat 1: Catania838 (button) folded before Flop (didn't bet)
Seat 2: MOLDAVO1069 (small blind) collected (€0.12)
Seat 3: stfuplzudonk (big blind) folded on the Flop
Seat 4: robertoH2O folded before Flop (didn't bet)
Seat 5: caduceus369 folded before Flop (didn't bet)
Seat 6: ivano747 folded before Flop (didn't bet)



PokerStars Zoom Hand #257987822753:  Hold'em No Limit (€0.01/€0.02) [ADM ID: M62BA304494E32ST] - 2025/10/03 23:17:15 CET [2025/10/03 17:17:15 ET]
Table 'Sirio' 6-max Seat #1 is the button
Seat 1: EasyToRule (€2.27 in chips) 
Seat 2: ivano747 (€4.62 in chips) 
Seat 3: caduceus369 (€2.03 in chips) 
Seat 4: Mr_Frost02 (€1.15 in chips) 
Seat 5: MOLDAVO1069 (€9.40 in chips) 
Seat 6: curlinho (€1.50 in chips) 
ivano747: posts small blind €0.01
caduceus369: posts big blind €0.02
*** HOLE CARDS ***
Dealt to caduceus369 [5h 4s]
Mr_Frost02: folds 
MOLDAVO1069: folds 
curlinho: folds 
EasyToRule: raises €0.04 to €0.06
ivano747: folds 
caduceus369: folds 
Uncalled bet (€0.04) returned to EasyToRule
EasyToRule collected €0.05 from pot
EasyToRule: doesn't show hand 
*** SUMMARY ***
Total pot €0.05 | Rake €0 
Seat 1: EasyToRule (button) collected (€0.05)
Seat 2: ivano747 (small blind) folded before Flop
Seat 3: caduceus369 (big blind) folded before Flop
Seat 4: Mr_Frost02 folded before Flop (didn't bet)
Seat 5: MOLDAVO1069 folded before Flop (didn't bet)
Seat 6: curlinho folded before Flop (didn't bet)



PokerStars Zoom Hand #257987821775:  Hold'em No Limit (€0.01/€0.02) [ADM ID: M62BA304494E32ST] - 2025/10/03 23:17:11 CET [2025/10/03 17:17:11 ET]
Table 'Sirio' 6-max Seat #1 is the button
Seat 1: Witness85906 (€4.32 in chips) 
Seat 2: robertoH2O (€3.52 in chips) 
Seat 3: AlwaisToRun (€0.66 in chips) 
Seat 4: Catania838 (€1.61 in chips) 
Seat 5: macchia1010 (€1.12 in chips) 
Seat 6: caduceus369 (€2.03 in chips) 
robertoH2O: posts small blind €0.01
AlwaisToRun: posts big blind €0.02
*** HOLE CARDS ***
Dealt to caduceus369 [9d 3h]
Catania838: folds 
macchia1010: calls €0.02
caduceus369: folds 
Witness85906: raises €0.06 to €0.08
robertoH2O: folds 
AlwaisToRun: folds 
macchia1010: folds 
Uncalled bet (€0.06) returned to Witness85906
Witness85906 collected €0.07 from pot
Witness85906: doesn't show hand 
*** SUMMARY ***
Total pot €0.07 | Rake €0 
Seat 1: Witness85906 (button) collected (€0.07)
Seat 2: robertoH2O (small blind) folded before Flop
Seat 3: AlwaisToRun (big blind) folded before Flop
Seat 4: Catania838 folded before Flop (didn't bet)
Seat 5: macchia1010 folded before Flop
Seat 6: caduceus369 folded before Flop (didn't bet)



PokerStars Zoom Hand #257987809193:  Hold'em No Limit (€0.01/€0.02) [ADM ID: M62BA304494E32ST] - 2025/10/03 23:16:20 CET [2025/10/03 17:16:20 ET]
Table 'Sirio' 6-max Seat #1 is the button
Seat 1: sgiafun (€0.82 in chips) 
Seat 2: Mr_Frost02 (€1.16 in chips) 
Seat 3: ahehihohuh0 (€0.91 in chips) 
Seat 4: caduceus369 (€2.06 in chips) 
Seat 5: stfuplzudonk (€2.24 in chips) 
Seat 6: Sium12302 (€2.01 in chips) 
Mr_Frost02: posts small blind €0.01
ahehihohuh0: posts big blind €0.02
*** HOLE CARDS ***
Dealt to caduceus369 [Qh 9c]
caduceus369: folds 
stfuplzudonk: raises €0.02 to €0.04
Sium12302 has timed out
Sium12302: folds 
sgiafun: raises €0.11 to €0.15
Mr_Frost02: folds 
ahehihohuh0: folds 
stfuplzudonk: calls €0.11
*** FLOP *** [3c 4c 7s]
stfuplzudonk: bets €0.16
sgiafun: calls €0.16
*** TURN *** [3c 4c 7s] [Td]
stfuplzudonk: checks 
sgiafun: checks 
*** RIVER *** [3c 4c 7s Td] [9h]
stfuplzudonk: checks 
sgiafun: checks 
*** SHOW DOWN ***
stfuplzudonk: shows [6c 6s] (a pair of Sixes)
sgiafun: mucks hand 
stfuplzudonk collected €0.62 from pot
*** SUMMARY ***
Total pot €0.65 | Rake €0.03 
Board [3c 4c 7s Td 9h]
Seat 1: sgiafun (button) mucked [Ad 6d]
Seat 2: Mr_Frost02 (small blind) folded before Flop
Seat 3: ahehihohuh0 (big blind) folded before Flop
Seat 4: caduceus369 folded before Flop (didn't bet)
Seat 5: stfuplzudonk showed [6c 6s] and won (€0.62) with a pair of Sixes
Seat 6: Sium12302 folded before Flop (didn't bet)



PokerStars Zoom Hand #257987827735:  Hold'em No Limit (€0.01/€0.02) [ADM ID: M62BA304494E32ST] - 2025/10/03 23:17:36 CET [2025/10/03 17:17:36 ET]
Table 'Sirio' 6-max Seat #1 is the button
Seat 1: caduceus369 (€2.01 in chips) 
Seat 2: Catania838 (€1.72 in chips) 
Seat 3: neoilnervoso (€2 in chips) 
Seat 4: SidneyPrescott (€3.51 in chips) 
Seat 5: EasyToRule (€2.05 in chips) 
Seat 6: J.S.Somers (€1.02 in chips) 
Catania838: posts small blind €0.01
neoilnervoso: posts big blind €0.02
*** HOLE CARDS ***
Dealt to caduceus369 [Jd As]
SidneyPrescott: folds 
EasyToRule: folds 
J.S.Somers: folds 
caduceus369: raises €0.04 to €0.06
Catania838: folds 
neoilnervoso: folds 
Uncalled bet (€0.04) returned to caduceus369
caduceus369 collected €0.05 from pot
caduceus369: doesn't show hand 
*** SUMMARY ***
Total pot €0.05 | Rake €0 
Seat 1: caduceus369 (button) collected (€0.05)
Seat 2: Catania838 (small blind) folded before Flop
Seat 3: neoilnervoso (big blind) folded before Flop
Seat 4: SidneyPrescott folded before Flop (didn't bet)
Seat 5: EasyToRule folded before Flop (didn't bet)
Seat 6: J.S.Somers folded before Flop (didn't bet)



PokerStars Zoom Hand #257987837833:  Hold'em No Limit (€0.01/€0.02) [ADM ID: M62BA304494E32ST] - 2025/10/03 23:18:17 CET [2025/10/03 17:18:17 ET]
Table 'Sirio' 6-max Seat #1 is the button
Seat 1: Catania838 (€1.51 in chips) 
Seat 2: gs0097 (€0.61 in chips) 
Seat 3: robertoH2O (€3.68 in chips) 
Seat 4: cesaretto23 (€2.44 in chips) 
Seat 5: caduceus369 (€2.03 in chips) 
Seat 6: ahehihohuh0 (€0.94 in chips) 
gs0097: posts small blind €0.01
robertoH2O: posts big blind €0.02
*** HOLE CARDS ***
Dealt to caduceus369 [8s 8c]
cesaretto23: calls €0.02
caduceus369 has timed out
caduceus369: folds 
ahehihohuh0: folds 
Catania838: folds 
gs0097: calls €0.01
robertoH2O: raises €0.08 to €0.10
cesaretto23: calls €0.08
gs0097: folds 
*** FLOP *** [4d 2s 9d]
robertoH2O: checks 
cesaretto23: bets €0.06
robertoH2O: folds 
Uncalled bet (€0.06) returned to cesaretto23
cesaretto23 collected €0.21 from pot
cesaretto23: doesn't show hand 
*** SUMMARY ***
Total pot €0.22 | Rake €0.01 
Board [4d 2s 9d]
Seat 1: Catania838 (button) folded before Flop (didn't bet)
Seat 2: gs0097 (small blind) folded before Flop
Seat 3: robertoH2O (big blind) folded on the Flop
Seat 4: cesaretto23 collected (€0.21)
Seat 5: caduceus369 folded before Flop (didn't bet)
Seat 6: ahehihohuh0 folded before Flop (didn't bet)



PokerStars Zoom Hand #257987834062:  Hold'em No Limit (€0.01/€0.02) [ADM ID: M62BA304494E32ST] - 2025/10/03 23:18:02 CET [2025/10/03 17:18:02 ET]
Table 'Sirio' 6-max Seat #1 is the button
Seat 1: rounders121282 (€5.87 in chips) 
Seat 2: caduceus369 (€2.04 in chips) 
Seat 3: ahehihohuh0 (€0.96 in chips) 
Seat 4: ADRIAN0_MEIS (€12.23 in chips) 
Seat 5: Chia9711 (€2.17 in chips) 
Seat 6: ivano747 (€3 in chips) 
caduceus369: posts small blind €0.01
ahehihohuh0: posts big blind €0.02
*** HOLE CARDS ***
Dealt to caduceus369 [5d Ts]
ADRIAN0_MEIS: folds 
Chia9711: calls €0.02
ivano747: raises €0.04 to €0.06
rounders121282: calls €0.06
caduceus369: folds 
ahehihohuh0: folds 
Chia9711: calls €0.04
*** FLOP *** [Kc Ac 4h]
Chia9711: checks 
ivano747: bets €0.10
rounders121282: calls €0.10
Chia9711: raises €0.50 to €0.60
ivano747: folds 
rounders121282: calls €0.50
*** TURN *** [Kc Ac 4h] [2c]
Chia9711: checks 
rounders121282: checks 
*** RIVER *** [Kc Ac 4h 2c] [Js]
Chia9711: checks 
rounders121282: checks 
*** SHOW DOWN ***
Chia9711: shows [4c 4s] (three of a kind, Fours)
rounders121282: mucks hand 
Chia9711 collected €1.43 from pot
*** SUMMARY ***
Total pot €1.51 | Rake €0.08 
Board [Kc Ac 4h 2c Js]
Seat 1: rounders121282 (button) mucked [Ad 7c]
Seat 2: caduceus369 (small blind) folded before Flop
Seat 3: ahehihohuh0 (big blind) folded before Flop
Seat 4: ADRIAN0_MEIS folded before Flop (didn't bet)
Seat 5: Chia9711 showed [4c 4s] and won (€1.43) with three of a kind, Fours
Seat 6: ivano747 folded on the Flop



PokerStars Zoom Hand #257987852362:  Hold'em No Limit (€0.01/€0.02) [ADM ID: M62BA304494E32ST] - 2025/10/03 23:19:18 CET [2025/10/03 17:19:18 ET]
Table 'Sirio' 6-max Seat #1 is the button
Seat 1: fantaasso (€2.48 in chips) 
Seat 2: lucpri (€2.28 in chips) 
Seat 3: caduceus369 (€2.03 in chips) 
Seat 4: robertoH2O (€2.26 in chips) 
Seat 5: stfuplzudonk (€4.45 in chips) 
Seat 6: Mr_Frost02 (€1.14 in chips) 
lucpri: posts small blind €0.01
caduceus369: posts big blind €0.02
*** HOLE CARDS ***
Dealt to caduceus369 [5d Ah]
robertoH2O: folds 
stfuplzudonk: folds 
Mr_Frost02: folds 
fantaasso: folds 
lucpri: folds 
Uncalled bet (€0.01) returned to caduceus369
caduceus369 collected €0.02 from pot
caduceus369: doesn't show hand 
*** SUMMARY ***
Total pot €0.02 | Rake €0 
Seat 1: fantaasso (button) folded before Flop (didn't bet)
Seat 2: lucpri (small blind) folded before Flop
Seat 3: caduceus369 (big blind) collected (€0.02)
Seat 4: robertoH2O folded before Flop (didn't bet)
Seat 5: stfuplzudonk folded before Flop (didn't bet)
Seat 6: Mr_Frost02 folded before Flop (didn't bet)



PokerStars Zoom Hand #257987855640:  Hold'em No Limit (€0.01/€0.02) [ADM ID: M62BA304494E32ST] - 2025/10/03 23:19:31 CET [2025/10/03 17:19:31 ET]
Table 'Sirio' 6-max Seat #1 is the button
Seat 1: Catania838 (€1.95 in chips) 
Seat 2: outshined8 (€1.04 in chips) 
Seat 3: Mr_Frost02 (€1.14 in chips) 
Seat 4: pia1256 (€0.73 in chips) 
Seat 5: ADRIAN0_MEIS (€7.61 in chips) 
Seat 6: caduceus369 (€2.04 in chips) 
outshined8: posts small blind €0.01
Mr_Frost02: posts big blind €0.02
*** HOLE CARDS ***
Dealt to caduceus369 [Qd 2d]
pia1256: folds 
ADRIAN0_MEIS: folds 
caduceus369: folds 
Catania838: folds 
outshined8: folds 
Uncalled bet (€0.01) returned to Mr_Frost02
Mr_Frost02 collected €0.02 from pot
Mr_Frost02: doesn't show hand 
*** SUMMARY ***
Total pot €0.02 | Rake €0 
Seat 1: Catania838 (button) folded before Flop (didn't bet)
Seat 2: outshined8 (small blind) folded before Flop
Seat 3: Mr_Frost02 (big blind) collected (€0.02)
Seat 4: pia1256 folded before Flop (didn't bet)
Seat 5: ADRIAN0_MEIS folded before Flop (didn't bet)
Seat 6: caduceus369 folded before Flop (didn't bet)



PokerStars Zoom Hand #257987857865:  Hold'em No Limit (€0.01/€0.02) [ADM ID: M62BA304494E32ST] - 2025/10/03 23:19:40 CET [2025/10/03 17:19:40 ET]
Table 'Sirio' 6-max Seat #1 is the button
Seat 1: AIA427 (€1.47 in chips) 
Seat 2: Catania838 (€1.95 in chips) 
Seat 3: ADRIAN0_MEIS (€7.61 in chips) 
Seat 4: CacciatoreAA (€3.37 in chips) 
Seat 5: caduceus369 (€2.04 in chips) 
Seat 6: father2008 (€6.27 in chips) 
Catania838: posts small blind €0.01
ADRIAN0_MEIS: posts big blind €0.02
*** HOLE CARDS ***
Dealt to caduceus369 [Qs 4s]
CacciatoreAA: raises €0.06 to €0.08
caduceus369: folds 
father2008: folds 
AIA427: folds 
Catania838: folds 
ADRIAN0_MEIS: folds 
Uncalled bet (€0.06) returned to CacciatoreAA
CacciatoreAA collected €0.05 from pot
CacciatoreAA: doesn't show hand 
*** SUMMARY ***
Total pot €0.05 | Rake €0 
Seat 1: AIA427 (button) folded before Flop (didn't bet)
Seat 2: Catania838 (small blind) folded before Flop
Seat 3: ADRIAN0_MEIS (big blind) folded before Flop
Seat 4: CacciatoreAA collected (€0.05)
Seat 5: caduceus369 folded before Flop (didn't bet)
Seat 6: father2008 folded before Flop (didn't bet)



PokerStars Zoom Hand #257987857105:  Hold'em No Limit (€0.01/€0.02) [ADM ID: M62BA304494E32ST] - 2025/10/03 23:19:37 CET [2025/10/03 17:19:37 ET]
Table 'Sirio' 6-max Seat #1 is the button
Seat 1: Neroonciolina (€4.83 in chips) 
Seat 2: montemeru (€2 in chips) 
Seat 3: fantaasso (€2.47 in chips) 
Seat 4: caduceus369 (€2.04 in chips) 
Seat 5: Catania838 (€1.95 in chips) 
Seat 6: outshined8 (€1.03 in chips) 
montemeru: posts small blind €0.01
fantaasso: posts big blind €0.02
*** HOLE CARDS ***
Dealt to caduceus369 [2s 8d]
caduceus369: folds 
Catania838: folds 
outshined8: raises €0.04 to €0.06
Neroonciolina: folds 
montemeru: calls €0.05
fantaasso: calls €0.04
*** FLOP *** [4h 6s Qh]
montemeru: checks 
fantaasso: checks 
outshined8: checks 
*** TURN *** [4h 6s Qh] [7h]
montemeru: checks 
fantaasso: checks 
outshined8: checks 
*** RIVER *** [4h 6s Qh 7h] [3c]
montemeru: checks 
fantaasso: checks 
outshined8: checks 
*** SHOW DOWN ***
montemeru: shows [Jc 8s] (high card Queen)
fantaasso: shows [As 3s] (a pair of Threes)
outshined8: mucks hand 
fantaasso collected €0.18 from pot
*** SUMMARY ***
Total pot €0.18 | Rake €0 
Board [4h 6s Qh 7h 3c]
Seat 1: Neroonciolina (button) folded before Flop (didn't bet)
Seat 2: montemeru (small blind) showed [Jc 8s] and lost with high card Queen
Seat 3: fantaasso (big blind) showed [As 3s] and won (€0.18) with a pair of Threes
Seat 4: caduceus369 folded before Flop (didn't bet)
Seat 5: Catania838 folded before Flop (didn't bet)
Seat 6: outshined8 mucked [Ad Tc]



PokerStars Zoom Hand #257987863450:  Hold'em No Limit (€0.01/€0.02) [ADM ID: M62BA304494E32ST] - 2025/10/03 23:20:04 CET [2025/10/03 17:20:04 ET]
Table 'Sirio' 6-max Seat #1 is the button
Seat 1: caduceus369 (€2.03 in chips) 
Seat 2: EasyToRule (€2.09 in chips) 
Seat 3: CacciatoreAA (€3.40 in chips) 
Seat 4: ivano747 (€2.84 in chips) 
Seat 5: AlwaisToRun (€0.80 in chips) 
Seat 6: Catania838 (€1.92 in chips) 
EasyToRule: posts small blind €0.01
CacciatoreAA: posts big blind €0.02
*** HOLE CARDS ***
Dealt to caduceus369 [3d Ts]
ivano747: folds 
AlwaisToRun: folds 
Catania838: folds 
caduceus369: folds 
EasyToRule: raises €0.03 to €0.05
CacciatoreAA: folds 
Uncalled bet (€0.03) returned to EasyToRule
EasyToRule collected €0.04 from pot
EasyToRule: doesn't show hand 
*** SUMMARY ***
Total pot €0.04 | Rake €0 
Seat 1: caduceus369 (button) folded before Flop (didn't bet)
Seat 2: EasyToRule (small blind) collected (€0.04)
Seat 3: CacciatoreAA (big blind) folded before Flop
Seat 4: ivano747 folded before Flop (didn't bet)
Seat 5: AlwaisToRun folded before Flop (didn't bet)
Seat 6: Catania838 folded before Flop (didn't bet)



PokerStars Zoom Hand #257987862201:  Hold'em No Limit (€0.01/€0.02) [ADM ID: M62BA304494E32ST] - 2025/10/03 23:19:58 CET [2025/10/03 17:19:58 ET]
Table 'Sirio' 6-max Seat #1 is the button
Seat 1: Scardo84 (€2.01 in chips) 
Seat 2: caduceus369 (€2.04 in chips) 
Seat 3: Witness85906 (€5.01 in chips) 
Seat 4: franky65124 (€1.22 in chips) 
Seat 5: skynet0308 (€0.58 in chips) 
Seat 6: cesaretto23 (€3.16 in chips) 
caduceus369: posts small blind €0.01
Witness85906: posts big blind €0.02
*** HOLE CARDS ***
Dealt to caduceus369 [2c 6h]
franky65124: calls €0.02
skynet0308: folds 
cesaretto23: calls €0.02
Scardo84: calls €0.02
caduceus369: folds 
Witness85906: checks 
*** FLOP *** [Jc Jh 8c]
Witness85906: checks 
franky65124: bets €0.02
cesaretto23: folds 
Scardo84: folds 
Witness85906: calls €0.02
*** TURN *** [Jc Jh 8c] [Ah]
Witness85906: checks 
franky65124: bets €0.04
Witness85906: calls €0.04
*** RIVER *** [Jc Jh 8c Ah] [Ac]
Witness85906: checks 
franky65124: checks 
*** SHOW DOWN ***
Witness85906: shows [8h 7s] (two pair, Aces and Jacks)
franky65124: shows [Qd Qs] (two pair, Aces and Queens)
franky65124 collected €0.20 from pot
*** SUMMARY ***
Total pot €0.21 | Rake €0.01 
Board [Jc Jh 8c Ah Ac]
Seat 1: Scardo84 (button) folded on the Flop
Seat 2: caduceus369 (small blind) folded before Flop
Seat 3: Witness85906 (big blind) showed [8h 7s] and lost with two pair, Aces and Jacks
Seat 4: franky65124 showed [Qd Qs] and won (€0.20) with two pair, Aces and Queens
Seat 5: skynet0308 folded before Flop (didn't bet)
Seat 6: cesaretto23 folded on the Flop



PokerStars Zoom Hand #257987850619:  Hold'em No Limit (€0.01/€0.02) [ADM ID: M62BA304494E32ST] - 2025/10/03 23:19:11 CET [2025/10/03 17:19:11 ET]
Table 'Sirio' 6-max Seat #1 is the button
Seat 1: Mr_Frost02 (€1.14 in chips) 
Seat 2: father2008 (€3.57 in chips) 
Seat 3: Catania838 (€1.62 in chips) 
Seat 4: caduceus369 (€2.03 in chips) 
Seat 5: franky65124 (€1.30 in chips) 
Seat 6: SidneyPrescott (€2.32 in chips) 
father2008: posts small blind €0.01
Catania838: posts big blind €0.02
*** HOLE CARDS ***
Dealt to caduceus369 [Kc 8s]
caduceus369: folds 
franky65124: calls €0.02
SidneyPrescott: raises €0.06 to €0.08
Mr_Frost02: folds 
father2008: calls €0.07
Catania838: calls €0.06
franky65124: calls €0.06
*** FLOP *** [6h Qd 4s]
father2008: checks 
Catania838: checks 
franky65124: checks 
SidneyPrescott: checks 
*** TURN *** [6h Qd 4s] [9c]
father2008: bets €0.20
Catania838: folds 
franky65124: folds 
SidneyPrescott: raises €0.40 to €0.60
father2008: raises €2.89 to €3.49 and is all-in
SidneyPrescott: folds 
Uncalled bet (€2.89) returned to father2008
father2008 collected €1.44 from pot
father2008: doesn't show hand 
*** SUMMARY ***
Total pot €1.52 | Rake €0.08 
Board [6h Qd 4s 9c]
Seat 1: Mr_Frost02 (button) folded before Flop (didn't bet)
Seat 2: father2008 (small blind) collected (€1.44)
Seat 3: Catania838 (big blind) folded on the Turn
Seat 4: caduceus369 folded before Flop (didn't bet)
Seat 5: franky65124 folded on the Turn
Seat 6: SidneyPrescott folded on the Turn



PokerStars Zoom Hand #257987864723:  Hold'em No Limit (€0.01/€0.02) [ADM ID: M62BA304494E32ST] - 2025/10/03 23:20:09 CET [2025/10/03 17:20:09 ET]
Table 'Sirio' 6-max Seat #1 is the button
Seat 1: MOLDAVO1069 (€9.31 in chips) 
Seat 2: stfuplzudonk (€3.17 in chips) 
Seat 3: AlwaisToRun (€0.80 in chips) 
Seat 4: lucpri (€2.28 in chips) 
Seat 5: gs0097 (€0.80 in chips) 
Seat 6: caduceus369 (€2.03 in chips) 
stfuplzudonk: posts small blind €0.01
AlwaisToRun: posts big blind €0.02
*** HOLE CARDS ***
Dealt to caduceus369 [7c 6c]
lucpri: folds 
gs0097: folds 
caduceus369: raises €0.04 to €0.06
MOLDAVO1069: folds 
stfuplzudonk: calls €0.05
AlwaisToRun: calls €0.04
*** FLOP *** [7s 9h 5d]
stfuplzudonk: checks 
AlwaisToRun: bets €0.02
caduceus369: raises €0.06 to €0.08
stfuplzudonk: folds 
AlwaisToRun: calls €0.06
*** TURN *** [7s 9h 5d] [Jc]
AlwaisToRun: checks 
caduceus369: bets €0.11
AlwaisToRun: calls €0.11
*** RIVER *** [7s 9h 5d Jc] [4h]
AlwaisToRun: checks 
caduceus369: checks 
*** SHOW DOWN ***
AlwaisToRun: shows [Kh Kd] (a pair of Kings)
caduceus369: mucks hand 
AlwaisToRun collected €0.53 from pot
*** SUMMARY ***
Total pot €0.56 | Rake €0.03 
Board [7s 9h 5d Jc 4h]
Seat 1: MOLDAVO1069 (button) folded before Flop (didn't bet)
Seat 2: stfuplzudonk (small blind) folded on the Flop
Seat 3: AlwaisToRun (big blind) showed [Kh Kd] and won (€0.53) with a pair of Kings
Seat 4: lucpri folded before Flop (didn't bet)
Seat 5: gs0097 folded before Flop (didn't bet)
Seat 6: caduceus369 mucked [7c 6c]



PokerStars Zoom Hand #257987885237:  Hold'em No Limit (€0.01/€0.02) [ADM ID: M62BA304494E32ST] - 2025/10/03 23:21:33 CET [2025/10/03 17:21:33 ET]
Table 'Sirio' 6-max Seat #1 is the button
Seat 1: father2008 (€4.36 in chips) 
Seat 2: skynet0308 (€0.56 in chips) 
Seat 3: giua1980 (€1.20 in chips) 
Seat 4: caduceus369 (€1.78 in chips) 
Seat 5: AlwaisToRun (€1.08 in chips) 
Seat 6: CacciatoreAA (€3.14 in chips) 
skynet0308: posts small blind €0.01
giua1980: posts big blind €0.02
*** HOLE CARDS ***
Dealt to caduceus369 [9d 7h]
caduceus369: folds 
AlwaisToRun: folds 
CacciatoreAA: folds 
father2008: folds 
skynet0308: folds 
Uncalled bet (€0.01) returned to giua1980
giua1980 collected €0.02 from pot
giua1980: doesn't show hand 
*** SUMMARY ***
Total pot €0.02 | Rake €0 
Seat 1: father2008 (button) folded before Flop (didn't bet)
Seat 2: skynet0308 (small blind) folded before Flop
Seat 3: giua1980 (big blind) collected (€0.02)
Seat 4: caduceus369 folded before Flop (didn't bet)
Seat 5: AlwaisToRun folded before Flop (didn't bet)
Seat 6: CacciatoreAA folded before Flop (didn't bet)



PokerStars Zoom Hand #257987886273:  Hold'em No Limit (€0.01/€0.02) [ADM ID: M62BA304494E32ST] - 2025/10/03 23:21:38 CET [2025/10/03 17:21:38 ET]
Table 'Sirio' 6-max Seat #1 is the button
Seat 1: caduceus369 (€1.78 in chips) 
Seat 2: neoilnervoso (€1.88 in chips) 
Seat 3: AIA427 (€1.37 in chips) 
Seat 4: ADRIAN0_MEIS (€12.65 in chips) 
Seat 5: stfuplzudonk (€2.81 in chips) 
Seat 6: skynet0308 (€0.55 in chips) 
neoilnervoso: posts small blind €0.01
AIA427: posts big blind €0.02
*** HOLE CARDS ***
Dealt to caduceus369 [4h 5c]
ADRIAN0_MEIS: raises €0.05 to €0.07
stfuplzudonk: folds 
skynet0308: folds 
caduceus369: folds 
neoilnervoso: folds 
AIA427: folds 
Uncalled bet (€0.05) returned to ADRIAN0_MEIS
ADRIAN0_MEIS collected €0.05 from pot
ADRIAN0_MEIS: doesn't show hand 
*** SUMMARY ***
Total pot €0.05 | Rake €0 
Seat 1: caduceus369 (button) folded before Flop (didn't bet)
Seat 2: neoilnervoso (small blind) folded before Flop
Seat 3: AIA427 (big blind) folded before Flop
Seat 4: ADRIAN0_MEIS collected (€0.05)
Seat 5: stfuplzudonk folded before Flop (didn't bet)
Seat 6: skynet0308 folded before Flop (didn't bet)



PokerStars Zoom Hand #257987887326:  Hold'em No Limit (€0.01/€0.02) [ADM ID: M62BA304494E32ST] - 2025/10/03 23:21:42 CET [2025/10/03 17:21:42 ET]
Table 'Sirio' 6-max Seat #1 is the button
Seat 1: SidneyPrescott (€3.87 in chips) 
Seat 2: stfuplzudonk (€2.81 in chips) 
Seat 3: caduceus369 (€1.78 in chips) 
Seat 4: skynet0308 (€0.55 in chips) 
Seat 5: neoilnervoso (€1.87 in chips) 
Seat 6: EasyToRule (€2.42 in chips) 
stfuplzudonk: posts small blind €0.01
caduceus369: posts big blind €0.02
*** HOLE CARDS ***
Dealt to caduceus369 [4c Ts]
skynet0308: folds 
neoilnervoso: folds 
EasyToRule: folds 
SidneyPrescott: folds 
stfuplzudonk: calls €0.01
caduceus369: checks 
*** FLOP *** [6h 5h Qd]
stfuplzudonk: checks 
caduceus369: checks 
*** TURN *** [6h 5h Qd] [2d]
stfuplzudonk: checks 
caduceus369: checks 
*** RIVER *** [6h 5h Qd 2d] [Kc]
stfuplzudonk: checks 
caduceus369: bets €0.03
stfuplzudonk: folds 
Uncalled bet (€0.03) returned to caduceus369
caduceus369 collected €0.04 from pot
caduceus369: doesn't show hand 
*** SUMMARY ***
Total pot €0.04 | Rake €0 
Board [6h 5h Qd 2d Kc]
Seat 1: SidneyPrescott (button) folded before Flop (didn't bet)
Seat 2: stfuplzudonk (small blind) folded on the River
Seat 3: caduceus369 (big blind) collected (€0.04)
Seat 4: skynet0308 folded before Flop (didn't bet)
Seat 5: neoilnervoso folded before Flop (didn't bet)
Seat 6: EasyToRule folded before Flop (didn't bet)



PokerStars Zoom Hand #257987898264:  Hold'em No Limit (€0.01/€0.02) [ADM ID: M62BA304494E32ST] - 2025/10/03 23:22:27 CET [2025/10/03 17:22:27 ET]
Table 'Sirio' 6-max Seat #1 is the button
Seat 1: stfuplzudonk (€3.04 in chips) 
Seat 2: caduceus369 (€1.80 in chips) 
Seat 3: ADRIAN0_MEIS (€9.13 in chips) 
Seat 4: robertoH2O (€3.80 in chips) 
Seat 5: Scardo84 (€2.44 in chips) 
Seat 6: Neroonciolina (€4.41 in chips) 
caduceus369: posts small blind €0.01
ADRIAN0_MEIS: posts big blind €0.02
*** HOLE CARDS ***
Dealt to caduceus369 [8c Ad]
robertoH2O: folds 
Scardo84: folds 
Neroonciolina: raises €0.08 to €0.10
stfuplzudonk: folds 
caduceus369: folds 
ADRIAN0_MEIS: folds 
Uncalled bet (€0.08) returned to Neroonciolina
Neroonciolina collected €0.05 from pot
Neroonciolina: doesn't show hand 
*** SUMMARY ***
Total pot €0.05 | Rake €0 
Seat 1: stfuplzudonk (button) folded before Flop (didn't bet)
Seat 2: caduceus369 (small blind) folded before Flop
Seat 3: ADRIAN0_MEIS (big blind) folded before Flop
Seat 4: robertoH2O folded before Flop (didn't bet)
Seat 5: Scardo84 folded before Flop (didn't bet)
Seat 6: Neroonciolina collected (€0.05)



PokerStars Zoom Hand #257987903157:  Hold'em No Limit (€0.01/€0.02) [ADM ID: M62BA304494E32ST] - 2025/10/03 23:22:47 CET [2025/10/03 17:22:47 ET]
Table 'Sirio' 6-max Seat #1 is the button
Seat 1: robertoH2O (€3.78 in chips) 
Seat 2: EasyToRule (€2.37 in chips) 
Seat 3: stfuplzudonk (€3.04 in chips) 
Seat 4: SidneyPrescott (€4.05 in chips) 
Seat 5: skynet0308 (€0.59 in chips) 
Seat 6: caduceus369 (€1.79 in chips) 
EasyToRule: posts small blind €0.01
stfuplzudonk: posts big blind €0.02
*** HOLE CARDS ***
Dealt to caduceus369 [8d 9c]
SidneyPrescott: folds 
skynet0308: folds 
caduceus369: folds 
robertoH2O: raises €0.03 to €0.05
EasyToRule: folds 
stfuplzudonk: folds 
Uncalled bet (€0.03) returned to robertoH2O
robertoH2O collected €0.05 from pot
robertoH2O: doesn't show hand 
*** SUMMARY ***
Total pot €0.05 | Rake €0 
Seat 1: robertoH2O (button) collected (€0.05)
Seat 2: EasyToRule (small blind) folded before Flop
Seat 3: stfuplzudonk (big blind) folded before Flop
Seat 4: SidneyPrescott folded before Flop (didn't bet)
Seat 5: skynet0308 folded before Flop (didn't bet)
Seat 6: caduceus369 folded before Flop (didn't bet)



PokerStars Zoom Hand #257987904110:  Hold'em No Limit (€0.01/€0.02) [ADM ID: M62BA304494E32ST] - 2025/10/03 23:22:51 CET [2025/10/03 17:22:51 ET]
Table 'Sirio' 6-max Seat #1 is the button
Seat 1: Generalexx (€0.90 in chips) 
Seat 2: montemeru (€2.36 in chips) 
Seat 3: caduceus369 (€1.79 in chips) 
Seat 4: SidneyPrescott (€4.05 in chips) 
Seat 5: TripInter (€1.02 in chips) 
Seat 6: ADRIAN0_MEIS (€9.10 in chips) 
montemeru: posts small blind €0.01
caduceus369: posts big blind €0.02
*** HOLE CARDS ***
Dealt to caduceus369 [5c Qc]
SidneyPrescott: folds 
TripInter: folds 
ADRIAN0_MEIS: folds 
Generalexx: folds 
montemeru: raises €0.04 to €0.06
caduceus369: calls €0.04
*** FLOP *** [9c Qs 8h]
montemeru: bets €0.06
caduceus369: calls €0.06
*** TURN *** [9c Qs 8h] [6s]
montemeru: checks 
caduceus369: bets €0.08
montemeru: calls €0.08
*** RIVER *** [9c Qs 8h 6s] [9s]
montemeru: checks 
caduceus369: checks 
*** SHOW DOWN ***
montemeru: shows [7s Kd] (a pair of Nines)
caduceus369: shows [5c Qc] (two pair, Queens and Nines)
caduceus369 collected €0.38 from pot
*** SUMMARY ***
Total pot €0.40 | Rake €0.02 
Board [9c Qs 8h 6s 9s]
Seat 1: Generalexx (button) folded before Flop (didn't bet)
Seat 2: montemeru (small blind) showed [7s Kd] and lost with a pair of Nines
Seat 3: caduceus369 (big blind) showed [5c Qc] and won (€0.38) with two pair, Queens and Nines
Seat 4: SidneyPrescott folded before Flop (didn't bet)
Seat 5: TripInter folded before Flop (didn't bet)
Seat 6: ADRIAN0_MEIS folded before Flop (didn't bet)



PokerStars Zoom Hand #257987916015:  Hold'em No Limit (€0.01/€0.02) [ADM ID: M62BA304494E32ST] - 2025/10/03 23:23:40 CET [2025/10/03 17:23:40 ET]
Table 'Sirio' 6-max Seat #1 is the button
Seat 1: SidneyPrescott (€2.07 in chips) 
Seat 2: caduceus369 (€1.97 in chips) 
Seat 3: ADRIAN0_MEIS (€2.31 in chips) 
Seat 4: montemeru (€2.16 in chips) 
Seat 5: pia1256 (€1.81 in chips) 
Seat 6: tigermiscio (€0.89 in chips) 
caduceus369: posts small blind €0.01
ADRIAN0_MEIS: posts big blind €0.02
*** HOLE CARDS ***
Dealt to caduceus369 [Jc 5s]
montemeru: folds 
pia1256: folds 
tigermiscio: folds 
SidneyPrescott: raises €0.04 to €0.06
caduceus369: folds 
ADRIAN0_MEIS: folds 
Uncalled bet (€0.04) returned to SidneyPrescott
SidneyPrescott collected €0.05 from pot
SidneyPrescott: doesn't show hand 
*** SUMMARY ***
Total pot €0.05 | Rake €0 
Seat 1: SidneyPrescott (button) collected (€0.05)
Seat 2: caduceus369 (small blind) folded before Flop
Seat 3: ADRIAN0_MEIS (big blind) folded before Flop
Seat 4: montemeru folded before Flop (didn't bet)
Seat 5: pia1256 folded before Flop (didn't bet)
Seat 6: tigermiscio folded before Flop (didn't bet)



PokerStars Zoom Hand #257987917596:  Hold'em No Limit (€0.01/€0.02) [ADM ID: M62BA304494E32ST] - 2025/10/03 23:23:47 CET [2025/10/03 17:23:47 ET]
Table 'Sirio' 6-max Seat #1 is the button
Seat 1: ivano747 (€4.42 in chips) 
Seat 2: fantaasso (€1.98 in chips) 
Seat 3: father2008 (€6.34 in chips) 
Seat 4: montemeru (€2.16 in chips) 
Seat 5: caduceus369 (€1.96 in chips) 
Seat 6: stfuplzudonk (€2.89 in chips) 
fantaasso: posts small blind €0.01
father2008: posts big blind €0.02
*** HOLE CARDS ***
Dealt to caduceus369 [3h 7d]
montemeru: raises €0.04 to €0.06
caduceus369: folds 
stfuplzudonk: folds 
ivano747: folds 
fantaasso: folds 
father2008: calls €0.04
*** FLOP *** [5h Qh Ts]
father2008: bets €0.08
montemeru: calls €0.08
*** TURN *** [5h Qh Ts] [Ad]
father2008: checks 
montemeru: bets €0.18
father2008: folds 
Uncalled bet (€0.18) returned to montemeru
montemeru collected €0.28 from pot
montemeru: doesn't show hand 
*** SUMMARY ***
Total pot €0.29 | Rake €0.01 
Board [5h Qh Ts Ad]
Seat 1: ivano747 (button) folded before Flop (didn't bet)
Seat 2: fantaasso (small blind) folded before Flop
Seat 3: father2008 (big blind) folded on the Turn
Seat 4: montemeru collected (€0.28)
Seat 5: caduceus369 folded before Flop (didn't bet)
Seat 6: stfuplzudonk folded before Flop (didn't bet)



PokerStars Zoom Hand #257987919008:  Hold'em No Limit (€0.01/€0.02) [ADM ID: M62BA304494E32ST] - 2025/10/03 23:23:53 CET [2025/10/03 17:23:53 ET]
Table 'Sirio' 6-max Seat #1 is the button
Seat 1: ADRIAN0_MEIS (€2.29 in chips) 
Seat 2: Chia9711 (€2.65 in chips) 
Seat 3: gs0097 (€0.85 in chips) 
Seat 4: stfuplzudonk (€2.89 in chips) 
Seat 5: Rg4bthtbt (€1.97 in chips) 
Seat 6: caduceus369 (€1.96 in chips) 
Chia9711: posts small blind €0.01
gs0097: posts big blind €0.02
*** HOLE CARDS ***
Dealt to caduceus369 [Jc Js]
stfuplzudonk: folds 
Rg4bthtbt has timed out while disconnected
Rg4bthtbt: folds 
caduceus369: raises €0.04 to €0.06
ADRIAN0_MEIS: folds 
Chia9711: folds 
gs0097: calls €0.04
*** FLOP *** [Ks Kh Ts]
gs0097: checks 
caduceus369: checks 
*** TURN *** [Ks Kh Ts] [3c]
gs0097: bets €0.06
caduceus369: calls €0.06
*** RIVER *** [Ks Kh Ts 3c] [Qc]
gs0097: bets €0.06
caduceus369: folds 
Uncalled bet (€0.06) returned to gs0097
gs0097 collected €0.24 from pot
gs0097: doesn't show hand 
*** SUMMARY ***
Total pot €0.25 | Rake €0.01 
Board [Ks Kh Ts 3c Qc]
Seat 1: ADRIAN0_MEIS (button) folded before Flop (didn't bet)
Seat 2: Chia9711 (small blind) folded before Flop
Seat 3: gs0097 (big blind) collected (€0.24)
Seat 4: stfuplzudonk folded before Flop (didn't bet)
Seat 5: Rg4bthtbt folded before Flop (didn't bet)
Seat 6: caduceus369 folded on the River



PokerStars Zoom Hand #257987934533:  Hold'em No Limit (€0.01/€0.02) [ADM ID: M62BA304494E32ST] - 2025/10/03 23:24:57 CET [2025/10/03 17:24:57 ET]
Table 'Sirio' 6-max Seat #1 is the button
Seat 1: ADRIAN0_MEIS (€12.67 in chips) 
Seat 2: fantaasso (€1.81 in chips) 
Seat 3: caduceus369 (€1.84 in chips) 
Seat 4: SidneyPrescott (€5.09 in chips) 
Seat 5: trillycata (€4.34 in chips) 
Seat 6: montemeru (€2.28 in chips) 
fantaasso: posts small blind €0.01
caduceus369: posts big blind €0.02
*** HOLE CARDS ***
Dealt to caduceus369 [5d 4s]
SidneyPrescott: folds 
trillycata: folds 
montemeru: folds 
ADRIAN0_MEIS: raises €0.05 to €0.07
fantaasso: folds 
caduceus369: folds 
Uncalled bet (€0.05) returned to ADRIAN0_MEIS
ADRIAN0_MEIS collected €0.05 from pot
ADRIAN0_MEIS: doesn't show hand 
*** SUMMARY ***
Total pot €0.05 | Rake €0 
Seat 1: ADRIAN0_MEIS (button) collected (€0.05)
Seat 2: fantaasso (small blind) folded before Flop
Seat 3: caduceus369 (big blind) folded before Flop
Seat 4: SidneyPrescott folded before Flop (didn't bet)
Seat 5: trillycata folded before Flop (didn't bet)
Seat 6: montemeru folded before Flop (didn't bet)



PokerStars Zoom Hand #257987932245:  Hold'em No Limit (€0.01/€0.02) [ADM ID: M62BA304494E32ST] - 2025/10/03 23:24:48 CET [2025/10/03 17:24:48 ET]
Table 'Sirio' 6-max Seat #1 is the button
Seat 1: franky65124 (€1.57 in chips) 
Seat 2: EasyToRule (€2.06 in chips) 
Seat 3: ADRIAN0_MEIS (€9.10 in chips) 
Seat 4: ivano747 (€3.15 in chips) 
Seat 5: caduceus369 (€1.84 in chips) 
Seat 6: diego-rigano (€0.95 in chips) 
EasyToRule: posts small blind €0.01
ADRIAN0_MEIS: posts big blind €0.02
*** HOLE CARDS ***
Dealt to caduceus369 [2d Js]
ivano747: folds 
caduceus369: folds 
diego-rigano: folds 
franky65124: calls €0.02
EasyToRule: folds 
ADRIAN0_MEIS: checks 
*** FLOP *** [8d 4c 9d]
ADRIAN0_MEIS: checks 
franky65124: bets €0.02
ADRIAN0_MEIS: folds 
Uncalled bet (€0.02) returned to franky65124
franky65124 collected €0.05 from pot
franky65124: doesn't show hand 
*** SUMMARY ***
Total pot €0.05 | Rake €0 
Board [8d 4c 9d]
Seat 1: franky65124 (button) collected (€0.05)
Seat 2: EasyToRule (small blind) folded before Flop
Seat 3: ADRIAN0_MEIS (big blind) folded on the Flop
Seat 4: ivano747 folded before Flop (didn't bet)
Seat 5: caduceus369 folded before Flop (didn't bet)
Seat 6: diego-rigano folded before Flop (didn't bet)



PokerStars Zoom Hand #257987930811:  Hold'em No Limit (€0.01/€0.02) [ADM ID: M62BA304494E32ST] - 2025/10/03 23:24:42 CET [2025/10/03 17:24:42 ET]
Table 'Sirio' 6-max Seat #1 is the button
Seat 1: caduceus369 (€1.84 in chips) 
Seat 2: tigermiscio (€0.93 in chips) 
Seat 3: montemeru (€2.30 in chips) 
Seat 4: ADRIAN0_MEIS (€9.10 in chips) 
Seat 5: pia1256 (€1.75 in chips) 
Seat 6: gs0097 (€0.97 in chips) 
tigermiscio: posts small blind €0.01
montemeru: posts big blind €0.02
*** HOLE CARDS ***
Dealt to caduceus369 [Jc 2s]
ADRIAN0_MEIS: folds 
pia1256: calls €0.02
gs0097: raises €0.07 to €0.09
caduceus369: folds 
tigermiscio: folds 
montemeru: folds 
pia1256: calls €0.07
*** FLOP *** [2c 4d Qc]
pia1256: checks 
gs0097: bets €0.06
pia1256: calls €0.06
*** TURN *** [2c 4d Qc] [3h]
pia1256: checks 
gs0097: bets €0.06
pia1256: calls €0.06
*** RIVER *** [2c 4d Qc 3h] [Ts]
pia1256: checks 
gs0097: bets €0.08
pia1256: calls €0.08
*** SHOW DOWN ***
gs0097: shows [Qh Qd] (three of a kind, Queens)
pia1256: mucks hand 
gs0097 collected €0.58 from pot
*** SUMMARY ***
Total pot €0.61 | Rake €0.03 
Board [2c 4d Qc 3h Ts]
Seat 1: caduceus369 (button) folded before Flop (didn't bet)
Seat 2: tigermiscio (small blind) folded before Flop
Seat 3: montemeru (big blind) folded before Flop
Seat 4: ADRIAN0_MEIS folded before Flop (didn't bet)
Seat 5: pia1256 mucked [Ah Tc]
Seat 6: gs0097 showed [Qh Qd] and won (€0.58) with three of a kind, Queens



PokerStars Zoom Hand #257987933733:  Hold'em No Limit (€0.01/€0.02) [ADM ID: M62BA304494E32ST] - 2025/10/03 23:24:54 CET [2025/10/03 17:24:54 ET]
Table 'Sirio' 6-max Seat #1 is the button
Seat 1: ivano747 (€3.15 in chips) 
Seat 2: stfuplzudonk (€4.59 in chips) 
Seat 3: EasyToRule (€2.22 in chips) 
Seat 4: caduceus369 (€1.84 in chips) 
Seat 5: diego-rigano (€0.95 in chips) 
Seat 6: ADRIAN0_MEIS (€8.50 in chips) 
stfuplzudonk: posts small blind €0.01
EasyToRule: posts big blind €0.02
*** HOLE CARDS ***
Dealt to caduceus369 [8d Th]
caduceus369: folds 
diego-rigano: folds 
ADRIAN0_MEIS: folds 
ivano747: raises €0.04 to €0.06
stfuplzudonk: folds 
EasyToRule: calls €0.04
*** FLOP *** [6d Tc Td]
EasyToRule: checks 
ivano747: bets €0.05
EasyToRule: calls €0.05
*** TURN *** [6d Tc Td] [7d]
EasyToRule: checks 
ivano747: checks 
*** RIVER *** [6d Tc Td 7d] [3h]
EasyToRule: checks 
ivano747: checks 
*** SHOW DOWN ***
EasyToRule: shows [Ac 9d] (a pair of Tens)
ivano747: mucks hand 
EasyToRule collected €0.22 from pot
*** SUMMARY ***
Total pot €0.23 | Rake €0.01 
Board [6d Tc Td 7d 3h]
Seat 1: ivano747 (button) mucked [4s As]
Seat 2: stfuplzudonk (small blind) folded before Flop
Seat 3: EasyToRule (big blind) showed [Ac 9d] and won (€0.22) with a pair of Tens
Seat 4: caduceus369 folded before Flop (didn't bet)
Seat 5: diego-rigano folded before Flop (didn't bet)
Seat 6: ADRIAN0_MEIS folded before Flop (didn't bet)



PokerStars Zoom Hand #257987943391:  Hold'em No Limit (€0.01/€0.02) [ADM ID: M62BA304494E32ST] - 2025/10/03 23:25:33 CET [2025/10/03 17:25:33 ET]
Table 'Sirio' 6-max Seat #1 is the button
Seat 1: Generalexx (€1.93 in chips) 
Seat 2: Catania838 (€2.56 in chips) 
Seat 3: KindRonin (€0.81 in chips) 
Seat 4: father2008 (€6.13 in chips) 
Seat 5: caduceus369 (€1.81 in chips) 
Seat 6: ADRIAN0_MEIS (€9.07 in chips) 
Catania838: posts small blind €0.01
KindRonin: posts big blind €0.02
*** HOLE CARDS ***
Dealt to caduceus369 [Ad Qs]
father2008: folds 
caduceus369: raises €0.04 to €0.06
ADRIAN0_MEIS: folds 
Generalexx: folds 
Catania838: folds 
KindRonin: folds 
Uncalled bet (€0.04) returned to caduceus369
caduceus369 collected €0.05 from pot
caduceus369: doesn't show hand 
*** SUMMARY ***
Total pot €0.05 | Rake €0 
Seat 1: Generalexx (button) folded before Flop (didn't bet)
Seat 2: Catania838 (small blind) folded before Flop
Seat 3: KindRonin (big blind) folded before Flop
Seat 4: father2008 folded before Flop (didn't bet)
Seat 5: caduceus369 collected (€0.05)
Seat 6: ADRIAN0_MEIS folded before Flop (didn't bet)



PokerStars Zoom Hand #257987940366:  Hold'em No Limit (€0.01/€0.02) [ADM ID: M62BA304494E32ST] - 2025/10/03 23:25:21 CET [2025/10/03 17:25:21 ET]
Table 'Sirio' 6-max Seat #1 is the button
Seat 1: SKERZA (€1.70 in chips) 
Seat 2: caduceus369 (€1.82 in chips) 
Seat 3: stfuplzudonk (€1.68 in chips) 
Seat 4: Catania838 (€1.45 in chips) 
Seat 5: KindRonin (€0.81 in chips) 
Seat 6: maury999999 (€2 in chips) 
caduceus369: posts small blind €0.01
stfuplzudonk: posts big blind €0.02
*** HOLE CARDS ***
Dealt to caduceus369 [Jh 7h]
Catania838: folds 
KindRonin: folds 
maury999999: folds 
SKERZA: raises €0.03 to €0.05
caduceus369: folds 
stfuplzudonk: calls €0.03
*** FLOP *** [7s Qs 4s]
stfuplzudonk: checks 
SKERZA: bets €0.08
stfuplzudonk: folds 
Uncalled bet (€0.08) returned to SKERZA
SKERZA collected €0.11 from pot
SKERZA: doesn't show hand 
*** SUMMARY ***
Total pot €0.11 | Rake €0 
Board [7s Qs 4s]
Seat 1: SKERZA (button) collected (€0.11)
Seat 2: caduceus369 (small blind) folded before Flop
Seat 3: stfuplzudonk (big blind) folded on the Flop
Seat 4: Catania838 folded before Flop (didn't bet)
Seat 5: KindRonin folded before Flop (didn't bet)
Seat 6: maury999999 folded before Flop (didn't bet)



PokerStars Zoom Hand #257987942270:  Hold'em No Limit (€0.01/€0.02) [ADM ID: M62BA304494E32ST] - 2025/10/03 23:25:29 CET [2025/10/03 17:25:29 ET]
Table 'Sirio' 6-max Seat #1 is the button
Seat 1: MOLDAVO1069 (€9.59 in chips) 
Seat 2: pia1256 (€1.46 in chips) 
Seat 3: Chia9711 (€2.62 in chips) 
Seat 4: father2008 (€6.13 in chips) 
Seat 5: gs0097 (€1.26 in chips) 
Seat 6: caduceus369 (€1.81 in chips) 
pia1256: posts small blind €0.01
Chia9711: posts big blind €0.02
*** HOLE CARDS ***
Dealt to caduceus369 [Kh 2s]
father2008: folds 
gs0097: folds 
caduceus369: folds 
MOLDAVO1069: raises €0.03 to €0.05
pia1256: calls €0.04
Chia9711: calls €0.03
*** FLOP *** [6d 7c 9h]
pia1256: checks 
Chia9711: bets €0.02
MOLDAVO1069: folds 
pia1256: calls €0.02
*** TURN *** [6d 7c 9h] [6c]
pia1256: checks 
Chia9711: checks 
*** RIVER *** [6d 7c 9h 6c] [5d]
pia1256: bets €0.18
Chia9711: folds 
Uncalled bet (€0.18) returned to pia1256
pia1256 collected €0.18 from pot
pia1256: doesn't show hand 
*** SUMMARY ***
Total pot €0.19 | Rake €0.01 
Board [6d 7c 9h 6c 5d]
Seat 1: MOLDAVO1069 (button) folded on the Flop
Seat 2: pia1256 (small blind) collected (€0.18)
Seat 3: Chia9711 (big blind) folded on the River
Seat 4: father2008 folded before Flop (didn't bet)
Seat 5: gs0097 folded before Flop (didn't bet)
Seat 6: caduceus369 folded before Flop (didn't bet)



PokerStars Zoom Hand #257987946452:  Hold'em No Limit (€0.01/€0.02) [ADM ID: M62BA304494E32ST] - 2025/10/03 23:25:46 CET [2025/10/03 17:25:46 ET]
Table 'Sirio' 6-max Seat #1 is the button
Seat 1: sancarlo18 (€1.40 in chips) 
Seat 2: skynet0308 (€1.12 in chips) 
Seat 3: SidneyPrescott (€4.15 in chips) 
Seat 4: caduceus369 (€1.84 in chips) 
Seat 5: ADRIAN0_MEIS (€9.07 in chips) 
Seat 6: stfuplzudonk (€3.22 in chips) 
skynet0308: posts small blind €0.01
SidneyPrescott: posts big blind €0.02
*** HOLE CARDS ***
Dealt to caduceus369 [Tc 9c]
caduceus369: folds 
ADRIAN0_MEIS: folds 
stfuplzudonk: folds 
sancarlo18: folds 
skynet0308: raises €0.04 to €0.06
SidneyPrescott: raises €0.12 to €0.18
skynet0308: folds 
Uncalled bet (€0.12) returned to SidneyPrescott
SidneyPrescott collected €0.12 from pot
SidneyPrescott: doesn't show hand 
*** SUMMARY ***
Total pot €0.12 | Rake €0 
Seat 1: sancarlo18 (button) folded before Flop (didn't bet)
Seat 2: skynet0308 (small blind) folded before Flop
Seat 3: SidneyPrescott (big blind) collected (€0.12)
Seat 4: caduceus369 folded before Flop (didn't bet)
Seat 5: ADRIAN0_MEIS folded before Flop (didn't bet)
Seat 6: stfuplzudonk folded before Flop (didn't bet)



PokerStars Zoom Hand #257987947414:  Hold'em No Limit (€0.01/€0.02) [ADM ID: M62BA304494E32ST] - 2025/10/03 23:25:50 CET [2025/10/03 17:25:50 ET]
Table 'Sirio' 6-max Seat #1 is the button
Seat 1: caduceus369 (€1.84 in chips) 
Seat 2: ivano747 (€3.04 in chips) 
Seat 3: montemeru (€2.30 in chips) 
Seat 4: MOLDAVO1069 (€9.54 in chips) 
Seat 5: Witness85906 (€4.65 in chips) 
Seat 6: stfuplzudonk (€4.44 in chips) 
ivano747: posts small blind €0.01
montemeru: posts big blind €0.02
*** HOLE CARDS ***
Dealt to caduceus369 [2d 9s]
MOLDAVO1069: folds 
Witness85906: folds 
stfuplzudonk: raises €0.04 to €0.06
caduceus369: folds 
ivano747: folds 
montemeru: calls €0.04
*** FLOP *** [6h 4s Ah]
montemeru: checks 
stfuplzudonk: checks 
*** TURN *** [6h 4s Ah] [3c]
montemeru: checks 
stfuplzudonk: bets €0.07
montemeru: folds 
Uncalled bet (€0.07) returned to stfuplzudonk
stfuplzudonk collected €0.13 from pot
stfuplzudonk: doesn't show hand 
*** SUMMARY ***
Total pot €0.13 | Rake €0 
Board [6h 4s Ah 3c]
Seat 1: caduceus369 (button) folded before Flop (didn't bet)
Seat 2: ivano747 (small blind) folded before Flop
Seat 3: montemeru (big blind) folded on the Turn
Seat 4: MOLDAVO1069 folded before Flop (didn't bet)
Seat 5: Witness85906 folded before Flop (didn't bet)
Seat 6: stfuplzudonk collected (€0.13)



PokerStars Zoom Hand #257987949839:  Hold'em No Limit (€0.01/€0.02) [ADM ID: M62BA304494E32ST] - 2025/10/03 23:26:00 CET [2025/10/03 17:26:00 ET]
Table 'Sirio' 6-max Seat #1 is the button
Seat 1: Witness85906 (€4.65 in chips) 
Seat 2: workman75 (€2.68 in chips) 
Seat 3: caduceus369 (€1.84 in chips) 
Seat 4: ADRIAN0_MEIS (€2 in chips) 
Seat 5: SKERZA (€1.76 in chips) 
Seat 6: stfuplzudonk (€2.94 in chips) 
workman75: posts small blind €0.01
caduceus369: posts big blind €0.02
*** HOLE CARDS ***
Dealt to caduceus369 [Qc 9d]
ADRIAN0_MEIS: raises €0.05 to €0.07
SKERZA: folds 
stfuplzudonk: calls €0.07
Witness85906: folds 
workman75: folds 
caduceus369: folds 
*** FLOP *** [4s As 3d]
ADRIAN0_MEIS: bets €0.13
stfuplzudonk: folds 
Uncalled bet (€0.13) returned to ADRIAN0_MEIS
ADRIAN0_MEIS collected €0.17 from pot
ADRIAN0_MEIS: doesn't show hand 
*** SUMMARY ***
Total pot €0.17 | Rake €0 
Board [4s As 3d]
Seat 1: Witness85906 (button) folded before Flop (didn't bet)
Seat 2: workman75 (small blind) folded before Flop
Seat 3: caduceus369 (big blind) folded before Flop
Seat 4: ADRIAN0_MEIS collected (€0.17)
Seat 5: SKERZA folded before Flop (didn't bet)
Seat 6: stfuplzudonk folded on the Flop



PokerStars Zoom Hand #257987948472:  Hold'em No Limit (€0.01/€0.02) [ADM ID: M62BA304494E32ST] - 2025/10/03 23:25:54 CET [2025/10/03 17:25:54 ET]
Table 'Sirio' 6-max Seat #1 is the button
Seat 1: ADRIAN0_MEIS (€9.07 in chips) 
Seat 2: macchia1010 (€1.65 in chips) 
Seat 3: ivano747 (€3.03 in chips) 
Seat 4: MOLDAVO1069 (€9.54 in chips) 
Seat 5: caduceus369 (€1.84 in chips) 
Seat 6: Witness85906 (€4.65 in chips) 
macchia1010: posts small blind €0.01
ivano747: posts big blind €0.02
*** HOLE CARDS ***
Dealt to caduceus369 [3c Kd]
MOLDAVO1069: folds 
caduceus369: folds 
Witness85906: folds 
ADRIAN0_MEIS: folds 
macchia1010: calls €0.01
ivano747: raises €0.04 to €0.06
macchia1010: calls €0.04
*** FLOP *** [2h Ac 7d]
macchia1010: checks 
ivano747: checks 
*** TURN *** [2h Ac 7d] [Kc]
macchia1010: checks 
ivano747: bets €0.12
macchia1010: folds 
Uncalled bet (€0.12) returned to ivano747
ivano747 collected €0.12 from pot
ivano747: doesn't show hand 
*** SUMMARY ***
Total pot €0.12 | Rake €0 
Board [2h Ac 7d Kc]
Seat 1: ADRIAN0_MEIS (button) folded before Flop (didn't bet)
Seat 2: macchia1010 (small blind) folded on the Turn
Seat 3: ivano747 (big blind) collected (€0.12)
Seat 4: MOLDAVO1069 folded before Flop (didn't bet)
Seat 5: caduceus369 folded before Flop (didn't bet)
Seat 6: Witness85906 folded before Flop (didn't bet)



PokerStars Zoom Hand #257987952979:  Hold'em No Limit (€0.01/€0.02) [ADM ID: M62BA304494E32ST] - 2025/10/03 23:26:14 CET [2025/10/03 17:26:14 ET]
Table 'Sirio' 6-max Seat #1 is the button
Seat 1: father2008 (€6.11 in chips) 
Seat 2: caduceus369 (€1.82 in chips) 
Seat 3: Catania838 (€1.43 in chips) 
Seat 4: ivano747 (€4.36 in chips) 
Seat 5: stfuplzudonk (€1.63 in chips) 
Seat 6: KindRonin (€0.78 in chips) 
caduceus369: posts small blind €0.01
Catania838: posts big blind €0.02
*** HOLE CARDS ***
Dealt to caduceus369 [4c 3s]
ivano747: folds 
stfuplzudonk: folds 
KindRonin: folds 
father2008: folds 
caduceus369: folds 
Uncalled bet (€0.01) returned to Catania838
Catania838 collected €0.02 from pot
Catania838: doesn't show hand 
*** SUMMARY ***
Total pot €0.02 | Rake €0 
Seat 1: father2008 (button) folded before Flop (didn't bet)
Seat 2: caduceus369 (small blind) folded before Flop
Seat 3: Catania838 (big blind) collected (€0.02)
Seat 4: ivano747 folded before Flop (didn't bet)
Seat 5: stfuplzudonk folded before Flop (didn't bet)
Seat 6: KindRonin folded before Flop (didn't bet)



PokerStars Zoom Hand #257987953896:  Hold'em No Limit (€0.01/€0.02) [ADM ID: M62BA304494E32ST] - 2025/10/03 23:26:17 CET [2025/10/03 17:26:17 ET]
Table 'Sirio' 6-max Seat #1 is the button
Seat 1: caduceus369 (€1.81 in chips) 
Seat 2: 999rizla (€1.59 in chips) 
Seat 3: Witness85906 (€4.65 in chips) 
Seat 4: ADRIAN0_MEIS (€9.07 in chips) 
Seat 5: KindRonin (€0.78 in chips) 
Seat 6: SidneyPrescott (€4.21 in chips) 
999rizla: posts small blind €0.01
Witness85906: posts big blind €0.02
*** HOLE CARDS ***
Dealt to caduceus369 [7d 7h]
ADRIAN0_MEIS: folds 
KindRonin: folds 
SidneyPrescott: folds 
caduceus369: raises €0.04 to €0.06
999rizla: folds 
Witness85906: calls €0.04
*** FLOP *** [Qc 6s 5h]
Witness85906: checks 
caduceus369: checks 
*** TURN *** [Qc 6s 5h] [Kh]
Witness85906: bets €0.10
caduceus369: folds 
Uncalled bet (€0.10) returned to Witness85906
Witness85906 collected €0.13 from pot
Witness85906: doesn't show hand 
*** SUMMARY ***
Total pot €0.13 | Rake €0 
Board [Qc 6s 5h Kh]
Seat 1: caduceus369 (button) folded on the Turn
Seat 2: 999rizla (small blind) folded before Flop
Seat 3: Witness85906 (big blind) collected (€0.13)
Seat 4: ADRIAN0_MEIS folded before Flop (didn't bet)
Seat 5: KindRonin folded before Flop (didn't bet)
Seat 6: SidneyPrescott folded before Flop (didn't bet)



PokerStars Zoom Hand #257987969535:  Hold'em No Limit (€0.01/€0.02) [ADM ID: M62BA304494E32ST] - 2025/10/03 23:27:23 CET [2025/10/03 17:27:23 ET]
Table 'Sirio' 6-max Seat #1 is the button
Seat 1: MOLDAVO1069 (€9.46 in chips) 
Seat 2: ADRIAN0_MEIS (€8.44 in chips) 
Seat 3: SKERZA (€1.56 in chips) 
Seat 4: caduceus369 (€1.75 in chips) 
Seat 5: fantaasso (€1.83 in chips) 
Seat 6: EasyToRule (€4.02 in chips) 
ADRIAN0_MEIS: posts small blind €0.01
SKERZA: posts big blind €0.02
*** HOLE CARDS ***
Dealt to caduceus369 [9c 6h]
caduceus369: folds 
fantaasso: folds 
EasyToRule: folds 
MOLDAVO1069: raises €0.03 to €0.05
ADRIAN0_MEIS: folds 
SKERZA: calls €0.03
*** FLOP *** [8d Ts Qh]
SKERZA: bets €0.08
MOLDAVO1069: folds 
Uncalled bet (€0.08) returned to SKERZA
SKERZA collected €0.11 from pot
SKERZA: doesn't show hand 
*** SUMMARY ***
Total pot €0.11 | Rake €0 
Board [8d Ts Qh]
Seat 1: MOLDAVO1069 (button) folded on the Flop
Seat 2: ADRIAN0_MEIS (small blind) folded before Flop
Seat 3: SKERZA (big blind) collected (€0.11)
Seat 4: caduceus369 folded before Flop (didn't bet)
Seat 5: fantaasso folded before Flop (didn't bet)
Seat 6: EasyToRule folded before Flop (didn't bet)



PokerStars Zoom Hand #257987967251:  Hold'em No Limit (€0.01/€0.02) [ADM ID: M62BA304494E32ST] - 2025/10/03 23:27:13 CET [2025/10/03 17:27:13 ET]
Table 'Sirio' 6-max Seat #1 is the button
Seat 1: tigermiscio (€0.83 in chips) 
Seat 2: franky65124 (€1.51 in chips) 
Seat 3: Catania838 (€2.23 in chips) 
Seat 4: SKERZA (€1.56 in chips) 
Seat 5: workman75 (€2.77 in chips) 
Seat 6: caduceus369 (€1.75 in chips) 
franky65124: posts small blind €0.01
Catania838: posts big blind €0.02
*** HOLE CARDS ***
Dealt to caduceus369 [3d 9s]
SKERZA: folds 
workman75: raises €0.04 to €0.06
caduceus369: folds 
tigermiscio: folds 
franky65124: folds 
Catania838: folds 
Uncalled bet (€0.04) returned to workman75
workman75 collected €0.05 from pot
workman75: doesn't show hand 
*** SUMMARY ***
Total pot €0.05 | Rake €0 
Seat 1: tigermiscio (button) folded before Flop (didn't bet)
Seat 2: franky65124 (small blind) folded before Flop
Seat 3: Catania838 (big blind) folded before Flop
Seat 4: SKERZA folded before Flop (didn't bet)
Seat 5: workman75 collected (€0.05)
Seat 6: caduceus369 folded before Flop (didn't bet)



PokerStars Zoom Hand #257987970576:  Hold'em No Limit (€0.01/€0.02) [ADM ID: M62BA304494E32ST] - 2025/10/03 23:27:27 CET [2025/10/03 17:27:27 ET]
Table 'Sirio' 6-max Seat #1 is the button
Seat 1: maury999999 (€2.06 in chips) 
Seat 2: Witness85906 (€4.72 in chips) 
Seat 3: fantaasso (€1.83 in chips) 
Seat 4: caduceus369 (€1.75 in chips) 
Seat 5: father2008 (€6.05 in chips) 
Seat 6: 999rizla (€1.31 in chips) 
Witness85906: posts small blind €0.01
fantaasso: posts big blind €0.02
*** HOLE CARDS ***
Dealt to caduceus369 [Ah 8s]
caduceus369 has timed out
caduceus369: folds 
father2008: folds 
999rizla: calls €0.02
maury999999: folds 
Witness85906: folds 
fantaasso: checks 
*** FLOP *** [6s Jd Js]
fantaasso: checks 
999rizla: checks 
*** TURN *** [6s Jd Js] [7h]
fantaasso: checks 
999rizla: checks 
*** RIVER *** [6s Jd Js 7h] [9s]
fantaasso: checks 
999rizla: checks 
*** SHOW DOWN ***
fantaasso: shows [Qh 7s] (two pair, Jacks and Sevens)
999rizla: mucks hand 
fantaasso collected €0.05 from pot
*** SUMMARY ***
Total pot €0.05 | Rake €0 
Board [6s Jd Js 7h 9s]
Seat 1: maury999999 (button) folded before Flop (didn't bet)
Seat 2: Witness85906 (small blind) folded before Flop
Seat 3: fantaasso (big blind) showed [Qh 7s] and won (€0.05) with two pair, Jacks and Sevens
Seat 4: caduceus369 folded before Flop (didn't bet)
Seat 5: father2008 folded before Flop (didn't bet)
Seat 6: 999rizla mucked [Kh 3h]



PokerStars Zoom Hand #257987975914:  Hold'em No Limit (€0.01/€0.02) [ADM ID: M62BA304494E32ST] - 2025/10/03 23:27:49 CET [2025/10/03 17:27:49 ET]
Table 'Sirio' 6-max Seat #1 is the button
Seat 1: neoilnervoso (€1.38 in chips) 
Seat 2: caduceus369 (€1.75 in chips) 
Seat 3: maury999999 (€2.30 in chips) 
Seat 4: lucpri (€2.11 in chips) 
Seat 5: CacciatoreAA (€1.86 in chips) 
Seat 6: Witness85906 (€4.71 in chips) 
caduceus369: posts small blind €0.01
maury999999: posts big blind €0.02
*** HOLE CARDS ***
Dealt to caduceus369 [Qd 6h]
lucpri: folds 
CacciatoreAA: folds 
Witness85906: folds 
neoilnervoso: folds 
caduceus369: folds 
Uncalled bet (€0.01) returned to maury999999
maury999999 collected €0.02 from pot
maury999999: doesn't show hand 
*** SUMMARY ***
Total pot €0.02 | Rake €0 
Seat 1: neoilnervoso (button) folded before Flop (didn't bet)
Seat 2: caduceus369 (small blind) folded before Flop
Seat 3: maury999999 (big blind) collected (€0.02)
Seat 4: lucpri folded before Flop (didn't bet)
Seat 5: CacciatoreAA folded before Flop (didn't bet)
Seat 6: Witness85906 folded before Flop (didn't bet)



PokerStars Zoom Hand #257987979129:  Hold'em No Limit (€0.01/€0.02) [ADM ID: M62BA304494E32ST] - 2025/10/03 23:28:02 CET [2025/10/03 17:28:02 ET]
Table 'Sirio' 6-max Seat #1 is the button
Seat 1: montemeru (€2.51 in chips) 
Seat 2: tigermiscio (€0.51 in chips) 
Seat 3: caduceus369 (€1.74 in chips) 
Seat 4: KindRonin (€0.61 in chips) 
Seat 5: savicevic74 (€3.33 in chips) 
Seat 6: stfuplzudonk (€3.20 in chips) 
tigermiscio: posts small blind €0.01
caduceus369: posts big blind €0.02
*** HOLE CARDS ***
Dealt to caduceus369 [5d 5s]
KindRonin: folds 
savicevic74: folds 
stfuplzudonk: folds 
montemeru: folds 
tigermiscio: folds 
Uncalled bet (€0.01) returned to caduceus369
caduceus369 collected €0.02 from pot
caduceus369: doesn't show hand 
*** SUMMARY ***
Total pot €0.02 | Rake €0 
Seat 1: montemeru (button) folded before Flop (didn't bet)
Seat 2: tigermiscio (small blind) folded before Flop
Seat 3: caduceus369 (big blind) collected (€0.02)
Seat 4: KindRonin folded before Flop (didn't bet)
Seat 5: savicevic74 folded before Flop (didn't bet)
Seat 6: stfuplzudonk folded before Flop (didn't bet)



PokerStars Zoom Hand #257987981537:  Hold'em No Limit (€0.01/€0.02) [ADM ID: M62BA304494E32ST] - 2025/10/03 23:28:12 CET [2025/10/03 17:28:12 ET]
Table 'Sirio' 6-max Seat #1 is the button
Seat 1: lucpri (€2.10 in chips) 
Seat 2: SKERZA (€1.61 in chips) 
Seat 3: KindRonin (€0.60 in chips) 
Seat 4: ivano747 (€4.39 in chips) 
Seat 5: caduceus369 (€1.75 in chips) 
Seat 6: neoilnervoso (€1.38 in chips) 
SKERZA: posts small blind €0.01
KindRonin: posts big blind €0.02
*** HOLE CARDS ***
Dealt to caduceus369 [2h Tc]
ivano747: folds 
caduceus369: folds 
neoilnervoso: folds 
lucpri: folds 
SKERZA: raises €0.03 to €0.05
KindRonin: calls €0.03
*** FLOP *** [6h 9h Jh]
SKERZA: bets €0.08
KindRonin: calls €0.08
*** TURN *** [6h 9h Jh] [6s]
SKERZA: bets €0.08
KindRonin: raises €0.10 to €0.18
SKERZA: calls €0.10
*** RIVER *** [6h 9h Jh 6s] [6d]
SKERZA: checks 
KindRonin: bets €0.29 and is all-in
SKERZA: folds 
Uncalled bet (€0.29) returned to KindRonin
KindRonin collected €0.59 from pot
KindRonin: doesn't show hand 
*** SUMMARY ***
Total pot €0.62 | Rake €0.03 
Board [6h 9h Jh 6s 6d]
Seat 1: lucpri (button) folded before Flop (didn't bet)
Seat 2: SKERZA (small blind) folded on the River
Seat 3: KindRonin (big blind) collected (€0.59)
Seat 4: ivano747 folded before Flop (didn't bet)
Seat 5: caduceus369 folded before Flop (didn't bet)
Seat 6: neoilnervoso folded before Flop (didn't bet)



PokerStars Zoom Hand #257987983495:  Hold'em No Limit (€0.01/€0.02) [ADM ID: M62BA304494E32ST] - 2025/10/03 23:28:20 CET [2025/10/03 17:28:20 ET]
Table 'Sirio' 6-max Seat #1 is the button
Seat 1: caduceus369 (€1.75 in chips) 
Seat 2: fantaasso (€1.98 in chips) 
Seat 3: Scardo84 (€2.02 in chips) 
Seat 4: ivano747 (€4.39 in chips) 
Seat 5: J.S.Somers (€1.88 in chips) 
Seat 6: Hope7075 (€0.89 in chips) 
fantaasso: posts small blind €0.01
Scardo84: posts big blind €0.02
*** HOLE CARDS ***
Dealt to caduceus369 [Kd As]
ivano747: folds 
J.S.Somers: folds 
Hope7075: raises €0.06 to €0.08
caduceus369: raises €0.22 to €0.30
fantaasso: folds 
Scardo84: folds 
Hope7075: calls €0.22
*** FLOP *** [6h 8s 4s]
Hope7075: checks 
caduceus369: checks 
*** TURN *** [6h 8s 4s] [8h]
Hope7075: checks 
caduceus369: checks 
*** RIVER *** [6h 8s 4s 8h] [6s]
Hope7075: checks 
caduceus369: checks 
*** SHOW DOWN ***
Hope7075: shows [Ac Th] (two pair, Eights and Sixes)
caduceus369: shows [Kd As] (two pair, Eights and Sixes)
Hope7075 collected €0.30 from pot
caduceus369 collected €0.30 from pot
*** SUMMARY ***
Total pot €0.63 | Rake €0.03 
Board [6h 8s 4s 8h 6s]
Seat 1: caduceus369 (button) showed [Kd As] and won (€0.30) with two pair, Eights and Sixes
Seat 2: fantaasso (small blind) folded before Flop
Seat 3: Scardo84 (big blind) folded before Flop
Seat 4: ivano747 folded before Flop (didn't bet)
Seat 5: J.S.Somers folded before Flop (didn't bet)
Seat 6: Hope7075 showed [Ac Th] and won (€0.30) with two pair, Eights and Sixes



PokerStars Zoom Hand #257987993979:  Hold'em No Limit (€0.01/€0.02) [ADM ID: M62BA304494E32ST] - 2025/10/03 23:29:04 CET [2025/10/03 17:29:04 ET]
Table 'Sirio' 6-max Seat #1 is the button
Seat 1: stfuplzudonk (€1.79 in chips) 
Seat 2: skynet0308 (€1.22 in chips) 
Seat 3: Hope7075 (€0.89 in chips) 
Seat 4: outshined8 (€1.72 in chips) 
Seat 5: MOLDAVO1069 (€9.87 in chips) 
Seat 6: caduceus369 (€1.75 in chips) 
skynet0308: posts small blind €0.01
Hope7075: posts big blind €0.02
*** HOLE CARDS ***
Dealt to caduceus369 [6d Ac]
outshined8: folds 
MOLDAVO1069: raises €0.03 to €0.05
caduceus369: folds 
stfuplzudonk: calls €0.05
skynet0308: folds 
Hope7075: calls €0.03
*** FLOP *** [9h Jh Td]
Hope7075: checks 
MOLDAVO1069: checks 
stfuplzudonk: checks 
*** TURN *** [9h Jh Td] [5c]
Hope7075: bets €0.16
MOLDAVO1069: folds 
stfuplzudonk: folds 
Uncalled bet (€0.16) returned to Hope7075
Hope7075 collected €0.16 from pot
Hope7075: doesn't show hand 
*** SUMMARY ***
Total pot €0.16 | Rake €0 
Board [9h Jh Td 5c]
Seat 1: stfuplzudonk (button) folded on the Turn
Seat 2: skynet0308 (small blind) folded before Flop
Seat 3: Hope7075 (big blind) collected (€0.16)
Seat 4: outshined8 folded before Flop (didn't bet)
Seat 5: MOLDAVO1069 folded on the Turn
Seat 6: caduceus369 folded before Flop (didn't bet)



PokerStars Zoom Hand #257987998579:  Hold'em No Limit (€0.01/€0.02) [ADM ID: M62BA304494E32ST] - 2025/10/03 23:29:22 CET [2025/10/03 17:29:22 ET]
Table 'Sirio' 6-max Seat #1 is the button
Seat 1: SidneyPrescott (€2 in chips) 
Seat 2: cartoonbest (€0.88 in chips) 
Seat 3: caduceus369 (€1.75 in chips) 
Seat 4: CacciatoreAA (€1.83 in chips) 
Seat 5: ivano747 (€2.90 in chips) 
Seat 6: lucpri (€2.04 in chips) 
cartoonbest: posts small blind €0.01
caduceus369: posts big blind €0.02
*** HOLE CARDS ***
Dealt to caduceus369 [6s 2s]
CacciatoreAA: raises €0.06 to €0.08
ivano747: folds 
lucpri: folds 
SidneyPrescott: folds 
cartoonbest: folds 
caduceus369: folds 
Uncalled bet (€0.06) returned to CacciatoreAA
CacciatoreAA collected €0.05 from pot
CacciatoreAA: doesn't show hand 
*** SUMMARY ***
Total pot €0.05 | Rake €0 
Seat 1: SidneyPrescott (button) folded before Flop (didn't bet)
Seat 2: cartoonbest (small blind) folded before Flop
Seat 3: caduceus369 (big blind) folded before Flop
Seat 4: CacciatoreAA collected (€0.05)
Seat 5: ivano747 folded before Flop (didn't bet)
Seat 6: lucpri folded before Flop (didn't bet)



PokerStars Zoom Hand #257987997243:  Hold'em No Limit (€0.01/€0.02) [ADM ID: M62BA304494E32ST] - 2025/10/03 23:29:17 CET [2025/10/03 17:29:17 ET]
Table 'Sirio' 6-max Seat #1 is the button
Seat 1: outshined8 (€1.72 in chips) 
Seat 2: workman75 (€2.65 in chips) 
Seat 3: diego-rigano (€0.80 in chips) 
Seat 4: caduceus369 (€1.75 in chips) 
Seat 5: fantaasso (€1.91 in chips) 
Seat 6: Goblin1999 (€2.15 in chips) 
workman75: posts small blind €0.01
diego-rigano: posts big blind €0.02
*** HOLE CARDS ***
Dealt to caduceus369 [2c Jd]
caduceus369: folds 
fantaasso: folds 
Goblin1999: calls €0.02
outshined8: calls €0.02
workman75: raises €0.08 to €0.10
diego-rigano: folds 
Goblin1999: folds 
outshined8: folds 
Uncalled bet (€0.08) returned to workman75
workman75 collected €0.08 from pot
workman75: doesn't show hand 
*** SUMMARY ***
Total pot €0.08 | Rake €0 
Seat 1: outshined8 (button) folded before Flop
Seat 2: workman75 (small blind) collected (€0.08)
Seat 3: diego-rigano (big blind) folded before Flop
Seat 4: caduceus369 folded before Flop (didn't bet)
Seat 5: fantaasso folded before Flop (didn't bet)
Seat 6: Goblin1999 folded before Flop



PokerStars Zoom Hand #257987994716:  Hold'em No Limit (€0.01/€0.02) [ADM ID: M62BA304494E32ST] - 2025/10/03 23:29:07 CET [2025/10/03 17:29:07 ET]
Table 'Sirio' 6-max Seat #1 is the button
Seat 1: skynet0308 (€1.21 in chips) 
Seat 2: CacciatoreAA (€1.81 in chips) 
Seat 3: savicevic74 (€3.25 in chips) 
Seat 4: caduceus369 (€1.75 in chips) 
Seat 5: father2008 (€4.14 in chips) 
Seat 6: Catania838 (€2.85 in chips) 
CacciatoreAA: posts small blind €0.01
savicevic74: posts big blind €0.02
*** HOLE CARDS ***
Dealt to caduceus369 [Qh 6c]
caduceus369: folds 
father2008: raises €0.05 to €0.07
Catania838: folds 
skynet0308: calls €0.07
CacciatoreAA: folds 
savicevic74: calls €0.05
*** FLOP *** [Kd 7d 9s]
savicevic74: checks 
father2008: checks 
skynet0308: checks 
*** TURN *** [Kd 7d 9s] [6h]
savicevic74: checks 
father2008: checks 
skynet0308: checks 
*** RIVER *** [Kd 7d 9s 6h] [2c]
savicevic74: checks 
father2008: checks 
skynet0308: checks 
*** SHOW DOWN ***
savicevic74: shows [Js Ad] (high card Ace)
father2008: shows [8d 8h] (a pair of Eights)
skynet0308: mucks hand 
father2008 collected €0.21 from pot
*** SUMMARY ***
Total pot €0.22 | Rake €0.01 
Board [Kd 7d 9s 6h 2c]
Seat 1: skynet0308 (button) mucked [Td Ah]
Seat 2: CacciatoreAA (small blind) folded before Flop
Seat 3: savicevic74 (big blind) showed [Js Ad] and lost with high card Ace
Seat 4: caduceus369 folded before Flop (didn't bet)
Seat 5: father2008 showed [8d 8h] and won (€0.21) with a pair of Eights
Seat 6: Catania838 folded before Flop (didn't bet)



PokerStars Zoom Hand #257988001249:  Hold'em No Limit (€0.01/€0.02) [ADM ID: M62BA304494E32ST] - 2025/10/03 23:29:33 CET [2025/10/03 17:29:33 ET]
Table 'Sirio' 6-max Seat #1 is the button
Seat 1: SKERZA (€1.22 in chips) 
Seat 2: caduceus369 (€1.73 in chips) 
Seat 3: MOLDAVO1069 (€9.82 in chips) 
Seat 4: KindRonin (€1.18 in chips) 
Seat 5: SidneyPrescott (€5.21 in chips) 
Seat 6: EasyToRule (€3.94 in chips) 
caduceus369: posts small blind €0.01
MOLDAVO1069: posts big blind €0.02
*** HOLE CARDS ***
Dealt to caduceus369 [8h Qh]
KindRonin: folds 
SidneyPrescott: raises €0.04 to €0.06
EasyToRule: folds 
SKERZA: calls €0.06
caduceus369: folds 
MOLDAVO1069: folds 
*** FLOP *** [Js Ac Qd]
SidneyPrescott: bets €0.10
SKERZA: calls €0.10
*** TURN *** [Js Ac Qd] [6d]
SidneyPrescott: bets €0.24
SKERZA: folds 
Uncalled bet (€0.24) returned to SidneyPrescott
SidneyPrescott collected €0.34 from pot
SidneyPrescott: doesn't show hand 
*** SUMMARY ***
Total pot €0.35 | Rake €0.01 
Board [Js Ac Qd 6d]
Seat 1: SKERZA (button) folded on the Turn
Seat 2: caduceus369 (small blind) folded before Flop
Seat 3: MOLDAVO1069 (big blind) folded before Flop
Seat 4: KindRonin folded before Flop (didn't bet)
Seat 5: SidneyPrescott collected (€0.34)
Seat 6: EasyToRule folded before Flop (didn't bet)



PokerStars Zoom Hand #257988004681:  Hold'em No Limit (€0.01/€0.02) [ADM ID: M62BA304494E32ST] - 2025/10/03 23:29:48 CET [2025/10/03 17:29:48 ET]
Table 'Sirio' 6-max Seat #1 is the button
Seat 1: ivano747 (€2.87 in chips) 
Seat 2: father2008 (€4.28 in chips) 
Seat 3: SidneyPrescott (€4.36 in chips) 
Seat 4: Witness85906 (€4.85 in chips) 
Seat 5: robertoH2O (€2 in chips) 
Seat 6: caduceus369 (€1.72 in chips) 
father2008: posts small blind €0.01
SidneyPrescott: posts big blind €0.02
*** HOLE CARDS ***
Dealt to caduceus369 [7s 7h]
Witness85906: raises €0.03 to €0.05
robertoH2O: folds 
caduceus369: calls €0.05
ivano747: folds 
father2008: folds 
SidneyPrescott: folds 
*** FLOP *** [Kd 3c 2s]
Witness85906: checks 
caduceus369: checks 
*** TURN *** [Kd 3c 2s] [Qc]
Witness85906: bets €0.04
caduceus369: raises €0.10 to €0.14
Witness85906: calls €0.10
*** RIVER *** [Kd 3c 2s Qc] [Th]
Witness85906: bets €0.32
caduceus369: folds 
Uncalled bet (€0.32) returned to Witness85906
Witness85906 collected €0.39 from pot
Witness85906: doesn't show hand 
*** SUMMARY ***
Total pot €0.41 | Rake €0.02 
Board [Kd 3c 2s Qc Th]
Seat 1: ivano747 (button) folded before Flop (didn't bet)
Seat 2: father2008 (small blind) folded before Flop
Seat 3: SidneyPrescott (big blind) folded before Flop
Seat 4: Witness85906 collected (€0.39)
Seat 5: robertoH2O folded before Flop (didn't bet)
Seat 6: caduceus369 folded on the River



PokerStars Zoom Hand #257988021697:  Hold'em No Limit (€0.01/€0.02) [ADM ID: M62BA304494E32ST] - 2025/10/03 23:30:59 CET [2025/10/03 17:30:59 ET]
Table 'Sirio' 6-max Seat #1 is the button
Seat 1: caduceus369 (€1.53 in chips) 
Seat 2: tigermiscio (€0.68 in chips) 
Seat 3: ADRIAN0_MEIS (€2.45 in chips) 
Seat 4: EasyToRule (€2 in chips) 
Seat 5: Witness85906 (€5.05 in chips) 
Seat 6: montemeru (€3.71 in chips) 
tigermiscio: posts small blind €0.01
ADRIAN0_MEIS: posts big blind €0.02
*** HOLE CARDS ***
Dealt to caduceus369 [6c Qd]
EasyToRule: folds 
Witness85906: folds 
montemeru: folds 
caduceus369: folds 
tigermiscio: folds 
Uncalled bet (€0.01) returned to ADRIAN0_MEIS
ADRIAN0_MEIS collected €0.02 from pot
ADRIAN0_MEIS: doesn't show hand 
*** SUMMARY ***
Total pot €0.02 | Rake €0 
Seat 1: caduceus369 (button) folded before Flop (didn't bet)
Seat 2: tigermiscio (small blind) folded before Flop
Seat 3: ADRIAN0_MEIS (big blind) collected (€0.02)
Seat 4: EasyToRule folded before Flop (didn't bet)
Seat 5: Witness85906 folded before Flop (didn't bet)
Seat 6: montemeru folded before Flop (didn't bet)



PokerStars Zoom Hand #257988024070:  Hold'em No Limit (€0.01/€0.02) [ADM ID: M62BA304494E32ST] - 2025/10/03 23:31:09 CET [2025/10/03 17:31:09 ET]
Table 'Sirio' 6-max Seat #1 is the button
Seat 1: outshined8 (€1.78 in chips) 
Seat 2: savicevic74 (€2.87 in chips) 
Seat 3: Witness85906 (€5.05 in chips) 
Seat 4: SidneyPrescott (€4.19 in chips) 
Seat 5: caduceus369 (€1.53 in chips) 
Seat 6: robertoH2O (€2.07 in chips) 
savicevic74: posts small blind €0.01
Witness85906: posts big blind €0.02
*** HOLE CARDS ***
Dealt to caduceus369 [Js Kh]
SidneyPrescott: folds 
caduceus369: raises €0.04 to €0.06
robertoH2O: folds 
outshined8: folds 
savicevic74: folds 
Witness85906: folds 
Uncalled bet (€0.04) returned to caduceus369
caduceus369 collected €0.05 from pot
caduceus369: doesn't show hand 
*** SUMMARY ***
Total pot €0.05 | Rake €0 
Seat 1: outshined8 (button) folded before Flop (didn't bet)
Seat 2: savicevic74 (small blind) folded before Flop
Seat 3: Witness85906 (big blind) folded before Flop
Seat 4: SidneyPrescott folded before Flop (didn't bet)
Seat 5: caduceus369 collected (€0.05)
Seat 6: robertoH2O folded before Flop (didn't bet)



PokerStars Zoom Hand #257988029802:  Hold'em No Limit (€0.01/€0.02) [ADM ID: M62BA304494E32ST] - 2025/10/03 23:31:33 CET [2025/10/03 17:31:33 ET]
Table 'Sirio' 6-max Seat #1 is the button
Seat 1: workman75 (€2.82 in chips) 
Seat 2: caduceus369 (€1.56 in chips) 
Seat 3: ivano747 (€4.38 in chips) 
Seat 4: KindRonin (€1.11 in chips) 
Seat 5: Chia9711 (€2.27 in chips) 
Seat 6: Sium12302 (€2 in chips) 
caduceus369: posts small blind €0.01
ivano747: posts big blind €0.02
*** HOLE CARDS ***
Dealt to caduceus369 [8h Kd]
KindRonin: folds 
Chia9711: calls €0.02
Sium12302: folds 
workman75: raises €0.07 to €0.09
caduceus369: folds 
ivano747: folds 
Chia9711: folds 
Uncalled bet (€0.07) returned to workman75
workman75 collected €0.07 from pot
workman75: doesn't show hand 
*** SUMMARY ***
Total pot €0.07 | Rake €0 
Seat 1: workman75 (button) collected (€0.07)
Seat 2: caduceus369 (small blind) folded before Flop
Seat 3: ivano747 (big blind) folded before Flop
Seat 4: KindRonin folded before Flop (didn't bet)
Seat 5: Chia9711 folded before Flop
Seat 6: Sium12302 folded before Flop (didn't bet)



PokerStars Zoom Hand #257988032371:  Hold'em No Limit (€0.01/€0.02) [ADM ID: M62BA304494E32ST] - 2025/10/03 23:31:44 CET [2025/10/03 17:31:44 ET]
Table 'Sirio' 6-max Seat #1 is the button
Seat 1: stfuplzudonk (€4.20 in chips) 
Seat 2: neoilnervoso (€1.85 in chips) 
Seat 3: caduceus369 (€1.55 in chips) 
Seat 4: Chia9711 (€2.25 in chips) 
Seat 5: father2008 (€6 in chips) 
Seat 6: Scardo84 (€2.05 in chips) 
neoilnervoso: posts small blind €0.01
caduceus369: posts big blind €0.02
*** HOLE CARDS ***
Dealt to caduceus369 [9s 3h]
Chia9711: folds 
father2008: folds 
Scardo84: folds 
stfuplzudonk: folds 
neoilnervoso: folds 
Uncalled bet (€0.01) returned to caduceus369
caduceus369 collected €0.02 from pot
caduceus369: doesn't show hand 
*** SUMMARY ***
Total pot €0.02 | Rake €0 
Seat 1: stfuplzudonk (button) folded before Flop (didn't bet)
Seat 2: neoilnervoso (small blind) folded before Flop
Seat 3: caduceus369 (big blind) collected (€0.02)
Seat 4: Chia9711 folded before Flop (didn't bet)
Seat 5: father2008 folded before Flop (didn't bet)
Seat 6: Scardo84 folded before Flop (didn't bet)



PokerStars Zoom Hand #257988034815:  Hold'em No Limit (€0.01/€0.02) [ADM ID: M62BA304494E32ST] - 2025/10/03 23:31:54 CET [2025/10/03 17:31:54 ET]
Table 'Sirio' 6-max Seat #1 is the button
Seat 1: caduceus369 (€1.56 in chips) 
Seat 2: EasyToRule (€3.79 in chips) 
Seat 3: pia1256 (€1.57 in chips) 
Seat 4: franky65124 (€1.49 in chips) 
Seat 5: ivano747 (€4.36 in chips) 
Seat 6: stfuplzudonk (€1.48 in chips) 
EasyToRule: posts small blind €0.01
pia1256: posts big blind €0.02
*** HOLE CARDS ***
Dealt to caduceus369 [Jd Qc]
franky65124: calls €0.02
ivano747: folds 
stfuplzudonk: raises €0.04 to €0.06
caduceus369: calls €0.06
EasyToRule: folds 
pia1256: calls €0.04
franky65124: calls €0.04
*** FLOP *** [As 8s 4s]
pia1256: checks 
franky65124: checks 
stfuplzudonk: checks 
caduceus369: checks 
*** TURN *** [As 8s 4s] [Jh]
pia1256: checks 
franky65124: checks 
stfuplzudonk: checks 
caduceus369: checks 
*** RIVER *** [As 8s 4s Jh] [6s]
pia1256: bets €0.24
franky65124: folds 
stfuplzudonk: folds 
caduceus369: folds 
Uncalled bet (€0.24) returned to pia1256
pia1256 collected €0.24 from pot
pia1256: doesn't show hand 
*** SUMMARY ***
Total pot €0.25 | Rake €0.01 
Board [As 8s 4s Jh 6s]
Seat 1: caduceus369 (button) folded on the River
Seat 2: EasyToRule (small blind) folded before Flop
Seat 3: pia1256 (big blind) collected (€0.24)
Seat 4: franky65124 folded on the River
Seat 5: ivano747 folded before Flop (didn't bet)
Seat 6: stfuplzudonk folded on the River



PokerStars Zoom Hand #257988044158:  Hold'em No Limit (€0.01/€0.02) [ADM ID: M62BA304494E32ST] - 2025/10/03 23:32:33 CET [2025/10/03 17:32:33 ET]
Table 'Sirio' 6-max Seat #1 is the button
Seat 1: ADRIAN0_MEIS (€2.46 in chips) 
Seat 2: Sium12302 (€2.01 in chips) 
Seat 3: maury999999 (€2.19 in chips) 
Seat 4: SidneyPrescott (€5.51 in chips) 
Seat 5: Hope7075 (€0.88 in chips) 
Seat 6: caduceus369 (€1.50 in chips) 
Sium12302: posts small blind €0.01
maury999999: posts big blind €0.02
*** HOLE CARDS ***
Dealt to caduceus369 [Ks As]
SidneyPrescott: folds 
Hope7075: calls €0.02
caduceus369: raises €0.06 to €0.08
ADRIAN0_MEIS: calls €0.08
Sium12302: folds 
maury999999: folds 
Hope7075: calls €0.06
*** FLOP *** [2h 6c Qs]
Hope7075: checks 
caduceus369: checks 
ADRIAN0_MEIS: checks 
*** TURN *** [2h 6c Qs] [4c]
Hope7075: checks 
caduceus369: bets €0.07
ADRIAN0_MEIS: raises €0.22 to €0.29
Hope7075: folds 
caduceus369: folds 
Uncalled bet (€0.22) returned to ADRIAN0_MEIS
ADRIAN0_MEIS collected €0.39 from pot
ADRIAN0_MEIS: doesn't show hand 
*** SUMMARY ***
Total pot €0.41 | Rake €0.02 
Board [2h 6c Qs 4c]
Seat 1: ADRIAN0_MEIS (button) collected (€0.39)
Seat 2: Sium12302 (small blind) folded before Flop
Seat 3: maury999999 (big blind) folded before Flop
Seat 4: SidneyPrescott folded before Flop (didn't bet)
Seat 5: Hope7075 folded on the Turn
Seat 6: caduceus369 folded on the Turn



PokerStars Zoom Hand #257988055810:  Hold'em No Limit (€0.01/€0.02) [ADM ID: M62BA304494E32ST] - 2025/10/03 23:33:21 CET [2025/10/03 17:33:21 ET]
Table 'Sirio' 6-max Seat #1 is the button
Seat 1: ADRIAN0_MEIS (€2.70 in chips) 
Seat 2: Witness85906 (€5.13 in chips) 
Seat 3: Sium12302 (€2.07 in chips) 
Seat 4: workman75 (€2.58 in chips) 
Seat 5: caduceus369 (€1.35 in chips) 
Seat 6: SidneyPrescott (€5.54 in chips) 
Witness85906: posts small blind €0.01
Sium12302: posts big blind €0.02
*** HOLE CARDS ***
Dealt to caduceus369 [7c 8s]
workman75: folds 
caduceus369: folds 
SidneyPrescott: folds 
ADRIAN0_MEIS: folds 
Witness85906: raises €0.04 to €0.06
Sium12302: folds 
Uncalled bet (€0.04) returned to Witness85906
Witness85906 collected €0.04 from pot
Witness85906: doesn't show hand 
*** SUMMARY ***
Total pot €0.04 | Rake €0 
Seat 1: ADRIAN0_MEIS (button) folded before Flop (didn't bet)
Seat 2: Witness85906 (small blind) collected (€0.04)
Seat 3: Sium12302 (big blind) folded before Flop
Seat 4: workman75 folded before Flop (didn't bet)
Seat 5: caduceus369 folded before Flop (didn't bet)
Seat 6: SidneyPrescott folded before Flop (didn't bet)



PokerStars Zoom Hand #257988056871:  Hold'em No Limit (€0.01/€0.02) [ADM ID: M62BA304494E32ST] - 2025/10/03 23:33:26 CET [2025/10/03 17:33:26 ET]
Table 'Sirio' 6-max Seat #1 is the button
Seat 1: xxcash88 (€1.98 in chips) 
Seat 2: MOLDAVO1069 (€3.35 in chips) 
Seat 3: stfuplzudonk (€4.49 in chips) 
Seat 4: caduceus369 (€1.35 in chips) 
Seat 5: SidneyPrescott (€3.98 in chips) 
Seat 6: tigermiscio (€0.51 in chips) 
MOLDAVO1069: posts small blind €0.01
stfuplzudonk: posts big blind €0.02
*** HOLE CARDS ***
Dealt to caduceus369 [Qc 9d]
caduceus369: folds 
SidneyPrescott: raises €0.04 to €0.06
tigermiscio: folds 
xxcash88: folds 
MOLDAVO1069: folds 
stfuplzudonk: calls €0.04
*** FLOP *** [5h Kh Kc]
stfuplzudonk: checks 
SidneyPrescott: checks 
*** TURN *** [5h Kh Kc] [As]
stfuplzudonk: checks 
SidneyPrescott: bets €0.06
stfuplzudonk: folds 
Uncalled bet (€0.06) returned to SidneyPrescott
SidneyPrescott collected €0.13 from pot
SidneyPrescott: doesn't show hand 
*** SUMMARY ***
Total pot €0.13 | Rake €0 
Board [5h Kh Kc As]
Seat 1: xxcash88 (button) folded before Flop (didn't bet)
Seat 2: MOLDAVO1069 (small blind) folded before Flop
Seat 3: stfuplzudonk (big blind) folded on the Turn
Seat 4: caduceus369 folded before Flop (didn't bet)
Seat 5: SidneyPrescott collected (€0.13)
Seat 6: tigermiscio folded before Flop (didn't bet)



PokerStars Zoom Hand #257988060934:  Hold'em No Limit (€0.01/€0.02) [ADM ID: M62BA304494E32ST] - 2025/10/03 23:33:43 CET [2025/10/03 17:33:43 ET]
Table 'Sirio' 6-max Seat #1 is the button
Seat 1: tigermiscio (€0.50 in chips) 
Seat 2: CacciatoreAA (€1.85 in chips) 
Seat 3: caduceus369 (€1.34 in chips) 
Seat 4: ivano747 (€2.83 in chips) 
Seat 5: Neroonciolina (€5.43 in chips) 
Seat 6: maury999999 (€2.38 in chips) 
CacciatoreAA: posts small blind €0.01
caduceus369: posts big blind €0.02
*** HOLE CARDS ***
Dealt to caduceus369 [8h 2c]
ivano747: folds 
Neroonciolina: calls €0.02
maury999999: folds 
tigermiscio: folds 
CacciatoreAA: folds 
caduceus369: checks 
*** FLOP *** [4s Ts Td]
caduceus369: checks 
Neroonciolina: checks 
*** TURN *** [4s Ts Td] [2s]
caduceus369: checks 
Neroonciolina: checks 
*** RIVER *** [4s Ts Td 2s] [8d]
caduceus369: checks 
Neroonciolina: checks 
*** SHOW DOWN ***
caduceus369: shows [8h 2c] (two pair, Tens and Eights)
Neroonciolina: mucks hand 
caduceus369 collected €0.05 from pot
*** SUMMARY ***
Total pot €0.05 | Rake €0 
Board [4s Ts Td 2s 8d]
Seat 1: tigermiscio (button) folded before Flop (didn't bet)
Seat 2: CacciatoreAA (small blind) folded before Flop
Seat 3: caduceus369 (big blind) showed [8h 2c] and won (€0.05) with two pair, Tens and Eights
Seat 4: ivano747 folded before Flop (didn't bet)
Seat 5: Neroonciolina mucked [Ad Jd]
Seat 6: maury999999 folded before Flop (didn't bet)



PokerStars Zoom Hand #257988059511:  Hold'em No Limit (€0.01/€0.02) [ADM ID: M62BA304494E32ST] - 2025/10/03 23:33:37 CET [2025/10/03 17:33:37 ET]
Table 'Sirio' 6-max Seat #1 is the button
Seat 1: outshined8 (€1.55 in chips) 
Seat 2: xxcash88 (€1.98 in chips) 
Seat 3: trillycata (€1.33 in chips) 
Seat 4: ivano747 (€4.22 in chips) 
Seat 5: Ceribelli1705 (€0.82 in chips) 
Seat 6: caduceus369 (€1.34 in chips) 
xxcash88: posts small blind €0.01
trillycata: posts big blind €0.02
*** HOLE CARDS ***
Dealt to caduceus369 [5d Ac]
ivano747: folds 
Ceribelli1705: calls €0.02
caduceus369: folds 
outshined8: calls €0.02
xxcash88: calls €0.01
trillycata: raises €0.02 to €0.04
Ceribelli1705: calls €0.02
outshined8: calls €0.02
xxcash88: calls €0.02
*** FLOP *** [Jc 8s 9d]
xxcash88: checks 
trillycata: checks 
Ceribelli1705: checks 
outshined8: checks 
*** TURN *** [Jc 8s 9d] [7s]
xxcash88: checks 
trillycata: checks 
Ceribelli1705: checks 
outshined8: checks 
*** RIVER *** [Jc 8s 9d 7s] [4s]
xxcash88: checks 
trillycata: checks 
Ceribelli1705: checks 
outshined8: checks 
*** SHOW DOWN ***
xxcash88: shows [9s Qd] (a pair of Nines)
trillycata: mucks hand 
Ceribelli1705: mucks hand 
outshined8: shows [9c Ad] (a pair of Nines - Ace kicker)
outshined8 collected €0.16 from pot
*** SUMMARY ***
Total pot €0.16 | Rake €0 
Board [Jc 8s 9d 7s 4s]
Seat 1: outshined8 (button) showed [9c Ad] and won (€0.16) with a pair of Nines
Seat 2: xxcash88 (small blind) showed [9s Qd] and lost with a pair of Nines
Seat 3: trillycata (big blind) mucked [Qc Kh]
Seat 4: ivano747 folded before Flop (didn't bet)
Seat 5: Ceribelli1705 mucked [3s Ah]
Seat 6: caduceus369 folded before Flop (didn't bet)



PokerStars Zoom Hand #257988072873:  Hold'em No Limit (€0.01/€0.02) [ADM ID: M62BA304494E32ST] - 2025/10/03 23:34:33 CET [2025/10/03 17:34:33 ET]
Table 'Sirio' 6-max Seat #1 is the button
Seat 1: stfuplzudonk (€2.94 in chips) 
Seat 2: EasyToRule (€3.66 in chips) 
Seat 3: CacciatoreAA (€1.84 in chips) 
Seat 4: pia1256 (€1.75 in chips) 
Seat 5: caduceus369 (€1.37 in chips) 
Seat 6: fantaasso (€1.86 in chips) 
EasyToRule: posts small blind €0.01
CacciatoreAA: posts big blind €0.02
*** HOLE CARDS ***
Dealt to caduceus369 [Qs Tc]
pia1256: folds 
caduceus369: folds 
fantaasso: raises €0.04 to €0.06
stfuplzudonk: folds 
EasyToRule: folds 
CacciatoreAA: folds 
Uncalled bet (€0.04) returned to fantaasso
fantaasso collected €0.05 from pot
fantaasso: doesn't show hand 
*** SUMMARY ***
Total pot €0.05 | Rake €0 
Seat 1: stfuplzudonk (button) folded before Flop (didn't bet)
Seat 2: EasyToRule (small blind) folded before Flop
Seat 3: CacciatoreAA (big blind) folded before Flop
Seat 4: pia1256 folded before Flop (didn't bet)
Seat 5: caduceus369 folded before Flop (didn't bet)
Seat 6: fantaasso collected (€0.05)



PokerStars Zoom Hand #257988058130:  Hold'em No Limit (€0.01/€0.02) [ADM ID: M62BA304494E32ST] - 2025/10/03 23:33:31 CET [2025/10/03 17:33:31 ET]
Table 'Sirio' 6-max Seat #1 is the button
Seat 1: trillycata (€1.33 in chips) 
Seat 2: caduceus369 (€1.35 in chips) 
Seat 3: ADRIAN0_MEIS (€12.46 in chips) 
Seat 4: Sium12302 (€2.05 in chips) 
Seat 5: Ceribelli1705 (€0.82 in chips) 
Seat 6: Scardo84 (€2.55 in chips) 
caduceus369: posts small blind €0.01
ADRIAN0_MEIS: posts big blind €0.02
*** HOLE CARDS ***
Dealt to caduceus369 [9d 8d]
Sium12302: raises €0.04 to €0.06
Ceribelli1705: folds 
Scardo84 is disconnected 
Scardo84 has timed out while disconnected
Scardo84: folds 
trillycata: folds 
caduceus369: folds 
ADRIAN0_MEIS: calls €0.04
*** FLOP *** [Td 7s 3c]
ADRIAN0_MEIS: checks 
Sium12302: bets €0.05
ADRIAN0_MEIS: raises €0.08 to €0.13
Sium12302: calls €0.08
*** TURN *** [Td 7s 3c] [2d]
ADRIAN0_MEIS: bets €0.20
Sium12302: calls €0.20
*** RIVER *** [Td 7s 3c 2d] [Jd]
ADRIAN0_MEIS: checks 
Sium12302: bets €0.22
ADRIAN0_MEIS: calls €0.22
*** SHOW DOWN ***
Sium12302: shows [Jc Js] (three of a kind, Jacks)
ADRIAN0_MEIS: mucks hand 
Sium12302 collected €1.17 from pot
*** SUMMARY ***
Total pot €1.23 | Rake €0.06 
Board [Td 7s 3c 2d Jd]
Seat 1: trillycata (button) folded before Flop (didn't bet)
Seat 2: caduceus369 (small blind) folded before Flop
Seat 3: ADRIAN0_MEIS (big blind) mucked [6s 6c]
Seat 4: Sium12302 showed [Jc Js] and won (€1.17) with three of a kind, Jacks
Seat 5: Ceribelli1705 folded before Flop (didn't bet)
Seat 6: Scardo84 folded before Flop (didn't bet)



PokerStars Zoom Hand #257988070007:  Hold'em No Limit (€0.01/€0.02) [ADM ID: M62BA304494E32ST] - 2025/10/03 23:34:21 CET [2025/10/03 17:34:21 ET]
Table 'Sirio' 6-max Seat #1 is the button
Seat 1: caduceus369 (€1.37 in chips) 
Seat 2: Neroonciolina (€5.41 in chips) 
Seat 3: SidneyPrescott (€4.04 in chips) 
Seat 4: diego-rigano (€0.56 in chips) 
Seat 5: MOLDAVO1069 (€9.68 in chips) 
Seat 6: Witness85906 (€5.10 in chips) 
Neroonciolina: posts small blind €0.01
SidneyPrescott: posts big blind €0.02
*** HOLE CARDS ***
Dealt to caduceus369 [6c 2s]
diego-rigano: raises €0.03 to €0.05
MOLDAVO1069: raises €0.10 to €0.15
Witness85906: folds 
caduceus369: folds 
Neroonciolina: folds 
SidneyPrescott: calls €0.13
diego-rigano: calls €0.10
*** FLOP *** [Qc 9c 2h]
SidneyPrescott: checks 
diego-rigano: checks 
MOLDAVO1069: checks 
*** TURN *** [Qc 9c 2h] [Ad]
SidneyPrescott: bets €0.30
diego-rigano: folds 
MOLDAVO1069: folds 
Uncalled bet (€0.30) returned to SidneyPrescott
SidneyPrescott collected €0.44 from pot
SidneyPrescott: doesn't show hand 
*** SUMMARY ***
Total pot €0.46 | Rake €0.02 
Board [Qc 9c 2h Ad]
Seat 1: caduceus369 (button) folded before Flop (didn't bet)
Seat 2: Neroonciolina (small blind) folded before Flop
Seat 3: SidneyPrescott (big blind) collected (€0.44)
Seat 4: diego-rigano folded on the Turn
Seat 5: MOLDAVO1069 folded on the Turn
Seat 6: Witness85906 folded before Flop (didn't bet)



PokerStars Zoom Hand #257988071735:  Hold'em No Limit (€0.01/€0.02) [ADM ID: M62BA304494E32ST] - 2025/10/03 23:34:28 CET [2025/10/03 17:34:28 ET]
Table 'Sirio' 6-max Seat #1 is the button
Seat 1: fantaasso (€1.86 in chips) 
Seat 2: cesaretto23 (€3.33 in chips) 
Seat 3: Catania838 (€1.96 in chips) 
Seat 4: caduceus369 (€1.37 in chips) 
Seat 5: ivano747 (€2.80 in chips) 
Seat 6: father2008 (€4.59 in chips) 
cesaretto23: posts small blind €0.01
Catania838: posts big blind €0.02
*** HOLE CARDS ***
Dealt to caduceus369 [9d 4s]
caduceus369: folds 
ivano747: raises €0.04 to €0.06
father2008: folds 
fantaasso: folds 
cesaretto23: calls €0.05
Catania838: folds 
*** FLOP *** [Tc As 9c]
cesaretto23: checks 
ivano747: bets €0.07
cesaretto23: folds 
Uncalled bet (€0.07) returned to ivano747
ivano747 collected €0.14 from pot
ivano747: doesn't show hand 
*** SUMMARY ***
Total pot €0.14 | Rake €0 
Board [Tc As 9c]
Seat 1: fantaasso (button) folded before Flop (didn't bet)
Seat 2: cesaretto23 (small blind) folded on the Flop
Seat 3: Catania838 (big blind) folded before Flop
Seat 4: caduceus369 folded before Flop (didn't bet)
Seat 5: ivano747 collected (€0.14)
Seat 6: father2008 folded before Flop (didn't bet)



PokerStars Zoom Hand #257988073653:  Hold'em No Limit (€0.01/€0.02) [ADM ID: M62BA304494E32ST] - 2025/10/03 23:34:36 CET [2025/10/03 17:34:36 ET]
Table 'Sirio' 6-max Seat #1 is the button
Seat 1: caduceus369 (€1.37 in chips) 
Seat 2: Catania838 (€3.17 in chips) 
Seat 3: pia1256 (€1.75 in chips) 
Seat 4: Sium12302 (€4.29 in chips) 
Seat 5: Neroonciolina (€5.40 in chips) 
Seat 6: fantaasso (€1.84 in chips) 
Catania838: posts small blind €0.01
pia1256: posts big blind €0.02
*** HOLE CARDS ***
Dealt to caduceus369 [2d Js]
Sium12302: folds 
Neroonciolina: calls €0.02
fantaasso: folds 
caduceus369: folds 
Catania838: calls €0.01
pia1256: checks 
*** FLOP *** [3d 9c 8d]
Catania838: checks 
pia1256: checks 
Neroonciolina: bets €0.06
Catania838: folds 
pia1256: calls €0.06
*** TURN *** [3d 9c 8d] [Qc]
pia1256: checks 
Neroonciolina: checks 
*** RIVER *** [3d 9c 8d Qc] [7h]
pia1256: checks 
Neroonciolina: checks 
*** SHOW DOWN ***
pia1256: shows [8c 4d] (a pair of Eights)
Neroonciolina: mucks hand 
pia1256 collected €0.18 from pot
*** SUMMARY ***
Total pot €0.18 | Rake €0 
Board [3d 9c 8d Qc 7h]
Seat 1: caduceus369 (button) folded before Flop (didn't bet)
Seat 2: Catania838 (small blind) folded on the Flop
Seat 3: pia1256 (big blind) showed [8c 4d] and won (€0.18) with a pair of Eights
Seat 4: Sium12302 folded before Flop (didn't bet)
Seat 5: Neroonciolina mucked [3c As]
Seat 6: fantaasso folded before Flop (didn't bet)



PokerStars Zoom Hand #257988074586:  Hold'em No Limit (€0.01/€0.02) [ADM ID: M62BA304494E32ST] - 2025/10/03 23:34:40 CET [2025/10/03 17:34:40 ET]
Table 'Sirio' 6-max Seat #1 is the button
Seat 1: ADRIAN0_MEIS (€2.66 in chips) 
Seat 2: stfuplzudonk (€2.94 in chips) 
Seat 3: caduceus369 (€1.37 in chips) 
Seat 4: EasyToRule (€2.24 in chips) 
Seat 5: montemeru (€1.72 in chips) 
Seat 6: fantaasso (€1.84 in chips) 
stfuplzudonk: posts small blind €0.01
caduceus369: posts big blind €0.02
*** HOLE CARDS ***
Dealt to caduceus369 [4h 9s]
EasyToRule: folds 
montemeru: raises €0.04 to €0.06
fantaasso: folds 
ADRIAN0_MEIS: raises €0.15 to €0.21
stfuplzudonk: folds 
caduceus369: folds 
montemeru: calls €0.15
*** FLOP *** [7h 4s 6h]
montemeru: checks 
ADRIAN0_MEIS: bets €0.32
montemeru: folds 
Uncalled bet (€0.32) returned to ADRIAN0_MEIS
ADRIAN0_MEIS collected €0.43 from pot
ADRIAN0_MEIS: doesn't show hand 
*** SUMMARY ***
Total pot €0.45 | Rake €0.02 
Board [7h 4s 6h]
Seat 1: ADRIAN0_MEIS (button) collected (€0.43)
Seat 2: stfuplzudonk (small blind) folded before Flop
Seat 3: caduceus369 (big blind) folded before Flop
Seat 4: EasyToRule folded before Flop (didn't bet)
Seat 5: montemeru folded on the Flop
Seat 6: fantaasso folded before Flop (didn't bet)



PokerStars Zoom Hand #257988079831:  Hold'em No Limit (€0.01/€0.02) [ADM ID: M62BA304494E32ST] - 2025/10/03 23:35:02 CET [2025/10/03 17:35:02 ET]
Table 'Sirio' 6-max Seat #1 is the button
Seat 1: ivano747 (€3.81 in chips) 
Seat 2: SidneyPrescott (€5.54 in chips) 
Seat 3: stfuplzudonk (€4.49 in chips) 
Seat 4: cesaretto23 (€3.27 in chips) 
Seat 5: EasyToRule (€2.22 in chips) 
Seat 6: caduceus369 (€1.34 in chips) 
SidneyPrescott: posts small blind €0.01
stfuplzudonk: posts big blind €0.02
*** HOLE CARDS ***
Dealt to caduceus369 [9c 7d]
cesaretto23: calls €0.02
EasyToRule: folds 
caduceus369: folds 
ivano747: raises €0.04 to €0.06
SidneyPrescott: folds 
stfuplzudonk: calls €0.04
cesaretto23: calls €0.04
*** FLOP *** [2c 7c Js]
stfuplzudonk: checks 
cesaretto23: checks 
ivano747: bets €0.09
stfuplzudonk: folds 
cesaretto23: folds 
Uncalled bet (€0.09) returned to ivano747
ivano747 collected €0.18 from pot
ivano747: doesn't show hand 
*** SUMMARY ***
Total pot €0.19 | Rake €0.01 
Board [2c 7c Js]
Seat 1: ivano747 (button) collected (€0.18)
Seat 2: SidneyPrescott (small blind) folded before Flop
Seat 3: stfuplzudonk (big blind) folded on the Flop
Seat 4: cesaretto23 folded on the Flop
Seat 5: EasyToRule folded before Flop (didn't bet)
Seat 6: caduceus369 folded before Flop (didn't bet)



PokerStars Zoom Hand #257988078721:  Hold'em No Limit (€0.01/€0.02) [ADM ID: M62BA304494E32ST] - 2025/10/03 23:34:57 CET [2025/10/03 17:34:57 ET]
Table 'Sirio' 6-max Seat #1 is the button
Seat 1: maury999999 (€2.28 in chips) 
Seat 2: caduceus369 (€1.35 in chips) 
Seat 3: cartoonbest (€2.79 in chips) 
Seat 4: Catania838 (€1.93 in chips) 
Seat 5: SidneyPrescott (€5.54 in chips) 
Seat 6: Genny040893 (€0.87 in chips) 
caduceus369: posts small blind €0.01
cartoonbest: posts big blind €0.02
*** HOLE CARDS ***
Dealt to caduceus369 [2s Ah]
Catania838: calls €0.02
SidneyPrescott: folds 
Genny040893: raises €0.08 to €0.10
maury999999: raises €0.26 to €0.36
caduceus369: folds 
cartoonbest: folds 
Catania838: folds 
Genny040893: calls €0.26
*** FLOP *** [Ac 4s Ad]
Genny040893: checks 
maury999999: bets €0.24
Genny040893: folds 
Uncalled bet (€0.24) returned to maury999999
maury999999 collected €0.73 from pot
maury999999: doesn't show hand 
*** SUMMARY ***
Total pot €0.77 | Rake €0.04 
Board [Ac 4s Ad]
Seat 1: maury999999 (button) collected (€0.73)
Seat 2: caduceus369 (small blind) folded before Flop
Seat 3: cartoonbest (big blind) folded before Flop
Seat 4: Catania838 folded before Flop
Seat 5: SidneyPrescott folded before Flop (didn't bet)
Seat 6: Genny040893 folded on the Flop



PokerStars Zoom Hand #257988081866:  Hold'em No Limit (€0.01/€0.02) [ADM ID: M62BA304494E32ST] - 2025/10/03 23:35:10 CET [2025/10/03 17:35:10 ET]
Table 'Sirio' 6-max Seat #1 is the button
Seat 1: sparky91580 (€0.86 in chips) 
Seat 2: savicevic74 (€3.33 in chips) 
Seat 3: MOLDAVO1069 (€3.28 in chips) 
Seat 4: montemeru (€3.99 in chips) 
Seat 5: caduceus369 (€1.34 in chips) 
Seat 6: xxcash88 (€2.03 in chips) 
savicevic74: posts small blind €0.01
MOLDAVO1069: posts big blind €0.02
*** HOLE CARDS ***
Dealt to caduceus369 [6h 8h]
montemeru: folds 
caduceus369: folds 
xxcash88: folds 
sparky91580: raises €0.02 to €0.04
savicevic74: folds 
MOLDAVO1069: calls €0.02
*** FLOP *** [Ac 4d 9h]
MOLDAVO1069: checks 
sparky91580: bets €0.09
MOLDAVO1069: folds 
Uncalled bet (€0.09) returned to sparky91580
sparky91580 collected €0.09 from pot
sparky91580: doesn't show hand 
*** SUMMARY ***
Total pot €0.09 | Rake €0 
Board [Ac 4d 9h]
Seat 1: sparky91580 (button) collected (€0.09)
Seat 2: savicevic74 (small blind) folded before Flop
Seat 3: MOLDAVO1069 (big blind) folded on the Flop
Seat 4: montemeru folded before Flop (didn't bet)
Seat 5: caduceus369 folded before Flop (didn't bet)
Seat 6: xxcash88 folded before Flop (didn't bet)



PokerStars Zoom Hand #257988089496:  Hold'em No Limit (€0.01/€0.02) [ADM ID: M62BA304494E32ST] - 2025/10/03 23:35:42 CET [2025/10/03 17:35:42 ET]
Table 'Sirio' 6-max Seat #1 is the button
Seat 1: franky65124 (€1.74 in chips) 
Seat 2: caduceus369 (€1.32 in chips) 
Seat 3: ADRIAN0_MEIS (€7.23 in chips) 
Seat 4: SidneyPrescott (€5.51 in chips) 
Seat 5: fantaasso (€1.83 in chips) 
Seat 6: trillycata (€1.26 in chips) 
caduceus369: posts small blind €0.01
ADRIAN0_MEIS: posts big blind €0.02
*** HOLE CARDS ***
Dealt to caduceus369 [7c Qs]
SidneyPrescott: folds 
fantaasso: folds 
trillycata: folds 
franky65124: calls €0.02
caduceus369: folds 
ADRIAN0_MEIS: checks 
*** FLOP *** [3d 8s 6h]
ADRIAN0_MEIS: checks 
franky65124: bets €0.02
ADRIAN0_MEIS: folds 
Uncalled bet (€0.02) returned to franky65124
franky65124 collected €0.05 from pot
franky65124: doesn't show hand 
*** SUMMARY ***
Total pot €0.05 | Rake €0 
Board [3d 8s 6h]
Seat 1: franky65124 (button) collected (€0.05)
Seat 2: caduceus369 (small blind) folded before Flop
Seat 3: ADRIAN0_MEIS (big blind) folded on the Flop
Seat 4: SidneyPrescott folded before Flop (didn't bet)
Seat 5: fantaasso folded before Flop (didn't bet)
Seat 6: trillycata folded before Flop (didn't bet)



PokerStars Zoom Hand #257988092643:  Hold'em No Limit (€0.01/€0.02) [ADM ID: M62BA304494E32ST] - 2025/10/03 23:35:55 CET [2025/10/03 17:35:55 ET]
Table 'Sirio' 6-max Seat #1 is the button
Seat 1: caduceus369 (€1.31 in chips) 
Seat 2: fantaasso (€1.83 in chips) 
Seat 3: cesaretto23 (€3.14 in chips) 
Seat 4: 999rizla (€1.22 in chips) 
Seat 5: outshined8 (€1.56 in chips) 
Seat 6: SKERZA (€0.96 in chips) 
fantaasso: posts small blind €0.01
cesaretto23: posts big blind €0.02
*** HOLE CARDS ***
Dealt to caduceus369 [6h 7d]
999rizla: folds 
outshined8: folds 
SKERZA: folds 
caduceus369: folds 
fantaasso: folds 
Uncalled bet (€0.01) returned to cesaretto23
cesaretto23 collected €0.02 from pot
cesaretto23: doesn't show hand 
*** SUMMARY ***
Total pot €0.02 | Rake €0 
Seat 1: caduceus369 (button) folded before Flop (didn't bet)
Seat 2: fantaasso (small blind) folded before Flop
Seat 3: cesaretto23 (big blind) collected (€0.02)
Seat 4: 999rizla folded before Flop (didn't bet)
Seat 5: outshined8 folded before Flop (didn't bet)
Seat 6: SKERZA folded before Flop (didn't bet)



PokerStars Zoom Hand #257988084964:  Hold'em No Limit (€0.01/€0.02) [ADM ID: M62BA304494E32ST] - 2025/10/03 23:35:23 CET [2025/10/03 17:35:23 ET]
Table 'Sirio' 6-max Seat #1 is the button
Seat 1: Chia9711 (€2.73 in chips) 
Seat 2: trillycata (€1.27 in chips) 
Seat 3: caduceus369 (€1.34 in chips) 
Seat 4: Catania838 (€1.86 in chips) 
Seat 5: ADRIAN0_MEIS (€2.88 in chips) 
Seat 6: cartoonbest (€2.77 in chips) 
trillycata: posts small blind €0.01
caduceus369: posts big blind €0.02
*** HOLE CARDS ***
Dealt to caduceus369 [2s Kd]
Catania838: calls €0.02
ADRIAN0_MEIS: folds 
cartoonbest: folds 
Chia9711: calls €0.02
trillycata: folds 
caduceus369: checks 
*** FLOP *** [Ts 7c 8h]
caduceus369: checks 
Catania838: checks 
Chia9711: bets €0.04
caduceus369: folds 
Catania838: calls €0.04
*** TURN *** [Ts 7c 8h] [2d]
Catania838: checks 
Chia9711: checks 
*** RIVER *** [Ts 7c 8h 2d] [6d]
Catania838: bets €0.10
Chia9711: calls €0.10
*** SHOW DOWN ***
Catania838: shows [Ks Js] (high card King)
Chia9711: shows [8d Ad] (a pair of Eights)
Chia9711 collected €0.34 from pot
*** SUMMARY ***
Total pot €0.35 | Rake €0.01 
Board [Ts 7c 8h 2d 6d]
Seat 1: Chia9711 (button) showed [8d Ad] and won (€0.34) with a pair of Eights
Seat 2: trillycata (small blind) folded before Flop
Seat 3: caduceus369 (big blind) folded on the Flop
Seat 4: Catania838 showed [Ks Js] and lost with high card King
Seat 5: ADRIAN0_MEIS folded before Flop (didn't bet)
Seat 6: cartoonbest folded before Flop (didn't bet)



PokerStars Zoom Hand #257988091169:  Hold'em No Limit (€0.01/€0.02) [ADM ID: M62BA304494E32ST] - 2025/10/03 23:35:49 CET [2025/10/03 17:35:49 ET]
Table 'Sirio' 6-max Seat #1 is the button
Seat 1: Ceribelli1705 (€0.89 in chips) 
Seat 2: Gabrielefante (€2.10 in chips) 
Seat 3: Sium12302 (€4.20 in chips) 
Seat 4: caduceus369 (€1.31 in chips) 
Seat 5: fantaasso (€1.89 in chips) 
Seat 6: SidneyPrescott (€2.29 in chips) 
Gabrielefante: posts small blind €0.01
Sium12302: posts big blind €0.02
*** HOLE CARDS ***
Dealt to caduceus369 [Ac 6s]
caduceus369: folds 
fantaasso: folds 
SidneyPrescott: raises €0.04 to €0.06
Ceribelli1705: folds 
Gabrielefante: folds 
Sium12302: folds 
Uncalled bet (€0.04) returned to SidneyPrescott
SidneyPrescott collected €0.05 from pot
SidneyPrescott: doesn't show hand 
*** SUMMARY ***
Total pot €0.05 | Rake €0 
Seat 1: Ceribelli1705 (button) folded before Flop (didn't bet)
Seat 2: Gabrielefante (small blind) folded before Flop
Seat 3: Sium12302 (big blind) folded before Flop
Seat 4: caduceus369 folded before Flop (didn't bet)
Seat 5: fantaasso folded before Flop (didn't bet)
Seat 6: SidneyPrescott collected (€0.05)



PokerStars Zoom Hand #257988093523:  Hold'em No Limit (€0.01/€0.02) [ADM ID: M62BA304494E32ST] - 2025/10/03 23:35:59 CET [2025/10/03 17:35:59 ET]
Table 'Sirio' 6-max Seat #1 is the button
Seat 1: MOLDAVO1069 (€3.24 in chips) 
Seat 2: CacciatoreAA (€1.85 in chips) 
Seat 3: KindRonin (€1.11 in chips) 
Seat 4: 999rizla (€1.22 in chips) 
Seat 5: SidneyPrescott (€4.30 in chips) 
Seat 6: caduceus369 (€1.31 in chips) 
CacciatoreAA: posts small blind €0.01
KindRonin: posts big blind €0.02
*** HOLE CARDS ***
Dealt to caduceus369 [5c Qh]
999rizla: calls €0.02
SidneyPrescott: folds 
caduceus369: folds 
MOLDAVO1069: folds 
CacciatoreAA: folds 
KindRonin: checks 
*** FLOP *** [8c 5h 6s]
KindRonin: checks 
999rizla: checks 
*** TURN *** [8c 5h 6s] [3h]
KindRonin: checks 
999rizla: checks 
*** RIVER *** [8c 5h 6s 3h] [2d]
KindRonin: checks 
999rizla: checks 
*** SHOW DOWN ***
KindRonin: shows [9h Td] (high card Ten)
999rizla: shows [Qs Ts] (high card Queen)
999rizla collected €0.05 from pot
*** SUMMARY ***
Total pot €0.05 | Rake €0 
Board [8c 5h 6s 3h 2d]
Seat 1: MOLDAVO1069 (button) folded before Flop (didn't bet)
Seat 2: CacciatoreAA (small blind) folded before Flop
Seat 3: KindRonin (big blind) showed [9h Td] and lost with high card Ten
Seat 4: 999rizla showed [Qs Ts] and won (€0.05) with high card Queen
Seat 5: SidneyPrescott folded before Flop (didn't bet)
Seat 6: caduceus369 folded before Flop (didn't bet)



PokerStars Zoom Hand #257988096517:  Hold'em No Limit (€0.01/€0.02) [ADM ID: M62BA304494E32ST] - 2025/10/03 23:36:12 CET [2025/10/03 17:36:12 ET]
Table 'Sirio' 6-max Seat #1 is the button
Seat 1: tigermiscio (€0.74 in chips) 
Seat 2: sparky91580 (€0.89 in chips) 
Seat 3: montemeru (€3.92 in chips) 
Seat 4: caduceus369 (€1.31 in chips) 
Seat 5: Goblin1999 (€4.77 in chips) 
Seat 6: cesaretto23 (€3.15 in chips) 
sparky91580: posts small blind €0.01
montemeru: posts big blind €0.02
*** HOLE CARDS ***
Dealt to caduceus369 [Jd Ad]
caduceus369: raises €0.04 to €0.06
Goblin1999: raises €0.54 to €0.60
cesaretto23: folds 
tigermiscio: folds 
sparky91580: folds 
montemeru: folds 
caduceus369: folds 
Uncalled bet (€0.54) returned to Goblin1999
Goblin1999 collected €0.15 from pot
Goblin1999: doesn't show hand 
*** SUMMARY ***
Total pot €0.15 | Rake €0 
Seat 1: tigermiscio (button) folded before Flop (didn't bet)
Seat 2: sparky91580 (small blind) folded before Flop
Seat 3: montemeru (big blind) folded before Flop
Seat 4: caduceus369 folded before Flop
Seat 5: Goblin1999 collected (€0.15)
Seat 6: cesaretto23 folded before Flop (didn't bet)



PokerStars Zoom Hand #257988107463:  Hold'em No Limit (€0.01/€0.02) [ADM ID: M62BA304494E32ST] - 2025/10/03 23:36:57 CET [2025/10/03 17:36:57 ET]
Table 'Sirio' 6-max Seat #1 is the button
Seat 1: 999rizla (€1.25 in chips) 
Seat 2: Witness85906 (€4.93 in chips) 
Seat 3: stfuplzudonk (€1.20 in chips) 
Seat 4: ivano747 (€3.78 in chips) 
Seat 5: caduceus369 (€1.24 in chips) 
Seat 6: CacciatoreAA (€1.85 in chips) 
Witness85906: posts small blind €0.01
stfuplzudonk: posts big blind €0.02
*** HOLE CARDS ***
Dealt to caduceus369 [9d As]
ivano747: folds 
caduceus369: folds 
CacciatoreAA: folds 
999rizla: folds 
Witness85906: folds 
Uncalled bet (€0.01) returned to stfuplzudonk
stfuplzudonk collected €0.02 from pot
stfuplzudonk: doesn't show hand 
*** SUMMARY ***
Total pot €0.02 | Rake €0 
Seat 1: 999rizla (button) folded before Flop (didn't bet)
Seat 2: Witness85906 (small blind) folded before Flop
Seat 3: stfuplzudonk (big blind) collected (€0.02)
Seat 4: ivano747 folded before Flop (didn't bet)
Seat 5: caduceus369 folded before Flop (didn't bet)
Seat 6: CacciatoreAA folded before Flop (didn't bet)



PokerStars Zoom Hand #257988105918:  Hold'em No Limit (€0.01/€0.02) [ADM ID: M62BA304494E32ST] - 2025/10/03 23:36:51 CET [2025/10/03 17:36:51 ET]
Table 'Sirio' 6-max Seat #1 is the button
Seat 1: maury999999 (€2.24 in chips) 
Seat 2: caduceus369 (€1.25 in chips) 
Seat 3: cap e'bomb95 (€2 in chips) 
Seat 4: SidneyPrescott (€4.30 in chips) 
Seat 5: savicevic74 (€3.19 in chips) 
Seat 6: father2008 (€6.12 in chips) 
caduceus369: posts small blind €0.01
cap e'bomb95: posts big blind €0.02
*** HOLE CARDS ***
Dealt to caduceus369 [4c Jh]
SidneyPrescott: folds 
savicevic74: folds 
father2008: folds 
maury999999 has timed out
maury999999: folds 
caduceus369: folds 
Uncalled bet (€0.01) returned to cap e'bomb95
cap e'bomb95 collected €0.02 from pot
cap e'bomb95: doesn't show hand 
*** SUMMARY ***
Total pot €0.02 | Rake €0 
Seat 1: maury999999 (button) folded before Flop (didn't bet)
Seat 2: caduceus369 (small blind) folded before Flop
Seat 3: cap e'bomb95 (big blind) collected (€0.02)
Seat 4: SidneyPrescott folded before Flop (didn't bet)
Seat 5: savicevic74 folded before Flop (didn't bet)
Seat 6: father2008 folded before Flop (didn't bet)



PokerStars Zoom Hand #257988109407:  Hold'em No Limit (€0.01/€0.02) [ADM ID: M62BA304494E32ST] - 2025/10/03 23:37:05 CET [2025/10/03 17:37:05 ET]
Table 'Sirio' 6-max Seat #1 is the button
Seat 1: Gabrielefante (€2.03 in chips) 
Seat 2: neoilnervoso (€0.98 in chips) 
Seat 3: caduceus369 (€1.24 in chips) 
Seat 4: tigermiscio (€0.48 in chips) 
Seat 5: SKERZA (€0.46 in chips) 
Seat 6: Catania838 (€2.33 in chips) 
neoilnervoso: posts small blind €0.01
caduceus369: posts big blind €0.02
*** HOLE CARDS ***
Dealt to caduceus369 [9c 8c]
tigermiscio: calls €0.02
SKERZA: folds 
Catania838: folds 
Gabrielefante: folds 
neoilnervoso: calls €0.01
caduceus369: checks 
*** FLOP *** [3c 8s 4h]
neoilnervoso: bets €0.04
caduceus369: raises €0.14 to €0.18
tigermiscio: folds 
neoilnervoso: calls €0.14
*** TURN *** [3c 8s 4h] [5c]
neoilnervoso: bets €0.40
caduceus369: raises €0.64 to €1.04 and is all-in
neoilnervoso: calls €0.38 and is all-in
Uncalled bet (€0.26) returned to caduceus369
*** RIVER *** [3c 8s 4h 5c] [As]
*** SHOW DOWN ***
neoilnervoso: shows [5h 8d] (two pair, Eights and Fives)
caduceus369: shows [9c 8c] (a pair of Eights)
neoilnervoso collected €1.88 from pot
*** SUMMARY ***
Total pot €1.98 | Rake €0.10 
Board [3c 8s 4h 5c As]
Seat 1: Gabrielefante (button) folded before Flop (didn't bet)
Seat 2: neoilnervoso (small blind) showed [5h 8d] and won (€1.88) with two pair, Eights and Fives
Seat 3: caduceus369 (big blind) showed [9c 8c] and lost with a pair of Eights
Seat 4: tigermiscio folded on the Flop
Seat 5: SKERZA folded before Flop (didn't bet)
Seat 6: Catania838 folded before Flop (didn't bet)



PokerStars Zoom Hand #257988121735:  Hold'em No Limit (€0.01/€0.02) [ADM ID: M62BA304494E32ST] - 2025/10/03 23:37:57 CET [2025/10/03 17:37:57 ET]
Table 'Sirio' 6-max Seat #1 is the button
Seat 1: caduceus369 (€0.26 in chips) 
Seat 2: cartoonbest (€2.62 in chips) 
Seat 3: Goblin1999 (€4.82 in chips) 
Seat 4: SidneyPrescott (€2.29 in chips) 
Seat 5: MOLDAVO1069 (€3.30 in chips) 
Seat 6: ivano747 (€3.75 in chips) 
cartoonbest: posts small blind €0.01
Goblin1999: posts big blind €0.02
*** HOLE CARDS ***
Dealt to caduceus369 [4d 7h]
SidneyPrescott: folds 
MOLDAVO1069: folds 
ivano747: folds 
caduceus369: folds 
cartoonbest: folds 
Uncalled bet (€0.01) returned to Goblin1999
Goblin1999 collected €0.02 from pot
Goblin1999: doesn't show hand 
*** SUMMARY ***
Total pot €0.02 | Rake €0 
Seat 1: caduceus369 (button) folded before Flop (didn't bet)
Seat 2: cartoonbest (small blind) folded before Flop
Seat 3: Goblin1999 (big blind) collected (€0.02)
Seat 4: SidneyPrescott folded before Flop (didn't bet)
Seat 5: MOLDAVO1069 folded before Flop (didn't bet)
Seat 6: ivano747 folded before Flop (didn't bet)



PokerStars Zoom Hand #257988122491:  Hold'em No Limit (€0.01/€0.02) [ADM ID: M62BA304494E32ST] - 2025/10/03 23:38:01 CET [2025/10/03 17:38:01 ET]
Table 'Sirio' 6-max Seat #1 is the button
Seat 1: fantaasso (€1.77 in chips) 
Seat 2: ivano747 (€3.75 in chips) 
Seat 3: ADRIAN0_MEIS (€12.20 in chips) 
Seat 4: MOLDAVO1069 (€3.30 in chips) 
Seat 5: Catania838 (€2.37 in chips) 
Seat 6: caduceus369 (€0.26 in chips) 
ivano747: posts small blind €0.01
ADRIAN0_MEIS: posts big blind €0.02
*** HOLE CARDS ***
Dealt to caduceus369 [5c 6s]
MOLDAVO1069: folds 
Catania838: folds 
caduceus369: folds 
fantaasso: raises €0.04 to €0.06
ivano747: folds 
ADRIAN0_MEIS: folds 
Uncalled bet (€0.04) returned to fantaasso
fantaasso collected €0.05 from pot
fantaasso: doesn't show hand 
*** SUMMARY ***
Total pot €0.05 | Rake €0 
Seat 1: fantaasso (button) collected (€0.05)
Seat 2: ivano747 (small blind) folded before Flop
Seat 3: ADRIAN0_MEIS (big blind) folded before Flop
Seat 4: MOLDAVO1069 folded before Flop (didn't bet)
Seat 5: Catania838 folded before Flop (didn't bet)
Seat 6: caduceus369 folded before Flop (didn't bet)



PokerStars Zoom Hand #257988130291:  Hold'em No Limit (€0.01/€0.02) [ADM ID: M62BA304494E32ST] - 2025/10/03 23:38:34 CET [2025/10/03 17:38:34 ET]
Table 'Sirio' 6-max Seat #1 is the button
Seat 1: fantaasso (€1.80 in chips) 
Seat 2: caduceus369 (€2 in chips) 
Seat 3: cap e'bomb95 (€1.97 in chips) 
Seat 4: Catania838 (€1.39 in chips) 
Seat 5: ADRIAN0_MEIS (€12.18 in chips) 
Seat 6: stfuplzudonk (€4.10 in chips) 
caduceus369: posts small blind €0.01
cap e'bomb95: posts big blind €0.02
*** HOLE CARDS ***
Dealt to caduceus369 [7h 8c]
Catania838: folds 
ADRIAN0_MEIS: folds 
stfuplzudonk: folds 
fantaasso: folds 
caduceus369: folds 
Uncalled bet (€0.01) returned to cap e'bomb95
cap e'bomb95 collected €0.02 from pot
cap e'bomb95: doesn't show hand 
*** SUMMARY ***
Total pot €0.02 | Rake €0 
Seat 1: fantaasso (button) folded before Flop (didn't bet)
Seat 2: caduceus369 (small blind) folded before Flop
Seat 3: cap e'bomb95 (big blind) collected (€0.02)
Seat 4: Catania838 folded before Flop (didn't bet)
Seat 5: ADRIAN0_MEIS folded before Flop (didn't bet)
Seat 6: stfuplzudonk folded before Flop (didn't bet)



PokerStars Zoom Hand #257988123798:  Hold'em No Limit (€0.01/€0.02) [ADM ID: M62BA304494E32ST] - 2025/10/03 23:38:06 CET [2025/10/03 17:38:06 ET]
Table 'Sirio' 6-max Seat #1 is the button
Seat 1: MOLDAVO1069 (€3.30 in chips) 
Seat 2: Chia9711 (€3 in chips) 
Seat 3: cap e'bomb95 (€2 in chips) 
Seat 4: Goblin1999 (€4.83 in chips) 
Seat 5: caduceus369 (€0.26 in chips) 
Seat 6: workman75 (€3.41 in chips) 
Chia9711: posts small blind €0.01
cap e'bomb95: posts big blind €0.02
*** HOLE CARDS ***
Dealt to caduceus369 [7d 4c]
Goblin1999: calls €0.02
caduceus369: folds 
workman75: calls €0.02
MOLDAVO1069: raises €0.10 to €0.12
Chia9711: folds 
cap e'bomb95: folds 
Goblin1999: calls €0.10
workman75: folds 
*** FLOP *** [Qs 2s 5h]
Goblin1999: checks 
MOLDAVO1069: checks 
*** TURN *** [Qs 2s 5h] [9c]
Goblin1999: bets €0.16
MOLDAVO1069: folds 
Uncalled bet (€0.16) returned to Goblin1999
Goblin1999 collected €0.28 from pot
Goblin1999: doesn't show hand 
*** SUMMARY ***
Total pot €0.29 | Rake €0.01 
Board [Qs 2s 5h 9c]
Seat 1: MOLDAVO1069 (button) folded on the Turn
Seat 2: Chia9711 (small blind) folded before Flop
Seat 3: cap e'bomb95 (big blind) folded before Flop
Seat 4: Goblin1999 collected (€0.28)
Seat 5: caduceus369 folded before Flop (didn't bet)
Seat 6: workman75 folded before Flop



PokerStars Zoom Hand #257988124814:  Hold'em No Limit (€0.01/€0.02) [ADM ID: M62BA304494E32ST] - 2025/10/03 23:38:11 CET [2025/10/03 17:38:11 ET]
Table 'Sirio' 6-max Seat #1 is the button
Seat 1: father2008 (€6.09 in chips) 
Seat 2: SidneyPrescott (€2.29 in chips) 
Seat 3: Catania838 (€2.37 in chips) 
Seat 4: cartoonbest (€2.61 in chips) 
Seat 5: maury999999 (€2 in chips) 
Seat 6: caduceus369 (€0.26 in chips) 
SidneyPrescott: posts small blind €0.01
Catania838: posts big blind €0.02
*** HOLE CARDS ***
Dealt to caduceus369 [9c 6d]
cartoonbest: calls €0.02
maury999999: folds 
caduceus369 has timed out
caduceus369: folds 
father2008 has timed out
father2008: folds 
SidneyPrescott: folds 
Catania838: checks 
*** FLOP *** [Td Ks Kc]
Catania838: checks 
cartoonbest: bets €0.04
Catania838: folds 
Uncalled bet (€0.04) returned to cartoonbest
cartoonbest collected €0.05 from pot
cartoonbest: doesn't show hand 
*** SUMMARY ***
Total pot €0.05 | Rake €0 
Board [Td Ks Kc]
Seat 1: father2008 (button) folded before Flop (didn't bet)
Seat 2: SidneyPrescott (small blind) folded before Flop
Seat 3: Catania838 (big blind) folded on the Flop
Seat 4: cartoonbest collected (€0.05)
Seat 5: maury999999 folded before Flop (didn't bet)
Seat 6: caduceus369 folded before Flop (didn't bet)



PokerStars Zoom Hand #257988140699:  Hold'em No Limit (€0.01/€0.02) [ADM ID: M62BA304494E32ST] - 2025/10/03 23:39:18 CET [2025/10/03 17:39:18 ET]
Table 'Sirio' 6-max Seat #1 is the button
Seat 1: Catania838 (€3.42 in chips) 
Seat 2: ivano747 (€1.93 in chips) 
Seat 3: father2008 (€4.32 in chips) 
Seat 4: fantaasso (€1.77 in chips) 
Seat 5: caduceus369 (€1.97 in chips) 
Seat 6: Witness85906 (€5.17 in chips) 
ivano747: posts small blind €0.01
father2008: posts big blind €0.02
*** HOLE CARDS ***
Dealt to caduceus369 [Qc 4h]
fantaasso: folds 
caduceus369: folds 
Witness85906: folds 
Catania838: folds 
ivano747: folds 
Uncalled bet (€0.01) returned to father2008
father2008 collected €0.02 from pot
father2008: doesn't show hand 
*** SUMMARY ***
Total pot €0.02 | Rake €0 
Seat 1: Catania838 (button) folded before Flop (didn't bet)
Seat 2: ivano747 (small blind) folded before Flop
Seat 3: father2008 (big blind) collected (€0.02)
Seat 4: fantaasso folded before Flop (didn't bet)
Seat 5: caduceus369 folded before Flop (didn't bet)
Seat 6: Witness85906 folded before Flop (didn't bet)



PokerStars Zoom Hand #257988142072:  Hold'em No Limit (€0.01/€0.02) [ADM ID: M62BA304494E32ST] - 2025/10/03 23:39:24 CET [2025/10/03 17:39:24 ET]
Table 'Sirio' 6-max Seat #1 is the button
Seat 1: Goblin1999 (€4.98 in chips) 
Seat 2: Monster2708 (€1.98 in chips) 
Seat 3: fantaasso (€1.77 in chips) 
Seat 4: ADRIAN0_MEIS (€7.25 in chips) 
Seat 5: caduceus369 (€1.97 in chips) 
Seat 6: ivano747 (€1.92 in chips) 
Monster2708: posts small blind €0.01
fantaasso: posts big blind €0.02
*** HOLE CARDS ***
Dealt to caduceus369 [6s Ks]
ADRIAN0_MEIS: folds 
caduceus369: folds 
ivano747: folds 
Goblin1999: raises €0.05 to €0.07
Monster2708: folds 
fantaasso: folds 
Uncalled bet (€0.05) returned to Goblin1999
Goblin1999 collected €0.05 from pot
Goblin1999: doesn't show hand 
*** SUMMARY ***
Total pot €0.05 | Rake €0 
Seat 1: Goblin1999 (button) collected (€0.05)
Seat 2: Monster2708 (small blind) folded before Flop
Seat 3: fantaasso (big blind) folded before Flop
Seat 4: ADRIAN0_MEIS folded before Flop (didn't bet)
Seat 5: caduceus369 folded before Flop (didn't bet)
Seat 6: ivano747 folded before Flop (didn't bet)



PokerStars Zoom Hand #257988139259:  Hold'em No Limit (€0.01/€0.02) [ADM ID: M62BA304494E32ST] - 2025/10/03 23:39:12 CET [2025/10/03 17:39:12 ET]
Table 'Sirio' 6-max Seat #1 is the button
Seat 1: caduceus369 (€1.97 in chips) 
Seat 2: capovujadin (€1.45 in chips) 
Seat 3: SidneyPrescott (€2.25 in chips) 
Seat 4: fantaasso (€1.77 in chips) 
Seat 5: Catania838 (€3.42 in chips) 
Seat 6: Sium12302 (€2.52 in chips) 
capovujadin: posts small blind €0.01
SidneyPrescott: posts big blind €0.02
*** HOLE CARDS ***
Dealt to caduceus369 [8c 2s]
fantaasso: folds 
Catania838: folds 
Sium12302: folds 
caduceus369: folds 
capovujadin: raises €0.02 to €0.04
SidneyPrescott: raises €0.12 to €0.16
capovujadin: calls €0.12
*** FLOP *** [Qs Kc 4h]
capovujadin: checks 
SidneyPrescott: bets €0.20
capovujadin: folds 
Uncalled bet (€0.20) returned to SidneyPrescott
SidneyPrescott collected €0.31 from pot
SidneyPrescott: doesn't show hand 
*** SUMMARY ***
Total pot €0.32 | Rake €0.01 
Board [Qs Kc 4h]
Seat 1: caduceus369 (button) folded before Flop (didn't bet)
Seat 2: capovujadin (small blind) folded on the Flop
Seat 3: SidneyPrescott (big blind) collected (€0.31)
Seat 4: fantaasso folded before Flop (didn't bet)
Seat 5: Catania838 folded before Flop (didn't bet)
Seat 6: Sium12302 folded before Flop (didn't bet)



PokerStars Zoom Hand #257988142850:  Hold'em No Limit (€0.01/€0.02) [ADM ID: M62BA304494E32ST] - 2025/10/03 23:39:27 CET [2025/10/03 17:39:27 ET]
Table 'Sirio' 6-max Seat #1 is the button
Seat 1: SidneyPrescott (€5.81 in chips) 
Seat 2: savicevic74 (€3.05 in chips) 
Seat 3: caduceus369 (€1.97 in chips) 
Seat 4: Witness85906 (€5.17 in chips) 
Seat 5: ivano747 (€3.44 in chips) 
Seat 6: MOLDAVO1069 (€3.15 in chips) 
savicevic74: posts small blind €0.01
caduceus369: posts big blind €0.02
*** HOLE CARDS ***
Dealt to caduceus369 [5d Td]
Witness85906: raises €0.03 to €0.05
ivano747: folds 
MOLDAVO1069: folds 
SidneyPrescott: folds 
savicevic74: folds 
caduceus369: folds 
Uncalled bet (€0.03) returned to Witness85906
Witness85906 collected €0.05 from pot
Witness85906: doesn't show hand 
*** SUMMARY ***
Total pot €0.05 | Rake €0 
Seat 1: SidneyPrescott (button) folded before Flop (didn't bet)
Seat 2: savicevic74 (small blind) folded before Flop
Seat 3: caduceus369 (big blind) folded before Flop
Seat 4: Witness85906 collected (€0.05)
Seat 5: ivano747 folded before Flop (didn't bet)
Seat 6: MOLDAVO1069 folded before Flop (didn't bet)



PokerStars Zoom Hand #257988137417:  Hold'em No Limit (€0.01/€0.02) [ADM ID: M62BA304494E32ST] - 2025/10/03 23:39:04 CET [2025/10/03 17:39:04 ET]
Table 'Sirio' 6-max Seat #1 is the button
Seat 1: Catania838 (€2.35 in chips) 
Seat 2: cap e'bomb95 (€1.98 in chips) 
Seat 3: montemeru (€4.03 in chips) 
Seat 4: caduceus369 (€1.97 in chips) 
Seat 5: SidneyPrescott (€2.25 in chips) 
Seat 6: capovujadin (€1.45 in chips) 
cap e'bomb95: posts small blind €0.01
montemeru: posts big blind €0.02
*** HOLE CARDS ***
Dealt to caduceus369 [7s As]
caduceus369: folds 
SidneyPrescott: folds 
capovujadin: folds 
Catania838: calls €0.02
cap e'bomb95: folds 
montemeru: checks 
*** FLOP *** [9c 2c 4d]
montemeru: checks 
Catania838: bets €0.02
montemeru: calls €0.02
*** TURN *** [9c 2c 4d] [6s]
montemeru: bets €0.05
Catania838: raises €0.19 to €0.24
montemeru: calls €0.19
*** RIVER *** [9c 2c 4d 6s] [9d]
montemeru: checks 
Catania838: bets €0.54
montemeru: folds 
Uncalled bet (€0.54) returned to Catania838
Catania838 collected €0.54 from pot
Catania838: doesn't show hand 
*** SUMMARY ***
Total pot €0.57 | Rake €0.03 
Board [9c 2c 4d 6s 9d]
Seat 1: Catania838 (button) collected (€0.54)
Seat 2: cap e'bomb95 (small blind) folded before Flop
Seat 3: montemeru (big blind) folded on the River
Seat 4: caduceus369 folded before Flop (didn't bet)
Seat 5: SidneyPrescott folded before Flop (didn't bet)
Seat 6: capovujadin folded before Flop (didn't bet)



PokerStars Zoom Hand #257988149966:  Hold'em No Limit (€0.01/€0.02) [ADM ID: M62BA304494E32ST] - 2025/10/03 23:39:57 CET [2025/10/03 17:39:57 ET]
Table 'Sirio' 6-max Seat #1 is the button
Seat 1: caduceus369 (€1.94 in chips) 
Seat 2: ADRIAN0_MEIS (€7.64 in chips) 
Seat 3: savicevic74 (€3.04 in chips) 
Seat 4: SidneyPrescott (€4.39 in chips) 
Seat 5: fantaasso (€2.26 in chips) 
Seat 6: Peru91j (€2 in chips) 
ADRIAN0_MEIS: posts small blind €0.01
savicevic74: posts big blind €0.02
*** HOLE CARDS ***
Dealt to caduceus369 [Qc 2h]
SidneyPrescott: folds 
fantaasso: raises €0.04 to €0.06
Peru91j: folds 
caduceus369: folds 
ADRIAN0_MEIS: folds 
savicevic74: folds 
Uncalled bet (€0.04) returned to fantaasso
fantaasso collected €0.05 from pot
fantaasso: doesn't show hand 
*** SUMMARY ***
Total pot €0.05 | Rake €0 
Seat 1: caduceus369 (button) folded before Flop (didn't bet)
Seat 2: ADRIAN0_MEIS (small blind) folded before Flop
Seat 3: savicevic74 (big blind) folded before Flop
Seat 4: SidneyPrescott folded before Flop (didn't bet)
Seat 5: fantaasso collected (€0.05)
Seat 6: Peru91j folded before Flop (didn't bet)



PokerStars Zoom Hand #257988133069:  Hold'em No Limit (€0.01/€0.02) [ADM ID: M62BA304494E32ST] - 2025/10/03 23:38:46 CET [2025/10/03 17:38:46 ET]
Table 'Sirio' 6-max Seat #1 is the button
Seat 1: franky65124 (€2.03 in chips) 
Seat 2: Ceribelli1705 (€1.10 in chips) 
Seat 3: caduceus369 (€1.99 in chips) 
Seat 4: SidneyPrescott (€4.42 in chips) 
Seat 5: Catania838 (€1.39 in chips) 
Seat 6: stfuplzudonk (€4.62 in chips) 
Ceribelli1705: posts small blind €0.01
caduceus369: posts big blind €0.02
*** HOLE CARDS ***
Dealt to caduceus369 [Jd 8d]
SidneyPrescott: folds 
Catania838: calls €0.02
stfuplzudonk: raises €0.06 to €0.08
franky65124: folds 
Ceribelli1705: calls €0.07
caduceus369: folds 
Catania838: calls €0.06
*** FLOP *** [Kc Th 9s]
Ceribelli1705: checks 
Catania838: checks 
stfuplzudonk: checks 
*** TURN *** [Kc Th 9s] [2d]
Ceribelli1705: checks 
Catania838: bets €0.25
stfuplzudonk: folds 
Ceribelli1705: folds 
Uncalled bet (€0.25) returned to Catania838
Catania838 collected €0.25 from pot
Catania838: doesn't show hand 
*** SUMMARY ***
Total pot €0.26 | Rake €0.01 
Board [Kc Th 9s 2d]
Seat 1: franky65124 (button) folded before Flop (didn't bet)
Seat 2: Ceribelli1705 (small blind) folded on the Turn
Seat 3: caduceus369 (big blind) folded before Flop
Seat 4: SidneyPrescott folded before Flop (didn't bet)
Seat 5: Catania838 collected (€0.25)
Seat 6: stfuplzudonk folded on the Turn



PokerStars Zoom Hand #257988148858:  Hold'em No Limit (€0.01/€0.02) [ADM ID: M62BA304494E32ST] - 2025/10/03 23:39:52 CET [2025/10/03 17:39:52 ET]
Table 'Sirio' 6-max Seat #1 is the button
Seat 1: Gabrielefante (€1.97 in chips) 
Seat 2: Monster2708 (€1.95 in chips) 
Seat 3: cap e'bomb95 (€1.78 in chips) 
Seat 4: caduceus369 (€1.94 in chips) 
Seat 5: Catania838 (€2.61 in chips) 
Seat 6: VrDmNl (€1.32 in chips) 
Monster2708: posts small blind €0.01
cap e'bomb95: posts big blind €0.02
*** HOLE CARDS ***
Dealt to caduceus369 [Js 5s]
caduceus369: folds 
Catania838: folds 
VrDmNl: raises €0.03 to €0.05
Gabrielefante: folds 
Monster2708: folds 
cap e'bomb95: folds 
Uncalled bet (€0.03) returned to VrDmNl
VrDmNl collected €0.05 from pot
VrDmNl: doesn't show hand 
*** SUMMARY ***
Total pot €0.05 | Rake €0 
Seat 1: Gabrielefante (button) folded before Flop (didn't bet)
Seat 2: Monster2708 (small blind) folded before Flop
Seat 3: cap e'bomb95 (big blind) folded before Flop
Seat 4: caduceus369 folded before Flop (didn't bet)
Seat 5: Catania838 folded before Flop (didn't bet)
Seat 6: VrDmNl collected (€0.05)



PokerStars Zoom Hand #257988147186:  Hold'em No Limit (€0.01/€0.02) [ADM ID: M62BA304494E32ST] - 2025/10/03 23:39:45 CET [2025/10/03 17:39:45 ET]
Table 'Sirio' 6-max Seat #1 is the button
Seat 1: montemeru (€3.75 in chips) 
Seat 2: caduceus369 (€1.95 in chips) 
Seat 3: Goblin1999 (€5.01 in chips) 
Seat 4: savicevic74 (€3.04 in chips) 
Seat 5: SidneyPrescott (€4.39 in chips) 
Seat 6: workman75 (€3.42 in chips) 
caduceus369: posts small blind €0.01
Goblin1999: posts big blind €0.02
*** HOLE CARDS ***
Dealt to caduceus369 [4s Jc]
savicevic74: folds 
SidneyPrescott: folds 
workman75: raises €0.04 to €0.06
montemeru: calls €0.06
caduceus369: folds 
Goblin1999: calls €0.04
*** FLOP *** [2d Js 8c]
Goblin1999: checks 
workman75: bets €0.06
montemeru: folds 
Goblin1999: folds 
Uncalled bet (€0.06) returned to workman75
workman75 collected €0.18 from pot
workman75: doesn't show hand 
*** SUMMARY ***
Total pot €0.19 | Rake €0.01 
Board [2d Js 8c]
Seat 1: montemeru (button) folded on the Flop
Seat 2: caduceus369 (small blind) folded before Flop
Seat 3: Goblin1999 (big blind) folded on the Flop
Seat 4: savicevic74 folded before Flop (didn't bet)
Seat 5: SidneyPrescott folded before Flop (didn't bet)
Seat 6: workman75 collected (€0.18)



PokerStars Zoom Hand #257988151431:  Hold'em No Limit (€0.01/€0.02) [ADM ID: M62BA304494E32ST] - 2025/10/03 23:40:03 CET [2025/10/03 17:40:03 ET]
Table 'Sirio' 6-max Seat #1 is the button
Seat 1: father2008 (€4.25 in chips) 
Seat 2: Catania838 (€2.61 in chips) 
Seat 3: Peru91j (€2.23 in chips) 
Seat 4: ivano747 (€3.44 in chips) 
Seat 5: Sium12302 (€6.26 in chips) 
Seat 6: caduceus369 (€1.94 in chips) 
Catania838: posts small blind €0.01
Peru91j: posts big blind €0.02
*** HOLE CARDS ***
Dealt to caduceus369 [8h 8s]
ivano747: folds 
Sium12302: folds 
caduceus369: raises €0.04 to €0.06
father2008: folds 
Catania838: calls €0.05
Peru91j: folds 
*** FLOP *** [4d 3d Jc]
Catania838: bets €0.02
caduceus369: calls €0.02
*** TURN *** [4d 3d Jc] [Qs]
Catania838: bets €0.02
caduceus369: raises €0.08 to €0.10
Catania838: calls €0.08
*** RIVER *** [4d 3d Jc Qs] [6h]
Catania838: checks 
caduceus369: bets €0.24
Catania838: folds 
Uncalled bet (€0.24) returned to caduceus369
caduceus369 collected €0.36 from pot
caduceus369: doesn't show hand 
*** SUMMARY ***
Total pot €0.38 | Rake €0.02 
Board [4d 3d Jc Qs 6h]
Seat 1: father2008 (button) folded before Flop (didn't bet)
Seat 2: Catania838 (small blind) folded on the River
Seat 3: Peru91j (big blind) folded before Flop
Seat 4: ivano747 folded before Flop (didn't bet)
Seat 5: Sium12302 folded before Flop (didn't bet)
Seat 6: caduceus369 collected (€0.36)



PokerStars Zoom Hand #257988174175:  Hold'em No Limit (€0.01/€0.02) [ADM ID: M62BA304494E32ST] - 2025/10/03 23:41:40 CET [2025/10/03 17:41:40 ET]
Table 'Sirio' 6-max Seat #1 is the button
Seat 1: trillycata (€1.27 in chips) 
Seat 2: Sium12302 (€6.31 in chips) 
Seat 3: CacciatoreAA (€1.66 in chips) 
Seat 4: caduceus369 (€2.12 in chips) 
Seat 5: cap e'bomb95 (€4.44 in chips) 
Seat 6: EasyToRule (€4.25 in chips) 
Sium12302: posts small blind €0.01
CacciatoreAA: posts big blind €0.02
*** HOLE CARDS ***
Dealt to caduceus369 [7d Tc]
caduceus369: folds 
cap e'bomb95: folds 
EasyToRule: folds 
trillycata: raises €0.05 to €0.07
Sium12302: folds 
CacciatoreAA: folds 
Uncalled bet (€0.05) returned to trillycata
trillycata collected €0.05 from pot
trillycata: doesn't show hand 
*** SUMMARY ***
Total pot €0.05 | Rake €0 
Seat 1: trillycata (button) collected (€0.05)
Seat 2: Sium12302 (small blind) folded before Flop
Seat 3: CacciatoreAA (big blind) folded before Flop
Seat 4: caduceus369 folded before Flop (didn't bet)
Seat 5: cap e'bomb95 folded before Flop (didn't bet)
Seat 6: EasyToRule folded before Flop (didn't bet)



PokerStars Zoom Hand #257988175810:  Hold'em No Limit (€0.01/€0.02) [ADM ID: M62BA304494E32ST] - 2025/10/03 23:41:47 CET [2025/10/03 17:41:47 ET]
Table 'Sirio' 6-max Seat #1 is the button
Seat 1: Catania838 (€2.41 in chips) 
Seat 2: caduceus369 (€2.12 in chips) 
Seat 3: stfuplzudonk (€4.27 in chips) 
Seat 4: tigermiscio (€0.10 in chips) 
Seat 5: VrDmNl (€1.41 in chips) 
Seat 6: ivano747 (€3.36 in chips) 
caduceus369: posts small blind €0.01
stfuplzudonk: posts big blind €0.02
*** HOLE CARDS ***
Dealt to caduceus369 [7d 4h]
tigermiscio: folds 
VrDmNl: raises €0.03 to €0.05
ivano747: folds 
Catania838: folds 
caduceus369: folds 
stfuplzudonk: calls €0.03
*** FLOP *** [Ac Ah 2c]
stfuplzudonk: checks 
VrDmNl: checks 
*** TURN *** [Ac Ah 2c] [Kh]
stfuplzudonk: checks 
VrDmNl: bets €0.06
stfuplzudonk: folds 
Uncalled bet (€0.06) returned to VrDmNl
VrDmNl collected €0.11 from pot
VrDmNl: doesn't show hand 
*** SUMMARY ***
Total pot €0.11 | Rake €0 
Board [Ac Ah 2c Kh]
Seat 1: Catania838 (button) folded before Flop (didn't bet)
Seat 2: caduceus369 (small blind) folded before Flop
Seat 3: stfuplzudonk (big blind) folded on the Turn
Seat 4: tigermiscio folded before Flop (didn't bet)
Seat 5: VrDmNl collected (€0.11)
Seat 6: ivano747 folded before Flop (didn't bet)



PokerStars Zoom Hand #257988176854:  Hold'em No Limit (€0.01/€0.02) [ADM ID: M62BA304494E32ST] - 2025/10/03 23:41:52 CET [2025/10/03 17:41:52 ET]
Table 'Sirio' 6-max Seat #1 is the button
Seat 1: cap e'bomb95 (€1.94 in chips) 
Seat 2: ADRIAN0_MEIS (€10.53 in chips) 
Seat 3: caduceus369 (€2.11 in chips) 
Seat 4: Neroonciolina (€4.71 in chips) 
Seat 5: Ceribelli1705 (€0.76 in chips) 
Seat 6: Catania838 (€2.41 in chips) 
ADRIAN0_MEIS: posts small blind €0.01
caduceus369: posts big blind €0.02
*** HOLE CARDS ***
Dealt to caduceus369 [8s 9d]
Neroonciolina: folds 
Ceribelli1705: folds 
Catania838: raises €0.02 to €0.04
cap e'bomb95: folds 
ADRIAN0_MEIS: folds 
caduceus369: calls €0.02
*** FLOP *** [3c Ah 6d]
caduceus369: checks 
Catania838: bets €0.05
caduceus369: raises €0.09 to €0.14
Catania838: calls €0.09
*** TURN *** [3c Ah 6d] [Jh]
caduceus369: checks 
Catania838: bets €2.23 and is all-in
caduceus369: folds 
Uncalled bet (€2.23) returned to Catania838
Catania838 collected €0.35 from pot
Catania838: doesn't show hand 
*** SUMMARY ***
Total pot €0.37 | Rake €0.02 
Board [3c Ah 6d Jh]
Seat 1: cap e'bomb95 (button) folded before Flop (didn't bet)
Seat 2: ADRIAN0_MEIS (small blind) folded before Flop
Seat 3: caduceus369 (big blind) folded on the Turn
Seat 4: Neroonciolina folded before Flop (didn't bet)
Seat 5: Ceribelli1705 folded before Flop (didn't bet)
Seat 6: Catania838 collected (€0.35)



PokerStars Zoom Hand #257988190928:  Hold'em No Limit (€0.01/€0.02) [ADM ID: M62BA304494E32ST] - 2025/10/03 23:42:52 CET [2025/10/03 17:42:52 ET]
Table 'Sirio' 6-max Seat #1 is the button
Seat 1: ADRIAN0_MEIS (€7.96 in chips) 
Seat 2: Catania838 (€3.57 in chips) 
Seat 3: CacciatoreAA (€1.55 in chips) 
Seat 4: Sium12302 (€2 in chips) 
Seat 5: caduceus369 (€1.93 in chips) 
Seat 6: SidneyPrescott (€2.17 in chips) 
Catania838: posts small blind €0.01
CacciatoreAA: posts big blind €0.02
*** HOLE CARDS ***
Dealt to caduceus369 [9s 8c]
Sium12302: folds 
caduceus369: folds 
SidneyPrescott: folds 
ADRIAN0_MEIS: folds 
Catania838: folds 
Uncalled bet (€0.01) returned to CacciatoreAA
CacciatoreAA collected €0.02 from pot
CacciatoreAA: doesn't show hand 
*** SUMMARY ***
Total pot €0.02 | Rake €0 
Seat 1: ADRIAN0_MEIS (button) folded before Flop (didn't bet)
Seat 2: Catania838 (small blind) folded before Flop
Seat 3: CacciatoreAA (big blind) collected (€0.02)
Seat 4: Sium12302 folded before Flop (didn't bet)
Seat 5: caduceus369 folded before Flop (didn't bet)
Seat 6: SidneyPrescott folded before Flop (didn't bet)



PokerStars Zoom Hand #257988189524:  Hold'em No Limit (€0.01/€0.02) [ADM ID: M62BA304494E32ST] - 2025/10/03 23:42:46 CET [2025/10/03 17:42:46 ET]
Table 'Sirio' 6-max Seat #1 is the button
Seat 1: VrDmNl (€1.48 in chips) 
Seat 2: EasyToRule (€2.39 in chips) 
Seat 3: father2008 (€6.01 in chips) 
Seat 4: Gabrielefante (€2.96 in chips) 
Seat 5: Sium12302 (€2 in chips) 
Seat 6: caduceus369 (€1.93 in chips) 
EasyToRule: posts small blind €0.01
father2008: posts big blind €0.02
*** HOLE CARDS ***
Dealt to caduceus369 [7h 9h]
Gabrielefante: folds 
Sium12302: folds 
caduceus369: folds 
VrDmNl: raises €0.03 to €0.05
EasyToRule: folds 
father2008: folds 
Uncalled bet (€0.03) returned to VrDmNl
VrDmNl collected €0.05 from pot
VrDmNl: doesn't show hand 
*** SUMMARY ***
Total pot €0.05 | Rake €0 
Seat 1: VrDmNl (button) collected (€0.05)
Seat 2: EasyToRule (small blind) folded before Flop
Seat 3: father2008 (big blind) folded before Flop
Seat 4: Gabrielefante folded before Flop (didn't bet)
Seat 5: Sium12302 folded before Flop (didn't bet)
Seat 6: caduceus369 folded before Flop (didn't bet)



PokerStars Zoom Hand #257988193960:  Hold'em No Limit (€0.01/€0.02) [ADM ID: M62BA304494E32ST] - 2025/10/03 23:43:05 CET [2025/10/03 17:43:05 ET]
Table 'Sirio' 6-max Seat #1 is the button
Seat 1: cap e'bomb95 (€5.19 in chips) 
Seat 2: VrDmNl (€1.51 in chips) 
Seat 3: ivano747 (€2.68 in chips) 
Seat 4: CacciatoreAA (€1.56 in chips) 
Seat 5: caduceus369 (€1.93 in chips) 
Seat 6: Ceribelli1705 (€0.68 in chips) 
VrDmNl: posts small blind €0.01
ivano747: posts big blind €0.02
*** HOLE CARDS ***
Dealt to caduceus369 [6s 7c]
CacciatoreAA: raises €0.06 to €0.08
caduceus369: folds 
Ceribelli1705: folds 
cap e'bomb95: folds 
VrDmNl: folds 
ivano747: folds 
Uncalled bet (€0.06) returned to CacciatoreAA
CacciatoreAA collected €0.05 from pot
CacciatoreAA: doesn't show hand 
*** SUMMARY ***
Total pot €0.05 | Rake €0 
Seat 1: cap e'bomb95 (button) folded before Flop (didn't bet)
Seat 2: VrDmNl (small blind) folded before Flop
Seat 3: ivano747 (big blind) folded before Flop
Seat 4: CacciatoreAA collected (€0.05)
Seat 5: caduceus369 folded before Flop (didn't bet)
Seat 6: Ceribelli1705 folded before Flop (didn't bet)



PokerStars Zoom Hand #257988192575:  Hold'em No Limit (€0.01/€0.02) [ADM ID: M62BA304494E32ST] - 2025/10/03 23:42:59 CET [2025/10/03 17:42:59 ET]
Table 'Sirio' 6-max Seat #1 is the button
Seat 1: caduceus369 (€1.93 in chips) 
Seat 2: ADRIAN0_MEIS (€7.96 in chips) 
Seat 3: fantaasso (€2.55 in chips) 
Seat 4: cap e'bomb95 (€5.19 in chips) 
Seat 5: trillycata (€1.15 in chips) 
Seat 6: EasyToRule (€2.38 in chips) 
ADRIAN0_MEIS: posts small blind €0.01
fantaasso: posts big blind €0.02
*** HOLE CARDS ***
Dealt to caduceus369 [8c Td]
cap e'bomb95: folds 
trillycata: raises €0.04 to €0.06
EasyToRule: folds 
caduceus369: folds 
ADRIAN0_MEIS: folds 
fantaasso: folds 
Uncalled bet (€0.04) returned to trillycata
trillycata collected €0.05 from pot
trillycata: doesn't show hand 
*** SUMMARY ***
Total pot €0.05 | Rake €0 
Seat 1: caduceus369 (button) folded before Flop (didn't bet)
Seat 2: ADRIAN0_MEIS (small blind) folded before Flop
Seat 3: fantaasso (big blind) folded before Flop
Seat 4: cap e'bomb95 folded before Flop (didn't bet)
Seat 5: trillycata collected (€0.05)
Seat 6: EasyToRule folded before Flop (didn't bet)



PokerStars Zoom Hand #257988195575:  Hold'em No Limit (€0.01/€0.02) [ADM ID: M62BA304494E32ST] - 2025/10/03 23:43:12 CET [2025/10/03 17:43:12 ET]
Table 'Sirio' 6-max Seat #1 is the button
Seat 1: diego-rigano (€1.37 in chips) 
Seat 2: caduceus369 (€1.93 in chips) 
Seat 3: Uechend (€0.80 in chips) 
Seat 4: Peru91j (€2.41 in chips) 
Seat 5: stfuplzudonk (€4.31 in chips) 
Seat 6: Neroonciolina (€6.10 in chips) 
caduceus369: posts small blind €0.01
Uechend: posts big blind €0.02
*** HOLE CARDS ***
Dealt to caduceus369 [8s Tc]
Peru91j: folds 
stfuplzudonk: raises €0.02 to €0.04
Neroonciolina: calls €0.04
diego-rigano: folds 
caduceus369: folds 
Uechend: calls €0.02
*** FLOP *** [Td Qs 4c]
Uechend: checks 
stfuplzudonk: checks 
Neroonciolina: bets €0.06
Uechend: folds 
stfuplzudonk: folds 
Uncalled bet (€0.06) returned to Neroonciolina
Neroonciolina collected €0.13 from pot
Neroonciolina: doesn't show hand 
*** SUMMARY ***
Total pot €0.13 | Rake €0 
Board [Td Qs 4c]
Seat 1: diego-rigano (button) folded before Flop (didn't bet)
Seat 2: caduceus369 (small blind) folded before Flop
Seat 3: Uechend (big blind) folded on the Flop
Seat 4: Peru91j folded before Flop (didn't bet)
Seat 5: stfuplzudonk folded on the Flop
Seat 6: Neroonciolina collected (€0.13)



PokerStars Zoom Hand #257988194677:  Hold'em No Limit (€0.01/€0.02) [ADM ID: M62BA304494E32ST] - 2025/10/03 23:43:08 CET [2025/10/03 17:43:08 ET]
Table 'Sirio' 6-max Seat #1 is the button
Seat 1: caduceus369 (€1.93 in chips) 
Seat 2: cap e'bomb95 (€1.65 in chips) 
Seat 3: EasyToRule (€2.38 in chips) 
Seat 4: KindRonin (€0.61 in chips) 
Seat 5: Peru91j (€2.41 in chips) 
Seat 6: franky65124 (€1.79 in chips) 
cap e'bomb95: posts small blind €0.01
EasyToRule: posts big blind €0.02
*** HOLE CARDS ***
Dealt to caduceus369 [5c 7h]
KindRonin: folds 
Peru91j: folds 
franky65124: calls €0.02
caduceus369: folds 
cap e'bomb95: calls €0.01
EasyToRule: checks 
*** FLOP *** [6h 2s 4c]
cap e'bomb95: checks 
EasyToRule: bets €0.02
franky65124: calls €0.02
cap e'bomb95: folds 
*** TURN *** [6h 2s 4c] [Kh]
EasyToRule: checks 
franky65124: bets €0.02
EasyToRule: calls €0.02
*** RIVER *** [6h 2s 4c Kh] [Kd]
EasyToRule: checks 
franky65124: checks 
*** SHOW DOWN ***
EasyToRule: shows [Qd 4s] (two pair, Kings and Fours)
franky65124: mucks hand 
EasyToRule collected €0.14 from pot
*** SUMMARY ***
Total pot €0.14 | Rake €0 
Board [6h 2s 4c Kh Kd]
Seat 1: caduceus369 (button) folded before Flop (didn't bet)
Seat 2: cap e'bomb95 (small blind) folded on the Flop
Seat 3: EasyToRule (big blind) showed [Qd 4s] and won (€0.14) with two pair, Kings and Fours
Seat 4: KindRonin folded before Flop (didn't bet)
Seat 5: Peru91j folded before Flop (didn't bet)
Seat 6: franky65124 mucked [2h Ah]



PokerStars Zoom Hand #257988198887:  Hold'em No Limit (€0.01/€0.02) [ADM ID: M62BA304494E32ST] - 2025/10/03 23:43:26 CET [2025/10/03 17:43:26 ET]
Table 'Sirio' 6-max Seat #1 is the button
Seat 1: Gigo373 (€0.67 in chips) 
Seat 2: maury999999 (€2.49 in chips) 
Seat 3: caduceus369 (€1.92 in chips) 
Seat 4: father2008 (€4.15 in chips) 
Seat 5: bruciapelo (€2.02 in chips) 
Seat 6: montemeru (€3.94 in chips) 
maury999999: posts small blind €0.01
caduceus369: posts big blind €0.02
*** HOLE CARDS ***
Dealt to caduceus369 [3h 4d]
father2008: folds 
bruciapelo: folds 
montemeru: folds 
Gigo373: calls €0.02
maury999999: folds 
caduceus369: checks 
*** FLOP *** [8s 8c Ts]
caduceus369: checks 
Gigo373: checks 
*** TURN *** [8s 8c Ts] [7c]
caduceus369: checks 
Gigo373: checks 
*** RIVER *** [8s 8c Ts 7c] [Ks]
caduceus369: checks 
Gigo373: checks 
*** SHOW DOWN ***
caduceus369: shows [3h 4d] (a pair of Eights)
Gigo373: shows [5h 5s] (two pair, Eights and Fives)
Gigo373 collected €0.05 from pot
*** SUMMARY ***
Total pot €0.05 | Rake €0 
Board [8s 8c Ts 7c Ks]
Seat 1: Gigo373 (button) showed [5h 5s] and won (€0.05) with two pair, Eights and Fives
Seat 2: maury999999 (small blind) folded before Flop
Seat 3: caduceus369 (big blind) showed [3h 4d] and lost with a pair of Eights
Seat 4: father2008 folded before Flop (didn't bet)
Seat 5: bruciapelo folded before Flop (didn't bet)
Seat 6: montemeru folded before Flop (didn't bet)



PokerStars Zoom Hand #257988209618:  Hold'em No Limit (€0.01/€0.02) [ADM ID: M62BA304494E32ST] - 2025/10/03 23:44:12 CET [2025/10/03 17:44:12 ET]
Table 'Sirio' 6-max Seat #1 is the button
Seat 1: ivano747 (€2.23 in chips) 
Seat 2: bruciapelo (€2.15 in chips) 
Seat 3: stfuplzudonk (€4.18 in chips) 
Seat 4: caduceus369 (€1.90 in chips) 
Seat 5: colosso2022 (€1.17 in chips) 
Seat 6: Gigo373 (€0.70 in chips) 
bruciapelo: posts small blind €0.01
stfuplzudonk: posts big blind €0.02
*** HOLE CARDS ***
Dealt to caduceus369 [Kd Jc]
caduceus369: raises €0.04 to €0.06
colosso2022: calls €0.06
Gigo373: calls €0.06
ivano747: folds 
bruciapelo: folds 
stfuplzudonk: calls €0.04
*** FLOP *** [Qh 6s 6c]
stfuplzudonk: checks 
caduceus369: checks 
colosso2022: bets €0.02
Gigo373: folds 
stfuplzudonk: folds 
caduceus369: calls €0.02
*** TURN *** [Qh 6s 6c] [7s]
caduceus369: checks 
colosso2022: bets €0.28
caduceus369: folds 
Uncalled bet (€0.28) returned to colosso2022
colosso2022 collected €0.28 from pot
colosso2022: doesn't show hand 
*** SUMMARY ***
Total pot €0.29 | Rake €0.01 
Board [Qh 6s 6c 7s]
Seat 1: ivano747 (button) folded before Flop (didn't bet)
Seat 2: bruciapelo (small blind) folded before Flop
Seat 3: stfuplzudonk (big blind) folded on the Flop
Seat 4: caduceus369 folded on the Turn
Seat 5: colosso2022 collected (€0.28)
Seat 6: Gigo373 folded on the Flop



PokerStars Zoom Hand #257988217662:  Hold'em No Limit (€0.01/€0.02) [ADM ID: M62BA304494E32ST] - 2025/10/03 23:44:46 CET [2025/10/03 17:44:46 ET]
Table 'Sirio' 6-max Seat #1 is the button
Seat 1: cesaretto23 (€3.26 in chips) 
Seat 2: EasyToRule (€4.23 in chips) 
Seat 3: Witness85906 (€4.69 in chips) 
Seat 4: Peru91j (€2.07 in chips) 
Seat 5: diego-rigano (€0.96 in chips) 
Seat 6: caduceus369 (€1.82 in chips) 
EasyToRule: posts small blind €0.01
Witness85906: posts big blind €0.02
*** HOLE CARDS ***
Dealt to caduceus369 [Qs Ac]
Peru91j: folds 
diego-rigano: folds 
caduceus369: raises €0.04 to €0.06
cesaretto23: folds 
EasyToRule: folds 
Witness85906: raises €0.16 to €0.22
caduceus369: calls €0.16
*** FLOP *** [Qd 6s 6c]
Witness85906: checks 
caduceus369: checks 
*** TURN *** [Qd 6s 6c] [5c]
Witness85906: bets €0.14
caduceus369: calls €0.14
*** RIVER *** [Qd 6s 6c 5c] [As]
Witness85906: checks 
caduceus369: bets €0.77
Witness85906: folds 
Uncalled bet (€0.77) returned to caduceus369
caduceus369 collected €0.69 from pot
caduceus369: doesn't show hand 
*** SUMMARY ***
Total pot €0.73 | Rake €0.04 
Board [Qd 6s 6c 5c As]
Seat 1: cesaretto23 (button) folded before Flop (didn't bet)
Seat 2: EasyToRule (small blind) folded before Flop
Seat 3: Witness85906 (big blind) folded on the River
Seat 4: Peru91j folded before Flop (didn't bet)
Seat 5: diego-rigano folded before Flop (didn't bet)
Seat 6: caduceus369 collected (€0.69)



PokerStars Zoom Hand #257988232077:  Hold'em No Limit (€0.01/€0.02) [ADM ID: M62BA304494E32ST] - 2025/10/03 23:45:49 CET [2025/10/03 17:45:49 ET]
Table 'Sirio' 6-max Seat #1 is the button
Seat 1: neoilnervoso (€1.75 in chips) 
Seat 2: Sium12302 (€2.03 in chips) 
Seat 3: Catania838 (€1.80 in chips) 
Seat 4: caduceus369 (€2.15 in chips) 
Seat 5: 999rizla (€0.78 in chips) 
Seat 6: Neroonciolina (€5.66 in chips) 
Sium12302: posts small blind €0.01
Catania838: posts big blind €0.02
*** HOLE CARDS ***
Dealt to caduceus369 [5c 8s]
caduceus369: folds 
999rizla: folds 
Neroonciolina: folds 
neoilnervoso: folds 
Sium12302: folds 
Uncalled bet (€0.01) returned to Catania838
Catania838 collected €0.02 from pot
Catania838: doesn't show hand 
*** SUMMARY ***
Total pot €0.02 | Rake €0 
Seat 1: neoilnervoso (button) folded before Flop (didn't bet)
Seat 2: Sium12302 (small blind) folded before Flop
Seat 3: Catania838 (big blind) collected (€0.02)
Seat 4: caduceus369 folded before Flop (didn't bet)
Seat 5: 999rizla folded before Flop (didn't bet)
Seat 6: Neroonciolina folded before Flop (didn't bet)



PokerStars Zoom Hand #257988232972:  Hold'em No Limit (€0.01/€0.02) [ADM ID: M62BA304494E32ST] - 2025/10/03 23:45:52 CET [2025/10/03 17:45:52 ET]
Table 'Sirio' 6-max Seat #1 is the button
Seat 1: Gabrielefante (€3.02 in chips) 
Seat 2: KindRonin (€0.78 in chips) 
Seat 3: caduceus369 (€2.15 in chips) 
Seat 4: SidneyPrescott (€4.83 in chips) 
Seat 5: father2008 (€4.23 in chips) 
Seat 6: neoilnervoso (€1.75 in chips) 
KindRonin: posts small blind €0.01
caduceus369: posts big blind €0.02
*** HOLE CARDS ***
Dealt to caduceus369 [Kc 5s]
SidneyPrescott: folds 
father2008: folds 
neoilnervoso: folds 
Gabrielefante: folds 
KindRonin: raises €0.02 to €0.04
caduceus369: calls €0.02
*** FLOP *** [Qh 4d Ac]
KindRonin: bets €0.04
caduceus369: folds 
Uncalled bet (€0.04) returned to KindRonin
KindRonin collected €0.08 from pot
KindRonin: doesn't show hand 
*** SUMMARY ***
Total pot €0.08 | Rake €0 
Board [Qh 4d Ac]
Seat 1: Gabrielefante (button) folded before Flop (didn't bet)
Seat 2: KindRonin (small blind) collected (€0.08)
Seat 3: caduceus369 (big blind) folded on the Flop
Seat 4: SidneyPrescott folded before Flop (didn't bet)
Seat 5: father2008 folded before Flop (didn't bet)
Seat 6: neoilnervoso folded before Flop (didn't bet)



PokerStars Zoom Hand #257988236476:  Hold'em No Limit (€0.01/€0.02) [ADM ID: M62BA304494E32ST] - 2025/10/03 23:46:08 CET [2025/10/03 17:46:08 ET]
Table 'Sirio' 6-max Seat #1 is the button
Seat 1: 999rizla (€0.77 in chips) 
Seat 2: stfuplzudonk (€1.76 in chips) 
Seat 3: ADRIAN0_MEIS (€11.29 in chips) 
Seat 4: Witness85906 (€4.30 in chips) 
Seat 5: caduceus369 (€2.11 in chips) 
Seat 6: bruciapelo (€2.16 in chips) 
stfuplzudonk: posts small blind €0.01
ADRIAN0_MEIS: posts big blind €0.02
*** HOLE CARDS ***
Dealt to caduceus369 [Kc 5c]
Witness85906: raises €0.03 to €0.05
caduceus369: folds 
bruciapelo: folds 
999rizla: folds 
stfuplzudonk: folds 
ADRIAN0_MEIS: folds 
Uncalled bet (€0.03) returned to Witness85906
Witness85906 collected €0.05 from pot
Witness85906: doesn't show hand 
*** SUMMARY ***
Total pot €0.05 | Rake €0 
Seat 1: 999rizla (button) folded before Flop (didn't bet)
Seat 2: stfuplzudonk (small blind) folded before Flop
Seat 3: ADRIAN0_MEIS (big blind) folded before Flop
Seat 4: Witness85906 collected (€0.05)
Seat 5: caduceus369 folded before Flop (didn't bet)
Seat 6: bruciapelo folded before Flop (didn't bet)



PokerStars Zoom Hand #257988238566:  Hold'em No Limit (€0.01/€0.02) [ADM ID: M62BA304494E32ST] - 2025/10/03 23:46:17 CET [2025/10/03 17:46:17 ET]
Table 'Sirio' 6-max Seat #1 is the button
Seat 1: fantaasso (€2.58 in chips) 
Seat 2: caduceus369 (€2.11 in chips) 
Seat 3: montemeru (€1.92 in chips) 
Seat 4: EasyToRule (€4.49 in chips) 
Seat 5: cap e'bomb95 (€1.63 in chips) 
Seat 6: michy0757 (€0.70 in chips) 
caduceus369: posts small blind €0.01
montemeru: posts big blind €0.02
*** HOLE CARDS ***
Dealt to caduceus369 [7c 4s]
EasyToRule: folds 
cap e'bomb95: folds 
michy0757: raises €0.02 to €0.04
fantaasso: folds 
caduceus369: folds 
montemeru: calls €0.02
*** FLOP *** [Ah Js Td]
montemeru: checks 
michy0757: checks 
*** TURN *** [Ah Js Td] [Tc]
montemeru: checks 
michy0757: bets €0.09
montemeru: folds 
Uncalled bet (€0.09) returned to michy0757
montemeru is disconnected 
michy0757 collected €0.09 from pot
michy0757: doesn't show hand 
*** SUMMARY ***
Total pot €0.09 | Rake €0 
Board [Ah Js Td Tc]
Seat 1: fantaasso (button) folded before Flop (didn't bet)
Seat 2: caduceus369 (small blind) folded before Flop
Seat 3: montemeru (big blind) folded on the Turn
Seat 4: EasyToRule folded before Flop (didn't bet)
Seat 5: cap e'bomb95 folded before Flop (didn't bet)
Seat 6: michy0757 collected (€0.09)



PokerStars Zoom Hand #257988239558:  Hold'em No Limit (€0.01/€0.02) [ADM ID: M62BA304494E32ST] - 2025/10/03 23:46:21 CET [2025/10/03 17:46:21 ET]
Table 'Sirio' 6-max Seat #1 is the button
Seat 1: caduceus369 (€2.10 in chips) 
Seat 2: fantaasso (€2.58 in chips) 
Seat 3: maury999999 (€2.84 in chips) 
Seat 4: cap e'bomb95 (€1.63 in chips) 
Seat 5: EasyToRule (€2.48 in chips) 
Seat 6: Fengjie82 (€1.47 in chips) 
fantaasso: posts small blind €0.01
maury999999: posts big blind €0.02
*** HOLE CARDS ***
Dealt to caduceus369 [8c Tc]
cap e'bomb95: folds 
EasyToRule: raises €0.03 to €0.05
Fengjie82: calls €0.05
caduceus369: folds 
fantaasso: folds 
maury999999: folds 
*** FLOP *** [2s 9d 8d]
EasyToRule: bets €0.07
Fengjie82: folds 
Uncalled bet (€0.07) returned to EasyToRule
EasyToRule collected €0.13 from pot
EasyToRule: doesn't show hand 
*** SUMMARY ***
Total pot €0.13 | Rake €0 
Board [2s 9d 8d]
Seat 1: caduceus369 (button) folded before Flop (didn't bet)
Seat 2: fantaasso (small blind) folded before Flop
Seat 3: maury999999 (big blind) folded before Flop
Seat 4: cap e'bomb95 folded before Flop (didn't bet)
Seat 5: EasyToRule collected (€0.13)
Seat 6: Fengjie82 folded on the Flop



PokerStars Zoom Hand #257988278669:  Hold'em No Limit (€0.01/€0.02) [ADM ID: M62BA304494E32ST] - 2025/10/03 23:49:15 CET [2025/10/03 17:49:15 ET]
Table 'Sirio' 6-max Seat #1 is the button
Seat 1: ivano747 (€2.61 in chips) 
Seat 2: cap e'bomb95 (€1.27 in chips) 
Seat 3: Sium12302 (€6.47 in chips) 
Seat 4: CacciatoreAA (€1.53 in chips) 
Seat 5: Catania838 (€2.87 in chips) 
Seat 6: caduceus369 (€2.10 in chips) 
cap e'bomb95: posts small blind €0.01
Sium12302: posts big blind €0.02
*** HOLE CARDS ***
Dealt to caduceus369 [6h 7h]
CacciatoreAA: folds 
Catania838: folds 
caduceus369: folds 
ivano747: folds 
cap e'bomb95: raises €0.03 to €0.05
Sium12302: folds 
Uncalled bet (€0.03) returned to cap e'bomb95
cap e'bomb95 collected €0.04 from pot
cap e'bomb95: doesn't show hand 
*** SUMMARY ***
Total pot €0.04 | Rake €0 
Seat 1: ivano747 (button) folded before Flop (didn't bet)
Seat 2: cap e'bomb95 (small blind) collected (€0.04)
Seat 3: Sium12302 (big blind) folded before Flop
Seat 4: CacciatoreAA folded before Flop (didn't bet)
Seat 5: Catania838 folded before Flop (didn't bet)
Seat 6: caduceus369 folded before Flop (didn't bet)



PokerStars Zoom Hand #257988276630:  Hold'em No Limit (€0.01/€0.02) [ADM ID: M62BA304494E32ST] - 2025/10/03 23:49:05 CET [2025/10/03 17:49:05 ET]
Table 'Sirio' 6-max Seat #1 is the button
Seat 1: Fengjie82 (€1.38 in chips) 
Seat 2: Catania838 (€2.88 in chips) 
Seat 3: Sium12302 (€2 in chips) 
Seat 4: neoilnervoso (€1.96 in chips) 
Seat 5: caduceus369 (€2.10 in chips) 
Seat 6: Freddy15081988 (€1.02 in chips) 
Catania838: posts small blind €0.01
Sium12302: posts big blind €0.02
*** HOLE CARDS ***
Dealt to caduceus369 [Js 5c]
neoilnervoso: folds 
caduceus369: folds 
Freddy15081988: calls €0.02
Fengjie82: folds 
Catania838: folds 
Sium12302: checks 
*** FLOP *** [7s Th 7d]
Sium12302: checks 
Freddy15081988: checks 
*** TURN *** [7s Th 7d] [5h]
Sium12302: checks 
Freddy15081988: bets €0.02
Sium12302: folds 
Uncalled bet (€0.02) returned to Freddy15081988
Freddy15081988 collected €0.05 from pot
Freddy15081988: doesn't show hand 
*** SUMMARY ***
Total pot €0.05 | Rake €0 
Board [7s Th 7d 5h]
Seat 1: Fengjie82 (button) folded before Flop (didn't bet)
Seat 2: Catania838 (small blind) folded before Flop
Seat 3: Sium12302 (big blind) folded on the Turn
Seat 4: neoilnervoso folded before Flop (didn't bet)
Seat 5: caduceus369 folded before Flop (didn't bet)
Seat 6: Freddy15081988 collected (€0.05)



PokerStars Zoom Hand #257988280984:  Hold'em No Limit (€0.01/€0.02) [ADM ID: M62BA304494E32ST] - 2025/10/03 23:49:24 CET [2025/10/03 17:49:24 ET]
Table 'Sirio' 6-max Seat #1 is the button
Seat 1: Uechend (€1.88 in chips) 
Seat 2: Fengjie82 (€1.36 in chips) 
Seat 3: Catania838 (€1.86 in chips) 
Seat 4: caduceus369 (€2.10 in chips) 
Seat 5: ivano747 (€2.61 in chips) 
Seat 6: EasyToRule (€4.57 in chips) 
Fengjie82: posts small blind €0.01
Catania838: posts big blind €0.02
*** HOLE CARDS ***
Dealt to caduceus369 [9d Kh]
caduceus369: folds 
ivano747: folds 
EasyToRule: folds 
Uechend: folds 
Fengjie82: calls €0.01
Catania838: raises €0.02 to €0.04
Fengjie82: folds 
Uncalled bet (€0.02) returned to Catania838
Catania838 collected €0.04 from pot
Catania838: doesn't show hand 
*** SUMMARY ***
Total pot €0.04 | Rake €0 
Seat 1: Uechend (button) folded before Flop (didn't bet)
Seat 2: Fengjie82 (small blind) folded before Flop
Seat 3: Catania838 (big blind) collected (€0.04)
Seat 4: caduceus369 folded before Flop (didn't bet)
Seat 5: ivano747 folded before Flop (didn't bet)
Seat 6: EasyToRule folded before Flop (didn't bet)



PokerStars Zoom Hand #257988281885:  Hold'em No Limit (€0.01/€0.02) [ADM ID: M62BA304494E32ST] - 2025/10/03 23:49:29 CET [2025/10/03 17:49:29 ET]
Table 'Sirio' 6-max Seat #1 is the button
Seat 1: robertoH2O (€2.16 in chips) 
Seat 2: caduceus369 (€2.10 in chips) 
Seat 3: 999rizla (€0.62 in chips) 
Seat 4: CacciatoreAA (€1.53 in chips) 
Seat 5: macchia1010 (€1.16 in chips) 
Seat 6: ivano747 (€2.61 in chips) 
caduceus369: posts small blind €0.01
999rizla: posts big blind €0.02
*** HOLE CARDS ***
Dealt to caduceus369 [4d 8d]
CacciatoreAA: raises €0.06 to €0.08
macchia1010: calls €0.08
ivano747: folds 
robertoH2O: folds 
caduceus369: folds 
999rizla: folds 
*** FLOP *** [Ks 3d 5h]
CacciatoreAA: checks 
macchia1010: bets €0.08
CacciatoreAA: folds 
Uncalled bet (€0.08) returned to macchia1010
macchia1010 collected €0.18 from pot
macchia1010: doesn't show hand 
*** SUMMARY ***
Total pot €0.19 | Rake €0.01 
Board [Ks 3d 5h]
Seat 1: robertoH2O (button) folded before Flop (didn't bet)
Seat 2: caduceus369 (small blind) folded before Flop
Seat 3: 999rizla (big blind) folded before Flop
Seat 4: CacciatoreAA folded on the Flop
Seat 5: macchia1010 collected (€0.18)
Seat 6: ivano747 folded before Flop (didn't bet)



PokerStars Zoom Hand #257988284125:  Hold'em No Limit (€0.01/€0.02) [ADM ID: M62BA304494E32ST] - 2025/10/03 23:49:39 CET [2025/10/03 17:49:39 ET]
Table 'Sirio' 6-max Seat #1 is the button
Seat 1: SidneyPrescott (€4.33 in chips) 
Seat 2: fantaasso (€2.46 in chips) 
Seat 3: criptlux (€2.43 in chips) 
Seat 4: caduceus369 (€2.09 in chips) 
Seat 5: ADRIAN0_MEIS (€2.62 in chips) 
Seat 6: father2008 (€5.82 in chips) 
fantaasso: posts small blind €0.01
criptlux: posts big blind €0.02
*** HOLE CARDS ***
Dealt to caduceus369 [6d Qd]
caduceus369: folds 
ADRIAN0_MEIS: raises €0.04 to €0.06
father2008: raises €0.15 to €0.21
SidneyPrescott: folds 
fantaasso: folds 
criptlux: folds 
ADRIAN0_MEIS: folds 
Uncalled bet (€0.15) returned to father2008
father2008 collected €0.15 from pot
father2008: doesn't show hand 
*** SUMMARY ***
Total pot €0.15 | Rake €0 
Seat 1: SidneyPrescott (button) folded before Flop (didn't bet)
Seat 2: fantaasso (small blind) folded before Flop
Seat 3: criptlux (big blind) folded before Flop
Seat 4: caduceus369 folded before Flop (didn't bet)
Seat 5: ADRIAN0_MEIS folded before Flop
Seat 6: father2008 collected (€0.15)



PokerStars Zoom Hand #257988290794:  Hold'em No Limit (€0.01/€0.02) [ADM ID: M62BA304494E32ST] - 2025/10/03 23:50:08 CET [2025/10/03 17:50:08 ET]
Table 'Sirio' 6-max Seat #1 is the button
Seat 1: caduceus369 (€2.07 in chips) 
Seat 2: Sium12302 (€6.39 in chips) 
Seat 3: criptlux (€1.93 in chips) 
Seat 4: EasyToRule (€2.54 in chips) 
Seat 5: ADRIAN0_MEIS (€7.91 in chips) 
Seat 6: ivano747 (€2.16 in chips) 
Sium12302: posts small blind €0.01
criptlux: posts big blind €0.02
*** HOLE CARDS ***
Dealt to caduceus369 [8c 4d]
EasyToRule: folds 
ADRIAN0_MEIS: folds 
ivano747: folds 
caduceus369: folds 
Sium12302: folds 
Uncalled bet (€0.01) returned to criptlux
criptlux collected €0.02 from pot
criptlux: doesn't show hand 
*** SUMMARY ***
Total pot €0.02 | Rake €0 
Seat 1: caduceus369 (button) folded before Flop (didn't bet)
Seat 2: Sium12302 (small blind) folded before Flop
Seat 3: criptlux (big blind) collected (€0.02)
Seat 4: EasyToRule folded before Flop (didn't bet)
Seat 5: ADRIAN0_MEIS folded before Flop (didn't bet)
Seat 6: ivano747 folded before Flop (didn't bet)



PokerStars Zoom Hand #257988286061:  Hold'em No Limit (€0.01/€0.02) [ADM ID: M62BA304494E32ST] - 2025/10/03 23:49:47 CET [2025/10/03 17:49:47 ET]
Table 'Sirio' 6-max Seat #1 is the button
Seat 1: Gigo373 (€0.96 in chips) 
Seat 2: Catania838 (€2.05 in chips) 
Seat 3: caduceus369 (€2.09 in chips) 
Seat 4: Fengjie82 (€1.34 in chips) 
Seat 5: Sium12302 (€2 in chips) 
Seat 6: SidneyPrescott (€4.33 in chips) 
Catania838: posts small blind €0.01
caduceus369: posts big blind €0.02
*** HOLE CARDS ***
Dealt to caduceus369 [7s 8c]
Fengjie82: raises €0.04 to €0.06
Sium12302: folds 
SidneyPrescott: folds 
Gigo373: calls €0.06
Catania838: folds 
caduceus369: folds 
*** FLOP *** [Qd Ad 4s]
Fengjie82: bets €0.06
Gigo373: calls €0.06
*** TURN *** [Qd Ad 4s] [4d]
Fengjie82: checks 
Gigo373: checks 
*** RIVER *** [Qd Ad 4s 4d] [2d]
Fengjie82: bets €0.08
Gigo373: folds 
Uncalled bet (€0.08) returned to Fengjie82
Fengjie82 collected €0.26 from pot
Fengjie82: doesn't show hand 
*** SUMMARY ***
Total pot €0.27 | Rake €0.01 
Board [Qd Ad 4s 4d 2d]
Seat 1: Gigo373 (button) folded on the River
Seat 2: Catania838 (small blind) folded before Flop
Seat 3: caduceus369 (big blind) folded before Flop
Seat 4: Fengjie82 collected (€0.26)
Seat 5: Sium12302 folded before Flop (didn't bet)
Seat 6: SidneyPrescott folded before Flop (didn't bet)



PokerStars Zoom Hand #257988291864:  Hold'em No Limit (€0.01/€0.02) [ADM ID: M62BA304494E32ST] - 2025/10/03 23:50:13 CET [2025/10/03 17:50:13 ET]
Table 'Sirio' 6-max Seat #1 is the button
Seat 1: franky65124 (€1.58 in chips) 
Seat 2: Witness85906 (€4.46 in chips) 
Seat 3: EasyToRule (€2.54 in chips) 
Seat 4: Catania838 (€1.87 in chips) 
Seat 5: criptlux (€2.40 in chips) 
Seat 6: caduceus369 (€2.07 in chips) 
Witness85906: posts small blind €0.01
EasyToRule: posts big blind €0.02
*** HOLE CARDS ***
Dealt to caduceus369 [8d Ad]
Catania838: folds 
criptlux: folds 
caduceus369 has timed out
caduceus369: folds 
franky65124: folds 
Witness85906: folds 
Uncalled bet (€0.01) returned to EasyToRule
EasyToRule collected €0.02 from pot
EasyToRule: doesn't show hand 
*** SUMMARY ***
Total pot €0.02 | Rake €0 
Seat 1: franky65124 (button) folded before Flop (didn't bet)
Seat 2: Witness85906 (small blind) folded before Flop
Seat 3: EasyToRule (big blind) collected (€0.02)
Seat 4: Catania838 folded before Flop (didn't bet)
Seat 5: criptlux folded before Flop (didn't bet)
Seat 6: caduceus369 folded before Flop (didn't bet)



PokerStars Zoom Hand #257988300008:  Hold'em No Limit (€0.01/€0.02) [ADM ID: M62BA304494E32ST] - 2025/10/03 23:50:49 CET [2025/10/03 17:50:49 ET]
Table 'Sirio' 6-max Seat #1 is the button
Seat 1: Peru91j (€2.02 in chips) 
Seat 2: ivano747 (€2.53 in chips) 
Seat 3: Fengjie82 (€1.48 in chips) 
Seat 4: SidneyPrescott (€4.49 in chips) 
Seat 5: caduceus369 (€2.07 in chips) 
Seat 6: robertoH2O (€2.18 in chips) 
ivano747: posts small blind €0.01
Fengjie82: posts big blind €0.02
*** HOLE CARDS ***
Dealt to caduceus369 [Qd Td]
SidneyPrescott: raises €0.04 to €0.06
caduceus369: folds 
robertoH2O: folds 
Peru91j: folds 
ivano747: folds 
Fengjie82: folds 
Uncalled bet (€0.04) returned to SidneyPrescott
SidneyPrescott collected €0.05 from pot
SidneyPrescott: doesn't show hand 
*** SUMMARY ***
Total pot €0.05 | Rake €0 
Seat 1: Peru91j (button) folded before Flop (didn't bet)
Seat 2: ivano747 (small blind) folded before Flop
Seat 3: Fengjie82 (big blind) folded before Flop
Seat 4: SidneyPrescott collected (€0.05)
Seat 5: caduceus369 folded before Flop (didn't bet)
Seat 6: robertoH2O folded before Flop (didn't bet)



PokerStars Zoom Hand #257988296343:  Hold'em No Limit (€0.01/€0.02) [ADM ID: M62BA304494E32ST] - 2025/10/03 23:50:33 CET [2025/10/03 17:50:33 ET]
Table 'Sirio' 6-max Seat #1 is the button
Seat 1: caduceus369 (€2.07 in chips) 
Seat 2: CacciatoreAA (€1.35 in chips) 
Seat 3: stfuplzudonk (€3.96 in chips) 
Seat 4: fantaasso (€2.27 in chips) 
Seat 5: Sium12302 (€6.36 in chips) 
Seat 6: outshined8 (€1.97 in chips) 
CacciatoreAA: posts small blind €0.01
stfuplzudonk: posts big blind €0.02
*** HOLE CARDS ***
Dealt to caduceus369 [9d Jh]
fantaasso: folds 
Sium12302: folds 
outshined8: folds 
caduceus369: folds 
CacciatoreAA: raises €0.06 to €0.08
stfuplzudonk: calls €0.06
*** FLOP *** [2h 5c 6d]
CacciatoreAA: bets €0.08
stfuplzudonk: calls €0.08
*** TURN *** [2h 5c 6d] [2s]
CacciatoreAA: bets €0.31
stfuplzudonk: folds 
Uncalled bet (€0.31) returned to CacciatoreAA
CacciatoreAA collected €0.31 from pot
CacciatoreAA: doesn't show hand 
*** SUMMARY ***
Total pot €0.32 | Rake €0.01 
Board [2h 5c 6d 2s]
Seat 1: caduceus369 (button) folded before Flop (didn't bet)
Seat 2: CacciatoreAA (small blind) collected (€0.31)
Seat 3: stfuplzudonk (big blind) folded on the Turn
Seat 4: fantaasso folded before Flop (didn't bet)
Seat 5: Sium12302 folded before Flop (didn't bet)
Seat 6: outshined8 folded before Flop (didn't bet)



PokerStars Zoom Hand #257988304017:  Hold'em No Limit (€0.01/€0.02) [ADM ID: M62BA304494E32ST] - 2025/10/03 23:51:07 CET [2025/10/03 17:51:07 ET]
Table 'Sirio' 6-max Seat #1 is the button
Seat 1: robertoH2O (€2.18 in chips) 
Seat 2: cap e'bomb95 (€2.35 in chips) 
Seat 3: ADRIAN0_MEIS (€2.58 in chips) 
Seat 4: ivano747 (€2.52 in chips) 
Seat 5: Catania838 (€2.86 in chips) 
Seat 6: caduceus369 (€2.06 in chips) 
cap e'bomb95: posts small blind €0.01
ADRIAN0_MEIS: posts big blind €0.02
*** HOLE CARDS ***
Dealt to caduceus369 [4d 8s]
ivano747: folds 
Catania838: folds 
caduceus369: folds 
robertoH2O: folds 
cap e'bomb95: folds 
Uncalled bet (€0.01) returned to ADRIAN0_MEIS
ADRIAN0_MEIS collected €0.02 from pot
ADRIAN0_MEIS: doesn't show hand 
*** SUMMARY ***
Total pot €0.02 | Rake €0 
Seat 1: robertoH2O (button) folded before Flop (didn't bet)
Seat 2: cap e'bomb95 (small blind) folded before Flop
Seat 3: ADRIAN0_MEIS (big blind) collected (€0.02)
Seat 4: ivano747 folded before Flop (didn't bet)
Seat 5: Catania838 folded before Flop (didn't bet)
Seat 6: caduceus369 folded before Flop (didn't bet)



PokerStars Zoom Hand #257988303139:  Hold'em No Limit (€0.01/€0.02) [ADM ID: M62BA304494E32ST] - 2025/10/03 23:51:03 CET [2025/10/03 17:51:03 ET]
Table 'Sirio' 6-max Seat #1 is the button
Seat 1: cap e'bomb95 (€2.35 in chips) 
Seat 2: caduceus369 (€2.07 in chips) 
Seat 3: Sium12302 (€6.35 in chips) 
Seat 4: robertoH2O (€2.18 in chips) 
Seat 5: Neroonciolina (€1.08 in chips) 
Seat 6: ivano747 (€2.52 in chips) 
caduceus369: posts small blind €0.01
Sium12302: posts big blind €0.02
*** HOLE CARDS ***
Dealt to caduceus369 [9d 8s]
robertoH2O: folds 
Neroonciolina: raises €0.04 to €0.06
ivano747: folds 
cap e'bomb95: folds 
caduceus369: folds 
Sium12302: calls €0.04
*** FLOP *** [2c 7c 5d]
Sium12302: checks 
Neroonciolina: bets €0.14
Sium12302: folds 
Uncalled bet (€0.14) returned to Neroonciolina
Neroonciolina collected €0.13 from pot
Neroonciolina: doesn't show hand 
*** SUMMARY ***
Total pot €0.13 | Rake €0 
Board [2c 7c 5d]
Seat 1: cap e'bomb95 (button) folded before Flop (didn't bet)
Seat 2: caduceus369 (small blind) folded before Flop
Seat 3: Sium12302 (big blind) folded on the Flop
Seat 4: robertoH2O folded before Flop (didn't bet)
Seat 5: Neroonciolina collected (€0.13)
Seat 6: ivano747 folded before Flop (didn't bet)



PokerStars Zoom Hand #257988307013:  Hold'em No Limit (€0.01/€0.02) [ADM ID: M62BA304494E32ST] - 2025/10/03 23:51:20 CET [2025/10/03 17:51:20 ET]
Table 'Sirio' 6-max Seat #1 is the button
Seat 1: cap e'bomb95 (€1.33 in chips) 
Seat 2: stfuplzudonk (€2.50 in chips) 
Seat 3: caduceus369 (€2.06 in chips) 
Seat 4: CacciatoreAA (€1.50 in chips) 
Seat 5: pia1256 (€2.05 in chips) 
Seat 6: outshined8 (€1.92 in chips) 
stfuplzudonk: posts small blind €0.01
caduceus369: posts big blind €0.02
*** HOLE CARDS ***
Dealt to caduceus369 [2c Qd]
CacciatoreAA: folds 
pia1256: calls €0.02
outshined8: folds 
cap e'bomb95: folds 
stfuplzudonk: calls €0.01
caduceus369: checks 
*** FLOP *** [7s Jh 9h]
stfuplzudonk: checks 
caduceus369: checks 
pia1256: checks 
*** TURN *** [7s Jh 9h] [3d]
stfuplzudonk: bets €0.03
caduceus369: folds 
pia1256: folds 
Uncalled bet (€0.03) returned to stfuplzudonk
stfuplzudonk collected €0.06 from pot
stfuplzudonk: doesn't show hand 
*** SUMMARY ***
Total pot €0.06 | Rake €0 
Board [7s Jh 9h 3d]
Seat 1: cap e'bomb95 (button) folded before Flop (didn't bet)
Seat 2: stfuplzudonk (small blind) collected (€0.06)
Seat 3: caduceus369 (big blind) folded on the Turn
Seat 4: CacciatoreAA folded before Flop (didn't bet)
Seat 5: pia1256 folded on the Turn
Seat 6: outshined8 folded before Flop (didn't bet)



PokerStars Zoom Hand #257988312341:  Hold'em No Limit (€0.01/€0.02) [ADM ID: M62BA304494E32ST] - 2025/10/03 23:51:44 CET [2025/10/03 17:51:44 ET]
Table 'Sirio' 6-max Seat #1 is the button
Seat 1: Sium12302 (€2 in chips) 
Seat 2: Fengjie82 (€1.49 in chips) 
Seat 3: tigermiscio (€0.81 in chips) 
Seat 4: EasyToRule (€4.60 in chips) 
Seat 5: caduceus369 (€2.04 in chips) 
Seat 6: father2008 (€5.94 in chips) 
Fengjie82: posts small blind €0.01
tigermiscio: posts big blind €0.02
*** HOLE CARDS ***
Dealt to caduceus369 [Ah Kd]
EasyToRule: folds 
caduceus369: raises €0.04 to €0.06
father2008: folds 
Sium12302: folds 
Fengjie82: folds 
tigermiscio: calls €0.04
*** FLOP *** [5s 8d Tc]
tigermiscio: checks 
caduceus369: checks 
*** TURN *** [5s 8d Tc] [2h]
tigermiscio: bets €0.04
caduceus369: calls €0.04
*** RIVER *** [5s 8d Tc 2h] [5h]
tigermiscio: checks 
caduceus369: checks 
*** SHOW DOWN ***
tigermiscio: shows [Qc 8h] (two pair, Eights and Fives)
caduceus369: mucks hand 
tigermiscio collected €0.20 from pot
*** SUMMARY ***
Total pot €0.21 | Rake €0.01 
Board [5s 8d Tc 2h 5h]
Seat 1: Sium12302 (button) folded before Flop (didn't bet)
Seat 2: Fengjie82 (small blind) folded before Flop
Seat 3: tigermiscio (big blind) showed [Qc 8h] and won (€0.20) with two pair, Eights and Fives
Seat 4: EasyToRule folded before Flop (didn't bet)
Seat 5: caduceus369 mucked [Ah Kd]
Seat 6: father2008 folded before Flop (didn't bet)



PokerStars Zoom Hand #257988306183:  Hold'em No Limit (€0.01/€0.02) [ADM ID: M62BA304494E32ST] - 2025/10/03 23:51:17 CET [2025/10/03 17:51:17 ET]
Table 'Sirio' 6-max Seat #1 is the button
Seat 1: criptlux (€2.35 in chips) 
Seat 2: KindRonin (€0.67 in chips) 
Seat 3: Davi3231973 (€0.81 in chips) 
Seat 4: caduceus369 (€2.06 in chips) 
Seat 5: colosso2022 (€2.27 in chips) 
Seat 6: ADRIAN0_MEIS (€10.41 in chips) 
KindRonin: posts small blind €0.01
Davi3231973: posts big blind €0.02
*** HOLE CARDS ***
Dealt to caduceus369 [8d 6s]
caduceus369: folds 
colosso2022: calls €0.02
ADRIAN0_MEIS: raises €0.05 to €0.07
criptlux: folds 
KindRonin: folds 
Davi3231973: folds 
colosso2022: calls €0.05
*** FLOP *** [2s Ts 7h]
colosso2022: checks 
ADRIAN0_MEIS: checks 
*** TURN *** [2s Ts 7h] [2c]
colosso2022: bets €0.02
ADRIAN0_MEIS: calls €0.02
*** RIVER *** [2s Ts 7h 2c] [8h]
colosso2022: bets €0.06
ADRIAN0_MEIS: calls €0.06
*** SHOW DOWN ***
colosso2022: shows [As Kc] (a pair of Deuces)
ADRIAN0_MEIS: mucks hand 
colosso2022 collected €0.32 from pot
*** SUMMARY ***
Total pot €0.33 | Rake €0.01 
Board [2s Ts 7h 2c 8h]
Seat 1: criptlux (button) folded before Flop (didn't bet)
Seat 2: KindRonin (small blind) folded before Flop
Seat 3: Davi3231973 (big blind) folded before Flop
Seat 4: caduceus369 folded before Flop (didn't bet)
Seat 5: colosso2022 showed [As Kc] and won (€0.32) with a pair of Deuces
Seat 6: ADRIAN0_MEIS mucked [Ah 3h]



PokerStars Zoom Hand #257988320185:  Hold'em No Limit (€0.01/€0.02) [ADM ID: M62BA304494E32ST] - 2025/10/03 23:52:19 CET [2025/10/03 17:52:19 ET]
Table 'Sirio' 6-max Seat #1 is the button
Seat 1: Neroonciolina (€1.22 in chips) 
Seat 2: fantaasso (€3.17 in chips) 
Seat 3: EasyToRule (€4.62 in chips) 
Seat 4: caduceus369 (€1.94 in chips) 
Seat 5: Sium12302 (€2 in chips) 
Seat 6: stevalmg (€2.04 in chips) 
fantaasso: posts small blind €0.01
EasyToRule: posts big blind €0.02
*** HOLE CARDS ***
Dealt to caduceus369 [Td 5d]
caduceus369: folds 
Sium12302: folds 
stevalmg: folds 
Neroonciolina: folds 
fantaasso: folds 
Uncalled bet (€0.01) returned to EasyToRule
EasyToRule collected €0.02 from pot
EasyToRule: doesn't show hand 
*** SUMMARY ***
Total pot €0.02 | Rake €0 
Seat 1: Neroonciolina (button) folded before Flop (didn't bet)
Seat 2: fantaasso (small blind) folded before Flop
Seat 3: EasyToRule (big blind) collected (€0.02)
Seat 4: caduceus369 folded before Flop (didn't bet)
Seat 5: Sium12302 folded before Flop (didn't bet)
Seat 6: stevalmg folded before Flop (didn't bet)



PokerStars Zoom Hand #257988320857:  Hold'em No Limit (€0.01/€0.02) [ADM ID: M62BA304494E32ST] - 2025/10/03 23:52:22 CET [2025/10/03 17:52:22 ET]
Table 'Sirio' 6-max Seat #1 is the button
Seat 1: tigermiscio (€0.90 in chips) 
Seat 2: Sium12302 (€2 in chips) 
Seat 3: caduceus369 (€1.94 in chips) 
Seat 4: colosso2022 (€2.44 in chips) 
Seat 5: ADRIAN0_MEIS (€10.26 in chips) 
Seat 6: trillycata (€1.03 in chips) 
Sium12302: posts small blind €0.01
caduceus369: posts big blind €0.02
*** HOLE CARDS ***
Dealt to caduceus369 [3d 5s]
colosso2022: folds 
ADRIAN0_MEIS: folds 
trillycata: folds 
tigermiscio: folds 
Sium12302: folds 
Uncalled bet (€0.01) returned to caduceus369
caduceus369 collected €0.02 from pot
caduceus369: doesn't show hand 
*** SUMMARY ***
Total pot €0.02 | Rake €0 
Seat 1: tigermiscio (button) folded before Flop (didn't bet)
Seat 2: Sium12302 (small blind) folded before Flop
Seat 3: caduceus369 (big blind) collected (€0.02)
Seat 4: colosso2022 folded before Flop (didn't bet)
Seat 5: ADRIAN0_MEIS folded before Flop (didn't bet)
Seat 6: trillycata folded before Flop (didn't bet)



PokerStars Zoom Hand #257988329128:  Hold'em No Limit (€0.01/€0.02) [ADM ID: M62BA304494E32ST] - 2025/10/03 23:52:59 CET [2025/10/03 17:52:59 ET]
Table 'Sirio' 6-max Seat #1 is the button
Seat 1: caduceus369 (€1.94 in chips) 
Seat 2: cap e'bomb95 (€1.24 in chips) 
Seat 3: CacciatoreAA (€1.51 in chips) 
Seat 4: ADRIAN0_MEIS (€10.23 in chips) 
Seat 5: EasyToRule (€2.60 in chips) 
Seat 6: Witness85906 (€5.26 in chips) 
cap e'bomb95: posts small blind €0.01
CacciatoreAA: posts big blind €0.02
*** HOLE CARDS ***
Dealt to caduceus369 [Ac 9d]
ADRIAN0_MEIS: folds 
EasyToRule: folds 
Witness85906: folds 
caduceus369: raises €0.04 to €0.06
cap e'bomb95: folds 
CacciatoreAA: folds 
Uncalled bet (€0.04) returned to caduceus369
caduceus369 collected €0.05 from pot
caduceus369: doesn't show hand 
*** SUMMARY ***
Total pot €0.05 | Rake €0 
Seat 1: caduceus369 (button) collected (€0.05)
Seat 2: cap e'bomb95 (small blind) folded before Flop
Seat 3: CacciatoreAA (big blind) folded before Flop
Seat 4: ADRIAN0_MEIS folded before Flop (didn't bet)
Seat 5: EasyToRule folded before Flop (didn't bet)
Seat 6: Witness85906 folded before Flop (didn't bet)



PokerStars Zoom Hand #257988325618:  Hold'em No Limit (€0.01/€0.02) [ADM ID: M62BA304494E32ST] - 2025/10/03 23:52:44 CET [2025/10/03 17:52:44 ET]
Table 'Sirio' 6-max Seat #1 is the button
Seat 1: tigermiscio (€0.90 in chips) 
Seat 2: caduceus369 (€1.95 in chips) 
Seat 3: bruciapelo (€1.52 in chips) 
Seat 4: robertoH2O (€2.22 in chips) 
Seat 5: EasyToRule (€4.63 in chips) 
Seat 6: franky65124 (€1.38 in chips) 
caduceus369: posts small blind €0.01
bruciapelo: posts big blind €0.02
*** HOLE CARDS ***
Dealt to caduceus369 [8d 7s]
robertoH2O: folds 
EasyToRule: folds 
franky65124: calls €0.02
tigermiscio: raises €0.02 to €0.04
caduceus369: folds 
bruciapelo: folds 
franky65124: calls €0.02
*** FLOP *** [Kh 9d Tc]
franky65124: bets €0.02
tigermiscio: calls €0.02
*** TURN *** [Kh 9d Tc] [6c]
franky65124: bets €0.06
tigermiscio: folds 
Uncalled bet (€0.06) returned to franky65124
franky65124 collected €0.15 from pot
franky65124: doesn't show hand 
*** SUMMARY ***
Total pot €0.15 | Rake €0 
Board [Kh 9d Tc 6c]
Seat 1: tigermiscio (button) folded on the Turn
Seat 2: caduceus369 (small blind) folded before Flop
Seat 3: bruciapelo (big blind) folded before Flop
Seat 4: robertoH2O folded before Flop (didn't bet)
Seat 5: EasyToRule folded before Flop (didn't bet)
Seat 6: franky65124 collected (€0.15)



PokerStars Zoom Hand #257988334833:  Hold'em No Limit (€0.01/€0.02) [ADM ID: M62BA304494E32ST] - 2025/10/03 23:53:24 CET [2025/10/03 17:53:24 ET]
Table 'Sirio' 6-max Seat #1 is the button
Seat 1: Sium12302 (€6.26 in chips) 
Seat 2: criptlux (€2.38 in chips) 
Seat 3: Catania838 (€1.88 in chips) 
Seat 4: caduceus369 (€1.97 in chips) 
Seat 5: Witness85906 (€5.25 in chips) 
Seat 6: Gabrielefante (€3.20 in chips) 
criptlux: posts small blind €0.01
Catania838: posts big blind €0.02
*** HOLE CARDS ***
Dealt to caduceus369 [Jc 7h]
caduceus369: folds 
Witness85906: folds 
Gabrielefante: folds 
Sium12302: folds 
criptlux: folds 
Uncalled bet (€0.01) returned to Catania838
Catania838 collected €0.02 from pot
Catania838: doesn't show hand 
*** SUMMARY ***
Total pot €0.02 | Rake €0 
Seat 1: Sium12302 (button) folded before Flop (didn't bet)
Seat 2: criptlux (small blind) folded before Flop
Seat 3: Catania838 (big blind) collected (€0.02)
Seat 4: caduceus369 folded before Flop (didn't bet)
Seat 5: Witness85906 folded before Flop (didn't bet)
Seat 6: Gabrielefante folded before Flop (didn't bet)



PokerStars Zoom Hand #257988332473:  Hold'em No Limit (€0.01/€0.02) [ADM ID: M62BA304494E32ST] - 2025/10/03 23:53:14 CET [2025/10/03 17:53:14 ET]
Table 'Sirio' 6-max Seat #1 is the button
Seat 1: michy0757 (€0.72 in chips) 
Seat 2: cap e'bomb95 (€5.07 in chips) 
Seat 3: ADRIAN0_MEIS (€2.52 in chips) 
Seat 4: Catania838 (€2.34 in chips) 
Seat 5: maury999999 (€3.28 in chips) 
Seat 6: caduceus369 (€1.97 in chips) 
cap e'bomb95: posts small blind €0.01
ADRIAN0_MEIS: posts big blind €0.02
*** HOLE CARDS ***
Dealt to caduceus369 [6c 7d]
Catania838: calls €0.02
maury999999: folds 
caduceus369: folds 
michy0757: raises €0.11 to €0.13
cap e'bomb95: folds 
ADRIAN0_MEIS: folds 
Catania838: folds 
Uncalled bet (€0.11) returned to michy0757
michy0757 collected €0.07 from pot
michy0757: doesn't show hand 
*** SUMMARY ***
Total pot €0.07 | Rake €0 
Seat 1: michy0757 (button) collected (€0.07)
Seat 2: cap e'bomb95 (small blind) folded before Flop
Seat 3: ADRIAN0_MEIS (big blind) folded before Flop
Seat 4: Catania838 folded before Flop
Seat 5: maury999999 folded before Flop (didn't bet)
Seat 6: caduceus369 folded before Flop (didn't bet)



PokerStars Zoom Hand #257988335609:  Hold'em No Limit (€0.01/€0.02) [ADM ID: M62BA304494E32ST] - 2025/10/03 23:53:28 CET [2025/10/03 17:53:28 ET]
Table 'Sirio' 6-max Seat #1 is the button
Seat 1: EasyToRule (€2.58 in chips) 
Seat 2: ADRIAN0_MEIS (€10.26 in chips) 
Seat 3: stfuplzudonk (€2.58 in chips) 
Seat 4: caduceus369 (€1.97 in chips) 
Seat 5: Gabrielefante (€3.20 in chips) 
Seat 6: Witness85906 (€5.25 in chips) 
ADRIAN0_MEIS: posts small blind €0.01
stfuplzudonk: posts big blind €0.02
*** HOLE CARDS ***
Dealt to caduceus369 [9c 5d]
caduceus369: folds 
Gabrielefante: folds 
Witness85906: raises €0.03 to €0.05
EasyToRule: folds 
ADRIAN0_MEIS: calls €0.04
stfuplzudonk: calls €0.03
*** FLOP *** [As 9s 3d]
ADRIAN0_MEIS: checks 
stfuplzudonk: checks 
Witness85906: checks 
*** TURN *** [As 9s 3d] [3s]
ADRIAN0_MEIS: bets €0.11
stfuplzudonk: folds 
Witness85906: folds 
Uncalled bet (€0.11) returned to ADRIAN0_MEIS
ADRIAN0_MEIS collected €0.15 from pot
ADRIAN0_MEIS: doesn't show hand 
*** SUMMARY ***
Total pot €0.15 | Rake €0 
Board [As 9s 3d 3s]
Seat 1: EasyToRule (button) folded before Flop (didn't bet)
Seat 2: ADRIAN0_MEIS (small blind) collected (€0.15)
Seat 3: stfuplzudonk (big blind) folded on the Turn
Seat 4: caduceus369 folded before Flop (didn't bet)
Seat 5: Gabrielefante folded before Flop (didn't bet)
Seat 6: Witness85906 folded on the Turn



PokerStars Zoom Hand #257988336467:  Hold'em No Limit (€0.01/€0.02) [ADM ID: M62BA304494E32ST] - 2025/10/03 23:53:32 CET [2025/10/03 17:53:32 ET]
Table 'Sirio' 6-max Seat #1 is the button
Seat 1: caduceus369 (€1.97 in chips) 
Seat 2: ADRIAN0_MEIS (€2.50 in chips) 
Seat 3: VrDmNl (€1.31 in chips) 
Seat 4: Peru91j (€2.01 in chips) 
Seat 5: tigermiscio (€0.72 in chips) 
Seat 6: fantaasso (€3.13 in chips) 
ADRIAN0_MEIS: posts small blind €0.01
VrDmNl: posts big blind €0.02
*** HOLE CARDS ***
Dealt to caduceus369 [Ah Qs]
Peru91j: folds 
tigermiscio: folds 
fantaasso: folds 
caduceus369: raises €0.04 to €0.06
ADRIAN0_MEIS: folds 
VrDmNl: calls €0.04
*** FLOP *** [9h 9c 2s]
VrDmNl: checks 
caduceus369: checks 
*** TURN *** [9h 9c 2s] [3s]
VrDmNl: bets €0.05
caduceus369: calls €0.05
*** RIVER *** [9h 9c 2s 3s] [2c]
VrDmNl: bets €0.15
caduceus369: calls €0.15
*** SHOW DOWN ***
VrDmNl: shows [Qh Jh] (two pair, Nines and Deuces)
caduceus369: shows [Ah Qs] (two pair, Nines and Deuces - Ace kicker)
caduceus369 collected €0.51 from pot
*** SUMMARY ***
Total pot €0.53 | Rake €0.02 
Board [9h 9c 2s 3s 2c]
Seat 1: caduceus369 (button) showed [Ah Qs] and won (€0.51) with two pair, Nines and Deuces
Seat 2: ADRIAN0_MEIS (small blind) folded before Flop
Seat 3: VrDmNl (big blind) showed [Qh Jh] and lost with two pair, Nines and Deuces
Seat 4: Peru91j folded before Flop (didn't bet)
Seat 5: tigermiscio folded before Flop (didn't bet)
Seat 6: fantaasso folded before Flop (didn't bet)



PokerStars Zoom Hand #257988352078:  Hold'em No Limit (€0.01/€0.02) [ADM ID: M62BA304494E32ST] - 2025/10/03 23:54:40 CET [2025/10/03 17:54:40 ET]
Table 'Sirio' 6-max Seat #1 is the button
Seat 1: criptlux (€2.32 in chips) 
Seat 2: VrDmNl (€1.05 in chips) 
Seat 3: caduceus369 (€2.22 in chips) 
Seat 4: ADRIAN0_MEIS (€2.41 in chips) 
Seat 5: Sium12302 (€6.22 in chips) 
Seat 6: stevalmg (€2.11 in chips) 
VrDmNl: posts small blind €0.01
caduceus369: posts big blind €0.02
*** HOLE CARDS ***
Dealt to caduceus369 [6c 3d]
ADRIAN0_MEIS: folds 
Sium12302: folds 
stevalmg: folds 
criptlux: folds 
VrDmNl: calls €0.01
caduceus369: checks 
*** FLOP *** [Jh Kd Th]
VrDmNl: checks 
caduceus369: checks 
*** TURN *** [Jh Kd Th] [8d]
VrDmNl: checks 
caduceus369: checks 
*** RIVER *** [Jh Kd Th 8d] [4s]
VrDmNl: checks 
caduceus369: checks 
*** SHOW DOWN ***
VrDmNl: shows [7s 5d] (high card King)
caduceus369: mucks hand 
VrDmNl collected €0.04 from pot
*** SUMMARY ***
Total pot €0.04 | Rake €0 
Board [Jh Kd Th 8d 4s]
Seat 1: criptlux (button) folded before Flop (didn't bet)
Seat 2: VrDmNl (small blind) showed [7s 5d] and won (€0.04) with high card King
Seat 3: caduceus369 (big blind) mucked [6c 3d]
Seat 4: ADRIAN0_MEIS folded before Flop (didn't bet)
Seat 5: Sium12302 folded before Flop (didn't bet)
Seat 6: stevalmg folded before Flop (didn't bet)



PokerStars Zoom Hand #257988358234:  Hold'em No Limit (€0.01/€0.02) [ADM ID: M62BA304494E32ST] - 2025/10/03 23:55:10 CET [2025/10/03 17:55:10 ET]
Table 'Sirio' 6-max Seat #1 is the button
Seat 1: VrDmNl (€1.07 in chips) 
Seat 2: caduceus369 (€2.20 in chips) 
Seat 3: Gabrielefante (€3.31 in chips) 
Seat 4: Sium12302 (€6.20 in chips) 
Seat 5: Fengjie82 (€2.67 in chips) 
Seat 6: outshined8 (€0.71 in chips) 
caduceus369: posts small blind €0.01
Gabrielefante: posts big blind €0.02
*** HOLE CARDS ***
Dealt to caduceus369 [Td As]
Sium12302: folds 
Fengjie82: folds 
outshined8: folds 
VrDmNl: folds 
caduceus369: calls €0.01
Gabrielefante: checks 
*** FLOP *** [9c Ad Qc]
caduceus369: checks 
Gabrielefante: checks 
*** TURN *** [9c Ad Qc] [9h]
caduceus369: checks 
Gabrielefante: checks 
*** RIVER *** [9c Ad Qc 9h] [Ts]
caduceus369: bets €0.12
Gabrielefante: folds 
Uncalled bet (€0.12) returned to caduceus369
caduceus369 collected €0.04 from pot
caduceus369: doesn't show hand 
*** SUMMARY ***
Total pot €0.04 | Rake €0 
Board [9c Ad Qc 9h Ts]
Seat 1: VrDmNl (button) folded before Flop (didn't bet)
Seat 2: caduceus369 (small blind) collected (€0.04)
Seat 3: Gabrielefante (big blind) folded on the River
Seat 4: Sium12302 folded before Flop (didn't bet)
Seat 5: Fengjie82 folded before Flop (didn't bet)
Seat 6: outshined8 folded before Flop (didn't bet)



PokerStars Zoom Hand #257988362882:  Hold'em No Limit (€0.01/€0.02) [ADM ID: M62BA304494E32ST] - 2025/10/03 23:55:38 CET [2025/10/03 17:55:38 ET]
Table 'Sirio' 6-max Seat #1 is the button
Seat 1: teicano98 (€0.92 in chips) 
Seat 2: Fengjie82 (€2.65 in chips) 
Seat 3: ADRIAN0_MEIS (€11.58 in chips) 
Seat 4: cap e'bomb95 (€5.03 in chips) 
Seat 5: caduceus369 (€2.22 in chips) 
Seat 6: neoilnervoso (€1.73 in chips) 
Fengjie82: posts small blind €0.01
ADRIAN0_MEIS: posts big blind €0.02
*** HOLE CARDS ***
Dealt to caduceus369 [4h 2s]
cap e'bomb95: folds 
caduceus369: folds 
neoilnervoso: folds 
teicano98: folds 
Fengjie82: folds 
Uncalled bet (€0.01) returned to ADRIAN0_MEIS
ADRIAN0_MEIS collected €0.02 from pot
ADRIAN0_MEIS: doesn't show hand 
*** SUMMARY ***
Total pot €0.02 | Rake €0 
Seat 1: teicano98 (button) folded before Flop (didn't bet)
Seat 2: Fengjie82 (small blind) folded before Flop
Seat 3: ADRIAN0_MEIS (big blind) collected (€0.02)
Seat 4: cap e'bomb95 folded before Flop (didn't bet)
Seat 5: caduceus369 folded before Flop (didn't bet)
Seat 6: neoilnervoso folded before Flop (didn't bet)



PokerStars Zoom Hand #257988363582:  Hold'em No Limit (€0.01/€0.02) [ADM ID: M62BA304494E32ST] - 2025/10/03 23:55:42 CET [2025/10/03 17:55:42 ET]
Table 'Sirio' 6-max Seat #1 is the button
Seat 1: neoilnervoso (€1.73 in chips) 
Seat 2: criptlux (€2.20 in chips) 
Seat 3: fantaasso (€3.30 in chips) 
Seat 4: Sium12302 (€2.03 in chips) 
Seat 5: Catania838 (€2.88 in chips) 
Seat 6: caduceus369 (€2.22 in chips) 
criptlux: posts small blind €0.01
fantaasso: posts big blind €0.02
*** HOLE CARDS ***
Dealt to caduceus369 [Ad 8s]
Sium12302: folds 
Catania838: calls €0.02
caduceus369: folds 
neoilnervoso: folds 
criptlux: folds 
fantaasso: checks 
*** FLOP *** [2s 6d 2d]
fantaasso: checks 
Catania838: bets €0.04
fantaasso: folds 
Uncalled bet (€0.04) returned to Catania838
Catania838 collected €0.05 from pot
Catania838: doesn't show hand 
*** SUMMARY ***
Total pot €0.05 | Rake €0 
Board [2s 6d 2d]
Seat 1: neoilnervoso (button) folded before Flop (didn't bet)
Seat 2: criptlux (small blind) folded before Flop
Seat 3: fantaasso (big blind) folded on the Flop
Seat 4: Sium12302 folded before Flop (didn't bet)
Seat 5: Catania838 collected (€0.05)
Seat 6: caduceus369 folded before Flop (didn't bet)



PokerStars Zoom Hand #257988364570:  Hold'em No Limit (€0.01/€0.02) [ADM ID: M62BA304494E32ST] - 2025/10/03 23:55:48 CET [2025/10/03 17:55:48 ET]
Table 'Sirio' 6-max Seat #1 is the button
Seat 1: CacciatoreAA (€1.45 in chips) 
Seat 2: teicano98 (€0.83 in chips) 
Seat 3: Witness85906 (€5.40 in chips) 
Seat 4: tigermiscio (€0.80 in chips) 
Seat 5: caduceus369 (€2.22 in chips) 
Seat 6: Sium12302 (€2.03 in chips) 
teicano98: posts small blind €0.01
Witness85906: posts big blind €0.02
*** HOLE CARDS ***
Dealt to caduceus369 [Ts Ad]
tigermiscio is disconnected 
tigermiscio has timed out while disconnected
tigermiscio: folds 
caduceus369: raises €0.04 to €0.06
Sium12302: folds 
CacciatoreAA: folds 
teicano98: folds 
Witness85906: folds 
Uncalled bet (€0.04) returned to caduceus369
caduceus369 collected €0.05 from pot
caduceus369: doesn't show hand 
*** SUMMARY ***
Total pot €0.05 | Rake €0 
Seat 1: CacciatoreAA (button) folded before Flop (didn't bet)
Seat 2: teicano98 (small blind) folded before Flop
Seat 3: Witness85906 (big blind) folded before Flop
Seat 4: tigermiscio folded before Flop (didn't bet)
Seat 5: caduceus369 collected (€0.05)
Seat 6: Sium12302 folded before Flop (didn't bet)



PokerStars Zoom Hand #257988368811:  Hold'em No Limit (€0.01/€0.02) [ADM ID: M62BA304494E32ST] - 2025/10/03 23:56:14 CET [2025/10/03 17:56:14 ET]
Table 'Sirio' 6-max Seat #1 is the button
Seat 1: teicano98 (€1.24 in chips) 
Seat 2: outshined8 (€0.93 in chips) 
Seat 3: max24428 (€0.68 in chips) 
Seat 4: caduceus369 (€2.25 in chips) 
Seat 5: Catania838 (€2.03 in chips) 
Seat 6: stfuplzudonk (€2.58 in chips) 
outshined8: posts small blind €0.01
max24428: posts big blind €0.02
*** HOLE CARDS ***
Dealt to caduceus369 [Td Ks]
caduceus369: folds 
Catania838: folds 
stfuplzudonk: folds 
teicano98: folds 
outshined8: calls €0.01
max24428: checks 
*** FLOP *** [5h 7c Kc]
outshined8: bets €0.04
max24428: folds 
Uncalled bet (€0.04) returned to outshined8
outshined8 collected €0.04 from pot
outshined8: doesn't show hand 
*** SUMMARY ***
Total pot €0.04 | Rake €0 
Board [5h 7c Kc]
Seat 1: teicano98 (button) folded before Flop (didn't bet)
Seat 2: outshined8 (small blind) collected (€0.04)
Seat 3: max24428 (big blind) folded on the Flop
Seat 4: caduceus369 folded before Flop (didn't bet)
Seat 5: Catania838 folded before Flop (didn't bet)
Seat 6: stfuplzudonk folded before Flop (didn't bet)



PokerStars Zoom Hand #257988371431:  Hold'em No Limit (€0.01/€0.02) [ADM ID: M62BA304494E32ST] - 2025/10/03 23:56:30 CET [2025/10/03 17:56:30 ET]
Table 'Sirio' 6-max Seat #1 is the button
Seat 1: criptlux (€2.31 in chips) 
Seat 2: caduceus369 (€2.25 in chips) 
Seat 3: Catania838 (€2.03 in chips) 
Seat 4: VrDmNl (€1.20 in chips) 
Seat 5: ADRIAN0_MEIS (€10.49 in chips) 
Seat 6: cesaretto23 (€2.15 in chips) 
caduceus369: posts small blind €0.01
Catania838: posts big blind €0.02
*** HOLE CARDS ***
Dealt to caduceus369 [4d Qc]
VrDmNl: folds 
ADRIAN0_MEIS: folds 
cesaretto23: folds 
criptlux: folds 
caduceus369: folds 
Uncalled bet (€0.01) returned to Catania838
Catania838 collected €0.02 from pot
Catania838: doesn't show hand 
*** SUMMARY ***
Total pot €0.02 | Rake €0 
Seat 1: criptlux (button) folded before Flop (didn't bet)
Seat 2: caduceus369 (small blind) folded before Flop
Seat 3: Catania838 (big blind) collected (€0.02)
Seat 4: VrDmNl folded before Flop (didn't bet)
Seat 5: ADRIAN0_MEIS folded before Flop (didn't bet)
Seat 6: cesaretto23 folded before Flop (didn't bet)



PokerStars Zoom Hand #257988372128:  Hold'em No Limit (€0.01/€0.02) [ADM ID: M62BA304494E32ST] - 2025/10/03 23:56:34 CET [2025/10/03 17:56:34 ET]
Table 'Sirio' 6-max Seat #1 is the button
Seat 1: Rg4bthtbt (€1.91 in chips) 
Seat 2: cap e'bomb95 (€5.11 in chips) 
Seat 3: caduceus369 (€2.24 in chips) 
Seat 4: maury999999 (€3.34 in chips) 
Seat 5: max24428 (€0.66 in chips) 
Seat 6: Patatina8 (€1.71 in chips) 
cap e'bomb95: posts small blind €0.01
caduceus369: posts big blind €0.02
*** HOLE CARDS ***
Dealt to caduceus369 [7d 3s]
maury999999: folds 
max24428: folds 
Patatina8: folds 
Rg4bthtbt: folds 
cap e'bomb95: folds 
Uncalled bet (€0.01) returned to caduceus369
caduceus369 collected €0.02 from pot
caduceus369: doesn't show hand 
*** SUMMARY ***
Total pot €0.02 | Rake €0 
Seat 1: Rg4bthtbt (button) folded before Flop (didn't bet)
Seat 2: cap e'bomb95 (small blind) folded before Flop
Seat 3: caduceus369 (big blind) collected (€0.02)
Seat 4: maury999999 folded before Flop (didn't bet)
Seat 5: max24428 folded before Flop (didn't bet)
Seat 6: Patatina8 folded before Flop (didn't bet)



PokerStars Zoom Hand #257988374762:  Hold'em No Limit (€0.01/€0.02) [ADM ID: M62BA304494E32ST] - 2025/10/03 23:56:51 CET [2025/10/03 17:56:51 ET]
Table 'Sirio' 6-max Seat #1 is the button
Seat 1: caduceus369 (€2.25 in chips) 
Seat 2: neoilnervoso (€1.87 in chips) 
Seat 3: fantaasso (€2.46 in chips) 
Seat 4: michy0757 (€0.80 in chips) 
Seat 5: father2008 (€5.61 in chips) 
Seat 6: ADRIAN0_MEIS (€7.75 in chips) 
neoilnervoso: posts small blind €0.01
fantaasso: posts big blind €0.02
*** HOLE CARDS ***
Dealt to caduceus369 [2h 2d]
michy0757: raises €0.08 to €0.10
father2008: folds 
ADRIAN0_MEIS: folds 
caduceus369: folds 
neoilnervoso: folds 
fantaasso: folds 
Uncalled bet (€0.08) returned to michy0757
michy0757 collected €0.05 from pot
michy0757: doesn't show hand 
*** SUMMARY ***
Total pot €0.05 | Rake €0 
Seat 1: caduceus369 (button) folded before Flop (didn't bet)
Seat 2: neoilnervoso (small blind) folded before Flop
Seat 3: fantaasso (big blind) folded before Flop
Seat 4: michy0757 collected (€0.05)
Seat 5: father2008 folded before Flop (didn't bet)
Seat 6: ADRIAN0_MEIS folded before Flop (didn't bet)



PokerStars Zoom Hand #257988376614:  Hold'em No Limit (€0.01/€0.02) [ADM ID: M62BA304494E32ST] - 2025/10/03 23:57:01 CET [2025/10/03 17:57:01 ET]
Table 'Sirio' 6-max Seat #1 is the button
Seat 1: Catania838 (€2.03 in chips) 
Seat 2: caduceus369 (€2.25 in chips) 
Seat 3: bruciapelo (€1.73 in chips) 
Seat 4: ADRIAN0_MEIS (€12.32 in chips) 
Seat 5: Sium12302 (€6.16 in chips) 
Seat 6: Witness85906 (€5.43 in chips) 
caduceus369: posts small blind €0.01
bruciapelo: posts big blind €0.02
*** HOLE CARDS ***
Dealt to caduceus369 [6c 8d]
ADRIAN0_MEIS: folds 
Sium12302: folds 
Witness85906: raises €0.03 to €0.05
Catania838: folds 
caduceus369: folds 
bruciapelo: folds 
Uncalled bet (€0.03) returned to Witness85906
Witness85906 collected €0.05 from pot
Witness85906: doesn't show hand 
*** SUMMARY ***
Total pot €0.05 | Rake €0 
Seat 1: Catania838 (button) folded before Flop (didn't bet)
Seat 2: caduceus369 (small blind) folded before Flop
Seat 3: bruciapelo (big blind) folded before Flop
Seat 4: ADRIAN0_MEIS folded before Flop (didn't bet)
Seat 5: Sium12302 folded before Flop (didn't bet)
Seat 6: Witness85906 collected (€0.05)



PokerStars Zoom Hand #257988378206:  Hold'em No Limit (€0.01/€0.02) [ADM ID: M62BA304494E32ST] - 2025/10/03 23:57:11 CET [2025/10/03 17:57:11 ET]
Table 'Sirio' 6-max Seat #1 is the button
Seat 1: Sium12302 (€2.01 in chips) 
Seat 2: ADRIAN0_MEIS (€7.75 in chips) 
Seat 3: colosso2022 (€3.08 in chips) 
Seat 4: Patatina8 (€1.75 in chips) 
Seat 5: outshined8 (€1.02 in chips) 
Seat 6: caduceus369 (€2.24 in chips) 
ADRIAN0_MEIS: posts small blind €0.01
colosso2022: posts big blind €0.02
*** HOLE CARDS ***
Dealt to caduceus369 [4d Qh]
Patatina8: folds 
outshined8: folds 
caduceus369: folds 
Sium12302: folds 
ADRIAN0_MEIS: raises €0.02 to €0.04
colosso2022: calls €0.02
*** FLOP *** [7h 3h Qc]
ADRIAN0_MEIS: checks 
colosso2022: checks 
*** TURN *** [7h 3h Qc] [Js]
ADRIAN0_MEIS: checks 
colosso2022: checks 
*** RIVER *** [7h 3h Qc Js] [6c]
ADRIAN0_MEIS: checks 
colosso2022: checks 
*** SHOW DOWN ***
ADRIAN0_MEIS: shows [Ad 9h] (high card Ace)
colosso2022: shows [Tc 6h] (a pair of Sixes)
colosso2022 collected €0.08 from pot
*** SUMMARY ***
Total pot €0.08 | Rake €0 
Board [7h 3h Qc Js 6c]
Seat 1: Sium12302 (button) folded before Flop (didn't bet)
Seat 2: ADRIAN0_MEIS (small blind) showed [Ad 9h] and lost with high card Ace
Seat 3: colosso2022 (big blind) showed [Tc 6h] and won (€0.08) with a pair of Sixes
Seat 4: Patatina8 folded before Flop (didn't bet)
Seat 5: outshined8 folded before Flop (didn't bet)
Seat 6: caduceus369 folded before Flop (didn't bet)



PokerStars Zoom Hand #257988379705:  Hold'em No Limit (€0.01/€0.02) [ADM ID: M62BA304494E32ST] - 2025/10/03 23:57:20 CET [2025/10/03 17:57:20 ET]
Table 'Sirio' 6-max Seat #1 is the button
Seat 1: Davi3231973 (€0.63 in chips) 
Seat 2: ADRIAN0_MEIS (€10.47 in chips) 
Seat 3: CacciatoreAA (€1.46 in chips) 
Seat 4: bruciapelo (€1.71 in chips) 
Seat 5: caduceus369 (€2.24 in chips) 
Seat 6: Fengjie82 (€2.56 in chips) 
ADRIAN0_MEIS: posts small blind €0.01
CacciatoreAA: posts big blind €0.02
*** HOLE CARDS ***
Dealt to caduceus369 [7c 6c]
bruciapelo: raises €0.04 to €0.06
caduceus369: folds 
Fengjie82: folds 
Davi3231973: calls €0.06
ADRIAN0_MEIS: folds 
CacciatoreAA: folds 
*** FLOP *** [Tc Jd 7h]
bruciapelo: bets €0.08
Davi3231973: calls €0.08
*** TURN *** [Tc Jd 7h] [3s]
bruciapelo: bets €0.15
Davi3231973: calls €0.15
*** RIVER *** [Tc Jd 7h 3s] [Qd]
bruciapelo: checks 
Davi3231973: checks 
*** SHOW DOWN ***
bruciapelo: shows [Jh Ac] (a pair of Jacks)
Davi3231973: shows [Qs 9s] (a pair of Queens)
Davi3231973 collected €0.58 from pot
*** SUMMARY ***
Total pot €0.61 | Rake €0.03 
Board [Tc Jd 7h 3s Qd]
Seat 1: Davi3231973 (button) showed [Qs 9s] and won (€0.58) with a pair of Queens
Seat 2: ADRIAN0_MEIS (small blind) folded before Flop
Seat 3: CacciatoreAA (big blind) folded before Flop
Seat 4: bruciapelo showed [Jh Ac] and lost with a pair of Jacks
Seat 5: caduceus369 folded before Flop (didn't bet)
Seat 6: Fengjie82 folded before Flop (didn't bet)



PokerStars Zoom Hand #257988380206:  Hold'em No Limit (€0.01/€0.02) [ADM ID: M62BA304494E32ST] - 2025/10/03 23:57:23 CET [2025/10/03 17:57:23 ET]
Table 'Sirio' 6-max Seat #1 is the button
Seat 1: criptlux (€2.17 in chips) 
Seat 2: CIKO71131 (€0.78 in chips) 
Seat 3: caduceus369 (€2.24 in chips) 
Seat 4: franky65124 (€1.30 in chips) 
Seat 5: Sium12302 (€2.01 in chips) 
Seat 6: stfuplzudonk (€2.05 in chips) 
CIKO71131: posts small blind €0.01
caduceus369: posts big blind €0.02
*** HOLE CARDS ***
Dealt to caduceus369 [Ah 7h]
franky65124: calls €0.02
Sium12302: folds 
stfuplzudonk: folds 
criptlux: folds 
CIKO71131: calls €0.01
caduceus369: checks 
*** FLOP *** [Qc 6s 3d]
CIKO71131: checks 
caduceus369: checks 
franky65124: bets €0.02
CIKO71131: calls €0.02
caduceus369: folds 
*** TURN *** [Qc 6s 3d] [Jc]
CIKO71131: checks 
franky65124: bets €0.04
CIKO71131: calls €0.04
*** RIVER *** [Qc 6s 3d Jc] [Js]
CIKO71131: checks 
franky65124: checks 
*** SHOW DOWN ***
CIKO71131: shows [Ac Ts] (a pair of Jacks)
franky65124: shows [Qd 9h] (two pair, Queens and Jacks)
franky65124 collected €0.18 from pot
*** SUMMARY ***
Total pot €0.18 | Rake €0 
Board [Qc 6s 3d Jc Js]
Seat 1: criptlux (button) folded before Flop (didn't bet)
Seat 2: CIKO71131 (small blind) showed [Ac Ts] and lost with a pair of Jacks
Seat 3: caduceus369 (big blind) folded on the Flop
Seat 4: franky65124 showed [Qd 9h] and won (€0.18) with two pair, Queens and Jacks
Seat 5: Sium12302 folded before Flop (didn't bet)
Seat 6: stfuplzudonk folded before Flop (didn't bet)



PokerStars Zoom Hand #257988390536:  Hold'em No Limit (€0.01/€0.02) [ADM ID: M62BA304494E32ST] - 2025/10/03 23:58:23 CET [2025/10/03 17:58:23 ET]
Table 'Sirio' 6-max Seat #1 is the button
Seat 1: caduceus369 (€2.22 in chips) 
Seat 2: fantaasso (€3.59 in chips) 
Seat 3: Catania838 (€2.71 in chips) 
Seat 4: ADRIAN0_MEIS (€3.12 in chips) 
Seat 5: Peru91j (€3.25 in chips) 
Seat 6: Asganaway123 (€2.01 in chips) 
fantaasso: posts small blind €0.01
Catania838: posts big blind €0.02
*** HOLE CARDS ***
Dealt to caduceus369 [4h Ks]
ADRIAN0_MEIS: folds 
Peru91j: raises €0.04 to €0.06
Asganaway123: calls €0.06
caduceus369: folds 
fantaasso: folds 
Catania838: folds 
*** FLOP *** [5c 9h Jd]
Peru91j: bets €0.08
Asganaway123: calls €0.08
*** TURN *** [5c 9h Jd] [6c]
Peru91j: checks 
Asganaway123: bets €0.16
Peru91j: folds 
Uncalled bet (€0.16) returned to Asganaway123
Asganaway123 collected €0.30 from pot
Asganaway123: doesn't show hand 
*** SUMMARY ***
Total pot €0.31 | Rake €0.01 
Board [5c 9h Jd 6c]
Seat 1: caduceus369 (button) folded before Flop (didn't bet)
Seat 2: fantaasso (small blind) folded before Flop
Seat 3: Catania838 (big blind) folded before Flop
Seat 4: ADRIAN0_MEIS folded before Flop (didn't bet)
Seat 5: Peru91j folded on the Turn
Seat 6: Asganaway123 collected (€0.30)



PokerStars Zoom Hand #257988394519:  Hold'em No Limit (€0.01/€0.02) [ADM ID: M62BA304494E32ST] - 2025/10/03 23:58:47 CET [2025/10/03 17:58:47 ET]
Table 'Sirio' 6-max Seat #1 is the button
Seat 1: michy0757 (€0.96 in chips) 
Seat 2: stfuplzudonk (€1.93 in chips) 
Seat 3: Catania838 (€1.50 in chips) 
Seat 4: caduceus369 (€2.22 in chips) 
Seat 5: fantaasso (€3.15 in chips) 
Seat 6: Sium12302 (€6.11 in chips) 
stfuplzudonk: posts small blind €0.01
Catania838: posts big blind €0.02
*** HOLE CARDS ***
Dealt to caduceus369 [Jd Jh]
caduceus369: raises €0.04 to €0.06
fantaasso: folds 
Sium12302: folds 
michy0757: raises €0.12 to €0.18
stfuplzudonk: folds 
Catania838: folds 
caduceus369: calls €0.12
*** FLOP *** [3h 2d 3d]
caduceus369: checks 
michy0757: bets €0.19
caduceus369: raises €0.39 to €0.58
michy0757: calls €0.39
*** TURN *** [3h 2d 3d] [Kh]
caduceus369: checks 
michy0757: checks 
*** RIVER *** [3h 2d 3d Kh] [2s]
caduceus369: bets €0.74
michy0757: calls €0.20 and is all-in
Uncalled bet (€0.54) returned to caduceus369
*** SHOW DOWN ***
caduceus369: shows [Jd Jh] (two pair, Jacks and Threes)
michy0757: shows [Qs Qd] (two pair, Queens and Threes)
michy0757 collected €1.85 from pot
*** SUMMARY ***
Total pot €1.95 | Rake €0.10 
Board [3h 2d 3d Kh 2s]
Seat 1: michy0757 (button) showed [Qs Qd] and won (€1.85) with two pair, Queens and Threes
Seat 2: stfuplzudonk (small blind) folded before Flop
Seat 3: Catania838 (big blind) folded before Flop
Seat 4: caduceus369 showed [Jd Jh] and lost with two pair, Jacks and Threes
Seat 5: fantaasso folded before Flop (didn't bet)
Seat 6: Sium12302 folded before Flop (didn't bet)



PokerStars Zoom Hand #257988393940:  Hold'em No Limit (€0.01/€0.02) [ADM ID: M62BA304494E32ST] - 2025/10/03 23:58:44 CET [2025/10/03 17:58:44 ET]
Table 'Sirio' 6-max Seat #1 is the button
Seat 1: CIKO71131 (€0.70 in chips) 
Seat 2: franky65124 (€1.40 in chips) 
Seat 3: father2008 (€4.66 in chips) 
Seat 4: Catania838 (€1.50 in chips) 
Seat 5: caduceus369 (€2.22 in chips) 
Seat 6: criptlux (€2.13 in chips) 
franky65124: posts small blind €0.01
father2008: posts big blind €0.02
*** HOLE CARDS ***
Dealt to caduceus369 [2h 6c]
Catania838: folds 
caduceus369: folds 
criptlux: folds 
CIKO71131: calls €0.02
franky65124: calls €0.01
father2008: checks 
*** FLOP *** [Ah 5h As]
franky65124: checks 
father2008: checks 
CIKO71131: checks 
*** TURN *** [Ah 5h As] [7d]
franky65124: checks 
father2008: checks 
CIKO71131: checks 
*** RIVER *** [Ah 5h As 7d] [8c]
franky65124: checks 
father2008: checks 
CIKO71131: checks 
*** SHOW DOWN ***
franky65124: shows [3d Tc] (a pair of Aces)
father2008: shows [Td 3s] (a pair of Aces)
CIKO71131: shows [Kc 9c] (a pair of Aces - King kicker)
CIKO71131 collected €0.06 from pot
*** SUMMARY ***
Total pot €0.06 | Rake €0 
Board [Ah 5h As 7d 8c]
Seat 1: CIKO71131 (button) showed [Kc 9c] and won (€0.06) with a pair of Aces
Seat 2: franky65124 (small blind) showed [3d Tc] and lost with a pair of Aces
Seat 3: father2008 (big blind) showed [Td 3s] and lost with a pair of Aces
Seat 4: Catania838 folded before Flop (didn't bet)
Seat 5: caduceus369 folded before Flop (didn't bet)
Seat 6: criptlux folded before Flop (didn't bet)



PokerStars Zoom Hand #257988392050:  Hold'em No Limit (€0.01/€0.02) [ADM ID: M62BA304494E32ST] - 2025/10/03 23:58:32 CET [2025/10/03 17:58:32 ET]
Table 'Sirio' 6-max Seat #1 is the button
Seat 1: Adamo55222 (€0.86 in chips) 
Seat 2: IsyP99 (€0.74 in chips) 
Seat 3: fantaasso (€3.58 in chips) 
Seat 4: outshined8 (€1.22 in chips) 
Seat 5: ADRIAN0_MEIS (€12.29 in chips) 
Seat 6: caduceus369 (€2.22 in chips) 
IsyP99: posts small blind €0.01
fantaasso: posts big blind €0.02
*** HOLE CARDS ***
Dealt to caduceus369 [3h Th]
outshined8: raises €0.02 to €0.04
ADRIAN0_MEIS: calls €0.04
caduceus369: folds 
Adamo55222: calls €0.04
IsyP99: folds 
fantaasso: calls €0.02
*** FLOP *** [7s 6c 9c]
fantaasso: checks 
outshined8: checks 
ADRIAN0_MEIS: checks 
Adamo55222: checks 
*** TURN *** [7s 6c 9c] [9h]
fantaasso: checks 
outshined8: checks 
ADRIAN0_MEIS: checks 
Adamo55222: checks 
*** RIVER *** [7s 6c 9c 9h] [8c]
fantaasso: checks 
outshined8: checks 
ADRIAN0_MEIS: bets €0.13
Adamo55222: folds 
fantaasso: folds 
outshined8: folds 
Uncalled bet (€0.13) returned to ADRIAN0_MEIS
ADRIAN0_MEIS collected €0.17 from pot
ADRIAN0_MEIS: doesn't show hand 
*** SUMMARY ***
Total pot €0.17 | Rake €0 
Board [7s 6c 9c 9h 8c]
Seat 1: Adamo55222 (button) folded on the River
Seat 2: IsyP99 (small blind) folded before Flop
Seat 3: fantaasso (big blind) folded on the River
Seat 4: outshined8 folded on the River
Seat 5: ADRIAN0_MEIS collected (€0.17)
Seat 6: caduceus369 folded before Flop (didn't bet)



PokerStars Zoom Hand #257988401633:  Hold'em No Limit (€0.01/€0.02) [ADM ID: M62BA304494E32ST] - 2025/10/03 23:59:29 CET [2025/10/03 17:59:29 ET]
Table 'Sirio' 6-max Seat #1 is the button
Seat 1: ADRIAN0_MEIS (€10.35 in chips) 
Seat 2: father2008 (€4.64 in chips) 
Seat 3: EasyToRule (€2.52 in chips) 
Seat 4: macchia1010 (€0.33 in chips) 
Seat 5: cap e'bomb95 (€3.93 in chips) 
Seat 6: caduceus369 (€1.26 in chips) 
father2008: posts small blind €0.01
EasyToRule: posts big blind €0.02
*** HOLE CARDS ***
Dealt to caduceus369 [4h 4d]
macchia1010: calls €0.02
cap e'bomb95: folds 
caduceus369: calls €0.02
ADRIAN0_MEIS: raises €0.09 to €0.11
father2008: folds 
EasyToRule: folds 
macchia1010: calls €0.09
caduceus369: folds 
*** FLOP *** [Ah 9c 9h]
macchia1010: checks 
ADRIAN0_MEIS: bets €0.20
macchia1010: folds 
Uncalled bet (€0.20) returned to ADRIAN0_MEIS
ADRIAN0_MEIS collected €0.26 from pot
ADRIAN0_MEIS: doesn't show hand 
*** SUMMARY ***
Total pot €0.27 | Rake €0.01 
Board [Ah 9c 9h]
Seat 1: ADRIAN0_MEIS (button) collected (€0.26)
Seat 2: father2008 (small blind) folded before Flop
Seat 3: EasyToRule (big blind) folded before Flop
Seat 4: macchia1010 folded on the Flop
Seat 5: cap e'bomb95 folded before Flop (didn't bet)
Seat 6: caduceus369 folded before Flop



PokerStars Zoom Hand #257988405253:  Hold'em No Limit (€0.01/€0.02) [ADM ID: M62BA304494E32ST] - 2025/10/03 23:59:51 CET [2025/10/03 17:59:51 ET]
Table 'Sirio' 6-max Seat #1 is the button
Seat 1: CacciatoreAA (€3.28 in chips) 
Seat 2: caduceus369 (€1.24 in chips) 
Seat 3: cap e'bomb95 (€3.93 in chips) 
Seat 4: CIKO71131 (€0.74 in chips) 
Seat 5: ADRIAN0_MEIS (€12.42 in chips) 
Seat 6: Catania838 (€2.03 in chips) 
caduceus369: posts small blind €0.01
cap e'bomb95: posts big blind €0.02
*** HOLE CARDS ***
Dealt to caduceus369 [Ac 8h]
CIKO71131: folds 
ADRIAN0_MEIS: folds 
Catania838: folds 
CacciatoreAA: folds 
caduceus369: folds 
Uncalled bet (€0.01) returned to cap e'bomb95
cap e'bomb95 collected €0.02 from pot
cap e'bomb95: doesn't show hand 
*** SUMMARY ***
Total pot €0.02 | Rake €0 
Seat 1: CacciatoreAA (button) folded before Flop (didn't bet)
Seat 2: caduceus369 (small blind) folded before Flop
Seat 3: cap e'bomb95 (big blind) collected (€0.02)
Seat 4: CIKO71131 folded before Flop (didn't bet)
Seat 5: ADRIAN0_MEIS folded before Flop (didn't bet)
Seat 6: Catania838 folded before Flop (didn't bet)



PokerStars Zoom Hand #257988406328:  Hold'em No Limit (€0.01/€0.02) [ADM ID: M62BA304494E32ST] - 2025/10/03 23:59:57 CET [2025/10/03 17:59:57 ET]
Table 'Sirio' 6-max Seat #1 is the button
Seat 1: criptlux (€2.16 in chips) 
Seat 2: Catania838 (€2.03 in chips) 
Seat 3: caduceus369 (€1.23 in chips) 
Seat 4: EasyToRule (€2.49 in chips) 
Seat 5: CIKO71131 (€0.54 in chips) 
Seat 6: trillycata (€0.77 in chips) 
Catania838: posts small blind €0.01
caduceus369: posts big blind €0.02
*** HOLE CARDS ***
Dealt to caduceus369 [9d Kd]
EasyToRule: folds 
CIKO71131: folds 
trillycata: folds 
criptlux: folds 
Catania838: folds 
Uncalled bet (€0.01) returned to caduceus369
caduceus369 collected €0.02 from pot
caduceus369: doesn't show hand 
*** SUMMARY ***
Total pot €0.02 | Rake €0 
Seat 1: criptlux (button) folded before Flop (didn't bet)
Seat 2: Catania838 (small blind) folded before Flop
Seat 3: caduceus369 (big blind) collected (€0.02)
Seat 4: EasyToRule folded before Flop (didn't bet)
Seat 5: CIKO71131 folded before Flop (didn't bet)
Seat 6: trillycata folded before Flop (didn't bet)



PokerStars Zoom Hand #257988408784:  Hold'em No Limit (€0.01/€0.02) [ADM ID: M62BA304494E32ST] - 2025/10/04 0:00:11 CET [2025/10/03 18:00:11 ET]
Table 'Sirio' 6-max Seat #1 is the button
Seat 1: caduceus369 (€1.24 in chips) 
Seat 2: VrDmNl (€1.45 in chips) 
Seat 3: father2008 (€5.46 in chips) 
Seat 4: ADRIAN0_MEIS (€3.15 in chips) 
Seat 5: EasyToRule (€2.49 in chips) 
Seat 6: Asganaway123 (€1.95 in chips) 
VrDmNl: posts small blind €0.01
father2008: posts big blind €0.02
*** HOLE CARDS ***
Dealt to caduceus369 [3d Kd]
ADRIAN0_MEIS: folds 
EasyToRule: raises €0.04 to €0.06
Asganaway123: folds 
caduceus369: folds 
VrDmNl: folds 
father2008: folds 
Uncalled bet (€0.04) returned to EasyToRule
EasyToRule collected €0.05 from pot
EasyToRule: doesn't show hand 
*** SUMMARY ***
Total pot €0.05 | Rake €0 
Seat 1: caduceus369 (button) folded before Flop (didn't bet)
Seat 2: VrDmNl (small blind) folded before Flop
Seat 3: father2008 (big blind) folded before Flop
Seat 4: ADRIAN0_MEIS folded before Flop (didn't bet)
Seat 5: EasyToRule collected (€0.05)
Seat 6: Asganaway123 folded before Flop (didn't bet)



PokerStars Zoom Hand #257988410635:  Hold'em No Limit (€0.01/€0.02) [ADM ID: M62BA304494E32ST] - 2025/10/04 0:00:22 CET [2025/10/03 18:00:22 ET]
Table 'Sirio' 6-max Seat #1 is the button
Seat 1: criptlux (€2.16 in chips) 
Seat 2: fantaasso (€3.40 in chips) 
Seat 3: Ceribelli1705 (€0.65 in chips) 
Seat 4: caduceus369 (€1.24 in chips) 
Seat 5: colosso2022 (€3.04 in chips) 
Seat 6: ADRIAN0_MEIS (€7.64 in chips) 
fantaasso: posts small blind €0.01
Ceribelli1705: posts big blind €0.02
*** HOLE CARDS ***
Dealt to caduceus369 [7d 4c]
caduceus369: folds 
colosso2022: raises €0.02 to €0.04
ADRIAN0_MEIS: folds 
criptlux: folds 
fantaasso: folds 
Ceribelli1705: folds 
Uncalled bet (€0.02) returned to colosso2022
colosso2022 collected €0.05 from pot
colosso2022: doesn't show hand 
*** SUMMARY ***
Total pot €0.05 | Rake €0 
Seat 1: criptlux (button) folded before Flop (didn't bet)
Seat 2: fantaasso (small blind) folded before Flop
Seat 3: Ceribelli1705 (big blind) folded before Flop
Seat 4: caduceus369 folded before Flop (didn't bet)
Seat 5: colosso2022 collected (€0.05)
Seat 6: ADRIAN0_MEIS folded before Flop (didn't bet)



PokerStars Zoom Hand #257988413040:  Hold'em No Limit (€0.01/€0.02) [ADM ID: M62BA304494E32ST] - 2025/10/04 0:00:35 CET [2025/10/03 18:00:35 ET]
Table 'Sirio' 6-max Seat #1 is the button
Seat 1: CIKO71131 (€0.53 in chips) 
Seat 2: Witness85906 (€5.12 in chips) 
Seat 3: CacciatoreAA (€3.28 in chips) 
Seat 4: fantaasso (€3.48 in chips) 
Seat 5: macchia1010 (€0.20 in chips) 
Seat 6: caduceus369 (€1.24 in chips) 
Witness85906: posts small blind €0.01
CacciatoreAA: posts big blind €0.02
*** HOLE CARDS ***
Dealt to caduceus369 [Qc Jh]
fantaasso: folds 
macchia1010: folds 
caduceus369: raises €0.04 to €0.06
CIKO71131: folds 
Witness85906: folds 
CacciatoreAA: folds 
Uncalled bet (€0.04) returned to caduceus369
caduceus369 collected €0.05 from pot
caduceus369: doesn't show hand 
*** SUMMARY ***
Total pot €0.05 | Rake €0 
Seat 1: CIKO71131 (button) folded before Flop (didn't bet)
Seat 2: Witness85906 (small blind) folded before Flop
Seat 3: CacciatoreAA (big blind) folded before Flop
Seat 4: fantaasso folded before Flop (didn't bet)
Seat 5: macchia1010 folded before Flop (didn't bet)
Seat 6: caduceus369 collected (€0.05)



PokerStars Zoom Hand #257988409696:  Hold'em No Limit (€0.01/€0.02) [ADM ID: M62BA304494E32ST] - 2025/10/04 0:00:17 CET [2025/10/03 18:00:17 ET]
Table 'Sirio' 6-max Seat #1 is the button
Seat 1: franky65124 (€1.30 in chips) 
Seat 2: ADRIAN0_MEIS (€12.40 in chips) 
Seat 3: trillycata (€0.77 in chips) 
Seat 4: fantaasso (€3.40 in chips) 
Seat 5: caduceus369 (€1.24 in chips) 
Seat 6: IsyP99 (€0.74 in chips) 
ADRIAN0_MEIS: posts small blind €0.01
trillycata: posts big blind €0.02
*** HOLE CARDS ***
Dealt to caduceus369 [2h Qc]
fantaasso: folds 
caduceus369: folds 
IsyP99: calls €0.02
franky65124: calls €0.02
ADRIAN0_MEIS: calls €0.01
trillycata: checks 
*** FLOP *** [2d 6s 3s]
ADRIAN0_MEIS: checks 
trillycata: checks 
IsyP99: checks 
franky65124: checks 
*** TURN *** [2d 6s 3s] [Jc]
ADRIAN0_MEIS: checks 
trillycata: bets €0.04
IsyP99: folds 
franky65124: folds 
ADRIAN0_MEIS: folds 
Uncalled bet (€0.04) returned to trillycata
trillycata collected €0.08 from pot
trillycata: doesn't show hand 
*** SUMMARY ***
Total pot €0.08 | Rake €0 
Board [2d 6s 3s Jc]
Seat 1: franky65124 (button) folded on the Turn
Seat 2: ADRIAN0_MEIS (small blind) folded on the Turn
Seat 3: trillycata (big blind) collected (€0.08)
Seat 4: fantaasso folded before Flop (didn't bet)
Seat 5: caduceus369 folded before Flop (didn't bet)
Seat 6: IsyP99 folded on the Turn



PokerStars Zoom Hand #257988418240:  Hold'em No Limit (€0.01/€0.02) [ADM ID: M62BA304494E32ST] - 2025/10/04 0:01:00 CET [2025/10/03 18:01:00 ET]
Table 'Sirio' 6-max Seat #1 is the button
Seat 1: cap e'bomb95 (€1.24 in chips) 
Seat 2: colosso2022 (€3.05 in chips) 
Seat 3: caduceus369 (€2 in chips) 
Seat 4: fantaasso (€3.39 in chips) 
Seat 5: Peru91j (€2.40 in chips) 
Seat 6: xxcash88 (€2.06 in chips) 
colosso2022: posts small blind €0.01
caduceus369: posts big blind €0.02
*** HOLE CARDS ***
Dealt to caduceus369 [7s 8h]
fantaasso: folds 
Peru91j: folds 
xxcash88: raises €0.04 to €0.06
cap e'bomb95: folds 
colosso2022: calls €0.05
caduceus369: folds 
*** FLOP *** [Th 4d 9h]
colosso2022: bets €0.14
xxcash88: calls €0.14
*** TURN *** [Th 4d 9h] [8s]
colosso2022: bets €0.40
xxcash88: folds 
Uncalled bet (€0.40) returned to colosso2022
colosso2022 collected €0.40 from pot
colosso2022: doesn't show hand 
*** SUMMARY ***
Total pot €0.42 | Rake €0.02 
Board [Th 4d 9h 8s]
Seat 1: cap e'bomb95 (button) folded before Flop (didn't bet)
Seat 2: colosso2022 (small blind) collected (€0.40)
Seat 3: caduceus369 (big blind) folded before Flop
Seat 4: fantaasso folded before Flop (didn't bet)
Seat 5: Peru91j folded before Flop (didn't bet)
Seat 6: xxcash88 folded on the Turn



PokerStars Zoom Hand #257988422086:  Hold'em No Limit (€0.01/€0.02) [ADM ID: M62BA304494E32ST] - 2025/10/04 0:01:20 CET [2025/10/03 18:01:20 ET]
Table 'Sirio' 6-max Seat #1 is the button
Seat 1: fantaasso (€3.45 in chips) 
Seat 2: caduceus369 (€1.98 in chips) 
Seat 3: ADRIAN0_MEIS (€10.34 in chips) 
Seat 4: cap e'bomb95 (€1.23 in chips) 
Seat 5: father2008 (€5.39 in chips) 
Seat 6: Freddy15081988 (€0.09 in chips) 
caduceus369: posts small blind €0.01
ADRIAN0_MEIS: posts big blind €0.02
*** HOLE CARDS ***
Dealt to caduceus369 [7d 7s]
cap e'bomb95: folds 
father2008: folds 
Freddy15081988: folds 
fantaasso: folds 
caduceus369: calls €0.01
ADRIAN0_MEIS: checks 
*** FLOP *** [As Qs 8h]
caduceus369: checks 
ADRIAN0_MEIS: checks 
*** TURN *** [As Qs 8h] [3h]
caduceus369: bets €0.02
ADRIAN0_MEIS: raises €0.04 to €0.06
caduceus369: folds 
Uncalled bet (€0.04) returned to ADRIAN0_MEIS
ADRIAN0_MEIS collected €0.08 from pot
ADRIAN0_MEIS: doesn't show hand 
*** SUMMARY ***
Total pot €0.08 | Rake €0 
Board [As Qs 8h 3h]
Seat 1: fantaasso (button) folded before Flop (didn't bet)
Seat 2: caduceus369 (small blind) folded on the Turn
Seat 3: ADRIAN0_MEIS (big blind) collected (€0.08)
Seat 4: cap e'bomb95 folded before Flop (didn't bet)
Seat 5: father2008 folded before Flop (didn't bet)
Seat 6: Freddy15081988 folded before Flop (didn't bet)



PokerStars Zoom Hand #257988428102:  Hold'em No Limit (€0.01/€0.02) [ADM ID: M62BA304494E32ST] - 2025/10/04 0:01:48 CET [2025/10/03 18:01:48 ET]
Table 'Sirio' 6-max Seat #1 is the button
Seat 1: caduceus369 (€1.94 in chips) 
Seat 2: fantaasso (€3.43 in chips) 
Seat 3: Catania838 (€1.65 in chips) 
Seat 4: Patatina8 (€1.29 in chips) 
Seat 5: Davi3231973 (€0.96 in chips) 
Seat 6: colosso2022 (€3.25 in chips) 
fantaasso: posts small blind €0.01
Catania838: posts big blind €0.02
*** HOLE CARDS ***
Dealt to caduceus369 [As 6c]
Patatina8: folds 
Davi3231973: folds 
colosso2022: calls €0.02
caduceus369: folds 
fantaasso: folds 
Catania838: checks 
*** FLOP *** [Jd Ah 5s]
Catania838: checks 
colosso2022: checks 
*** TURN *** [Jd Ah 5s] [Jc]
Catania838: checks 
colosso2022: checks 
*** RIVER *** [Jd Ah 5s Jc] [2s]
Catania838: checks 
colosso2022: checks 
*** SHOW DOWN ***
Catania838: shows [7s Th] (a pair of Jacks)
colosso2022: shows [2h Qc] (two pair, Jacks and Deuces)
colosso2022 collected €0.05 from pot
*** SUMMARY ***
Total pot €0.05 | Rake €0 
Board [Jd Ah 5s Jc 2s]
Seat 1: caduceus369 (button) folded before Flop (didn't bet)
Seat 2: fantaasso (small blind) folded before Flop
Seat 3: Catania838 (big blind) showed [7s Th] and lost with a pair of Jacks
Seat 4: Patatina8 folded before Flop (didn't bet)
Seat 5: Davi3231973 folded before Flop (didn't bet)
Seat 6: colosso2022 showed [2h Qc] and won (€0.05) with two pair, Jacks and Deuces



PokerStars Zoom Hand #257988432088:  Hold'em No Limit (€0.01/€0.02) [ADM ID: M62BA304494E32ST] - 2025/10/04 0:02:06 CET [2025/10/03 18:02:06 ET]
Table 'Sirio' 6-max Seat #1 is the button
Seat 1: fantaasso (€3.42 in chips) 
Seat 2: criptlux (€2.13 in chips) 
Seat 3: cap e'bomb95 (€5.41 in chips) 
Seat 4: caduceus369 (€1.94 in chips) 
Seat 5: Catania838 (€1.75 in chips) 
Seat 6: father2008 (€5.41 in chips) 
criptlux: posts small blind €0.01
cap e'bomb95: posts big blind €0.02
*** HOLE CARDS ***
Dealt to caduceus369 [Qs Jc]
caduceus369: calls €0.02
Catania838: raises €0.02 to €0.04
father2008: folds 
fantaasso: folds 
criptlux: folds 
cap e'bomb95: calls €0.02
caduceus369: calls €0.02
*** FLOP *** [2d 2c 5s]
cap e'bomb95: checks 
caduceus369: checks 
Catania838: bets €0.07
cap e'bomb95: calls €0.07
caduceus369: folds 
*** TURN *** [2d 2c 5s] [Qh]
cap e'bomb95: checks 
Catania838: bets €0.13
cap e'bomb95: calls €0.13
*** RIVER *** [2d 2c 5s Qh] [Ks]
cap e'bomb95: checks 
Catania838: bets €0.26
cap e'bomb95: folds 
Uncalled bet (€0.26) returned to Catania838
Catania838 collected €0.51 from pot
Catania838: doesn't show hand 
*** SUMMARY ***
Total pot €0.53 | Rake €0.02 
Board [2d 2c 5s Qh Ks]
Seat 1: fantaasso (button) folded before Flop (didn't bet)
Seat 2: criptlux (small blind) folded before Flop
Seat 3: cap e'bomb95 (big blind) folded on the River
Seat 4: caduceus369 folded on the Flop
Seat 5: Catania838 collected (€0.51)
Seat 6: father2008 folded before Flop (didn't bet)



PokerStars Zoom Hand #257988441769:  Hold'em No Limit (€0.01/€0.02) [ADM ID: M62BA304494E32ST] - 2025/10/04 0:02:51 CET [2025/10/03 18:02:51 ET]
Table 'Sirio' 6-max Seat #1 is the button
Seat 1: ADRIAN0_MEIS (€12.24 in chips) 
Seat 2: bruciapelo (€1.17 in chips) 
Seat 3: Catania838 (€1.60 in chips) 
Seat 4: Peru91j (€2.42 in chips) 
Seat 5: robertoH2O (€2 in chips) 
Seat 6: caduceus369 (€1.89 in chips) 
bruciapelo: posts small blind €0.01
Catania838: posts big blind €0.02
*** HOLE CARDS ***
Dealt to caduceus369 [3h Ts]
Peru91j: folds 
robertoH2O: folds 
caduceus369: folds 
ADRIAN0_MEIS: folds 
bruciapelo: folds 
Uncalled bet (€0.01) returned to Catania838
Catania838 collected €0.02 from pot
Catania838: doesn't show hand 
*** SUMMARY ***
Total pot €0.02 | Rake €0 
Seat 1: ADRIAN0_MEIS (button) folded before Flop (didn't bet)
Seat 2: bruciapelo (small blind) folded before Flop
Seat 3: Catania838 (big blind) collected (€0.02)
Seat 4: Peru91j folded before Flop (didn't bet)
Seat 5: robertoH2O folded before Flop (didn't bet)
Seat 6: caduceus369 folded before Flop (didn't bet)



PokerStars Zoom Hand #257988439818:  Hold'em No Limit (€0.01/€0.02) [ADM ID: M62BA304494E32ST] - 2025/10/04 0:02:42 CET [2025/10/03 18:02:42 ET]
Table 'Sirio' 6-max Seat #1 is the button
Seat 1: Catania838 (€1.63 in chips) 
Seat 2: caduceus369 (€1.90 in chips) 
Seat 3: Ceribelli1705 (€1.15 in chips) 
Seat 4: cap e'bomb95 (€3.86 in chips) 
Seat 5: father2008 (€4.45 in chips) 
Seat 6: robertoH2O (€2 in chips) 
caduceus369: posts small blind €0.01
Ceribelli1705: posts big blind €0.02
*** HOLE CARDS ***
Dealt to caduceus369 [Qs 7c]
cap e'bomb95: folds 
father2008: raises €0.05 to €0.07
robertoH2O: folds 
Catania838: folds 
caduceus369: folds 
Ceribelli1705: calls €0.05
*** FLOP *** [6s 9c 4d]
Ceribelli1705: checks 
father2008: checks 
*** TURN *** [6s 9c 4d] [5c]
Ceribelli1705: checks 
father2008: checks 
*** RIVER *** [6s 9c 4d 5c] [Tc]
Ceribelli1705: checks 
father2008: checks 
*** SHOW DOWN ***
Ceribelli1705: shows [7d As] (high card Ace)
father2008: shows [Ac Kh] (high card Ace - King kicker)
father2008 collected €0.15 from pot
*** SUMMARY ***
Total pot €0.15 | Rake €0 
Board [6s 9c 4d 5c Tc]
Seat 1: Catania838 (button) folded before Flop (didn't bet)
Seat 2: caduceus369 (small blind) folded before Flop
Seat 3: Ceribelli1705 (big blind) showed [7d As] and lost with high card Ace
Seat 4: cap e'bomb95 folded before Flop (didn't bet)
Seat 5: father2008 showed [Ac Kh] and won (€0.15) with high card Ace
Seat 6: robertoH2O folded before Flop (didn't bet)



PokerStars Zoom Hand #257988443762:  Hold'em No Limit (€0.01/€0.02) [ADM ID: M62BA304494E32ST] - 2025/10/04 0:03:00 CET [2025/10/03 18:03:00 ET]
Table 'Sirio' 6-max Seat #1 is the button
Seat 1: neoilnervoso (€1.50 in chips) 
Seat 2: Fengjie82 (€2.94 in chips) 
Seat 3: CacciatoreAA (€3.13 in chips) 
Seat 4: outshined8 (€1.15 in chips) 
Seat 5: caduceus369 (€1.89 in chips) 
Seat 6: ADRIAN0_MEIS (€12.24 in chips) 
Fengjie82: posts small blind €0.01
CacciatoreAA: posts big blind €0.02
*** HOLE CARDS ***
Dealt to caduceus369 [Qd 9s]
outshined8: folds 
caduceus369: folds 
ADRIAN0_MEIS: folds 
neoilnervoso: folds 
Fengjie82: raises €0.02 to €0.04
CacciatoreAA: folds 
Uncalled bet (€0.02) returned to Fengjie82
Fengjie82 collected €0.04 from pot
Fengjie82: doesn't show hand 
*** SUMMARY ***
Total pot €0.04 | Rake €0 
Seat 1: neoilnervoso (button) folded before Flop (didn't bet)
Seat 2: Fengjie82 (small blind) collected (€0.04)
Seat 3: CacciatoreAA (big blind) folded before Flop
Seat 4: outshined8 folded before Flop (didn't bet)
Seat 5: caduceus369 folded before Flop (didn't bet)
Seat 6: ADRIAN0_MEIS folded before Flop (didn't bet)



PokerStars Zoom Hand #257988445211:  Hold'em No Limit (€0.01/€0.02) [ADM ID: M62BA304494E32ST] - 2025/10/04 0:03:07 CET [2025/10/03 18:03:07 ET]
Table 'Sirio' 6-max Seat #1 is the button
Seat 1: criptlux (€2.25 in chips) 
Seat 2: franky65124 (€1.19 in chips) 
Seat 3: caduceus369 (€1.89 in chips) 
Seat 4: Catania838 (€2.02 in chips) 
Seat 5: cap e'bomb95 (€5.17 in chips) 
Seat 6: Witness85906 (€4.30 in chips) 
franky65124: posts small blind €0.01
caduceus369: posts big blind €0.02
*** HOLE CARDS ***
Dealt to caduceus369 [Qc 6s]
Catania838: folds 
cap e'bomb95: folds 
Witness85906: folds 
criptlux: raises €0.10 to €0.12
franky65124: folds 
caduceus369: folds 
Uncalled bet (€0.10) returned to criptlux
criptlux collected €0.05 from pot
criptlux: doesn't show hand 
*** SUMMARY ***
Total pot €0.05 | Rake €0 
Seat 1: criptlux (button) collected (€0.05)
Seat 2: franky65124 (small blind) folded before Flop
Seat 3: caduceus369 (big blind) folded before Flop
Seat 4: Catania838 folded before Flop (didn't bet)
Seat 5: cap e'bomb95 folded before Flop (didn't bet)
Seat 6: Witness85906 folded before Flop (didn't bet)



PokerStars Zoom Hand #257988450020:  Hold'em No Limit (€0.01/€0.02) [ADM ID: M62BA304494E32ST] - 2025/10/04 0:03:28 CET [2025/10/03 18:03:28 ET]
Table 'Sirio' 6-max Seat #1 is the button
Seat 1: caduceus369 (€1.87 in chips) 
Seat 2: Asganaway123 (€1.96 in chips) 
Seat 3: Catania838 (€2.02 in chips) 
Seat 4: cap e'bomb95 (€1.18 in chips) 
Seat 5: franky65124 (€1.18 in chips) 
Seat 6: Peru91j (€3.10 in chips) 
Asganaway123: posts small blind €0.01
Catania838: posts big blind €0.02
*** HOLE CARDS ***
Dealt to caduceus369 [Kh Ac]
cap e'bomb95: folds 
franky65124: calls €0.02
Peru91j: raises €0.07 to €0.09
caduceus369: raises €0.23 to €0.32
Asganaway123: folds 
Catania838: folds 
franky65124: folds 
Peru91j: calls €0.23
*** FLOP *** [Ah 2h 5d]
Peru91j: checks 
caduceus369: checks 
*** TURN *** [Ah 2h 5d] [8c]
Peru91j: checks 
caduceus369: bets €0.23
Peru91j: folds 
Uncalled bet (€0.23) returned to caduceus369
caduceus369 collected €0.66 from pot
caduceus369: doesn't show hand 
*** SUMMARY ***
Total pot €0.69 | Rake €0.03 
Board [Ah 2h 5d 8c]
Seat 1: caduceus369 (button) collected (€0.66)
Seat 2: Asganaway123 (small blind) folded before Flop
Seat 3: Catania838 (big blind) folded before Flop
Seat 4: cap e'bomb95 folded before Flop (didn't bet)
Seat 5: franky65124 folded before Flop
Seat 6: Peru91j folded on the Turn



PokerStars Zoom Hand #257988460316:  Hold'em No Limit (€0.01/€0.02) [ADM ID: M62BA304494E32ST] - 2025/10/04 0:04:15 CET [2025/10/03 18:04:15 ET]
Table 'Sirio' 6-max Seat #1 is the button
Seat 1: LentaM3nte (€2.07 in chips) 
Seat 2: caduceus369 (€2.21 in chips) 
Seat 3: trillycata (€1.30 in chips) 
Seat 4: EasyToRule (€2.50 in chips) 
Seat 5: outshined8 (€1.60 in chips) 
Seat 6: fantaasso (€3.44 in chips) 
caduceus369: posts small blind €0.01
trillycata: posts big blind €0.02
*** HOLE CARDS ***
Dealt to caduceus369 [4s 7d]
EasyToRule: folds 
outshined8: folds 
fantaasso: folds 
LentaM3nte: folds 
caduceus369: folds 
Uncalled bet (€0.01) returned to trillycata
trillycata collected €0.02 from pot
trillycata: doesn't show hand 
*** SUMMARY ***
Total pot €0.02 | Rake €0 
Seat 1: LentaM3nte (button) folded before Flop (didn't bet)
Seat 2: caduceus369 (small blind) folded before Flop
Seat 3: trillycata (big blind) collected (€0.02)
Seat 4: EasyToRule folded before Flop (didn't bet)
Seat 5: outshined8 folded before Flop (didn't bet)
Seat 6: fantaasso folded before Flop (didn't bet)



PokerStars Zoom Hand #257988461435:  Hold'em No Limit (€0.01/€0.02) [ADM ID: M62BA304494E32ST] - 2025/10/04 0:04:20 CET [2025/10/03 18:04:20 ET]
Table 'Sirio' 6-max Seat #1 is the button
Seat 1: fantaasso (€3.44 in chips) 
Seat 2: Catania838 (€2.92 in chips) 
Seat 3: EasyToRule (€2.50 in chips) 
Seat 4: caduceus369 (€2.20 in chips) 
Seat 5: LentaM3nte (€2.07 in chips) 
Seat 6: cuzzi68 (€0.70 in chips) 
Catania838: posts small blind €0.01
EasyToRule: posts big blind €0.02
*** HOLE CARDS ***
Dealt to caduceus369 [4h 2d]
caduceus369: folds 
LentaM3nte: folds 
cuzzi68: raises €0.04 to €0.06
fantaasso: folds 
Catania838: folds 
EasyToRule: calls €0.04
*** FLOP *** [7s Td 5s]
EasyToRule: checks 
cuzzi68: checks 
*** TURN *** [7s Td 5s] [4c]
EasyToRule: checks 
cuzzi68: bets €0.13
EasyToRule: folds 
Uncalled bet (€0.13) returned to cuzzi68
cuzzi68 collected €0.13 from pot
cuzzi68: doesn't show hand 
*** SUMMARY ***
Total pot €0.13 | Rake €0 
Board [7s Td 5s 4c]
Seat 1: fantaasso (button) folded before Flop (didn't bet)
Seat 2: Catania838 (small blind) folded before Flop
Seat 3: EasyToRule (big blind) folded on the Turn
Seat 4: caduceus369 folded before Flop (didn't bet)
Seat 5: LentaM3nte folded before Flop (didn't bet)
Seat 6: cuzzi68 collected (€0.13)



PokerStars Zoom Hand #257988463528:  Hold'em No Limit (€0.01/€0.02) [ADM ID: M62BA304494E32ST] - 2025/10/04 0:04:29 CET [2025/10/03 18:04:29 ET]
Table 'Sirio' 6-max Seat #1 is the button
Seat 1: father2008 (€4.33 in chips) 
Seat 2: Poetto65 (€0.78 in chips) 
Seat 3: LentaM3nte (€2.07 in chips) 
Seat 4: fantaasso (€3.44 in chips) 
Seat 5: Catania838 (€2.91 in chips) 
Seat 6: caduceus369 (€2.20 in chips) 
Poetto65: posts small blind €0.01
LentaM3nte: posts big blind €0.02
*** HOLE CARDS ***
Dealt to caduceus369 [6d Jh]
fantaasso: folds 
Catania838: calls €0.02
caduceus369: folds 
father2008: folds 
Poetto65: folds 
LentaM3nte: checks 
*** FLOP *** [2d Kd 5h]
LentaM3nte: checks 
Catania838: checks 
*** TURN *** [2d Kd 5h] [Ah]
LentaM3nte: checks 
Catania838: bets €0.02
LentaM3nte: folds 
Uncalled bet (€0.02) returned to Catania838
Catania838 collected €0.05 from pot
Catania838: doesn't show hand 
*** SUMMARY ***
Total pot €0.05 | Rake €0 
Board [2d Kd 5h Ah]
Seat 1: father2008 (button) folded before Flop (didn't bet)
Seat 2: Poetto65 (small blind) folded before Flop
Seat 3: LentaM3nte (big blind) folded on the Turn
Seat 4: fantaasso folded before Flop (didn't bet)
Seat 5: Catania838 collected (€0.05)
Seat 6: caduceus369 folded before Flop (didn't bet)



PokerStars Zoom Hand #257988464795:  Hold'em No Limit (€0.01/€0.02) [ADM ID: M62BA304494E32ST] - 2025/10/04 0:04:35 CET [2025/10/03 18:04:35 ET]
Table 'Sirio' 6-max Seat #1 is the button
Seat 1: maur62 (€1.02 in chips) 
Seat 2: fantaasso (€3.44 in chips) 
Seat 3: CacciatoreAA (€3.20 in chips) 
Seat 4: criptlux (€2.28 in chips) 
Seat 5: caduceus369 (€2.20 in chips) 
Seat 6: Davi3231973 (€1.09 in chips) 
fantaasso: posts small blind €0.01
CacciatoreAA: posts big blind €0.02
*** HOLE CARDS ***
Dealt to caduceus369 [As 4s]
criptlux: calls €0.02
caduceus369: calls €0.02
Davi3231973: calls €0.02
maur62: folds 
fantaasso: calls €0.01
CacciatoreAA: checks 
*** FLOP *** [Ts Ac Qd]
fantaasso: checks 
CacciatoreAA: checks 
criptlux: bets €0.06
caduceus369: calls €0.06
Davi3231973: folds 
fantaasso: folds 
CacciatoreAA: folds 
*** TURN *** [Ts Ac Qd] [Ad]
criptlux: bets €0.22
caduceus369: calls €0.22
*** RIVER *** [Ts Ac Qd Ad] [Qh]
criptlux: checks 
caduceus369: bets €0.79
criptlux: folds 
Uncalled bet (€0.79) returned to caduceus369
caduceus369 collected €0.63 from pot
caduceus369: doesn't show hand 
*** SUMMARY ***
Total pot €0.66 | Rake €0.03 
Board [Ts Ac Qd Ad Qh]
Seat 1: maur62 (button) folded before Flop (didn't bet)
Seat 2: fantaasso (small blind) folded on the Flop
Seat 3: CacciatoreAA (big blind) folded on the Flop
Seat 4: criptlux folded on the River
Seat 5: caduceus369 collected (€0.63)
Seat 6: Davi3231973 folded on the Flop



PokerStars Zoom Hand #257988481861:  Hold'em No Limit (€0.01/€0.02) [ADM ID: M62BA304494E32ST] - 2025/10/04 0:05:53 CET [2025/10/03 18:05:53 ET]
Table 'Sirio' 6-max Seat #1 is the button
Seat 1: caduceus369 (€2.53 in chips) 
Seat 2: Witness85906 (€4.23 in chips) 
Seat 3: cap e'bomb95 (€1.15 in chips) 
Seat 4: criptlux (€1.98 in chips) 
Seat 5: CacciatoreAA (€3.18 in chips) 
Seat 6: LentaM3nte (€1.97 in chips) 
Witness85906: posts small blind €0.01
cap e'bomb95: posts big blind €0.02
*** HOLE CARDS ***
Dealt to caduceus369 [3s 5d]
criptlux: folds 
CacciatoreAA: folds 
LentaM3nte: folds 
caduceus369: folds 
Witness85906: folds 
Uncalled bet (€0.01) returned to cap e'bomb95
cap e'bomb95 collected €0.02 from pot
cap e'bomb95: doesn't show hand 
*** SUMMARY ***
Total pot €0.02 | Rake €0 
Seat 1: caduceus369 (button) folded before Flop (didn't bet)
Seat 2: Witness85906 (small blind) folded before Flop
Seat 3: cap e'bomb95 (big blind) collected (€0.02)
Seat 4: criptlux folded before Flop (didn't bet)
Seat 5: CacciatoreAA folded before Flop (didn't bet)
Seat 6: LentaM3nte folded before Flop (didn't bet)



PokerStars Zoom Hand #257988484277:  Hold'em No Limit (€0.01/€0.02) [ADM ID: M62BA304494E32ST] - 2025/10/04 0:06:03 CET [2025/10/03 18:06:03 ET]
Table 'Sirio' 6-max Seat #1 is the button
Seat 1: stevalmg (€1.98 in chips) 
Seat 2: criptlux (€1.98 in chips) 
Seat 3: caduceus369 (€2.53 in chips) 
Seat 4: CacciatoreAA (€3.18 in chips) 
Seat 5: Poetto65 (€0.68 in chips) 
Seat 6: fantaasso (€3.32 in chips) 
criptlux: posts small blind €0.01
caduceus369: posts big blind €0.02
*** HOLE CARDS ***
Dealt to caduceus369 [2d 9h]
CacciatoreAA: folds 
Poetto65 has timed out
Poetto65: folds 
fantaasso: folds 
stevalmg: raises €0.04 to €0.06
criptlux: folds 
caduceus369: folds 
Uncalled bet (€0.04) returned to stevalmg
stevalmg collected €0.05 from pot
stevalmg: doesn't show hand 
*** SUMMARY ***
Total pot €0.05 | Rake €0 
Seat 1: stevalmg (button) collected (€0.05)
Seat 2: criptlux (small blind) folded before Flop
Seat 3: caduceus369 (big blind) folded before Flop
Seat 4: CacciatoreAA folded before Flop (didn't bet)
Seat 5: Poetto65 folded before Flop (didn't bet)
Seat 6: fantaasso folded before Flop (didn't bet)



PokerStars Zoom Hand #257988493261:  Hold'em No Limit (€0.01/€0.02) [ADM ID: M62BA304494E32ST] - 2025/10/04 0:06:44 CET [2025/10/03 18:06:44 ET]
Table 'Sirio' 6-max Seat #1 is the button
Seat 1: cap e'bomb95 (€4.81 in chips) 
Seat 2: caduceus369 (€2.51 in chips) 
Seat 3: stfuplzudonk (€4.15 in chips) 
Seat 4: cesaretto23 (€1.45 in chips) 
Seat 5: workman75 (€4.01 in chips) 
Seat 6: Catania838 (€1.95 in chips) 
caduceus369: posts small blind €0.01
stfuplzudonk: posts big blind €0.02
*** HOLE CARDS ***
Dealt to caduceus369 [7s Qs]
cesaretto23: folds 
workman75: folds 
Catania838: folds 
cap e'bomb95: raises €0.03 to €0.05
caduceus369: folds 
stfuplzudonk: calls €0.03
*** FLOP *** [Th Js 8s]
stfuplzudonk: checks 
cap e'bomb95: checks 
*** TURN *** [Th Js 8s] [7c]
stfuplzudonk: checks 
cap e'bomb95: checks 
*** RIVER *** [Th Js 8s 7c] [Ad]
stfuplzudonk: bets €0.08
cap e'bomb95: calls €0.08
*** SHOW DOWN ***
stfuplzudonk: shows [Jc 9c] (a straight, Seven to Jack)
cap e'bomb95: mucks hand 
stfuplzudonk collected €0.26 from pot
*** SUMMARY ***
Total pot €0.27 | Rake €0.01 
Board [Th Js 8s 7c Ad]
Seat 1: cap e'bomb95 (button) mucked [5c Ac]
Seat 2: caduceus369 (small blind) folded before Flop
Seat 3: stfuplzudonk (big blind) showed [Jc 9c] and won (€0.26) with a straight, Seven to Jack
Seat 4: cesaretto23 folded before Flop (didn't bet)
Seat 5: workman75 folded before Flop (didn't bet)
Seat 6: Catania838 folded before Flop (didn't bet)



PokerStars Zoom Hand #257988495896:  Hold'em No Limit (€0.01/€0.02) [ADM ID: M62BA304494E32ST] - 2025/10/04 0:06:56 CET [2025/10/03 18:06:56 ET]
Table 'Sirio' 6-max Seat #1 is the button
Seat 1: CIKO71131 (€1.04 in chips) 
Seat 2: Peru91j (€2.75 in chips) 
Seat 3: colosso2022 (€1.74 in chips) 
Seat 4: trillycata (€1.50 in chips) 
Seat 5: criptlux (€2.09 in chips) 
Seat 6: caduceus369 (€2.50 in chips) 
Peru91j: posts small blind €0.01
colosso2022: posts big blind €0.02
*** HOLE CARDS ***
Dealt to caduceus369 [5d 4c]
trillycata: calls €0.02
criptlux: folds 
caduceus369: folds 
CIKO71131: folds 
Peru91j: folds 
colosso2022: checks 
*** FLOP *** [4d Ad 2s]
colosso2022: bets €0.02
trillycata: folds 
Uncalled bet (€0.02) returned to colosso2022
colosso2022 collected €0.05 from pot
colosso2022: doesn't show hand 
*** SUMMARY ***
Total pot €0.05 | Rake €0 
Board [4d Ad 2s]
Seat 1: CIKO71131 (button) folded before Flop (didn't bet)
Seat 2: Peru91j (small blind) folded before Flop
Seat 3: colosso2022 (big blind) collected (€0.05)
Seat 4: trillycata folded on the Flop
Seat 5: criptlux folded before Flop (didn't bet)
Seat 6: caduceus369 folded before Flop (didn't bet)



PokerStars Zoom Hand #257988496575:  Hold'em No Limit (€0.01/€0.02) [ADM ID: M62BA304494E32ST] - 2025/10/04 0:06:59 CET [2025/10/03 18:06:59 ET]
Table 'Sirio' 6-max Seat #1 is the button
Seat 1: caduceus369 (€2.50 in chips) 
Seat 2: Asganaway123 (€1.04 in chips) 
Seat 3: stfuplzudonk (€1.92 in chips) 
Seat 4: neoilnervoso (€0.36 in chips) 
Seat 5: teicano98 (€1.15 in chips) 
Seat 6: CacciatoreAA (€3.18 in chips) 
Asganaway123: posts small blind €0.01
stfuplzudonk: posts big blind €0.02
*** HOLE CARDS ***
Dealt to caduceus369 [Qd 9d]
neoilnervoso: raises €0.34 to €0.36 and is all-in
teicano98: folds 
CacciatoreAA: folds 
caduceus369: folds 
Asganaway123: raises €0.68 to €1.04 and is all-in
stfuplzudonk: folds 
Uncalled bet (€0.68) returned to Asganaway123
*** FLOP *** [2h 5d 4h]
*** TURN *** [2h 5d 4h] [7c]
*** RIVER *** [2h 5d 4h 7c] [Kd]
*** SHOW DOWN ***
Asganaway123: shows [Jh Js] (a pair of Jacks)
neoilnervoso: shows [Qh Ac] (high card Ace)
Asganaway123 collected €0.70 from pot
*** SUMMARY ***
Total pot €0.74 | Rake €0.04 
Board [2h 5d 4h 7c Kd]
Seat 1: caduceus369 (button) folded before Flop (didn't bet)
Seat 2: Asganaway123 (small blind) showed [Jh Js] and won (€0.70) with a pair of Jacks
Seat 3: stfuplzudonk (big blind) folded before Flop
Seat 4: neoilnervoso showed [Qh Ac] and lost with high card Ace
Seat 5: teicano98 folded before Flop (didn't bet)
Seat 6: CacciatoreAA folded before Flop (didn't bet)



PokerStars Zoom Hand #257988490619:  Hold'em No Limit (€0.01/€0.02) [ADM ID: M62BA304494E32ST] - 2025/10/04 0:06:32 CET [2025/10/03 18:06:32 ET]
Table 'Sirio' 6-max Seat #1 is the button
Seat 1: maur62 (€1.44 in chips) 
Seat 2: stevalmg (€2.01 in chips) 
Seat 3: cap e'bomb95 (€5.03 in chips) 
Seat 4: LentaM3nte (€1.92 in chips) 
Seat 5: caduceus369 (€2.51 in chips) 
Seat 6: cuzzi68 (€0.96 in chips) 
stevalmg: posts small blind €0.01
cap e'bomb95: posts big blind €0.02
*** HOLE CARDS ***
Dealt to caduceus369 [7d 6d]
LentaM3nte: folds 
caduceus369: folds 
cuzzi68: calls €0.02
maur62: calls €0.02
stevalmg: folds 
cap e'bomb95: raises €0.03 to €0.05
cuzzi68: calls €0.03
maur62: calls €0.03
*** FLOP *** [8h Qh Kh]
cap e'bomb95: checks 
cuzzi68: bets €0.08
maur62: calls €0.08
cap e'bomb95: folds 
*** TURN *** [8h Qh Kh] [6c]
cuzzi68: bets €0.02
maur62: calls €0.02
*** RIVER *** [8h Qh Kh 6c] [5d]
cuzzi68: bets €0.02
maur62: folds 
Uncalled bet (€0.02) returned to cuzzi68
cuzzi68 collected €0.35 from pot
cuzzi68: doesn't show hand 
*** SUMMARY ***
Total pot €0.36 | Rake €0.01 
Board [8h Qh Kh 6c 5d]
Seat 1: maur62 (button) folded on the River
Seat 2: stevalmg (small blind) folded before Flop
Seat 3: cap e'bomb95 (big blind) folded on the Flop
Seat 4: LentaM3nte folded before Flop (didn't bet)
Seat 5: caduceus369 folded before Flop (didn't bet)
Seat 6: cuzzi68 collected (€0.35)



PokerStars Zoom Hand #257988504751:  Hold'em No Limit (€0.01/€0.02) [ADM ID: M62BA304494E32ST] - 2025/10/04 0:07:36 CET [2025/10/03 18:07:36 ET]
Table 'Sirio' 6-max Seat #1 is the button
Seat 1: Asganaway123 (€1.38 in chips) 
Seat 2: EasyToRule (€5.20 in chips) 
Seat 3: criptlux (€2.08 in chips) 
Seat 4: caduceus369 (€2.48 in chips) 
Seat 5: cuzzi68 (€1.16 in chips) 
Seat 6: cap e'bomb95 (€1.15 in chips) 
EasyToRule: posts small blind €0.01
criptlux: posts big blind €0.02
*** HOLE CARDS ***
Dealt to caduceus369 [2c 6c]
caduceus369: folds 
cuzzi68: folds 
cap e'bomb95: folds 
Asganaway123: folds 
EasyToRule: folds 
Uncalled bet (€0.01) returned to criptlux
criptlux collected €0.02 from pot
criptlux: doesn't show hand 
*** SUMMARY ***
Total pot €0.02 | Rake €0 
Seat 1: Asganaway123 (button) folded before Flop (didn't bet)
Seat 2: EasyToRule (small blind) folded before Flop
Seat 3: criptlux (big blind) collected (€0.02)
Seat 4: caduceus369 folded before Flop (didn't bet)
Seat 5: cuzzi68 folded before Flop (didn't bet)
Seat 6: cap e'bomb95 folded before Flop (didn't bet)



PokerStars Zoom Hand #257988500578:  Hold'em No Limit (€0.01/€0.02) [ADM ID: M62BA304494E32ST] - 2025/10/04 0:07:17 CET [2025/10/03 18:07:17 ET]
Table 'Sirio' 6-max Seat #1 is the button
Seat 1: teicano98 (€0.78 in chips) 
Seat 2: trillycata (€1.48 in chips) 
Seat 3: caduceus369 (€2.50 in chips) 
Seat 4: Peru91j (€2.53 in chips) 
Seat 5: fantaasso (€3.32 in chips) 
Seat 6: criptlux (€1.95 in chips) 
trillycata: posts small blind €0.01
caduceus369: posts big blind €0.02
*** HOLE CARDS ***
Dealt to caduceus369 [8h Ks]
Peru91j: raises €0.04 to €0.06
fantaasso: folds 
criptlux: folds 
teicano98: calls €0.06
trillycata: folds 
caduceus369: folds 
*** FLOP *** [4d 2h 3h]
Peru91j: checks 
teicano98: bets €0.07
Peru91j: folds 
Uncalled bet (€0.07) returned to teicano98
teicano98 collected €0.15 from pot
teicano98: doesn't show hand 
*** SUMMARY ***
Total pot €0.15 | Rake €0 
Board [4d 2h 3h]
Seat 1: teicano98 (button) collected (€0.15)
Seat 2: trillycata (small blind) folded before Flop
Seat 3: caduceus369 (big blind) folded before Flop
Seat 4: Peru91j folded on the Flop
Seat 5: fantaasso folded before Flop (didn't bet)
Seat 6: criptlux folded before Flop (didn't bet)



PokerStars Zoom Hand #257988499783:  Hold'em No Limit (€0.01/€0.02) [ADM ID: M62BA304494E32ST] - 2025/10/04 0:07:14 CET [2025/10/03 18:07:14 ET]
Table 'Sirio' 6-max Seat #1 is the button
Seat 1: Ceribelli1705 (€2.84 in chips) 
Seat 2: CacciatoreAA (€3.18 in chips) 
Seat 3: pepenero11 (€0.80 in chips) 
Seat 4: caduceus369 (€2.50 in chips) 
Seat 5: Peru91j (€2.74 in chips) 
Seat 6: cap e'bomb95 (€4.98 in chips) 
CacciatoreAA: posts small blind €0.01
pepenero11: posts big blind €0.02
*** HOLE CARDS ***
Dealt to caduceus369 [5c 6d]
caduceus369: folds 
Peru91j: raises €0.04 to €0.06
cap e'bomb95: folds 
Ceribelli1705: folds 
CacciatoreAA: calls €0.05
pepenero11: folds 
*** FLOP *** [Th 5s 3s]
CacciatoreAA: checks 
Peru91j: bets €0.04
CacciatoreAA: folds 
Uncalled bet (€0.04) returned to Peru91j
Peru91j collected €0.14 from pot
Peru91j: doesn't show hand 
*** SUMMARY ***
Total pot €0.14 | Rake €0 
Board [Th 5s 3s]
Seat 1: Ceribelli1705 (button) folded before Flop (didn't bet)
Seat 2: CacciatoreAA (small blind) folded on the Flop
Seat 3: pepenero11 (big blind) folded before Flop
Seat 4: caduceus369 folded before Flop (didn't bet)
Seat 5: Peru91j collected (€0.14)
Seat 6: cap e'bomb95 folded before Flop (didn't bet)



PokerStars Zoom Hand #257988506060:  Hold'em No Limit (€0.01/€0.02) [ADM ID: M62BA304494E32ST] - 2025/10/04 0:07:41 CET [2025/10/03 18:07:41 ET]
Table 'Sirio' 6-max Seat #1 is the button
Seat 1: stevalmg (€1.62 in chips) 
Seat 2: caduceus369 (€2.48 in chips) 
Seat 3: Fengjie82 (€2.53 in chips) 
Seat 4: Poetto65 (€0.73 in chips) 
Seat 5: Bristol1964 (€1.11 in chips) 
Seat 6: EasyToRule (€5.19 in chips) 
caduceus369: posts small blind €0.01
Fengjie82: posts big blind €0.02
*** HOLE CARDS ***
Dealt to caduceus369 [5d 8h]
Poetto65: folds 
Bristol1964: folds 
EasyToRule: folds 
stevalmg: folds 
caduceus369: folds 
Uncalled bet (€0.01) returned to Fengjie82
Fengjie82 collected €0.02 from pot
Fengjie82: doesn't show hand 
*** SUMMARY ***
Total pot €0.02 | Rake €0 
Seat 1: stevalmg (button) folded before Flop (didn't bet)
Seat 2: caduceus369 (small blind) folded before Flop
Seat 3: Fengjie82 (big blind) collected (€0.02)
Seat 4: Poetto65 folded before Flop (didn't bet)
Seat 5: Bristol1964 folded before Flop (didn't bet)
Seat 6: EasyToRule folded before Flop (didn't bet)



PokerStars Zoom Hand #257988508463:  Hold'em No Limit (€0.01/€0.02) [ADM ID: M62BA304494E32ST] - 2025/10/04 0:07:52 CET [2025/10/03 18:07:52 ET]
Table 'Sirio' 6-max Seat #1 is the button
Seat 1: robertoH2O (€2.88 in chips) 
Seat 2: The clansman77 (€0.81 in chips) 
Seat 3: caduceus369 (€2.47 in chips) 
Seat 4: teicano98 (€0.87 in chips) 
Seat 5: Catania838 (€1.50 in chips) 
Seat 6: workman75 (€3.62 in chips) 
The clansman77: posts small blind €0.01
caduceus369: posts big blind €0.02
*** HOLE CARDS ***
Dealt to caduceus369 [5c 9h]
teicano98: raises €0.02 to €0.04
Catania838: folds 
workman75: folds 
robertoH2O: folds 
The clansman77: folds 
caduceus369: folds 
Uncalled bet (€0.02) returned to teicano98
teicano98 collected €0.05 from pot
teicano98: doesn't show hand 
*** SUMMARY ***
Total pot €0.05 | Rake €0 
Seat 1: robertoH2O (button) folded before Flop (didn't bet)
Seat 2: The clansman77 (small blind) folded before Flop
Seat 3: caduceus369 (big blind) folded before Flop
Seat 4: teicano98 collected (€0.05)
Seat 5: Catania838 folded before Flop (didn't bet)
Seat 6: workman75 folded before Flop (didn't bet)



PokerStars Zoom Hand #257988506938:  Hold'em No Limit (€0.01/€0.02) [ADM ID: M62BA304494E32ST] - 2025/10/04 0:07:45 CET [2025/10/03 18:07:45 ET]
Table 'Sirio' 6-max Seat #1 is the button
Seat 1: EasyToRule (€5.19 in chips) 
Seat 2: cap e'bomb95 (€4.96 in chips) 
Seat 3: cuzzi68 (€1.16 in chips) 
Seat 4: michy0757 (€1.17 in chips) 
Seat 5: Poetto65 (€0.73 in chips) 
Seat 6: caduceus369 (€2.47 in chips) 
cap e'bomb95: posts small blind €0.01
cuzzi68: posts big blind €0.02
*** HOLE CARDS ***
Dealt to caduceus369 [6h Jc]
michy0757: raises €0.05 to €0.07
Poetto65: folds 
caduceus369: folds 
EasyToRule: folds 
cap e'bomb95: calls €0.06
cuzzi68: calls €0.05
*** FLOP *** [9s Qs 7d]
cap e'bomb95: checks 
cuzzi68: checks 
michy0757: checks 
*** TURN *** [9s Qs 7d] [6s]
cap e'bomb95: checks 
cuzzi68: checks 
michy0757: checks 
*** RIVER *** [9s Qs 7d 6s] [4d]
cap e'bomb95: checks 
cuzzi68: checks 
michy0757: bets €0.20
cap e'bomb95: folds 
cuzzi68: folds 
Uncalled bet (€0.20) returned to michy0757
michy0757 collected €0.20 from pot
michy0757: doesn't show hand 
*** SUMMARY ***
Total pot €0.21 | Rake €0.01 
Board [9s Qs 7d 6s 4d]
Seat 1: EasyToRule (button) folded before Flop (didn't bet)
Seat 2: cap e'bomb95 (small blind) folded on the River
Seat 3: cuzzi68 (big blind) folded on the River
Seat 4: michy0757 collected (€0.20)
Seat 5: Poetto65 folded before Flop (didn't bet)
Seat 6: caduceus369 folded before Flop (didn't bet)



PokerStars Zoom Hand #257988519549:  Hold'em No Limit (€0.01/€0.02) [ADM ID: M62BA304494E32ST] - 2025/10/04 0:08:43 CET [2025/10/03 18:08:43 ET]
Table 'Sirio' 6-max Seat #1 is the button
Seat 1: Poetto65 (€0.77 in chips) 
Seat 2: caduceus369 (€2.45 in chips) 
Seat 3: Bristol1964 (€1.09 in chips) 
Seat 4: cap e'bomb95 (€4.89 in chips) 
Seat 5: CacciatoreAA (€3.10 in chips) 
Seat 6: pepenero11 (€0.71 in chips) 
caduceus369: posts small blind €0.01
Bristol1964: posts big blind €0.02
*** HOLE CARDS ***
Dealt to caduceus369 [Ts 4s]
cap e'bomb95: raises €0.03 to €0.05
CacciatoreAA: folds 
pepenero11 has timed out while disconnected
pepenero11: folds 
Poetto65: folds 
caduceus369: folds 
Bristol1964: folds 
Uncalled bet (€0.03) returned to cap e'bomb95
cap e'bomb95 collected €0.05 from pot
cap e'bomb95: doesn't show hand 
*** SUMMARY ***
Total pot €0.05 | Rake €0 
Seat 1: Poetto65 (button) folded before Flop (didn't bet)
Seat 2: caduceus369 (small blind) folded before Flop
Seat 3: Bristol1964 (big blind) folded before Flop
Seat 4: cap e'bomb95 collected (€0.05)
Seat 5: CacciatoreAA folded before Flop (didn't bet)
Seat 6: pepenero11 folded before Flop (didn't bet)



PokerStars Zoom Hand #257988516473:  Hold'em No Limit (€0.01/€0.02) [ADM ID: M62BA304494E32ST] - 2025/10/04 0:08:29 CET [2025/10/03 18:08:29 ET]
Table 'Sirio' 6-max Seat #1 is the button
Seat 1: stfuplzudonk (€2.21 in chips) 
Seat 2: Fengjie82 (€2.54 in chips) 
Seat 3: maur62 (€2.18 in chips) 
Seat 4: Catania838 (€2.11 in chips) 
Seat 5: caduceus369 (€2.45 in chips) 
Seat 6: criptlux (€1.92 in chips) 
Fengjie82: posts small blind €0.01
maur62: posts big blind €0.02
*** HOLE CARDS ***
Dealt to caduceus369 [Ad 2h]
Catania838: folds 
caduceus369: folds 
criptlux: folds 
stfuplzudonk: raises €0.02 to €0.04
Fengjie82: calls €0.03
maur62: folds 
*** FLOP *** [6c 8h 3h]
Fengjie82: checks 
stfuplzudonk: bets €0.05
Fengjie82: calls €0.05
*** TURN *** [6c 8h 3h] [7c]
Fengjie82: checks 
stfuplzudonk: checks 
*** RIVER *** [6c 8h 3h 7c] [Kc]
Fengjie82: bets €0.10
stfuplzudonk: calls €0.10
*** SHOW DOWN ***
Fengjie82: shows [Tc 9c] (a flush, King high)
stfuplzudonk: mucks hand 
Fengjie82 collected €0.38 from pot
*** SUMMARY ***
Total pot €0.40 | Rake €0.02 
Board [6c 8h 3h 7c Kc]
Seat 1: stfuplzudonk (button) mucked [7h 5s]
Seat 2: Fengjie82 (small blind) showed [Tc 9c] and won (€0.38) with a flush, King high
Seat 3: maur62 (big blind) folded before Flop
Seat 4: Catania838 folded before Flop (didn't bet)
Seat 5: caduceus369 folded before Flop (didn't bet)
Seat 6: criptlux folded before Flop (didn't bet)



PokerStars Zoom Hand #257988526621:  Hold'em No Limit (€0.01/€0.02) [ADM ID: M62BA304494E32ST] - 2025/10/04 0:09:16 CET [2025/10/03 18:09:16 ET]
Table 'Sirio' 6-max Seat #1 is the button
Seat 1: EasyToRule (€5.25 in chips) 
Seat 2: cap e'bomb95 (€1.40 in chips) 
Seat 3: The clansman77 (€0.76 in chips) 
Seat 4: stfuplzudonk (€4.12 in chips) 
Seat 5: fantaasso (€3.16 in chips) 
Seat 6: caduceus369 (€2.44 in chips) 
cap e'bomb95: posts small blind €0.01
The clansman77: posts big blind €0.02
*** HOLE CARDS ***
Dealt to caduceus369 [2c 7s]
stfuplzudonk: folds 
fantaasso: folds 
caduceus369: folds 
EasyToRule: raises €0.02 to €0.04
cap e'bomb95: folds 
The clansman77: folds 
Uncalled bet (€0.02) returned to EasyToRule
EasyToRule collected €0.05 from pot
EasyToRule: doesn't show hand 
*** SUMMARY ***
Total pot €0.05 | Rake €0 
Seat 1: EasyToRule (button) collected (€0.05)
Seat 2: cap e'bomb95 (small blind) folded before Flop
Seat 3: The clansman77 (big blind) folded before Flop
Seat 4: stfuplzudonk folded before Flop (didn't bet)
Seat 5: fantaasso folded before Flop (didn't bet)
Seat 6: caduceus369 folded before Flop (didn't bet)



PokerStars Zoom Hand #257988517875:  Hold'em No Limit (€0.01/€0.02) [ADM ID: M62BA304494E32ST] - 2025/10/04 0:08:36 CET [2025/10/03 18:08:36 ET]
Table 'Sirio' 6-max Seat #1 is the button
Seat 1: caduceus369 (€2.45 in chips) 
Seat 2: cuzzi68 (€1.09 in chips) 
Seat 3: Catania838 (€2.11 in chips) 
Seat 4: stfuplzudonk (€1.53 in chips) 
Seat 5: criptlux (€1.92 in chips) 
Seat 6: Witness85906 (€5 in chips) 
cuzzi68: posts small blind €0.01
Catania838: posts big blind €0.02
*** HOLE CARDS ***
Dealt to caduceus369 [5s 6c]
stfuplzudonk: raises €0.02 to €0.04
criptlux: calls €0.04
Witness85906: folds 
caduceus369: folds 
cuzzi68: folds 
Catania838: calls €0.02
*** FLOP *** [Ac 7h 3h]
Catania838: checks 
stfuplzudonk: checks 
criptlux: bets €0.08
Catania838: calls €0.08
stfuplzudonk: folds 
*** TURN *** [Ac 7h 3h] [9s]
Catania838: checks 
criptlux: bets €0.40
Catania838: raises €1.59 to €1.99 and is all-in
criptlux: calls €1.40 and is all-in
Uncalled bet (€0.19) returned to Catania838
*** RIVER *** [Ac 7h 3h 9s] [Tc]
*** SHOW DOWN ***
Catania838: shows [Ah 9d] (two pair, Aces and Nines)
criptlux: shows [7c 7s] (three of a kind, Sevens)
criptlux collected €3.68 from pot
*** SUMMARY ***
Total pot €3.89 | Rake €0.21 
Board [Ac 7h 3h 9s Tc]
Seat 1: caduceus369 (button) folded before Flop (didn't bet)
Seat 2: cuzzi68 (small blind) folded before Flop
Seat 3: Catania838 (big blind) showed [Ah 9d] and lost with two pair, Aces and Nines
Seat 4: stfuplzudonk folded on the Flop
Seat 5: criptlux showed [7c 7s] and won (€3.68) with three of a kind, Sevens
Seat 6: Witness85906 folded before Flop (didn't bet)



PokerStars Zoom Hand #257988530273:  Hold'em No Limit (€0.01/€0.02) [ADM ID: M62BA304494E32ST] - 2025/10/04 0:09:32 CET [2025/10/03 18:09:32 ET]
Table 'Sirio' 6-max Seat #1 is the button
Seat 1: deojking (€1.97 in chips) 
Seat 2: Catania838 (€2.87 in chips) 
Seat 3: caduceus369 (€2.44 in chips) 
Seat 4: fantaasso (€3.16 in chips) 
Seat 5: cap e'bomb95 (€1.39 in chips) 
Seat 6: criptlux (€2 in chips) 
Catania838: posts small blind €0.01
caduceus369: posts big blind €0.02
*** HOLE CARDS ***
Dealt to caduceus369 [Th 6d]
fantaasso: folds 
cap e'bomb95: folds 
criptlux: folds 
deojking: folds 
Catania838: folds 
Uncalled bet (€0.01) returned to caduceus369
caduceus369 collected €0.02 from pot
caduceus369: doesn't show hand 
*** SUMMARY ***
Total pot €0.02 | Rake €0 
Seat 1: deojking (button) folded before Flop (didn't bet)
Seat 2: Catania838 (small blind) folded before Flop
Seat 3: caduceus369 (big blind) collected (€0.02)
Seat 4: fantaasso folded before Flop (didn't bet)
Seat 5: cap e'bomb95 folded before Flop (didn't bet)
Seat 6: criptlux folded before Flop (didn't bet)



PokerStars Zoom Hand #257988525477:  Hold'em No Limit (€0.01/€0.02) [ADM ID: M62BA304494E32ST] - 2025/10/04 0:09:10 CET [2025/10/03 18:09:10 ET]
Table 'Sirio' 6-max Seat #1 is the button
Seat 1: EasyToRule (€2.20 in chips) 
Seat 2: Bristol1964 (€1.07 in chips) 
Seat 3: Poetto65 (€0.77 in chips) 
Seat 4: deojking (€2.01 in chips) 
Seat 5: caduceus369 (€2.44 in chips) 
Seat 6: stevalmg (€2.04 in chips) 
Bristol1964: posts small blind €0.01
Poetto65: posts big blind €0.02
*** HOLE CARDS ***
Dealt to caduceus369 [3h Ts]
deojking: calls €0.02
caduceus369: folds 
stevalmg: folds 
EasyToRule: folds 
Bristol1964: calls €0.01
Poetto65: checks 
*** FLOP *** [Ad 4h 5c]
Bristol1964: checks 
Poetto65: checks 
deojking: checks 
*** TURN *** [Ad 4h 5c] [Qs]
Bristol1964: checks 
Poetto65: checks 
deojking: checks 
*** RIVER *** [Ad 4h 5c Qs] [8c]
Bristol1964: checks 
Poetto65: checks 
deojking: checks 
*** SHOW DOWN ***
Bristol1964: shows [Jd 6s] (high card Ace)
Poetto65: shows [7d 5s] (a pair of Fives)
deojking: mucks hand 
Poetto65 collected €0.06 from pot
*** SUMMARY ***
Total pot €0.06 | Rake €0 
Board [Ad 4h 5c Qs 8c]
Seat 1: EasyToRule (button) folded before Flop (didn't bet)
Seat 2: Bristol1964 (small blind) showed [Jd 6s] and lost with high card Ace
Seat 3: Poetto65 (big blind) showed [7d 5s] and won (€0.06) with a pair of Fives
Seat 4: deojking mucked [2d 2c]
Seat 5: caduceus369 folded before Flop (didn't bet)
Seat 6: stevalmg folded before Flop (didn't bet)



PokerStars Zoom Hand #257988528286:  Hold'em No Limit (€0.01/€0.02) [ADM ID: M62BA304494E32ST] - 2025/10/04 0:09:24 CET [2025/10/03 18:09:24 ET]
Table 'Sirio' 6-max Seat #1 is the button
Seat 1: caduceus369 (€2.44 in chips) 
Seat 2: LentaM3nte (€1.76 in chips) 
Seat 3: stfuplzudonk (€4.12 in chips) 
Seat 4: stevalmg (€2.04 in chips) 
Seat 5: colosso2022 (€1.82 in chips) 
Seat 6: fantaasso (€3.16 in chips) 
LentaM3nte: posts small blind €0.01
stfuplzudonk: posts big blind €0.02
*** HOLE CARDS ***
Dealt to caduceus369 [2d 2h]
stevalmg: raises €0.05 to €0.07
colosso2022: folds 
fantaasso: folds 
caduceus369: folds 
LentaM3nte: calls €0.06
stfuplzudonk: calls €0.05
*** FLOP *** [Ac 3h 7h]
LentaM3nte: bets €0.12
stfuplzudonk: folds 
stevalmg: calls €0.12
*** TURN *** [Ac 3h 7h] [8c]
LentaM3nte: bets €0.22
stevalmg: calls €0.22
*** RIVER *** [Ac 3h 7h 8c] [5s]
LentaM3nte: checks 
stevalmg: checks 
*** SHOW DOWN ***
LentaM3nte: shows [As Qd] (a pair of Aces)
stevalmg: mucks hand 
LentaM3nte collected €0.85 from pot
*** SUMMARY ***
Total pot €0.89 | Rake €0.04 
Board [Ac 3h 7h 8c 5s]
Seat 1: caduceus369 (button) folded before Flop (didn't bet)
Seat 2: LentaM3nte (small blind) showed [As Qd] and won (€0.85) with a pair of Aces
Seat 3: stfuplzudonk (big blind) folded on the Flop
Seat 4: stevalmg mucked [Qc Qs]
Seat 5: colosso2022 folded before Flop (didn't bet)
Seat 6: fantaasso folded before Flop (didn't bet)



PokerStars Zoom Hand #257988535106:  Hold'em No Limit (€0.01/€0.02) [ADM ID: M62BA304494E32ST] - 2025/10/04 0:09:55 CET [2025/10/03 18:09:55 ET]
Table 'Sirio' 6-max Seat #1 is the button
Seat 1: maur62 (€2.20 in chips) 
Seat 2: Catania838 (€1.46 in chips) 
Seat 3: fantaasso (€4.34 in chips) 
Seat 4: caduceus369 (€2.45 in chips) 
Seat 5: Peru91j (€2.42 in chips) 
Seat 6: EasyToRule (€5.25 in chips) 
Catania838: posts small blind €0.01
fantaasso: posts big blind €0.02
*** HOLE CARDS ***
Dealt to caduceus369 [7d 8h]
caduceus369: folds 
Peru91j: folds 
EasyToRule: folds 
maur62: calls €0.02
Catania838: folds 
fantaasso: raises €0.06 to €0.08
maur62: calls €0.06
*** FLOP *** [Ac 6h 8c]
fantaasso: bets €0.09
maur62: calls €0.09
*** TURN *** [Ac 6h 8c] [Ts]
fantaasso: checks 
maur62: bets €0.02
fantaasso: calls €0.02
*** RIVER *** [Ac 6h 8c Ts] [Td]
fantaasso: checks 
maur62: checks 
*** SHOW DOWN ***
fantaasso: shows [Kc Kd] (two pair, Kings and Tens)
maur62: shows [Js As] (two pair, Aces and Tens)
maur62 collected €0.37 from pot
*** SUMMARY ***
Total pot €0.39 | Rake €0.02 
Board [Ac 6h 8c Ts Td]
Seat 1: maur62 (button) showed [Js As] and won (€0.37) with two pair, Aces and Tens
Seat 2: Catania838 (small blind) folded before Flop
Seat 3: fantaasso (big blind) showed [Kc Kd] and lost with two pair, Kings and Tens
Seat 4: caduceus369 folded before Flop (didn't bet)
Seat 5: Peru91j folded before Flop (didn't bet)
Seat 6: EasyToRule folded before Flop (didn't bet)



PokerStars Zoom Hand #257988537858:  Hold'em No Limit (€0.01/€0.02) [ADM ID: M62BA304494E32ST] - 2025/10/04 0:10:08 CET [2025/10/03 18:10:08 ET]
Table 'Sirio' 6-max Seat #1 is the button
Seat 1: robertoH2O (€2.91 in chips) 
Seat 2: caduceus369 (€2.45 in chips) 
Seat 3: stfuplzudonk (€1.43 in chips) 
Seat 4: Peru91j (€2.67 in chips) 
Seat 5: Fengjie82 (€2.67 in chips) 
Seat 6: Catania838 (€0.19 in chips) 
caduceus369: posts small blind €0.01
stfuplzudonk: posts big blind €0.02
*** HOLE CARDS ***
Dealt to caduceus369 [Qh 2c]
Peru91j: folds 
Fengjie82: raises €0.02 to €0.04
Catania838: raises €0.15 to €0.19 and is all-in
robertoH2O: folds 
caduceus369: folds 
stfuplzudonk: raises €0.17 to €0.36
Fengjie82: folds 
Uncalled bet (€0.17) returned to stfuplzudonk
*** FLOP *** [4d 3c 2d]
*** TURN *** [4d 3c 2d] [5s]
*** RIVER *** [4d 3c 2d 5s] [7s]
*** SHOW DOWN ***
stfuplzudonk: shows [As Ac] (a straight, Ace to Five)
Catania838: shows [Qd Ad] (a straight, Ace to Five)
stfuplzudonk collected €0.21 from pot
Catania838 collected €0.20 from pot
*** SUMMARY ***
Total pot €0.43 | Rake €0.02 
Board [4d 3c 2d 5s 7s]
Seat 1: robertoH2O (button) folded before Flop (didn't bet)
Seat 2: caduceus369 (small blind) folded before Flop
Seat 3: stfuplzudonk (big blind) showed [As Ac] and won (€0.21) with a straight, Ace to Five
Seat 4: Peru91j folded before Flop (didn't bet)
Seat 5: Fengjie82 folded before Flop
Seat 6: Catania838 showed [Qd Ad] and won (€0.20) with a straight, Ace to Five



PokerStars Zoom Hand #257988540491:  Hold'em No Limit (€0.01/€0.02) [ADM ID: M62BA304494E32ST] - 2025/10/04 0:10:20 CET [2025/10/03 18:10:20 ET]
Table 'Sirio' 6-max Seat #1 is the button
Seat 1: deojking (€1.93 in chips) 
Seat 2: bruciapelo (€2.53 in chips) 
Seat 3: EasyToRule (€5.25 in chips) 
Seat 4: cap e'bomb95 (€4.80 in chips) 
Seat 5: caduceus369 (€2.44 in chips) 
Seat 6: cuzzi68 (€1 in chips) 
bruciapelo: posts small blind €0.01
EasyToRule: posts big blind €0.02
*** HOLE CARDS ***
Dealt to caduceus369 [4s 2c]
cap e'bomb95: folds 
caduceus369: folds 
cuzzi68: folds 
deojking: folds 
bruciapelo: raises €0.04 to €0.06
EasyToRule: folds 
Uncalled bet (€0.04) returned to bruciapelo
bruciapelo collected €0.04 from pot
bruciapelo: doesn't show hand 
*** SUMMARY ***
Total pot €0.04 | Rake €0 
Seat 1: deojking (button) folded before Flop (didn't bet)
Seat 2: bruciapelo (small blind) collected (€0.04)
Seat 3: EasyToRule (big blind) folded before Flop
Seat 4: cap e'bomb95 folded before Flop (didn't bet)
Seat 5: caduceus369 folded before Flop (didn't bet)
Seat 6: cuzzi68 folded before Flop (didn't bet)



PokerStars Zoom Hand #257988541323:  Hold'em No Limit (€0.01/€0.02) [ADM ID: M62BA304494E32ST] - 2025/10/04 0:10:24 CET [2025/10/03 18:10:24 ET]
Table 'Sirio' 6-max Seat #1 is the button
Seat 1: cuzzi68 (€1 in chips) 
Seat 2: fantaasso (€3.13 in chips) 
Seat 3: deojking (€1.97 in chips) 
Seat 4: workman75 (€3.43 in chips) 
Seat 5: caduceus369 (€2.44 in chips) 
Seat 6: Catania838 (€1.45 in chips) 
fantaasso: posts small blind €0.01
deojking: posts big blind €0.02
*** HOLE CARDS ***
Dealt to caduceus369 [As 8d]
workman75: folds 
caduceus369 has timed out
caduceus369: folds 
Catania838: folds 
cuzzi68: folds 
fantaasso: raises €0.02 to €0.04
deojking: folds 
Uncalled bet (€0.02) returned to fantaasso
fantaasso collected €0.04 from pot
fantaasso: doesn't show hand 
*** SUMMARY ***
Total pot €0.04 | Rake €0 
Seat 1: cuzzi68 (button) folded before Flop (didn't bet)
Seat 2: fantaasso (small blind) collected (€0.04)
Seat 3: deojking (big blind) folded before Flop
Seat 4: workman75 folded before Flop (didn't bet)
Seat 5: caduceus369 folded before Flop (didn't bet)
Seat 6: Catania838 folded before Flop (didn't bet)



PokerStars Zoom Hand #257988548827:  Hold'em No Limit (€0.01/€0.02) [ADM ID: M62BA304494E32ST] - 2025/10/04 0:10:59 CET [2025/10/03 18:10:59 ET]
Table 'Sirio' 6-max Seat #1 is the button
Seat 1: father2008 (€4.15 in chips) 
Seat 2: LentaM3nte (€2.18 in chips) 
Seat 3: caduceus369 (€2.44 in chips) 
Seat 4: deojking (€2.11 in chips) 
Seat 5: EasyToRule (€2.22 in chips) 
Seat 6: workman75 (€3.01 in chips) 
LentaM3nte: posts small blind €0.01
caduceus369: posts big blind €0.02
*** HOLE CARDS ***
Dealt to caduceus369 [7c Ah]
deojking: folds 
EasyToRule: folds 
workman75: folds 
father2008: folds 
LentaM3nte: folds 
Uncalled bet (€0.01) returned to caduceus369
caduceus369 collected €0.02 from pot
caduceus369: doesn't show hand 
*** SUMMARY ***
Total pot €0.02 | Rake €0 
Seat 1: father2008 (button) folded before Flop (didn't bet)
Seat 2: LentaM3nte (small blind) folded before Flop
Seat 3: caduceus369 (big blind) collected (€0.02)
Seat 4: deojking folded before Flop (didn't bet)
Seat 5: EasyToRule folded before Flop (didn't bet)
Seat 6: workman75 folded before Flop (didn't bet)



PokerStars Zoom Hand #257988552364:  Hold'em No Limit (€0.01/€0.02) [ADM ID: M62BA304494E32ST] - 2025/10/04 0:11:15 CET [2025/10/03 18:11:15 ET]
Table 'Sirio' 6-max Seat #1 is the button
Seat 1: caduceus369 (€2.45 in chips) 
Seat 2: stfuplzudonk (€4.02 in chips) 
Seat 3: CacciatoreAA (€2.95 in chips) 
Seat 4: cap e'bomb95 (€4.77 in chips) 
Seat 5: DAMPER_KK (€1.89 in chips) 
Seat 6: deojking (€2.10 in chips) 
stfuplzudonk: posts small blind €0.01
CacciatoreAA: posts big blind €0.02
*** HOLE CARDS ***
Dealt to caduceus369 [6c 3c]
cap e'bomb95: folds 
DAMPER_KK: raises €0.02 to €0.04
deojking: folds 
caduceus369: folds 
stfuplzudonk: calls €0.03
CacciatoreAA: folds 
*** FLOP *** [Qd 3h Tc]
stfuplzudonk: checks 
DAMPER_KK: bets €0.04
stfuplzudonk: folds 
Uncalled bet (€0.04) returned to DAMPER_KK
DAMPER_KK collected €0.10 from pot
DAMPER_KK: doesn't show hand 
*** SUMMARY ***
Total pot €0.10 | Rake €0 
Board [Qd 3h Tc]
Seat 1: caduceus369 (button) folded before Flop (didn't bet)
Seat 2: stfuplzudonk (small blind) folded on the Flop
Seat 3: CacciatoreAA (big blind) folded before Flop
Seat 4: cap e'bomb95 folded before Flop (didn't bet)
Seat 5: DAMPER_KK collected (€0.10)
Seat 6: deojking folded before Flop (didn't bet)



PokerStars Zoom Hand #257988547679:  Hold'em No Limit (€0.01/€0.02) [ADM ID: M62BA304494E32ST] - 2025/10/04 0:10:53 CET [2025/10/03 18:10:53 ET]
Table 'Sirio' 6-max Seat #1 is the button
Seat 1: Peru91j (€2.39 in chips) 
Seat 2: pepenero11 (€1.86 in chips) 
Seat 3: father2008 (€5.58 in chips) 
Seat 4: caduceus369 (€2.44 in chips) 
Seat 5: cap e'bomb95 (€4.79 in chips) 
Seat 6: Asganaway123 (€1.61 in chips) 
pepenero11: posts small blind €0.01
father2008: posts big blind €0.02
*** HOLE CARDS ***
Dealt to caduceus369 [5s 3s]
caduceus369: folds 
cap e'bomb95: folds 
Asganaway123: calls €0.02
Peru91j: folds 
pepenero11: calls €0.01
father2008: checks 
*** FLOP *** [Jc 8d Ks]
pepenero11: checks 
father2008: checks 
Asganaway123: checks 
*** TURN *** [Jc 8d Ks] [Js]
pepenero11: bets €0.03
father2008: folds 
Asganaway123: calls €0.03
*** RIVER *** [Jc 8d Ks Js] [4d]
pepenero11: bets €0.04
Asganaway123: folds 
Uncalled bet (€0.04) returned to pepenero11
pepenero11 collected €0.12 from pot
pepenero11: doesn't show hand 
*** SUMMARY ***
Total pot €0.12 | Rake €0 
Board [Jc 8d Ks Js 4d]
Seat 1: Peru91j (button) folded before Flop (didn't bet)
Seat 2: pepenero11 (small blind) collected (€0.12)
Seat 3: father2008 (big blind) folded on the Turn
Seat 4: caduceus369 folded before Flop (didn't bet)
Seat 5: cap e'bomb95 folded before Flop (didn't bet)
Seat 6: Asganaway123 folded on the River



PokerStars Zoom Hand #257988546714:  Hold'em No Limit (€0.01/€0.02) [ADM ID: M62BA304494E32ST] - 2025/10/04 0:10:49 CET [2025/10/03 18:10:49 ET]
Table 'Sirio' 6-max Seat #1 is the button
Seat 1: cap e'bomb95 (€4.79 in chips) 
Seat 2: Catania838 (€2.84 in chips) 
Seat 3: criptlux (€2.02 in chips) 
Seat 4: stfuplzudonk (€1.97 in chips) 
Seat 5: bruciapelo (€2.55 in chips) 
Seat 6: caduceus369 (€2.44 in chips) 
Catania838: posts small blind €0.01
criptlux: posts big blind €0.02
*** HOLE CARDS ***
Dealt to caduceus369 [7c 3c]
stfuplzudonk: raises €0.04 to €0.06
bruciapelo: folds 
caduceus369: folds 
cap e'bomb95: folds 
Catania838: calls €0.05
criptlux: calls €0.04
*** FLOP *** [6d 5d 8s]
Catania838: bets €0.02
criptlux: calls €0.02
stfuplzudonk: calls €0.02
*** TURN *** [6d 5d 8s] [4c]
Catania838: checks 
criptlux: checks 
stfuplzudonk: checks 
*** RIVER *** [6d 5d 8s 4c] [8d]
Catania838: bets €2.76 and is all-in
criptlux: folds 
stfuplzudonk: folds 
Uncalled bet (€2.76) returned to Catania838
Catania838 collected €0.23 from pot
Catania838: doesn't show hand 
*** SUMMARY ***
Total pot €0.24 | Rake €0.01 
Board [6d 5d 8s 4c 8d]
Seat 1: cap e'bomb95 (button) folded before Flop (didn't bet)
Seat 2: Catania838 (small blind) collected (€0.23)
Seat 3: criptlux (big blind) folded on the River
Seat 4: stfuplzudonk folded on the River
Seat 5: bruciapelo folded before Flop (didn't bet)
Seat 6: caduceus369 folded before Flop (didn't bet)



PokerStars Zoom Hand #257988555838:  Hold'em No Limit (€0.01/€0.02) [ADM ID: M62BA304494E32ST] - 2025/10/04 0:11:31 CET [2025/10/03 18:11:31 ET]
Table 'Sirio' 6-max Seat #1 is the button
Seat 1: deojking (€1.90 in chips) 
Seat 2: father2008 (€5.56 in chips) 
Seat 3: cap e'bomb95 (€1.41 in chips) 
Seat 4: caduceus369 (€2.45 in chips) 
Seat 5: fantaasso (€3.07 in chips) 
Seat 6: Bristol1964 (€1.11 in chips) 
father2008: posts small blind €0.01
cap e'bomb95: posts big blind €0.02
*** HOLE CARDS ***
Dealt to caduceus369 [5c 9h]
caduceus369: folds 
fantaasso: folds 
Bristol1964: folds 
deojking: folds 
father2008: calls €0.01
cap e'bomb95: checks 
*** FLOP *** [Kd Qc 7d]
father2008: checks 
cap e'bomb95: bets €0.04
father2008: folds 
Uncalled bet (€0.04) returned to cap e'bomb95
cap e'bomb95 collected €0.04 from pot
cap e'bomb95: doesn't show hand 
*** SUMMARY ***
Total pot €0.04 | Rake €0 
Board [Kd Qc 7d]
Seat 1: deojking (button) folded before Flop (didn't bet)
Seat 2: father2008 (small blind) folded on the Flop
Seat 3: cap e'bomb95 (big blind) collected (€0.04)
Seat 4: caduceus369 folded before Flop (didn't bet)
Seat 5: fantaasso folded before Flop (didn't bet)
Seat 6: Bristol1964 folded before Flop (didn't bet)



PokerStars Zoom Hand #257988557267:  Hold'em No Limit (€0.01/€0.02) [ADM ID: M62BA304494E32ST] - 2025/10/04 0:11:37 CET [2025/10/03 18:11:37 ET]
Table 'Sirio' 6-max Seat #1 is the button
Seat 1: DAMPER_KK (€1.95 in chips) 
Seat 2: caduceus369 (€2.45 in chips) 
Seat 3: EasyToRule (€5.25 in chips) 
Seat 4: fantaasso (€3.07 in chips) 
Seat 5: maur62 (€2.37 in chips) 
Seat 6: stfuplzudonk (€1.63 in chips) 
caduceus369: posts small blind €0.01
EasyToRule: posts big blind €0.02
*** HOLE CARDS ***
Dealt to caduceus369 [Qc Kh]
fantaasso: folds 
maur62: folds 
stfuplzudonk: folds 
DAMPER_KK has timed out while disconnected
DAMPER_KK: folds 
caduceus369: calls €0.01
EasyToRule: checks 
*** FLOP *** [8h 8c 9h]
caduceus369: bets €0.02
EasyToRule: folds 
Uncalled bet (€0.02) returned to caduceus369
caduceus369 collected €0.04 from pot
caduceus369: doesn't show hand 
*** SUMMARY ***
Total pot €0.04 | Rake €0 
Board [8h 8c 9h]
Seat 1: DAMPER_KK (button) folded before Flop (didn't bet)
Seat 2: caduceus369 (small blind) collected (€0.04)
Seat 3: EasyToRule (big blind) folded on the Flop
Seat 4: fantaasso folded before Flop (didn't bet)
Seat 5: maur62 folded before Flop (didn't bet)
Seat 6: stfuplzudonk folded before Flop (didn't bet)



PokerStars Zoom Hand #257988565784:  Hold'em No Limit (€0.01/€0.02) [ADM ID: M62BA304494E32ST] - 2025/10/04 0:12:17 CET [2025/10/03 18:12:17 ET]
Table 'Sirio' 6-max Seat #1 is the button
Seat 1: cuzzi68 (€1.88 in chips) 
Seat 2: cap e'bomb95 (€5.84 in chips) 
Seat 3: deojking (€0.97 in chips) 
Seat 4: Poetto65 (€0.76 in chips) 
Seat 5: EasyToRule (€5.23 in chips) 
Seat 6: caduceus369 (€2.47 in chips) 
cap e'bomb95: posts small blind €0.01
deojking: posts big blind €0.02
*** HOLE CARDS ***
Dealt to caduceus369 [Jd Qd]
Poetto65: folds 
EasyToRule: folds 
caduceus369: raises €0.04 to €0.06
cuzzi68: calls €0.06
cap e'bomb95: folds 
deojking: folds 
*** FLOP *** [Kh 5s 4c]
caduceus369: checks 
cuzzi68: checks 
*** TURN *** [Kh 5s 4c] [Qh]
caduceus369: checks 
cuzzi68: bets €0.02
caduceus369: calls €0.02
*** RIVER *** [Kh 5s 4c Qh] [Qc]
caduceus369: checks 
cuzzi68: checks 
*** SHOW DOWN ***
caduceus369: shows [Jd Qd] (three of a kind, Queens)
cuzzi68: mucks hand 
caduceus369 collected €0.18 from pot
*** SUMMARY ***
Total pot €0.19 | Rake €0.01 
Board [Kh 5s 4c Qh Qc]
Seat 1: cuzzi68 (button) mucked [Js Tc]
Seat 2: cap e'bomb95 (small blind) folded before Flop
Seat 3: deojking (big blind) folded before Flop
Seat 4: Poetto65 folded before Flop (didn't bet)
Seat 5: EasyToRule folded before Flop (didn't bet)
Seat 6: caduceus369 showed [Jd Qd] and won (€0.18) with three of a kind, Queens



PokerStars Zoom Hand #257988576482:  Hold'em No Limit (€0.01/€0.02) [ADM ID: M62BA304494E32ST] - 2025/10/04 0:13:06 CET [2025/10/03 18:13:06 ET]
Table 'Sirio' 6-max Seat #1 is the button
Seat 1: criptlux (€1.76 in chips) 
Seat 2: Peru91j (€2.22 in chips) 
Seat 3: caduceus369 (€2.57 in chips) 
Seat 4: bruciapelo (€2.54 in chips) 
Seat 5: stfuplzudonk (€5.25 in chips) 
Seat 6: TeoFeli13 (€0.83 in chips) 
Peru91j: posts small blind €0.01
caduceus369: posts big blind €0.02
*** HOLE CARDS ***
Dealt to caduceus369 [2s Jh]
bruciapelo: folds 
stfuplzudonk: folds 
TeoFeli13: folds 
criptlux: folds 
Peru91j: raises €0.04 to €0.06
caduceus369: folds 
Uncalled bet (€0.04) returned to Peru91j
Peru91j collected €0.04 from pot
Peru91j: doesn't show hand 
*** SUMMARY ***
Total pot €0.04 | Rake €0 
Seat 1: criptlux (button) folded before Flop (didn't bet)
Seat 2: Peru91j (small blind) collected (€0.04)
Seat 3: caduceus369 (big blind) folded before Flop
Seat 4: bruciapelo folded before Flop (didn't bet)
Seat 5: stfuplzudonk folded before Flop (didn't bet)
Seat 6: TeoFeli13 folded before Flop (didn't bet)



PokerStars Zoom Hand #257988574359:  Hold'em No Limit (€0.01/€0.02) [ADM ID: M62BA304494E32ST] - 2025/10/04 0:12:57 CET [2025/10/03 18:12:57 ET]
Table 'Sirio' 6-max Seat #1 is the button
Seat 1: stfuplzudonk (€1.83 in chips) 
Seat 2: deojking (€1.88 in chips) 
Seat 3: Witness85906 (€4.57 in chips) 
Seat 4: caduceus369 (€2.57 in chips) 
Seat 5: cuzzi68 (€1.80 in chips) 
Seat 6: father2008 (€3.90 in chips) 
deojking: posts small blind €0.01
Witness85906: posts big blind €0.02
*** HOLE CARDS ***
Dealt to caduceus369 [7c Jc]
caduceus369: folds 
cuzzi68: calls €0.02
father2008: folds 
stfuplzudonk: calls €0.02
deojking: folds 
Witness85906: checks 
*** FLOP *** [3s Qc 6d]
Witness85906: checks 
cuzzi68: checks 
stfuplzudonk: checks 
*** TURN *** [3s Qc 6d] [7h]
Witness85906: checks 
cuzzi68: bets €0.07
stfuplzudonk: folds 
Witness85906: calls €0.07
*** RIVER *** [3s Qc 6d 7h] [8c]
Witness85906: checks 
cuzzi68: bets €0.20
Witness85906: folds 
Uncalled bet (€0.20) returned to cuzzi68
cuzzi68 collected €0.20 from pot
cuzzi68: doesn't show hand 
*** SUMMARY ***
Total pot €0.21 | Rake €0.01 
Board [3s Qc 6d 7h 8c]
Seat 1: stfuplzudonk (button) folded on the Turn
Seat 2: deojking (small blind) folded before Flop
Seat 3: Witness85906 (big blind) folded on the River
Seat 4: caduceus369 folded before Flop (didn't bet)
Seat 5: cuzzi68 collected (€0.20)
Seat 6: father2008 folded before Flop (didn't bet)



PokerStars Zoom Hand #257988582157:  Hold'em No Limit (€0.01/€0.02) [ADM ID: M62BA304494E32ST] - 2025/10/04 0:13:33 CET [2025/10/03 18:13:33 ET]
Table 'Sirio' 6-max Seat #1 is the button
Seat 1: caduceus369 (€2.55 in chips) 
Seat 2: deojking (€1.37 in chips) 
Seat 3: EasyToRule (€2.21 in chips) 
Seat 4: fantaasso (€4.07 in chips) 
Seat 5: criptlux (€3.69 in chips) 
Seat 6: bruciapelo (€2.52 in chips) 
deojking: posts small blind €0.01
EasyToRule: posts big blind €0.02
*** HOLE CARDS ***
Dealt to caduceus369 [Td 5h]
fantaasso: folds 
criptlux: folds 
bruciapelo: raises €0.04 to €0.06
caduceus369: folds 
deojking: folds 
EasyToRule: folds 
Uncalled bet (€0.04) returned to bruciapelo
bruciapelo collected €0.05 from pot
bruciapelo: doesn't show hand 
*** SUMMARY ***
Total pot €0.05 | Rake €0 
Seat 1: caduceus369 (button) folded before Flop (didn't bet)
Seat 2: deojking (small blind) folded before Flop
Seat 3: EasyToRule (big blind) folded before Flop
Seat 4: fantaasso folded before Flop (didn't bet)
Seat 5: criptlux folded before Flop (didn't bet)
Seat 6: bruciapelo collected (€0.05)



PokerStars Zoom Hand #257988584645:  Hold'em No Limit (€0.01/€0.02) [ADM ID: M62BA304494E32ST] - 2025/10/04 0:13:44 CET [2025/10/03 18:13:44 ET]
Table 'Sirio' 6-max Seat #1 is the button
Seat 1: stfuplzudonk (€5.25 in chips) 
Seat 2: caduceus369 (€2.55 in chips) 
Seat 3: cuzzi68 (€1.91 in chips) 
Seat 4: cap e'bomb95 (€6.41 in chips) 
Seat 5: Catania838 (€0.57 in chips) 
Seat 6: EasyToRule (€2.19 in chips) 
caduceus369: posts small blind €0.01
cuzzi68: posts big blind €0.02
*** HOLE CARDS ***
Dealt to caduceus369 [Ks 8s]
cap e'bomb95: folds 
Catania838: raises €0.08 to €0.10
EasyToRule: folds 
stfuplzudonk: folds 
caduceus369: folds 
cuzzi68: folds 
Uncalled bet (€0.08) returned to Catania838
Catania838 collected €0.05 from pot
Catania838: doesn't show hand 
*** SUMMARY ***
Total pot €0.05 | Rake €0 
Seat 1: stfuplzudonk (button) folded before Flop (didn't bet)
Seat 2: caduceus369 (small blind) folded before Flop
Seat 3: cuzzi68 (big blind) folded before Flop
Seat 4: cap e'bomb95 folded before Flop (didn't bet)
Seat 5: Catania838 collected (€0.05)
Seat 6: EasyToRule folded before Flop (didn't bet)



PokerStars Zoom Hand #257988587710:  Hold'em No Limit (€0.01/€0.02) [ADM ID: M62BA304494E32ST] - 2025/10/04 0:13:58 CET [2025/10/03 18:13:58 ET]
Table 'Sirio' 6-max Seat #1 is the button
Seat 1: EasyToRule (€2.19 in chips) 
Seat 2: criptlux (€3.69 in chips) 
Seat 3: deojking (€2.13 in chips) 
Seat 4: outshined8 (€0.50 in chips) 
Seat 5: CacciatoreAA (€3.11 in chips) 
Seat 6: caduceus369 (€2.54 in chips) 
criptlux: posts small blind €0.01
deojking: posts big blind €0.02
*** HOLE CARDS ***
Dealt to caduceus369 [Ac 3h]
outshined8: folds 
CacciatoreAA: folds 
caduceus369: folds 
EasyToRule: raises €0.02 to €0.04
criptlux: folds 
deojking: folds 
Uncalled bet (€0.02) returned to EasyToRule
EasyToRule collected €0.05 from pot
EasyToRule: doesn't show hand 
*** SUMMARY ***
Total pot €0.05 | Rake €0 
Seat 1: EasyToRule (button) collected (€0.05)
Seat 2: criptlux (small blind) folded before Flop
Seat 3: deojking (big blind) folded before Flop
Seat 4: outshined8 folded before Flop (didn't bet)
Seat 5: CacciatoreAA folded before Flop (didn't bet)
Seat 6: caduceus369 folded before Flop (didn't bet)



PokerStars Zoom Hand #257988590786:  Hold'em No Limit (€0.01/€0.02) [ADM ID: M62BA304494E32ST] - 2025/10/04 0:14:12 CET [2025/10/03 18:14:12 ET]
Table 'Sirio' 6-max Seat #1 is the button
Seat 1: EasyToRule (€5.11 in chips) 
Seat 2: fantaasso (€4.08 in chips) 
Seat 3: cap e'bomb95 (€0.97 in chips) 
Seat 4: deojking (€1.36 in chips) 
Seat 5: caduceus369 (€2.54 in chips) 
Seat 6: criptlux (€3.68 in chips) 
fantaasso: posts small blind €0.01
cap e'bomb95: posts big blind €0.02
*** HOLE CARDS ***
Dealt to caduceus369 [2c Js]
deojking: calls €0.02
caduceus369: folds 
criptlux: folds 
EasyToRule: folds 
fantaasso: folds 
cap e'bomb95: checks 
*** FLOP *** [Td 4s Jd]
cap e'bomb95: checks 
deojking: checks 
*** TURN *** [Td 4s Jd] [Qh]
cap e'bomb95: checks 
deojking: bets €0.04
cap e'bomb95: calls €0.04
*** RIVER *** [Td 4s Jd Qh] [5s]
cap e'bomb95: checks 
deojking: bets €0.11
cap e'bomb95: folds 
Uncalled bet (€0.11) returned to deojking
deojking collected €0.13 from pot
deojking: doesn't show hand 
*** SUMMARY ***
Total pot €0.13 | Rake €0 
Board [Td 4s Jd Qh 5s]
Seat 1: EasyToRule (button) folded before Flop (didn't bet)
Seat 2: fantaasso (small blind) folded before Flop
Seat 3: cap e'bomb95 (big blind) folded on the River
Seat 4: deojking collected (€0.13)
Seat 5: caduceus369 folded before Flop (didn't bet)
Seat 6: criptlux folded before Flop (didn't bet)



PokerStars Zoom Hand #257988595736:  Hold'em No Limit (€0.01/€0.02) [ADM ID: M62BA304494E32ST] - 2025/10/04 0:14:35 CET [2025/10/03 18:14:35 ET]
Table 'Sirio' 6-max Seat #1 is the button
Seat 1: caduceus369 (€2.52 in chips) 
Seat 2: father2008 (€5.45 in chips) 
Seat 3: stfuplzudonk (€1.57 in chips) 
Seat 4: cap e'bomb95 (€4.69 in chips) 
Seat 5: trillycata (€0.70 in chips) 
Seat 6: Poetto65 (€0.88 in chips) 
father2008: posts small blind €0.01
stfuplzudonk: posts big blind €0.02
*** HOLE CARDS ***
Dealt to caduceus369 [9h 5h]
cap e'bomb95: folds 
trillycata: folds 
Poetto65: folds 
caduceus369: folds 
father2008: calls €0.01
stfuplzudonk: raises €0.04 to €0.06
father2008: calls €0.04
*** FLOP *** [7c 3d 6d]
father2008: checks 
stfuplzudonk: checks 
*** TURN *** [7c 3d 6d] [As]
father2008: checks 
stfuplzudonk: checks 
*** RIVER *** [7c 3d 6d As] [2c]
father2008: checks 
stfuplzudonk: bets €0.06
father2008: folds 
Uncalled bet (€0.06) returned to stfuplzudonk
stfuplzudonk collected €0.12 from pot
stfuplzudonk: doesn't show hand 
*** SUMMARY ***
Total pot €0.12 | Rake €0 
Board [7c 3d 6d As 2c]
Seat 1: caduceus369 (button) folded before Flop (didn't bet)
Seat 2: father2008 (small blind) folded on the River
Seat 3: stfuplzudonk (big blind) collected (€0.12)
Seat 4: cap e'bomb95 folded before Flop (didn't bet)
Seat 5: trillycata folded before Flop (didn't bet)
Seat 6: Poetto65 folded before Flop (didn't bet)



PokerStars Zoom Hand #257988592650:  Hold'em No Limit (€0.01/€0.02) [ADM ID: M62BA304494E32ST] - 2025/10/04 0:14:21 CET [2025/10/03 18:14:21 ET]
Table 'Sirio' 6-max Seat #1 is the button
Seat 1: Catania838 (€2.04 in chips) 
Seat 2: cuzzi68 (€1.89 in chips) 
Seat 3: caduceus369 (€2.54 in chips) 
Seat 4: outshined8 (€0.47 in chips) 
Seat 5: Ceribelli1705 (€3.04 in chips) 
Seat 6: michy0757 (€2.40 in chips) 
cuzzi68: posts small blind €0.01
caduceus369: posts big blind €0.02
*** HOLE CARDS ***
Dealt to caduceus369 [Ts Jh]
outshined8: folds 
Ceribelli1705: calls €0.02
michy0757: raises €0.07 to €0.09
Catania838 has timed out
Catania838: folds 
cuzzi68: folds 
caduceus369: folds 
Ceribelli1705: folds 
Uncalled bet (€0.07) returned to michy0757
michy0757 collected €0.07 from pot
michy0757: doesn't show hand 
*** SUMMARY ***
Total pot €0.07 | Rake €0 
Seat 1: Catania838 (button) folded before Flop (didn't bet)
Seat 2: cuzzi68 (small blind) folded before Flop
Seat 3: caduceus369 (big blind) folded before Flop
Seat 4: outshined8 folded before Flop (didn't bet)
Seat 5: Ceribelli1705 folded before Flop
Seat 6: michy0757 collected (€0.07)



PokerStars Zoom Hand #257988597070:  Hold'em No Limit (€0.01/€0.02) [ADM ID: M62BA304494E32ST] - 2025/10/04 0:14:42 CET [2025/10/03 18:14:42 ET]
Table 'Sirio' 6-max Seat #1 is the button
Seat 1: maur62 (€0.20 in chips) 
Seat 2: EasyToRule (€2.23 in chips) 
Seat 3: criptlux (€3.68 in chips) 
Seat 4: caduceus369 (€2.52 in chips) 
Seat 5: cap e'bomb95 (€4.69 in chips) 
Seat 6: cesaretto23 (€0.81 in chips) 
EasyToRule: posts small blind €0.01
criptlux: posts big blind €0.02
*** HOLE CARDS ***
Dealt to caduceus369 [5h 5s]
caduceus369: calls €0.02
cap e'bomb95: folds 
cesaretto23: calls €0.02
maur62: folds 
EasyToRule: calls €0.01
criptlux: checks 
*** FLOP *** [4h 2c 7s]
EasyToRule: checks 
criptlux: checks 
caduceus369: checks 
cesaretto23: checks 
*** TURN *** [4h 2c 7s] [Qs]
EasyToRule: checks 
criptlux: bets €0.02
caduceus369: folds 
cesaretto23: folds 
EasyToRule: folds 
Uncalled bet (€0.02) returned to criptlux
criptlux collected €0.08 from pot
criptlux: doesn't show hand 
*** SUMMARY ***
Total pot €0.08 | Rake €0 
Board [4h 2c 7s Qs]
Seat 1: maur62 (button) folded before Flop (didn't bet)
Seat 2: EasyToRule (small blind) folded on the Turn
Seat 3: criptlux (big blind) collected (€0.08)
Seat 4: caduceus369 folded on the Turn
Seat 5: cap e'bomb95 folded before Flop (didn't bet)
Seat 6: cesaretto23 folded on the Turn



PokerStars Zoom Hand #257988615077:  Hold'em No Limit (€0.01/€0.02) [ADM ID: M62BA304494E32ST] - 2025/10/04 0:16:06 CET [2025/10/03 18:16:06 ET]
Table 'Sirio' 6-max Seat #1 is the button
Seat 1: EasyToRule (€2.21 in chips) 
Seat 2: maur62 (€2.53 in chips) 
Seat 3: workman75 (€2.34 in chips) 
Seat 4: Asganaway123 (€1.63 in chips) 
Seat 5: caduceus369 (€2.49 in chips) 
Seat 6: deojking (€2.02 in chips) 
maur62: posts small blind €0.01
workman75: posts big blind €0.02
*** HOLE CARDS ***
Dealt to caduceus369 [Kc Qc]
Asganaway123: folds 
caduceus369: raises €0.04 to €0.06
deojking: folds 
EasyToRule: folds 
maur62: folds 
workman75: folds 
Uncalled bet (€0.04) returned to caduceus369
caduceus369 collected €0.05 from pot
caduceus369: doesn't show hand 
*** SUMMARY ***
Total pot €0.05 | Rake €0 
Seat 1: EasyToRule (button) folded before Flop (didn't bet)
Seat 2: maur62 (small blind) folded before Flop
Seat 3: workman75 (big blind) folded before Flop
Seat 4: Asganaway123 folded before Flop (didn't bet)
Seat 5: caduceus369 collected (€0.05)
Seat 6: deojking folded before Flop (didn't bet)



PokerStars Zoom Hand #257988609258:  Hold'em No Limit (€0.01/€0.02) [ADM ID: M62BA304494E32ST] - 2025/10/04 0:15:39 CET [2025/10/03 18:15:39 ET]
Table 'Sirio' 6-max Seat #1 is the button
Seat 1: cap e'bomb95 (€4.91 in chips) 
Seat 2: Peru91j (€2.63 in chips) 
Seat 3: michy0757 (€2.48 in chips) 
Seat 4: caduceus369 (€2.50 in chips) 
Seat 5: cuzzi68 (€1.85 in chips) 
Seat 6: Ceribelli1705 (€2.73 in chips) 
Peru91j: posts small blind €0.01
michy0757: posts big blind €0.02
*** HOLE CARDS ***
Dealt to caduceus369 [2c Tc]
caduceus369: folds 
cuzzi68: raises €0.02 to €0.04
Ceribelli1705: folds 
cap e'bomb95: folds 
Peru91j: folds 
michy0757: calls €0.02
*** FLOP *** [Jh 7h 4c]
michy0757: bets €0.02
cuzzi68: raises €0.04 to €0.06
michy0757: calls €0.04
*** TURN *** [Jh 7h 4c] [5s]
michy0757: checks 
cuzzi68: bets €0.06
michy0757: calls €0.06
*** RIVER *** [Jh 7h 4c 5s] [6c]
michy0757: checks 
cuzzi68: checks 
*** SHOW DOWN ***
michy0757: shows [As 4d] (a pair of Fours)
cuzzi68: shows [9s Js] (a pair of Jacks)
cuzzi68 collected €0.32 from pot
*** SUMMARY ***
Total pot €0.33 | Rake €0.01 
Board [Jh 7h 4c 5s 6c]
Seat 1: cap e'bomb95 (button) folded before Flop (didn't bet)
Seat 2: Peru91j (small blind) folded before Flop
Seat 3: michy0757 (big blind) showed [As 4d] and lost with a pair of Fours
Seat 4: caduceus369 folded before Flop (didn't bet)
Seat 5: cuzzi68 showed [9s Js] and won (€0.32) with a pair of Jacks
Seat 6: Ceribelli1705 folded before Flop (didn't bet)



PokerStars Zoom Hand #257988611125:  Hold'em No Limit (€0.01/€0.02) [ADM ID: M62BA304494E32ST] - 2025/10/04 0:15:47 CET [2025/10/03 18:15:47 ET]
Table 'Sirio' 6-max Seat #1 is the button
Seat 1: fantaasso (€4.25 in chips) 
Seat 2: caduceus369 (€2.50 in chips) 
Seat 3: colosso2022 (€2.04 in chips) 
Seat 4: Mabrac55 (€1.97 in chips) 
Seat 5: stfuplzudonk (€4.04 in chips) 
Seat 6: IsyP99 (€1.27 in chips) 
caduceus369: posts small blind €0.01
colosso2022: posts big blind €0.02
*** HOLE CARDS ***
Dealt to caduceus369 [5d 8h]
Mabrac55: raises €0.02 to €0.04
stfuplzudonk: calls €0.04
IsyP99: folds 
fantaasso: folds 
caduceus369: folds 
colosso2022: raises €0.02 to €0.06
Mabrac55: calls €0.02
stfuplzudonk: calls €0.02
*** FLOP *** [8c 6s As]
colosso2022: bets €0.18
Mabrac55: folds 
stfuplzudonk: calls €0.18
*** TURN *** [8c 6s As] [Ad]
colosso2022: bets €0.02
stfuplzudonk: calls €0.02
*** RIVER *** [8c 6s As Ad] [5c]
colosso2022: bets €0.02
stfuplzudonk: raises €0.60 to €0.62
colosso2022: folds 
Uncalled bet (€0.60) returned to stfuplzudonk
stfuplzudonk collected €0.60 from pot
stfuplzudonk: doesn't show hand 
*** SUMMARY ***
Total pot €0.63 | Rake €0.03 
Board [8c 6s As Ad 5c]
Seat 1: fantaasso (button) folded before Flop (didn't bet)
Seat 2: caduceus369 (small blind) folded before Flop
Seat 3: colosso2022 (big blind) folded on the River
Seat 4: Mabrac55 folded on the Flop
Seat 5: stfuplzudonk collected (€0.60)
Seat 6: IsyP99 folded before Flop (didn't bet)



PokerStars Zoom Hand #257988612398:  Hold'em No Limit (€0.01/€0.02) [ADM ID: M62BA304494E32ST] - 2025/10/04 0:15:53 CET [2025/10/03 18:15:53 ET]
Table 'Sirio' 6-max Seat #1 is the button
Seat 1: Witness85906 (€4.88 in chips) 
Seat 2: Ceribelli1705 (€2.73 in chips) 
Seat 3: cap e'bomb95 (€4.91 in chips) 
Seat 4: trillycata (€0.64 in chips) 
Seat 5: Peru91j (€2.39 in chips) 
Seat 6: caduceus369 (€2.49 in chips) 
Ceribelli1705: posts small blind €0.01
cap e'bomb95: posts big blind €0.02
*** HOLE CARDS ***
Dealt to caduceus369 [5d Qs]
trillycata: folds 
Peru91j: raises €0.04 to €0.06
caduceus369: folds 
Witness85906: calls €0.06
Ceribelli1705: calls €0.05
cap e'bomb95: folds 
*** FLOP *** [5h 8s Jh]
Ceribelli1705: checks 
Peru91j: checks 
Witness85906: checks 
*** TURN *** [5h 8s Jh] [6c]
Ceribelli1705: bets €0.06
Peru91j: folds 
Witness85906: calls €0.06
*** RIVER *** [5h 8s Jh 6c] [Qd]
Ceribelli1705: checks 
Witness85906: checks 
*** SHOW DOWN ***
Ceribelli1705: shows [3c 5c] (a pair of Fives)
Witness85906: shows [9c 8c] (a pair of Eights)
Witness85906 collected €0.31 from pot
*** SUMMARY ***
Total pot €0.32 | Rake €0.01 
Board [5h 8s Jh 6c Qd]
Seat 1: Witness85906 (button) showed [9c 8c] and won (€0.31) with a pair of Eights
Seat 2: Ceribelli1705 (small blind) showed [3c 5c] and lost with a pair of Fives
Seat 3: cap e'bomb95 (big blind) folded before Flop
Seat 4: trillycata folded before Flop (didn't bet)
Seat 5: Peru91j folded on the Turn
Seat 6: caduceus369 folded before Flop (didn't bet)



PokerStars Zoom Hand #257988617884:  Hold'em No Limit (€0.01/€0.02) [ADM ID: M62BA304494E32ST] - 2025/10/04 0:16:19 CET [2025/10/03 18:16:19 ET]
Table 'Sirio' 6-max Seat #1 is the button
Seat 1: stfuplzudonk (€1.70 in chips) 
Seat 2: deojking (€1.37 in chips) 
Seat 3: caduceus369 (€2.52 in chips) 
Seat 4: fantaasso (€2.89 in chips) 
Seat 5: Asganaway123 (€1.63 in chips) 
Seat 6: maur62 (€0.19 in chips) 
deojking: posts small blind €0.01
caduceus369: posts big blind €0.02
*** HOLE CARDS ***
Dealt to caduceus369 [Qd 9c]
fantaasso: folds 
Asganaway123: folds 
maur62: folds 
stfuplzudonk: raises €0.02 to €0.04
deojking: folds 
caduceus369: calls €0.02
*** FLOP *** [Ks Qh Qc]
caduceus369: checks 
stfuplzudonk: checks 
*** TURN *** [Ks Qh Qc] [9d]
caduceus369: bets €0.02
stfuplzudonk: folds 
Uncalled bet (€0.02) returned to caduceus369
caduceus369 collected €0.09 from pot
caduceus369: doesn't show hand 
*** SUMMARY ***
Total pot €0.09 | Rake €0 
Board [Ks Qh Qc 9d]
Seat 1: stfuplzudonk (button) folded on the Turn
Seat 2: deojking (small blind) folded before Flop
Seat 3: caduceus369 (big blind) collected (€0.09)
Seat 4: fantaasso folded before Flop (didn't bet)
Seat 5: Asganaway123 folded before Flop (didn't bet)
Seat 6: maur62 folded before Flop (didn't bet)



PokerStars Zoom Hand #257988625529:  Hold'em No Limit (€0.01/€0.02) [ADM ID: M62BA304494E32ST] - 2025/10/04 0:16:55 CET [2025/10/03 18:16:55 ET]
Table 'Sirio' 6-max Seat #1 is the button
Seat 1: caduceus369 (€2.57 in chips) 
Seat 2: Mabrac55 (€1.90 in chips) 
Seat 3: CacciatoreAA (€2.02 in chips) 
Seat 4: cap e'bomb95 (€1.72 in chips) 
Seat 5: Witness85906 (€5.06 in chips) 
Seat 6: workman75 (€2.28 in chips) 
Mabrac55: posts small blind €0.01
CacciatoreAA: posts big blind €0.02
*** HOLE CARDS ***
Dealt to caduceus369 [Kc Kh]
cap e'bomb95: raises €0.03 to €0.05
Witness85906: folds 
workman75: calls €0.05
caduceus369: raises €0.13 to €0.18
Mabrac55: folds 
CacciatoreAA: folds 
cap e'bomb95: calls €0.13
workman75: calls €0.13
*** FLOP *** [Ad 4d 9s]
cap e'bomb95: checks 
workman75: checks 
caduceus369: checks 
*** TURN *** [Ad 4d 9s] [Ks]
cap e'bomb95: bets €0.24
workman75: folds 
caduceus369: calls €0.24
*** RIVER *** [Ad 4d 9s Ks] [Ts]
cap e'bomb95: checks 
caduceus369: bets €1
cap e'bomb95: folds 
Uncalled bet (€1) returned to caduceus369
caduceus369 collected €1 from pot
caduceus369: doesn't show hand 
*** SUMMARY ***
Total pot €1.05 | Rake €0.05 
Board [Ad 4d 9s Ks Ts]
Seat 1: caduceus369 (button) collected (€1)
Seat 2: Mabrac55 (small blind) folded before Flop
Seat 3: CacciatoreAA (big blind) folded before Flop
Seat 4: cap e'bomb95 folded on the River
Seat 5: Witness85906 folded before Flop (didn't bet)
Seat 6: workman75 folded on the Turn



PokerStars Zoom Hand #257988640389:  Hold'em No Limit (€0.01/€0.02) [ADM ID: M62BA304494E32ST] - 2025/10/04 0:18:04 CET [2025/10/03 18:18:04 ET]
Table 'Sirio' 6-max Seat #1 is the button
Seat 1: satga155 (€1.24 in chips) 
Seat 2: cesaretto23 (€1.57 in chips) 
Seat 3: CacciatoreAA (€2.28 in chips) 
Seat 4: caduceus369 (€3.14 in chips) 
Seat 5: fantaasso (€4.31 in chips) 
Seat 6: stfuplzudonk (€5.31 in chips) 
cesaretto23: posts small blind €0.01
CacciatoreAA: posts big blind €0.02
*** HOLE CARDS ***
Dealt to caduceus369 [Ad Js]
caduceus369: raises €0.04 to €0.06
fantaasso: folds 
stfuplzudonk: folds 
satga155: folds 
cesaretto23: folds 
CacciatoreAA: folds 
Uncalled bet (€0.04) returned to caduceus369
caduceus369 collected €0.05 from pot
caduceus369: doesn't show hand 
*** SUMMARY ***
Total pot €0.05 | Rake €0 
Seat 1: satga155 (button) folded before Flop (didn't bet)
Seat 2: cesaretto23 (small blind) folded before Flop
Seat 3: CacciatoreAA (big blind) folded before Flop
Seat 4: caduceus369 collected (€0.05)
Seat 5: fantaasso folded before Flop (didn't bet)
Seat 6: stfuplzudonk folded before Flop (didn't bet)



PokerStars Zoom Hand #257988638377:  Hold'em No Limit (€0.01/€0.02) [ADM ID: M62BA304494E32ST] - 2025/10/04 0:17:55 CET [2025/10/03 18:17:55 ET]
Table 'Sirio' 6-max Seat #1 is the button
Seat 1: michy0757 (€2.31 in chips) 
Seat 2: caduceus369 (€3.15 in chips) 
Seat 3: Peru91j (€2.30 in chips) 
Seat 4: workman75 (€2.08 in chips) 
Seat 5: pepenero11 (€0.73 in chips) 
Seat 6: cap e'bomb95 (€4.83 in chips) 
caduceus369: posts small blind €0.01
Peru91j: posts big blind €0.02
*** HOLE CARDS ***
Dealt to caduceus369 [5d Jc]
workman75: folds 
pepenero11: calls €0.02
cap e'bomb95: folds 
michy0757: folds 
caduceus369: folds 
Peru91j: checks 
*** FLOP *** [5h Kd 9d]
Peru91j: checks 
pepenero11: bets €0.05
Peru91j: calls €0.05
*** TURN *** [5h Kd 9d] [Ts]
Peru91j: checks 
pepenero11: bets €0.02
Peru91j: calls €0.02
*** RIVER *** [5h Kd 9d Ts] [6c]
Peru91j: checks 
pepenero11: bets €0.09
Peru91j: folds 
Uncalled bet (€0.09) returned to pepenero11
pepenero11 collected €0.18 from pot
pepenero11: doesn't show hand 
*** SUMMARY ***
Total pot €0.19 | Rake €0.01 
Board [5h Kd 9d Ts 6c]
Seat 1: michy0757 (button) folded before Flop (didn't bet)
Seat 2: caduceus369 (small blind) folded before Flop
Seat 3: Peru91j (big blind) folded on the River
Seat 4: workman75 folded before Flop (didn't bet)
Seat 5: pepenero11 collected (€0.18)
Seat 6: cap e'bomb95 folded before Flop (didn't bet)



PokerStars Zoom Hand #257988645164:  Hold'em No Limit (€0.01/€0.02) [ADM ID: M62BA304494E32ST] - 2025/10/04 0:18:26 CET [2025/10/03 18:18:26 ET]
Table 'Sirio' 6-max Seat #1 is the button
Seat 1: LentaM3nte (€3.21 in chips) 
Seat 2: EasyToRule (€2.91 in chips) 
Seat 3: KillByte00 (€2.18 in chips) 
Seat 4: CacciatoreAA (€2.25 in chips) 
Seat 5: Witness85906 (€5.03 in chips) 
Seat 6: caduceus369 (€3.17 in chips) 
EasyToRule: posts small blind €0.01
KillByte00: posts big blind €0.02
*** HOLE CARDS ***
Dealt to caduceus369 [6d Qh]
LentaM3nte is disconnected 
CacciatoreAA: folds 
Witness85906: folds 
caduceus369: folds 
LentaM3nte has timed out while disconnected
LentaM3nte: folds 
EasyToRule: raises €0.04 to €0.06
KillByte00: folds 
Uncalled bet (€0.04) returned to EasyToRule
EasyToRule collected €0.04 from pot
EasyToRule: doesn't show hand 
*** SUMMARY ***
Total pot €0.04 | Rake €0 
Seat 1: LentaM3nte (button) folded before Flop (didn't bet)
Seat 2: EasyToRule (small blind) collected (€0.04)
Seat 3: KillByte00 (big blind) folded before Flop
Seat 4: CacciatoreAA folded before Flop (didn't bet)
Seat 5: Witness85906 folded before Flop (didn't bet)
Seat 6: caduceus369 folded before Flop (didn't bet)



PokerStars Zoom Hand #257988639788:  Hold'em No Limit (€0.01/€0.02) [ADM ID: M62BA304494E32ST] - 2025/10/04 0:18:01 CET [2025/10/03 18:18:01 ET]
Table 'Sirio' 6-max Seat #1 is the button
Seat 1: Poetto65 (€0.67 in chips) 
Seat 2: Catania838 (€3.01 in chips) 
Seat 3: michy0757 (€2.31 in chips) 
Seat 4: Witness85906 (€5.04 in chips) 
Seat 5: caduceus369 (€3.14 in chips) 
Seat 6: cap e'bomb95 (€1.30 in chips) 
Catania838: posts small blind €0.01
michy0757: posts big blind €0.02
*** HOLE CARDS ***
Dealt to caduceus369 [4s Qh]
Witness85906: folds 
caduceus369: folds 
cap e'bomb95: folds 
Poetto65: raises €0.02 to €0.04
Catania838: folds 
michy0757: calls €0.02
*** FLOP *** [3h 8c 8s]
michy0757: checks 
Poetto65: bets €0.09
michy0757: calls €0.09
*** TURN *** [3h 8c 8s] [As]
michy0757: checks 
Poetto65: checks 
*** RIVER *** [3h 8c 8s As] [Th]
michy0757: bets €0.10
Poetto65: raises €0.10 to €0.20
michy0757: folds 
Uncalled bet (€0.10) returned to Poetto65
Poetto65 collected €0.45 from pot
Poetto65: doesn't show hand 
*** SUMMARY ***
Total pot €0.47 | Rake €0.02 
Board [3h 8c 8s As Th]
Seat 1: Poetto65 (button) collected (€0.45)
Seat 2: Catania838 (small blind) folded before Flop
Seat 3: michy0757 (big blind) folded on the River
Seat 4: Witness85906 folded before Flop (didn't bet)
Seat 5: caduceus369 folded before Flop (didn't bet)
Seat 6: cap e'bomb95 folded before Flop (didn't bet)



PokerStars Zoom Hand #257988646885:  Hold'em No Limit (€0.01/€0.02) [ADM ID: M62BA304494E32ST] - 2025/10/04 0:18:34 CET [2025/10/03 18:18:34 ET]
Table 'Sirio' 6-max Seat #1 is the button
Seat 1: Witness85906 (€5.03 in chips) 
Seat 2: maur62 (€0.95 in chips) 
Seat 3: caduceus369 (€3.17 in chips) 
Seat 4: Davi3231973 (€0.44 in chips) 
Seat 5: Catania838 (€0.80 in chips) 
Seat 6: Peru91j (€2.21 in chips) 
maur62: posts small blind €0.01
caduceus369: posts big blind €0.02
*** HOLE CARDS ***
Dealt to caduceus369 [4s 8h]
Davi3231973: calls €0.02
Catania838: folds 
Peru91j: folds 
Witness85906: folds 
maur62: folds 
caduceus369: checks 
*** FLOP *** [Ac Ad 9c]
caduceus369: checks 
Davi3231973: bets €0.02
caduceus369: folds 
Uncalled bet (€0.02) returned to Davi3231973
Davi3231973 collected €0.05 from pot
Davi3231973: doesn't show hand 
*** SUMMARY ***
Total pot €0.05 | Rake €0 
Board [Ac Ad 9c]
Seat 1: Witness85906 (button) folded before Flop (didn't bet)
Seat 2: maur62 (small blind) folded before Flop
Seat 3: caduceus369 (big blind) folded on the Flop
Seat 4: Davi3231973 collected (€0.05)
Seat 5: Catania838 folded before Flop (didn't bet)
Seat 6: Peru91j folded before Flop (didn't bet)



PokerStars Zoom Hand #257988653216:  Hold'em No Limit (€0.01/€0.02) [ADM ID: M62BA304494E32ST] - 2025/10/04 0:19:04 CET [2025/10/03 18:19:04 ET]
Table 'Sirio' 6-max Seat #1 is the button
Seat 1: Giova8427 (€0.68 in chips) 
Seat 2: father2008 (€5.17 in chips) 
Seat 3: cap e'bomb95 (€4.77 in chips) 
Seat 4: Peru91j (€2.56 in chips) 
Seat 5: caduceus369 (€3.15 in chips) 
Seat 6: SKERZA (€1.97 in chips) 
father2008: posts small blind €0.01
cap e'bomb95: posts big blind €0.02
*** HOLE CARDS ***
Dealt to caduceus369 [9h 6d]
Peru91j: raises €0.04 to €0.06
caduceus369: folds 
SKERZA: calls €0.06
Giova8427: raises €0.62 to €0.68 and is all-in
father2008: folds 
cap e'bomb95: folds 
Peru91j: folds 
SKERZA: folds 
Uncalled bet (€0.62) returned to Giova8427
Giova8427 collected €0.21 from pot
Giova8427: doesn't show hand 
*** SUMMARY ***
Total pot €0.21 | Rake €0 
Seat 1: Giova8427 (button) collected (€0.21)
Seat 2: father2008 (small blind) folded before Flop
Seat 3: cap e'bomb95 (big blind) folded before Flop
Seat 4: Peru91j folded before Flop
Seat 5: caduceus369 folded before Flop (didn't bet)
Seat 6: SKERZA folded before Flop



PokerStars Zoom Hand #257988654496:  Hold'em No Limit (€0.01/€0.02) [ADM ID: M62BA304494E32ST] - 2025/10/04 0:19:10 CET [2025/10/03 18:19:10 ET]
Table 'Sirio' 6-max Seat #1 is the button
Seat 1: caduceus369 (€3.15 in chips) 
Seat 2: cuzzi68 (€1.55 in chips) 
Seat 3: outshined8 (€0.75 in chips) 
Seat 4: stfuplzudonk (€5.78 in chips) 
Seat 5: Peru91j (€2.20 in chips) 
Seat 6: assomatto308 (€1.04 in chips) 
cuzzi68: posts small blind €0.01
outshined8: posts big blind €0.02
*** HOLE CARDS ***
Dealt to caduceus369 [3s 2c]
stfuplzudonk: folds 
Peru91j: folds 
assomatto308: calls €0.02
caduceus369: folds 
cuzzi68: folds 
outshined8: checks 
*** FLOP *** [8s 9s Kd]
outshined8: bets €0.03
assomatto308: folds 
Uncalled bet (€0.03) returned to outshined8
outshined8 collected €0.05 from pot
outshined8: doesn't show hand 
*** SUMMARY ***
Total pot €0.05 | Rake €0 
Board [8s 9s Kd]
Seat 1: caduceus369 (button) folded before Flop (didn't bet)
Seat 2: cuzzi68 (small blind) folded before Flop
Seat 3: outshined8 (big blind) collected (€0.05)
Seat 4: stfuplzudonk folded before Flop (didn't bet)
Seat 5: Peru91j folded before Flop (didn't bet)
Seat 6: assomatto308 folded on the Flop



PokerStars Zoom Hand #257988655339:  Hold'em No Limit (€0.01/€0.02) [ADM ID: M62BA304494E32ST] - 2025/10/04 0:19:14 CET [2025/10/03 18:19:14 ET]
Table 'Sirio' 6-max Seat #1 is the button
Seat 1: 0inthemoney (€2.02 in chips) 
Seat 2: Asganaway123 (€1.50 in chips) 
Seat 3: KillByte00 (€2.15 in chips) 
Seat 4: Catania838 (€2.98 in chips) 
Seat 5: cuzzi68 (€1.54 in chips) 
Seat 6: caduceus369 (€3.15 in chips) 
Asganaway123: posts small blind €0.01
KillByte00: posts big blind €0.02
*** HOLE CARDS ***
Dealt to caduceus369 [4c 4s]
Catania838: calls €0.02
cuzzi68: folds 
caduceus369: calls €0.02
0inthemoney: raises €0.09 to €0.11
Asganaway123: folds 
KillByte00: folds 
Catania838: folds 
caduceus369: folds 
Uncalled bet (€0.09) returned to 0inthemoney
0inthemoney collected €0.09 from pot
0inthemoney: doesn't show hand 
*** SUMMARY ***
Total pot €0.09 | Rake €0 
Seat 1: 0inthemoney (button) collected (€0.09)
Seat 2: Asganaway123 (small blind) folded before Flop
Seat 3: KillByte00 (big blind) folded before Flop
Seat 4: Catania838 folded before Flop
Seat 5: cuzzi68 folded before Flop (didn't bet)
Seat 6: caduceus369 folded before Flop



PokerStars Zoom Hand #257988660948:  Hold'em No Limit (€0.01/€0.02) [ADM ID: M62BA304494E32ST] - 2025/10/04 0:19:40 CET [2025/10/03 18:19:40 ET]
Table 'Sirio' 6-max Seat #1 is the button
Seat 1: The clansman77 (€0.77 in chips) 
Seat 2: caduceus369 (€3.13 in chips) 
Seat 3: cuzzi68 (€1.53 in chips) 
Seat 4: SKERZA (€1.94 in chips) 
Seat 5: EasyToRule (€3.06 in chips) 
Seat 6: Peru91j (€2.20 in chips) 
caduceus369: posts small blind €0.01
cuzzi68: posts big blind €0.02
*** HOLE CARDS ***
Dealt to caduceus369 [Ts Qc]
SKERZA: raises €0.02 to €0.04
EasyToRule: folds 
Peru91j: folds 
The clansman77: folds 
caduceus369: folds 
cuzzi68: calls €0.02
*** FLOP *** [3s 6s 3h]
cuzzi68: checks 
SKERZA: bets €0.05
cuzzi68: folds 
Uncalled bet (€0.05) returned to SKERZA
SKERZA collected €0.09 from pot
SKERZA: doesn't show hand 
*** SUMMARY ***
Total pot €0.09 | Rake €0 
Board [3s 6s 3h]
Seat 1: The clansman77 (button) folded before Flop (didn't bet)
Seat 2: caduceus369 (small blind) folded before Flop
Seat 3: cuzzi68 (big blind) folded on the Flop
Seat 4: SKERZA collected (€0.09)
Seat 5: EasyToRule folded before Flop (didn't bet)
Seat 6: Peru91j folded before Flop (didn't bet)



PokerStars Zoom Hand #257988659633:  Hold'em No Limit (€0.01/€0.02) [ADM ID: M62BA304494E32ST] - 2025/10/04 0:19:34 CET [2025/10/03 18:19:34 ET]
Table 'Sirio' 6-max Seat #1 is the button
Seat 1: maur62 (€1.19 in chips) 
Seat 2: 0inthemoney (€2.09 in chips) 
Seat 3: Witness85906 (€5.77 in chips) 
Seat 4: caduceus369 (€3.13 in chips) 
Seat 5: Davi3231973 (€0.45 in chips) 
Seat 6: father2008 (€5.14 in chips) 
0inthemoney: posts small blind €0.01
Witness85906: posts big blind €0.02
*** HOLE CARDS ***
Dealt to caduceus369 [2c Ah]
caduceus369: folds 
Davi3231973: calls €0.02
father2008: folds 
maur62: folds 
0inthemoney: calls €0.01
Witness85906: raises €0.48 to €0.50
Davi3231973: folds 
0inthemoney: folds 
Uncalled bet (€0.48) returned to Witness85906
Witness85906 collected €0.06 from pot
Witness85906: doesn't show hand 
*** SUMMARY ***
Total pot €0.06 | Rake €0 
Seat 1: maur62 (button) folded before Flop (didn't bet)
Seat 2: 0inthemoney (small blind) folded before Flop
Seat 3: Witness85906 (big blind) collected (€0.06)
Seat 4: caduceus369 folded before Flop (didn't bet)
Seat 5: Davi3231973 folded before Flop
Seat 6: father2008 folded before Flop (didn't bet)



PokerStars Zoom Hand #257988661954:  Hold'em No Limit (€0.01/€0.02) [ADM ID: M62BA304494E32ST] - 2025/10/04 0:19:45 CET [2025/10/03 18:19:45 ET]
Table 'Sirio' 6-max Seat #1 is the button
Seat 1: father2008 (€5.14 in chips) 
Seat 2: Giova8427 (€0.81 in chips) 
Seat 3: caduceus369 (€3.12 in chips) 
Seat 4: outshined8 (€0.77 in chips) 
Seat 5: fantaasso (€4.84 in chips) 
Seat 6: cap e'bomb95 (€1.17 in chips) 
Giova8427: posts small blind €0.01
caduceus369: posts big blind €0.02
*** HOLE CARDS ***
Dealt to caduceus369 [2h 9c]
outshined8: folds 
fantaasso: folds 
cap e'bomb95: folds 
father2008: raises €0.04 to €0.06
Giova8427: calls €0.05
caduceus369: folds 
*** FLOP *** [As 2d 8d]
Giova8427: checks 
father2008: checks 
*** TURN *** [As 2d 8d] [7c]
Giova8427: checks 
father2008: checks 
*** RIVER *** [As 2d 8d 7c] [Ks]
Giova8427: bets €0.07
father2008: folds 
Uncalled bet (€0.07) returned to Giova8427
Giova8427 collected €0.14 from pot
Giova8427: doesn't show hand 
*** SUMMARY ***
Total pot €0.14 | Rake €0 
Board [As 2d 8d 7c Ks]
Seat 1: father2008 (button) folded on the River
Seat 2: Giova8427 (small blind) collected (€0.14)
Seat 3: caduceus369 (big blind) folded before Flop
Seat 4: outshined8 folded before Flop (didn't bet)
Seat 5: fantaasso folded before Flop (didn't bet)
Seat 6: cap e'bomb95 folded before Flop (didn't bet)



PokerStars Zoom Hand #257988666556:  Hold'em No Limit (€0.01/€0.02) [ADM ID: M62BA304494E32ST] - 2025/10/04 0:20:06 CET [2025/10/03 18:20:06 ET]
Table 'Sirio' 6-max Seat #1 is the button
Seat 1: workman75 (€1.91 in chips) 
Seat 2: wiola3922 (€1.07 in chips) 
Seat 3: cap e'bomb95 (€4.63 in chips) 
Seat 4: caduceus369 (€3.10 in chips) 
Seat 5: assomatto308 (€1.27 in chips) 
Seat 6: Witness85906 (€5.81 in chips) 
wiola3922: posts small blind €0.01
cap e'bomb95: posts big blind €0.02
*** HOLE CARDS ***
Dealt to caduceus369 [8h 4s]
caduceus369: folds 
assomatto308 is disconnected 
assomatto308 has timed out while disconnected
assomatto308: folds 
Witness85906: folds 
workman75: folds 
wiola3922: folds 
Uncalled bet (€0.01) returned to cap e'bomb95
cap e'bomb95 collected €0.02 from pot
cap e'bomb95: doesn't show hand 
*** SUMMARY ***
Total pot €0.02 | Rake €0 
Seat 1: workman75 (button) folded before Flop (didn't bet)
Seat 2: wiola3922 (small blind) folded before Flop
Seat 3: cap e'bomb95 (big blind) collected (€0.02)
Seat 4: caduceus369 folded before Flop (didn't bet)
Seat 5: assomatto308 folded before Flop (didn't bet)
Seat 6: Witness85906 folded before Flop (didn't bet)



PokerStars Zoom Hand #257988668864:  Hold'em No Limit (€0.01/€0.02) [ADM ID: M62BA304494E32ST] - 2025/10/04 0:20:17 CET [2025/10/03 18:20:17 ET]
Table 'Sirio' 6-max Seat #1 is the button
Seat 1: stevalmg (€1.97 in chips) 
Seat 2: caduceus369 (€3.10 in chips) 
Seat 3: franck19621962 (€1.09 in chips) 
Seat 4: EasyToRule (€2.98 in chips) 
Seat 5: Bristol1964 (€2.35 in chips) 
Seat 6: workman75 (€1.91 in chips) 
caduceus369: posts small blind €0.01
franck19621962: posts big blind €0.02
*** HOLE CARDS ***
Dealt to caduceus369 [4d 8s]
EasyToRule: folds 
Bristol1964: folds 
workman75: folds 
stevalmg: raises €0.04 to €0.06
caduceus369: folds 
franck19621962: folds 
Uncalled bet (€0.04) returned to stevalmg
stevalmg collected €0.05 from pot
stevalmg: doesn't show hand 
*** SUMMARY ***
Total pot €0.05 | Rake €0 
Seat 1: stevalmg (button) collected (€0.05)
Seat 2: caduceus369 (small blind) folded before Flop
Seat 3: franck19621962 (big blind) folded before Flop
Seat 4: EasyToRule folded before Flop (didn't bet)
Seat 5: Bristol1964 folded before Flop (didn't bet)
Seat 6: workman75 folded before Flop (didn't bet)



PokerStars Zoom Hand #257988664858:  Hold'em No Limit (€0.01/€0.02) [ADM ID: M62BA304494E32ST] - 2025/10/04 0:19:58 CET [2025/10/03 18:19:58 ET]
Table 'Sirio' 6-max Seat #1 is the button
Seat 1: Catania838 (€0.77 in chips) 
Seat 2: Peru91j (€2.48 in chips) 
Seat 3: Davi3231973 (€0.43 in chips) 
Seat 4: michy0757 (€2.01 in chips) 
Seat 5: caduceus369 (€3.10 in chips) 
Seat 6: Mabrac55 (€1.75 in chips) 
Peru91j: posts small blind €0.01
Davi3231973: posts big blind €0.02
*** HOLE CARDS ***
Dealt to caduceus369 [4d 4c]
michy0757: raises €0.05 to €0.07
caduceus369: folds 
Mabrac55: calls €0.07
Catania838: calls €0.07
Peru91j: folds 
Davi3231973: folds 
*** FLOP *** [7h 8s 5d]
michy0757: checks 
Mabrac55: checks 
Catania838: bets €0.23
michy0757: calls €0.23
Mabrac55: folds 
*** TURN *** [7h 8s 5d] [8h]
michy0757: checks 
Catania838: bets €0.47 and is all-in
michy0757: folds 
Uncalled bet (€0.47) returned to Catania838
Catania838 collected €0.67 from pot
Catania838: doesn't show hand 
*** SUMMARY ***
Total pot €0.70 | Rake €0.03 
Board [7h 8s 5d 8h]
Seat 1: Catania838 (button) collected (€0.67)
Seat 2: Peru91j (small blind) folded before Flop
Seat 3: Davi3231973 (big blind) folded before Flop
Seat 4: michy0757 folded on the Turn
Seat 5: caduceus369 folded before Flop (didn't bet)
Seat 6: Mabrac55 folded on the Flop



PokerStars Zoom Hand #257988671215:  Hold'em No Limit (€0.01/€0.02) [ADM ID: M62BA304494E32ST] - 2025/10/04 0:20:28 CET [2025/10/03 18:20:28 ET]
Table 'Sirio' 6-max Seat #1 is the button
Seat 1: Mabrac55 (€1.68 in chips) 
Seat 2: franck19621962 (€1.07 in chips) 
Seat 3: caduceus369 (€3.09 in chips) 
Seat 4: Giova8427 (€0.89 in chips) 
Seat 5: trillycata (€0.80 in chips) 
Seat 6: CacciatoreAA (€2.28 in chips) 
franck19621962: posts small blind €0.01
caduceus369: posts big blind €0.02
*** HOLE CARDS ***
Dealt to caduceus369 [5d Qc]
Giova8427: folds 
trillycata: raises €0.04 to €0.06
CacciatoreAA: folds 
Mabrac55: folds 
franck19621962: folds 
caduceus369: folds 
Uncalled bet (€0.04) returned to trillycata
trillycata collected €0.05 from pot
trillycata: doesn't show hand 
*** SUMMARY ***
Total pot €0.05 | Rake €0 
Seat 1: Mabrac55 (button) folded before Flop (didn't bet)
Seat 2: franck19621962 (small blind) folded before Flop
Seat 3: caduceus369 (big blind) folded before Flop
Seat 4: Giova8427 folded before Flop (didn't bet)
Seat 5: trillycata collected (€0.05)
Seat 6: CacciatoreAA folded before Flop (didn't bet)



PokerStars Zoom Hand #257988669780:  Hold'em No Limit (€0.01/€0.02) [ADM ID: M62BA304494E32ST] - 2025/10/04 0:20:21 CET [2025/10/03 18:20:21 ET]
Table 'Sirio' 6-max Seat #1 is the button
Seat 1: father2008 (€4.74 in chips) 
Seat 2: Bristol1964 (€2.35 in chips) 
Seat 3: EasyToRule (€2.98 in chips) 
Seat 4: tigermiscio (€0.96 in chips) 
Seat 5: workman75 (€1.91 in chips) 
Seat 6: caduceus369 (€3.09 in chips) 
Bristol1964: posts small blind €0.01
EasyToRule: posts big blind €0.02
*** HOLE CARDS ***
Dealt to caduceus369 [3h Jd]
tigermiscio: folds 
workman75: raises €0.04 to €0.06
caduceus369: folds 
father2008: raises €0.15 to €0.21
Bristol1964: folds 
EasyToRule: folds 
workman75: calls €0.15
*** FLOP *** [As Jc Qh]
workman75: checks 
father2008: checks 
*** TURN *** [As Jc Qh] [Js]
workman75: checks 
father2008: bets €0.22
workman75: folds 
Uncalled bet (€0.22) returned to father2008
father2008 collected €0.43 from pot
father2008: doesn't show hand 
*** SUMMARY ***
Total pot €0.45 | Rake €0.02 
Board [As Jc Qh Js]
Seat 1: father2008 (button) collected (€0.43)
Seat 2: Bristol1964 (small blind) folded before Flop
Seat 3: EasyToRule (big blind) folded before Flop
Seat 4: tigermiscio folded before Flop (didn't bet)
Seat 5: workman75 folded on the Turn
Seat 6: caduceus369 folded before Flop (didn't bet)



PokerStars Zoom Hand #257988667558:  Hold'em No Limit (€0.01/€0.02) [ADM ID: M62BA304494E32ST] - 2025/10/04 0:20:11 CET [2025/10/03 18:20:11 ET]
Table 'Sirio' 6-max Seat #1 is the button
Seat 1: caduceus369 (€3.10 in chips) 
Seat 2: Witness85906 (€5.81 in chips) 
Seat 3: DAMPER_KK (€2.08 in chips) 
Seat 4: Catania838 (€1.90 in chips) 
Seat 5: father2008 (€4.74 in chips) 
Seat 6: stevalmg (€1.97 in chips) 
Witness85906: posts small blind €0.01
DAMPER_KK: posts big blind €0.02
*** HOLE CARDS ***
Dealt to caduceus369 [Th 5d]
Catania838: raises €0.02 to €0.04
father2008: folds 
stevalmg: folds 
caduceus369: folds 
Witness85906: folds 
DAMPER_KK: calls €0.02
*** FLOP *** [2h 2d Jh]
DAMPER_KK: checks 
Catania838: bets €0.02
DAMPER_KK: calls €0.02
*** TURN *** [2h 2d Jh] [Jc]
DAMPER_KK: checks 
Catania838: bets €0.05
DAMPER_KK: calls €0.05
*** RIVER *** [2h 2d Jh Jc] [Qd]
DAMPER_KK: checks 
Catania838: checks 
*** SHOW DOWN ***
DAMPER_KK: shows [Ah 3s] (two pair, Jacks and Deuces)
Catania838: shows [3d 3h] (two pair, Jacks and Threes)
Catania838 collected €0.22 from pot
*** SUMMARY ***
Total pot €0.23 | Rake €0.01 
Board [2h 2d Jh Jc Qd]
Seat 1: caduceus369 (button) folded before Flop (didn't bet)
Seat 2: Witness85906 (small blind) folded before Flop
Seat 3: DAMPER_KK (big blind) showed [Ah 3s] and lost with two pair, Jacks and Deuces
Seat 4: Catania838 showed [3d 3h] and won (€0.22) with two pair, Jacks and Threes
Seat 5: father2008 folded before Flop (didn't bet)
Seat 6: stevalmg folded before Flop (didn't bet)



PokerStars Zoom Hand #257988674790:  Hold'em No Limit (€0.01/€0.02) [ADM ID: M62BA304494E32ST] - 2025/10/04 0:20:44 CET [2025/10/03 18:20:44 ET]
Table 'Sirio' 6-max Seat #1 is the button
Seat 1: maury999999 (€3.33 in chips) 
Seat 2: trillycata (€0.83 in chips) 
Seat 3: EasyToRule (€2.96 in chips) 
Seat 4: 0inthemoney (€2.02 in chips) 
Seat 5: wiola3922 (€0.95 in chips) 
Seat 6: caduceus369 (€3.07 in chips) 
trillycata: posts small blind €0.01
EasyToRule: posts big blind €0.02
*** HOLE CARDS ***
Dealt to caduceus369 [Ad Qh]
0inthemoney: raises €0.05 to €0.07
wiola3922: folds 
caduceus369: calls €0.07
maury999999: raises €0.19 to €0.26
trillycata: folds 
EasyToRule: folds 
0inthemoney: calls €0.19
caduceus369: calls €0.19
*** FLOP *** [8c 9c 6h]
0inthemoney: checks 
caduceus369: checks 
maury999999: checks 
*** TURN *** [8c 9c 6h] [7s]
0inthemoney: checks 
caduceus369: bets €0.26
maury999999: folds 
0inthemoney: raises €1.29 to €1.55
caduceus369: folds 
Uncalled bet (€1.29) returned to 0inthemoney
0inthemoney collected €1.26 from pot
0inthemoney: doesn't show hand 
*** SUMMARY ***
Total pot €1.33 | Rake €0.07 
Board [8c 9c 6h 7s]
Seat 1: maury999999 (button) folded on the Turn
Seat 2: trillycata (small blind) folded before Flop
Seat 3: EasyToRule (big blind) folded before Flop
Seat 4: 0inthemoney collected (€1.26)
Seat 5: wiola3922 folded before Flop (didn't bet)
Seat 6: caduceus369 folded on the Turn



PokerStars Zoom Hand #257988694628:  Hold'em No Limit (€0.01/€0.02) [ADM ID: M62BA304494E32ST] - 2025/10/04 0:22:16 CET [2025/10/03 18:22:16 ET]
Table 'Sirio' 6-max Seat #1 is the button
Seat 1: caduceus369 (€2.55 in chips) 
Seat 2: criptlux (€1.54 in chips) 
Seat 3: robertoH2O (€2.02 in chips) 
Seat 4: father2008 (€5.01 in chips) 
Seat 5: cap e'bomb95 (€5.47 in chips) 
Seat 6: pepenero11 (€1.59 in chips) 
criptlux: posts small blind €0.01
robertoH2O: posts big blind €0.02
*** HOLE CARDS ***
Dealt to caduceus369 [Jc 4c]
father2008: folds 
cap e'bomb95: folds 
pepenero11: folds 
caduceus369: folds 
criptlux: folds 
Uncalled bet (€0.01) returned to robertoH2O
robertoH2O collected €0.02 from pot
robertoH2O: doesn't show hand 
*** SUMMARY ***
Total pot €0.02 | Rake €0 
Seat 1: caduceus369 (button) folded before Flop (didn't bet)
Seat 2: criptlux (small blind) folded before Flop
Seat 3: robertoH2O (big blind) collected (€0.02)
Seat 4: father2008 folded before Flop (didn't bet)
Seat 5: cap e'bomb95 folded before Flop (didn't bet)
Seat 6: pepenero11 folded before Flop (didn't bet)



PokerStars Zoom Hand #257988696358:  Hold'em No Limit (€0.01/€0.02) [ADM ID: M62BA304494E32ST] - 2025/10/04 0:22:24 CET [2025/10/03 18:22:24 ET]
Table 'Sirio' 6-max Seat #1 is the button
Seat 1: iceangel2003 (€2.08 in chips) 
Seat 2: SKERZA (€1.98 in chips) 
Seat 3: criptlux (€3.70 in chips) 
Seat 4: cap e'bomb95 (€5.47 in chips) 
Seat 5: caduceus369 (€2.55 in chips) 
Seat 6: stfuplzudonk (€4.58 in chips) 
SKERZA: posts small blind €0.01
criptlux: posts big blind €0.02
*** HOLE CARDS ***
Dealt to caduceus369 [Qh 4h]
cap e'bomb95: folds 
caduceus369: folds 
stfuplzudonk: raises €0.04 to €0.06
iceangel2003: folds 
SKERZA: folds 
criptlux: folds 
Uncalled bet (€0.04) returned to stfuplzudonk
stfuplzudonk collected €0.05 from pot
stfuplzudonk: doesn't show hand 
*** SUMMARY ***
Total pot €0.05 | Rake €0 
Seat 1: iceangel2003 (button) folded before Flop (didn't bet)
Seat 2: SKERZA (small blind) folded before Flop
Seat 3: criptlux (big blind) folded before Flop
Seat 4: cap e'bomb95 folded before Flop (didn't bet)
Seat 5: caduceus369 folded before Flop (didn't bet)
Seat 6: stfuplzudonk collected (€0.05)



PokerStars Zoom Hand #257988697676:  Hold'em No Limit (€0.01/€0.02) [ADM ID: M62BA304494E32ST] - 2025/10/04 0:22:30 CET [2025/10/03 18:22:30 ET]
Table 'Sirio' 6-max Seat #1 is the button
Seat 1: stfuplzudonk (€5.30 in chips) 
Seat 2: caduceus369 (€2.55 in chips) 
Seat 3: trillycata (€0.70 in chips) 
Seat 4: criptlux (€1.53 in chips) 
Seat 5: father2008 (€5.18 in chips) 
Seat 6: cuzzi68 (€1.88 in chips) 
caduceus369: posts small blind €0.01
trillycata: posts big blind €0.02
*** HOLE CARDS ***
Dealt to caduceus369 [Kh Th]
criptlux: folds 
father2008: raises €0.05 to €0.07
cuzzi68: folds 
stfuplzudonk: folds 
caduceus369: folds 
trillycata: folds 
Uncalled bet (€0.05) returned to father2008
father2008 collected €0.05 from pot
father2008: doesn't show hand 
*** SUMMARY ***
Total pot €0.05 | Rake €0 
Seat 1: stfuplzudonk (button) folded before Flop (didn't bet)
Seat 2: caduceus369 (small blind) folded before Flop
Seat 3: trillycata (big blind) folded before Flop
Seat 4: criptlux folded before Flop (didn't bet)
Seat 5: father2008 collected (€0.05)
Seat 6: cuzzi68 folded before Flop (didn't bet)



PokerStars Zoom Hand #257988702895:  Hold'em No Limit (€0.01/€0.02) [ADM ID: M62BA304494E32ST] - 2025/10/04 0:22:54 CET [2025/10/03 18:22:54 ET]
Table 'Sirio' 6-max Seat #1 is the button
Seat 1: trillycata (€0.68 in chips) 
Seat 2: cap e'bomb95 (€1 in chips) 
Seat 3: caduceus369 (€2.54 in chips) 
Seat 4: IsyP99 (€0.74 in chips) 
Seat 5: Giova8427 (€0.17 in chips) 
Seat 6: criptlux (€1.53 in chips) 
cap e'bomb95: posts small blind €0.01
caduceus369: posts big blind €0.02
*** HOLE CARDS ***
Dealt to caduceus369 [Ts 3s]
IsyP99: folds 
Giova8427: folds 
criptlux: folds 
trillycata: folds 
cap e'bomb95: folds 
Uncalled bet (€0.01) returned to caduceus369
caduceus369 collected €0.02 from pot
caduceus369: doesn't show hand 
*** SUMMARY ***
Total pot €0.02 | Rake €0 
Seat 1: trillycata (button) folded before Flop (didn't bet)
Seat 2: cap e'bomb95 (small blind) folded before Flop
Seat 3: caduceus369 (big blind) collected (€0.02)
Seat 4: IsyP99 folded before Flop (didn't bet)
Seat 5: Giova8427 folded before Flop (didn't bet)
Seat 6: criptlux folded before Flop (didn't bet)



PokerStars Zoom Hand #257988699632:  Hold'em No Limit (€0.01/€0.02) [ADM ID: M62BA304494E32ST] - 2025/10/04 0:22:39 CET [2025/10/03 18:22:39 ET]
Table 'Sirio' 6-max Seat #1 is the button
Seat 1: colosso2022 (€1.30 in chips) 
Seat 2: cuzzi68 (€1.88 in chips) 
Seat 3: Meryjuventina (€2.47 in chips) 
Seat 4: stfuplzudonk (€2.76 in chips) 
Seat 5: caduceus369 (€2.54 in chips) 
Seat 6: cap e'bomb95 (€5.46 in chips) 
cuzzi68: posts small blind €0.01
Meryjuventina: posts big blind €0.02
*** HOLE CARDS ***
Dealt to caduceus369 [2h 9c]
stfuplzudonk: folds 
caduceus369: folds 
Meryjuventina is disconnected 
cap e'bomb95: folds 
colosso2022: raises €0.05 to €0.07
cuzzi68: folds 
Meryjuventina: calls €0.05
*** FLOP *** [9d 6s As]
Meryjuventina: bets €0.02
colosso2022: calls €0.02
*** TURN *** [9d 6s As] [7d]
Meryjuventina: bets €0.02
colosso2022: calls €0.02
*** RIVER *** [9d 6s As 7d] [Qc]
Meryjuventina: bets €0.08
colosso2022: raises €0.38 to €0.46
Meryjuventina: calls €0.38
*** SHOW DOWN ***
colosso2022: shows [Ad Qh] (two pair, Aces and Queens)
Meryjuventina: mucks hand 
colosso2022 collected €1.09 from pot
*** SUMMARY ***
Total pot €1.15 | Rake €0.06 
Board [9d 6s As 7d Qc]
Seat 1: colosso2022 (button) showed [Ad Qh] and won (€1.09) with two pair, Aces and Queens
Seat 2: cuzzi68 (small blind) folded before Flop
Seat 3: Meryjuventina (big blind) mucked [Ah 4h]
Seat 4: stfuplzudonk folded before Flop (didn't bet)
Seat 5: caduceus369 folded before Flop (didn't bet)
Seat 6: cap e'bomb95 folded before Flop (didn't bet)



PokerStars Zoom Hand #257988711058:  Hold'em No Limit (€0.01/€0.02) [ADM ID: M62BA304494E32ST] - 2025/10/04 0:23:32 CET [2025/10/03 18:23:32 ET]
Table 'Sirio' 6-max Seat #1 is the button
Seat 1: CacciatoreAA (€3.15 in chips) 
Seat 2: fantaasso (€4.57 in chips) 
Seat 3: Poetto65 (€0.93 in chips) 
Seat 4: pepenero11 (€1.36 in chips) 
Seat 5: The clansman77 (€0.64 in chips) 
Seat 6: caduceus369 (€2.54 in chips) 
fantaasso: posts small blind €0.01
Poetto65: posts big blind €0.02
*** HOLE CARDS ***
Dealt to caduceus369 [Ac 2d]
pepenero11: folds 
The clansman77: folds 
caduceus369: folds 
CacciatoreAA: raises €0.06 to €0.08
fantaasso: folds 
Poetto65: folds 
Uncalled bet (€0.06) returned to CacciatoreAA
CacciatoreAA collected €0.05 from pot
CacciatoreAA: doesn't show hand 
*** SUMMARY ***
Total pot €0.05 | Rake €0 
Seat 1: CacciatoreAA (button) collected (€0.05)
Seat 2: fantaasso (small blind) folded before Flop
Seat 3: Poetto65 (big blind) folded before Flop
Seat 4: pepenero11 folded before Flop (didn't bet)
Seat 5: The clansman77 folded before Flop (didn't bet)
Seat 6: caduceus369 folded before Flop (didn't bet)



PokerStars Zoom Hand #257988708948:  Hold'em No Limit (€0.01/€0.02) [ADM ID: M62BA304494E32ST] - 2025/10/04 0:23:22 CET [2025/10/03 18:23:22 ET]
Table 'Sirio' 6-max Seat #1 is the button
Seat 1: father2008 (€4.98 in chips) 
Seat 2: Meryjuventina (€1.90 in chips) 
Seat 3: cap e'bomb95 (€0.99 in chips) 
Seat 4: caduceus369 (€2.54 in chips) 
Seat 5: Catania838 (€1.88 in chips) 
Seat 6: colosso2022 (€1.82 in chips) 
Meryjuventina: posts small blind €0.01
cap e'bomb95: posts big blind €0.02
*** HOLE CARDS ***
Dealt to caduceus369 [Jh 8h]
caduceus369: folds 
Catania838: folds 
colosso2022: calls €0.02
father2008: folds 
Meryjuventina: calls €0.01
cap e'bomb95: checks 
*** FLOP *** [Kc 9h 9s]
Meryjuventina: checks 
cap e'bomb95: checks 
colosso2022: bets €0.04
Meryjuventina: calls €0.04
cap e'bomb95: folds 
*** TURN *** [Kc 9h 9s] [Qh]
Meryjuventina: bets €0.02
colosso2022: raises €0.02 to €0.04
Meryjuventina: calls €0.02
*** RIVER *** [Kc 9h 9s Qh] [6d]
Meryjuventina: checks 
colosso2022: checks 
*** SHOW DOWN ***
Meryjuventina: shows [Jc Jd] (two pair, Jacks and Nines)
colosso2022: mucks hand 
Meryjuventina collected €0.21 from pot
*** SUMMARY ***
Total pot €0.22 | Rake €0.01 
Board [Kc 9h 9s Qh 6d]
Seat 1: father2008 (button) folded before Flop (didn't bet)
Seat 2: Meryjuventina (small blind) showed [Jc Jd] and won (€0.21) with two pair, Jacks and Nines
Seat 3: cap e'bomb95 (big blind) folded on the Flop
Seat 4: caduceus369 folded before Flop (didn't bet)
Seat 5: Catania838 folded before Flop (didn't bet)
Seat 6: colosso2022 mucked [7d As]



PokerStars Zoom Hand #257988706424:  Hold'em No Limit (€0.01/€0.02) [ADM ID: M62BA304494E32ST] - 2025/10/04 0:23:10 CET [2025/10/03 18:23:10 ET]
Table 'Sirio' 6-max Seat #1 is the button
Seat 1: mbeck65 (€2.13 in chips) 
Seat 2: stfuplzudonk (€4.57 in chips) 
Seat 3: cap e'bomb95 (€5.46 in chips) 
Seat 4: Witness85906 (€5.76 in chips) 
Seat 5: caduceus369 (€2.55 in chips) 
Seat 6: criptlux (€3.67 in chips) 
stfuplzudonk: posts small blind €0.01
cap e'bomb95: posts big blind €0.02
*** HOLE CARDS ***
Dealt to caduceus369 [Qd 3s]
Witness85906: folds 
caduceus369: folds 
criptlux: folds 
mbeck65: folds 
stfuplzudonk: calls €0.01
cap e'bomb95: checks 
*** FLOP *** [4h 6h Ts]
stfuplzudonk: checks 
cap e'bomb95: checks 
*** TURN *** [4h 6h Ts] [2c]
stfuplzudonk: checks 
cap e'bomb95: checks 
*** RIVER *** [4h 6h Ts 2c] [Kd]
stfuplzudonk: checks 
cap e'bomb95: checks 
*** SHOW DOWN ***
stfuplzudonk: shows [9d Jc] (high card King)
cap e'bomb95: shows [Ah 8s] (high card Ace)
cap e'bomb95 collected €0.04 from pot
*** SUMMARY ***
Total pot €0.04 | Rake €0 
Board [4h 6h Ts 2c Kd]
Seat 1: mbeck65 (button) folded before Flop (didn't bet)
Seat 2: stfuplzudonk (small blind) showed [9d Jc] and lost with high card King
Seat 3: cap e'bomb95 (big blind) showed [Ah 8s] and won (€0.04) with high card Ace
Seat 4: Witness85906 folded before Flop (didn't bet)
Seat 5: caduceus369 folded before Flop (didn't bet)
Seat 6: criptlux folded before Flop (didn't bet)



PokerStars Zoom Hand #257988712355:  Hold'em No Limit (€0.01/€0.02) [ADM ID: M62BA304494E32ST] - 2025/10/04 0:23:38 CET [2025/10/03 18:23:38 ET]
Table 'Sirio' 6-max Seat #1 is the button
Seat 1: Mabrac55 (€1.76 in chips) 
Seat 2: stevalmg (€2.77 in chips) 
Seat 3: father2008 (€4.98 in chips) 
Seat 4: caduceus369 (€2.54 in chips) 
Seat 5: Catania838 (€1.88 in chips) 
Seat 6: The clansman77 (€0.64 in chips) 
stevalmg: posts small blind €0.01
father2008: posts big blind €0.02
*** HOLE CARDS ***
Dealt to caduceus369 [Jh 5h]
caduceus369: folds 
Catania838: calls €0.02
The clansman77: calls €0.02
Mabrac55: folds 
stevalmg: folds 
father2008: checks 
*** FLOP *** [Qd 4c 3h]
father2008: bets €0.06
Catania838: calls €0.06
The clansman77: folds 
*** TURN *** [Qd 4c 3h] [8c]
father2008: checks 
Catania838: bets €0.09
father2008: calls €0.09
*** RIVER *** [Qd 4c 3h 8c] [7d]
father2008: checks 
Catania838: bets €0.35
father2008: folds 
Uncalled bet (€0.35) returned to Catania838
Catania838 collected €0.35 from pot
Catania838: doesn't show hand 
*** SUMMARY ***
Total pot €0.37 | Rake €0.02 
Board [Qd 4c 3h 8c 7d]
Seat 1: Mabrac55 (button) folded before Flop (didn't bet)
Seat 2: stevalmg (small blind) folded before Flop
Seat 3: father2008 (big blind) folded on the River
Seat 4: caduceus369 folded before Flop (didn't bet)
Seat 5: Catania838 collected (€0.35)
Seat 6: The clansman77 folded on the Flop



PokerStars Zoom Hand #257988708065:  Hold'em No Limit (€0.01/€0.02) [ADM ID: M62BA304494E32ST] - 2025/10/04 0:23:18 CET [2025/10/03 18:23:18 ET]
Table 'Sirio' 6-max Seat #1 is the button
Seat 1: Catania838 (€1.88 in chips) 
Seat 2: caduceus369 (€2.55 in chips) 
Seat 3: KillByte00 (€2.25 in chips) 
Seat 4: Witness85906 (€5.76 in chips) 
Seat 5: pepenero11 (€1.36 in chips) 
Seat 6: wiola3922 (€0.88 in chips) 
caduceus369: posts small blind €0.01
KillByte00: posts big blind €0.02
*** HOLE CARDS ***
Dealt to caduceus369 [6d 8h]
Witness85906: raises €0.03 to €0.05
pepenero11: folds 
wiola3922: folds 
Catania838: folds 
caduceus369: folds 
KillByte00: calls €0.03
*** FLOP *** [Qc As 3h]
KillByte00: bets €0.04
Witness85906: calls €0.04
*** TURN *** [Qc As 3h] [4c]
KillByte00: checks 
Witness85906: bets €0.18
KillByte00: calls €0.18
*** RIVER *** [Qc As 3h 4c] [4d]
KillByte00: checks 
Witness85906: bets €0.17
KillByte00: calls €0.17
*** SHOW DOWN ***
Witness85906: shows [Ac Th] (two pair, Aces and Fours)
KillByte00: mucks hand 
Witness85906 collected €0.85 from pot
*** SUMMARY ***
Total pot €0.89 | Rake €0.04 
Board [Qc As 3h 4c 4d]
Seat 1: Catania838 (button) folded before Flop (didn't bet)
Seat 2: caduceus369 (small blind) folded before Flop
Seat 3: KillByte00 (big blind) mucked [8s Qs]
Seat 4: Witness85906 showed [Ac Th] and won (€0.85) with two pair, Aces and Fours
Seat 5: pepenero11 folded before Flop (didn't bet)
Seat 6: wiola3922 folded before Flop (didn't bet)



PokerStars Zoom Hand #257988701117:  Hold'em No Limit (€0.01/€0.02) [ADM ID: M62BA304494E32ST] - 2025/10/04 0:22:46 CET [2025/10/03 18:22:46 ET]
Table 'Sirio' 6-max Seat #1 is the button
Seat 1: caduceus369 (€2.54 in chips) 
Seat 2: iceangel2003 (€2.09 in chips) 
Seat 3: tigermiscio (€1.22 in chips) 
Seat 4: bruciapelo (€2.58 in chips) 
Seat 5: stfuplzudonk (€5.30 in chips) 
Seat 6: fantaasso (€3 in chips) 
iceangel2003: posts small blind €0.01
tigermiscio: posts big blind €0.02
*** HOLE CARDS ***
Dealt to caduceus369 [9s 4d]
bruciapelo: raises €0.04 to €0.06
stfuplzudonk: folds 
fantaasso: raises €0.13 to €0.19
caduceus369: folds 
iceangel2003: folds 
tigermiscio: folds 
bruciapelo: calls €0.13
*** FLOP *** [Qd 8c 2h]
bruciapelo: checks 
fantaasso: checks 
*** TURN *** [Qd 8c 2h] [3h]
bruciapelo: checks 
fantaasso: bets €0.20
bruciapelo: calls €0.20
*** RIVER *** [Qd 8c 2h 3h] [9d]
bruciapelo: checks 
fantaasso: checks 
*** SHOW DOWN ***
bruciapelo: shows [Ah Qc] (a pair of Queens)
fantaasso: mucks hand 
bruciapelo collected €0.77 from pot
*** SUMMARY ***
Total pot €0.81 | Rake €0.04 
Board [Qd 8c 2h 3h 9d]
Seat 1: caduceus369 (button) folded before Flop (didn't bet)
Seat 2: iceangel2003 (small blind) folded before Flop
Seat 3: tigermiscio (big blind) folded before Flop
Seat 4: bruciapelo showed [Ah Qc] and won (€0.77) with a pair of Queens
Seat 5: stfuplzudonk folded before Flop (didn't bet)
Seat 6: fantaasso mucked [Kd Ac]



PokerStars Zoom Hand #257988713467:  Hold'em No Limit (€0.01/€0.02) [ADM ID: M62BA304494E32ST] - 2025/10/04 0:23:43 CET [2025/10/03 18:23:43 ET]
Table 'Sirio' 6-max Seat #1 is the button
Seat 1: 0inthemoney (€2.67 in chips) 
Seat 2: Giova8427 (€0.19 in chips) 
Seat 3: caduceus369 (€2.54 in chips) 
Seat 4: EasyToRule (€2.91 in chips) 
Seat 5: Catania838 (€1.11 in chips) 
Seat 6: Gabillo70 (€0.77 in chips) 
Giova8427: posts small blind €0.01
caduceus369: posts big blind €0.02
*** HOLE CARDS ***
Dealt to caduceus369 [6h 7h]
EasyToRule: raises €0.04 to €0.06
Catania838: folds 
Gabillo70: folds 
0inthemoney: calls €0.06
Giova8427: folds 
caduceus369: calls €0.04
*** FLOP *** [2c 3c 4c]
caduceus369: checks 
EasyToRule: checks 
0inthemoney: bets €0.12
caduceus369: folds 
EasyToRule: folds 
Uncalled bet (€0.12) returned to 0inthemoney
0inthemoney collected €0.18 from pot
0inthemoney: doesn't show hand 
*** SUMMARY ***
Total pot €0.19 | Rake €0.01 
Board [2c 3c 4c]
Seat 1: 0inthemoney (button) collected (€0.18)
Seat 2: Giova8427 (small blind) folded before Flop
Seat 3: caduceus369 (big blind) folded on the Flop
Seat 4: EasyToRule folded on the Flop
Seat 5: Catania838 folded before Flop (didn't bet)
Seat 6: Gabillo70 folded before Flop (didn't bet)



PokerStars Zoom Hand #257988721433:  Hold'em No Limit (€0.01/€0.02) [ADM ID: M62BA304494E32ST] - 2025/10/04 0:24:19 CET [2025/10/03 18:24:19 ET]
Table 'Sirio' 6-max Seat #1 is the button
Seat 1: caduceus369 (€2.48 in chips) 
Seat 2: Giampon78 (€2.04 in chips) 
Seat 3: father2008 (€5.38 in chips) 
Seat 4: Catania838 (€2.06 in chips) 
Seat 5: stfuplzudonk (€3.44 in chips) 
Seat 6: SKERZA (€1.68 in chips) 
Giampon78: posts small blind €0.01
father2008: posts big blind €0.02
*** HOLE CARDS ***
Dealt to caduceus369 [7d Qd]
Catania838: folds 
stfuplzudonk: raises €0.02 to €0.04
SKERZA: folds 
caduceus369: folds 
Giampon78 has timed out
Giampon78: folds 
father2008: calls €0.02
*** FLOP *** [Th Ac 2h]
father2008: checks 
stfuplzudonk: checks 
*** TURN *** [Th Ac 2h] [8c]
father2008: checks 
stfuplzudonk: checks 
*** RIVER *** [Th Ac 2h 8c] [4h]
father2008: checks 
stfuplzudonk: checks 
*** SHOW DOWN ***
father2008: shows [9s 6d] (high card Ace)
stfuplzudonk: shows [3d 3h] (a pair of Threes)
stfuplzudonk collected €0.09 from pot
*** SUMMARY ***
Total pot €0.09 | Rake €0 
Board [Th Ac 2h 8c 4h]
Seat 1: caduceus369 (button) folded before Flop (didn't bet)
Seat 2: Giampon78 (small blind) folded before Flop
Seat 3: father2008 (big blind) showed [9s 6d] and lost with high card Ace
Seat 4: Catania838 folded before Flop (didn't bet)
Seat 5: stfuplzudonk showed [3d 3h] and won (€0.09) with a pair of Threes
Seat 6: SKERZA folded before Flop (didn't bet)



PokerStars Zoom Hand #257988723954:  Hold'em No Limit (€0.01/€0.02) [ADM ID: M62BA304494E32ST] - 2025/10/04 0:24:31 CET [2025/10/03 18:24:31 ET]
Table 'Sirio' 6-max Seat #1 is the button
Seat 1: stfuplzudonk (€2.67 in chips) 
Seat 2: EasyToRule (€4.04 in chips) 
Seat 3: fantaasso (€2.61 in chips) 
Seat 4: iceangel2003 (€2.15 in chips) 
Seat 5: caduceus369 (€2.48 in chips) 
Seat 6: wiola3922 (€0.78 in chips) 
EasyToRule: posts small blind €0.01
fantaasso: posts big blind €0.02
*** HOLE CARDS ***
Dealt to caduceus369 [3c 3d]
iceangel2003: folds 
caduceus369: calls €0.02
wiola3922: folds 
stfuplzudonk: folds 
EasyToRule: folds 
fantaasso: raises €0.06 to €0.08
caduceus369: calls €0.06
*** FLOP *** [7h Td 2h]
fantaasso: checks 
caduceus369: bets €0.08
fantaasso: calls €0.08
*** TURN *** [7h Td 2h] [5s]
fantaasso: checks 
caduceus369: bets €0.24
fantaasso: folds 
Uncalled bet (€0.24) returned to caduceus369
caduceus369 collected €0.32 from pot
caduceus369: doesn't show hand 
*** SUMMARY ***
Total pot €0.33 | Rake €0.01 
Board [7h Td 2h 5s]
Seat 1: stfuplzudonk (button) folded before Flop (didn't bet)
Seat 2: EasyToRule (small blind) folded before Flop
Seat 3: fantaasso (big blind) folded on the Turn
Seat 4: iceangel2003 folded before Flop (didn't bet)
Seat 5: caduceus369 collected (€0.32)
Seat 6: wiola3922 folded before Flop (didn't bet)



PokerStars Zoom Hand #257988736645:  Hold'em No Limit (€0.01/€0.02) [ADM ID: M62BA304494E32ST] - 2025/10/04 0:25:28 CET [2025/10/03 18:25:28 ET]
Table 'Sirio' 6-max Seat #1 is the button
Seat 1: cuzzi68 (€1.70 in chips) 
Seat 2: maur62 (€1.23 in chips) 
Seat 3: cap e'bomb95 (€4.88 in chips) 
Seat 4: iceangel2003 (€2.15 in chips) 
Seat 5: father2008 (€4.73 in chips) 
Seat 6: caduceus369 (€2.64 in chips) 
maur62: posts small blind €0.01
cap e'bomb95: posts big blind €0.02
*** HOLE CARDS ***
Dealt to caduceus369 [9d 7c]
iceangel2003: raises €0.24 to €0.26
father2008: folds 
caduceus369: folds 
cuzzi68: folds 
maur62: calls €0.25
cap e'bomb95: folds 
*** FLOP *** [2c 9s 2h]
maur62: checks 
iceangel2003: bets €1.89 and is all-in
maur62: calls €0.97 and is all-in
Uncalled bet (€0.92) returned to iceangel2003
*** TURN *** [2c 9s 2h] [2s]
*** RIVER *** [2c 9s 2h 2s] [3d]
*** SHOW DOWN ***
maur62: shows [Qh Ac] (three of a kind, Deuces)
iceangel2003: shows [Jc Jh] (a full house, Deuces full of Jacks)
iceangel2003 collected €2.35 from pot
*** SUMMARY ***
Total pot €2.48 | Rake €0.13 
Board [2c 9s 2h 2s 3d]
Seat 1: cuzzi68 (button) folded before Flop (didn't bet)
Seat 2: maur62 (small blind) showed [Qh Ac] and lost with three of a kind, Deuces
Seat 3: cap e'bomb95 (big blind) folded before Flop
Seat 4: iceangel2003 showed [Jc Jh] and won (€2.35) with a full house, Deuces full of Jacks
Seat 5: father2008 folded before Flop (didn't bet)
Seat 6: caduceus369 folded before Flop (didn't bet)



PokerStars Zoom Hand #257988741281:  Hold'em No Limit (€0.01/€0.02) [ADM ID: M62BA304494E32ST] - 2025/10/04 0:25:49 CET [2025/10/03 18:25:49 ET]
Table 'Sirio' 6-max Seat #1 is the button
Seat 1: wiola3922 (€0.80 in chips) 
Seat 2: cap e'bomb95 (€4.86 in chips) 
Seat 3: caduceus369 (€2.63 in chips) 
Seat 4: fantaasso (€4.51 in chips) 
Seat 5: 0inthemoney (€2.70 in chips) 
Seat 6: Mabrac55 (€1.85 in chips) 
cap e'bomb95: posts small blind €0.01
caduceus369: posts big blind €0.02
*** HOLE CARDS ***
Dealt to caduceus369 [4s Kh]
fantaasso: folds 
0inthemoney: folds 
Mabrac55: folds 
wiola3922: raises €0.05 to €0.07
cap e'bomb95: folds 
caduceus369: folds 
Uncalled bet (€0.05) returned to wiola3922
wiola3922 collected €0.05 from pot
wiola3922: doesn't show hand 
*** SUMMARY ***
Total pot €0.05 | Rake €0 
Seat 1: wiola3922 (button) collected (€0.05)
Seat 2: cap e'bomb95 (small blind) folded before Flop
Seat 3: caduceus369 (big blind) folded before Flop
Seat 4: fantaasso folded before Flop (didn't bet)
Seat 5: 0inthemoney folded before Flop (didn't bet)
Seat 6: Mabrac55 folded before Flop (didn't bet)



PokerStars Zoom Hand #257988738348:  Hold'em No Limit (€0.01/€0.02) [ADM ID: M62BA304494E32ST] - 2025/10/04 0:25:36 CET [2025/10/03 18:25:36 ET]
Table 'Sirio' 6-max Seat #1 is the button
Seat 1: EasyToRule (€3.92 in chips) 
Seat 2: caduceus369 (€2.64 in chips) 
Seat 3: 0inthemoney (€2.72 in chips) 
Seat 4: tigermiscio (€1.13 in chips) 
Seat 5: DAMPER_KK (€3.50 in chips) 
Seat 6: cap e'bomb95 (€4.86 in chips) 
caduceus369: posts small blind €0.01
0inthemoney: posts big blind €0.02
*** HOLE CARDS ***
Dealt to caduceus369 [4d 9d]
tigermiscio: folds 
DAMPER_KK: calls €0.02
cap e'bomb95: folds 
EasyToRule: raises €0.07 to €0.09
caduceus369: folds 
0inthemoney: folds 
DAMPER_KK: calls €0.07
*** FLOP *** [6s 4s Ad]
DAMPER_KK: checks 
EasyToRule: bets €0.05
DAMPER_KK: calls €0.05
*** TURN *** [6s 4s Ad] [4c]
DAMPER_KK: checks 
EasyToRule: checks 
*** RIVER *** [6s 4s Ad 4c] [5s]
DAMPER_KK: bets €0.50
EasyToRule: folds 
Uncalled bet (€0.50) returned to DAMPER_KK
DAMPER_KK collected €0.30 from pot
DAMPER_KK: doesn't show hand 
*** SUMMARY ***
Total pot €0.31 | Rake €0.01 
Board [6s 4s Ad 4c 5s]
Seat 1: EasyToRule (button) folded on the River
Seat 2: caduceus369 (small blind) folded before Flop
Seat 3: 0inthemoney (big blind) folded before Flop
Seat 4: tigermiscio folded before Flop (didn't bet)
Seat 5: DAMPER_KK collected (€0.30)
Seat 6: cap e'bomb95 folded before Flop (didn't bet)



PokerStars Zoom Hand #257988747038:  Hold'em No Limit (€0.01/€0.02) [ADM ID: M62BA304494E32ST] - 2025/10/04 0:26:16 CET [2025/10/03 18:26:16 ET]
Table 'Sirio' 6-max Seat #1 is the button
Seat 1: Giampon78 (€2.03 in chips) 
Seat 2: IsyP99 (€1.28 in chips) 
Seat 3: The clansman77 (€0.38 in chips) 
Seat 4: caduceus369 (€2.61 in chips) 
Seat 5: criptlux (€1.35 in chips) 
Seat 6: mbeck65 (€3.30 in chips) 
IsyP99: posts small blind €0.01
The clansman77: posts big blind €0.02
*** HOLE CARDS ***
Dealt to caduceus369 [4c 4d]
caduceus369: calls €0.02
criptlux: folds 
mbeck65: folds 
Giampon78: folds 
IsyP99: calls €0.01
The clansman77: checks 
*** FLOP *** [6s Kd 2d]
IsyP99: bets €0.03
The clansman77: folds 
caduceus369: calls €0.03
*** TURN *** [6s Kd 2d] [7h]
IsyP99: bets €0.06
caduceus369: folds 
Uncalled bet (€0.06) returned to IsyP99
IsyP99 collected €0.12 from pot
IsyP99: doesn't show hand 
*** SUMMARY ***
Total pot €0.12 | Rake €0 
Board [6s Kd 2d 7h]
Seat 1: Giampon78 (button) folded before Flop (didn't bet)
Seat 2: IsyP99 (small blind) collected (€0.12)
Seat 3: The clansman77 (big blind) folded on the Flop
Seat 4: caduceus369 folded on the Turn
Seat 5: criptlux folded before Flop (didn't bet)
Seat 6: mbeck65 folded before Flop (didn't bet)



PokerStars Zoom Hand #257988755153:  Hold'em No Limit (€0.01/€0.02) [ADM ID: M62BA304494E32ST] - 2025/10/04 0:26:53 CET [2025/10/03 18:26:53 ET]
Table 'Sirio' 6-max Seat #1 is the button
Seat 1: criptlux (€1.35 in chips) 
Seat 2: robertoH2O (€2.23 in chips) 
Seat 3: franck19621962 (€1.61 in chips) 
Seat 4: fantaasso (€2.61 in chips) 
Seat 5: caduceus369 (€2.56 in chips) 
Seat 6: wiola3922 (€0.97 in chips) 
robertoH2O: posts small blind €0.01
franck19621962: posts big blind €0.02
*** HOLE CARDS ***
Dealt to caduceus369 [5h 8s]
fantaasso: folds 
caduceus369: folds 
wiola3922: folds 
criptlux: raises €0.02 to €0.04
robertoH2O: folds 
franck19621962: calls €0.02
*** FLOP *** [Ad 7d Jd]
franck19621962: checks 
criptlux: checks 
*** TURN *** [Ad 7d Jd] [Kh]
franck19621962: checks 
criptlux: checks 
*** RIVER *** [Ad 7d Jd Kh] [Kd]
franck19621962: bets €0.02
criptlux: folds 
Uncalled bet (€0.02) returned to franck19621962
franck19621962 collected €0.09 from pot
franck19621962: doesn't show hand 
*** SUMMARY ***
Total pot €0.09 | Rake €0 
Board [Ad 7d Jd Kh Kd]
Seat 1: criptlux (button) folded on the River
Seat 2: robertoH2O (small blind) folded before Flop
Seat 3: franck19621962 (big blind) collected (€0.09)
Seat 4: fantaasso folded before Flop (didn't bet)
Seat 5: caduceus369 folded before Flop (didn't bet)
Seat 6: wiola3922 folded before Flop (didn't bet)



PokerStars Zoom Hand #257988757671:  Hold'em No Limit (€0.01/€0.02) [ADM ID: M62BA304494E32ST] - 2025/10/04 0:27:05 CET [2025/10/03 18:27:05 ET]
Table 'Sirio' 6-max Seat #1 is the button
Seat 1: Giampon78 (€2 in chips) 
Seat 2: father2008 (€4.59 in chips) 
Seat 3: The clansman77 (€0.35 in chips) 
Seat 4: caduceus369 (€2.56 in chips) 
Seat 5: wiola3922 (€0.97 in chips) 
Seat 6: tigermiscio (€1.07 in chips) 
father2008: posts small blind €0.01
The clansman77: posts big blind €0.02
*** HOLE CARDS ***
Dealt to caduceus369 [9c Tc]
caduceus369: raises €0.04 to €0.06
wiola3922: folds 
tigermiscio: folds 
Giampon78: calls €0.06
father2008: folds 
The clansman77: calls €0.04
*** FLOP *** [3s Jd 4c]
The clansman77: checks 
caduceus369: checks 
Giampon78: bets €0.06
The clansman77: raises €0.23 to €0.29 and is all-in
caduceus369: folds 
Giampon78: calls €0.23
*** TURN *** [3s Jd 4c] [7s]
*** RIVER *** [3s Jd 4c 7s] [Qd]
*** SHOW DOWN ***
The clansman77: shows [6h Js] (a pair of Jacks)
Giampon78: shows [Ad 4d] (a pair of Fours)
The clansman77 collected €0.73 from pot
*** SUMMARY ***
Total pot €0.77 | Rake €0.04 
Board [3s Jd 4c 7s Qd]
Seat 1: Giampon78 (button) showed [Ad 4d] and lost with a pair of Fours
Seat 2: father2008 (small blind) folded before Flop
Seat 3: The clansman77 (big blind) showed [6h Js] and won (€0.73) with a pair of Jacks
Seat 4: caduceus369 folded on the Flop
Seat 5: wiola3922 folded before Flop (didn't bet)
Seat 6: tigermiscio folded before Flop (didn't bet)



PokerStars Zoom Hand #257988764806:  Hold'em No Limit (€0.01/€0.02) [ADM ID: M62BA304494E32ST] - 2025/10/04 0:27:38 CET [2025/10/03 18:27:38 ET]
Table 'Sirio' 6-max Seat #1 is the button
Seat 1: KillByte00 (€2.85 in chips) 
Seat 2: caduceus369 (€2.50 in chips) 
Seat 3: father2008 (€4.58 in chips) 
Seat 4: cuzzi68 (€1.55 in chips) 
Seat 5: stfuplzudonk (€2.57 in chips) 
Seat 6: cap e'bomb95 (€0.85 in chips) 
caduceus369: posts small blind €0.01
father2008: posts big blind €0.02
*** HOLE CARDS ***
Dealt to caduceus369 [5s 5c]
cuzzi68: folds 
stfuplzudonk: folds 
cap e'bomb95: folds 
KillByte00: folds 
caduceus369: calls €0.01
father2008: checks 
*** FLOP *** [Qd 6d 6h]
caduceus369: checks 
father2008: checks 
*** TURN *** [Qd 6d 6h] [5d]
caduceus369: bets €0.02
father2008: folds 
Uncalled bet (€0.02) returned to caduceus369
caduceus369 collected €0.04 from pot
caduceus369: doesn't show hand 
*** SUMMARY ***
Total pot €0.04 | Rake €0 
Board [Qd 6d 6h 5d]
Seat 1: KillByte00 (button) folded before Flop (didn't bet)
Seat 2: caduceus369 (small blind) collected (€0.04)
Seat 3: father2008 (big blind) folded on the Turn
Seat 4: cuzzi68 folded before Flop (didn't bet)
Seat 5: stfuplzudonk folded before Flop (didn't bet)
Seat 6: cap e'bomb95 folded before Flop (didn't bet)



PokerStars Zoom Hand #257988770916:  Hold'em No Limit (€0.01/€0.02) [ADM ID: M62BA304494E32ST] - 2025/10/04 0:28:06 CET [2025/10/03 18:28:06 ET]
Table 'Sirio' 6-max Seat #1 is the button
Seat 1: father2008 (€5.40 in chips) 
Seat 2: Bristol1964 (€1.40 in chips) 
Seat 3: iceangel2003 (€2.97 in chips) 
Seat 4: EasyToRule (€3.84 in chips) 
Seat 5: Peru91j (€2.43 in chips) 
Seat 6: caduceus369 (€2.52 in chips) 
Bristol1964: posts small blind €0.01
iceangel2003: posts big blind €0.02
*** HOLE CARDS ***
Dealt to caduceus369 [3c 7h]
EasyToRule: folds 
Peru91j: folds 
caduceus369: folds 
father2008: folds 
Bristol1964: calls €0.01
iceangel2003: checks 
*** FLOP *** [Js 2d 5s]
Bristol1964: bets €0.02
iceangel2003: calls €0.02
*** TURN *** [Js 2d 5s] [3s]
Bristol1964: bets €0.02
iceangel2003: folds 
Uncalled bet (€0.02) returned to Bristol1964
Bristol1964 collected €0.08 from pot
Bristol1964: doesn't show hand 
*** SUMMARY ***
Total pot €0.08 | Rake €0 
Board [Js 2d 5s 3s]
Seat 1: father2008 (button) folded before Flop (didn't bet)
Seat 2: Bristol1964 (small blind) collected (€0.08)
Seat 3: iceangel2003 (big blind) folded on the Turn
Seat 4: EasyToRule folded before Flop (didn't bet)
Seat 5: Peru91j folded before Flop (didn't bet)
Seat 6: caduceus369 folded before Flop (didn't bet)



PokerStars Zoom Hand #257988773981:  Hold'em No Limit (€0.01/€0.02) [ADM ID: M62BA304494E32ST] - 2025/10/04 0:28:20 CET [2025/10/03 18:28:20 ET]
Table 'Sirio' 6-max Seat #1 is the button
Seat 1: pepenero11 (€0.78 in chips) 
Seat 2: father2008 (€4.56 in chips) 
Seat 3: caduceus369 (€2.52 in chips) 
Seat 4: Peru91j (€2 in chips) 
Seat 5: robertoH2O (€2.27 in chips) 
Seat 6: wiola3922 (€0.57 in chips) 
father2008: posts small blind €0.01
caduceus369: posts big blind €0.02
*** HOLE CARDS ***
Dealt to caduceus369 [6s 2h]
Peru91j: folds 
robertoH2O: raises €0.03 to €0.05
wiola3922: folds 
pepenero11: folds 
father2008: folds 
caduceus369: folds 
Uncalled bet (€0.03) returned to robertoH2O
robertoH2O collected €0.05 from pot
robertoH2O: doesn't show hand 
*** SUMMARY ***
Total pot €0.05 | Rake €0 
Seat 1: pepenero11 (button) folded before Flop (didn't bet)
Seat 2: father2008 (small blind) folded before Flop
Seat 3: caduceus369 (big blind) folded before Flop
Seat 4: Peru91j folded before Flop (didn't bet)
Seat 5: robertoH2O collected (€0.05)
Seat 6: wiola3922 folded before Flop (didn't bet)



PokerStars Zoom Hand #257988777834:  Hold'em No Limit (€0.01/€0.02) [ADM ID: M62BA304494E32ST] - 2025/10/04 0:28:38 CET [2025/10/03 18:28:38 ET]
Table 'Sirio' 6-max Seat #1 is the button
Seat 1: EasyToRule (€3.17 in chips) 
Seat 2: caduceus369 (€2.50 in chips) 
Seat 3: colosso2022 (€1.55 in chips) 
Seat 4: 0inthemoney (€2.84 in chips) 
Seat 5: Catania838 (€2.19 in chips) 
Seat 6: father2008 (€4.55 in chips) 
caduceus369: posts small blind €0.01
colosso2022: posts big blind €0.02
*** HOLE CARDS ***
Dealt to caduceus369 [Ks 4s]
0inthemoney: raises €0.04 to €0.06
Catania838: folds 
father2008: folds 
EasyToRule: folds 
caduceus369: folds 
colosso2022: calls €0.04
*** FLOP *** [Ts 9c Ac]
colosso2022: bets €0.07
0inthemoney: folds 
Uncalled bet (€0.07) returned to colosso2022
colosso2022 collected €0.13 from pot
colosso2022: doesn't show hand 
*** SUMMARY ***
Total pot €0.13 | Rake €0 
Board [Ts 9c Ac]
Seat 1: EasyToRule (button) folded before Flop (didn't bet)
Seat 2: caduceus369 (small blind) folded before Flop
Seat 3: colosso2022 (big blind) collected (€0.13)
Seat 4: 0inthemoney folded on the Flop
Seat 5: Catania838 folded before Flop (didn't bet)
Seat 6: father2008 folded before Flop (didn't bet)



PokerStars Zoom Hand #257988755964:  Hold'em No Limit (€0.01/€0.02) [ADM ID: M62BA304494E32ST] - 2025/10/04 0:26:57 CET [2025/10/03 18:26:57 ET]
Table 'Sirio' 6-max Seat #1 is the button
Seat 1: caduceus369 (€2.56 in chips) 
Seat 2: Catania838 (€3.87 in chips) 
Seat 3: DAMPER_KK (€3.66 in chips) 
Seat 4: SCOTTISHE (€0.84 in chips) 
Seat 5: Meryjuventina (€1.76 in chips) 
Seat 6: IsyP99 (€1.35 in chips) 
Catania838: posts small blind €0.01
DAMPER_KK: posts big blind €0.02
*** HOLE CARDS ***
Dealt to caduceus369 [7h 3d]
SCOTTISHE: calls €0.02
Meryjuventina: calls €0.02
IsyP99: calls €0.02
caduceus369: folds 
Catania838: folds 
DAMPER_KK: raises €0.02 to €0.04
SCOTTISHE: calls €0.02
Meryjuventina: calls €0.02
IsyP99: calls €0.02
*** FLOP *** [4d Ks 6s]
DAMPER_KK: checks 
SCOTTISHE: bets €0.04
Meryjuventina: calls €0.04
IsyP99: calls €0.04
DAMPER_KK: calls €0.04
*** TURN *** [4d Ks 6s] [4s]
DAMPER_KK: bets €0.14
SCOTTISHE: calls €0.14
Meryjuventina: raises €0.14 to €0.28
IsyP99: folds 
DAMPER_KK: raises €0.14 to €0.42
SCOTTISHE: folds 
Meryjuventina: raises €0.14 to €0.56
DAMPER_KK: calls €0.14
*** RIVER *** [4d Ks 6s 4s] [Qh]
DAMPER_KK: checks 
Meryjuventina: bets €0.44
DAMPER_KK: calls €0.44
*** SHOW DOWN ***
Meryjuventina: shows [As 8s] (a flush, Ace high)
DAMPER_KK: mucks hand 
Meryjuventina collected €2.34 from pot
*** SUMMARY ***
Total pot €2.47 | Rake €0.13 
Board [4d Ks 6s 4s Qh]
Seat 1: caduceus369 (button) folded before Flop (didn't bet)
Seat 2: Catania838 (small blind) folded before Flop
Seat 3: DAMPER_KK (big blind) mucked [4h Ah]
Seat 4: SCOTTISHE folded on the Turn
Seat 5: Meryjuventina showed [As 8s] and won (€2.34) with a flush, Ace high
Seat 6: IsyP99 folded on the Turn



PokerStars Zoom Hand #257988773125:  Hold'em No Limit (€0.01/€0.02) [ADM ID: M62BA304494E32ST] - 2025/10/04 0:28:16 CET [2025/10/03 18:28:16 ET]
Table 'Sirio' 6-max Seat #1 is the button
Seat 1: caduceus369 (€2.52 in chips) 
Seat 2: Ceribelli1705 (€0.56 in chips) 
Seat 3: cap e'bomb95 (€4.86 in chips) 
Seat 4: IsyP99 (€1.27 in chips) 
Seat 5: KillByte00 (€2.84 in chips) 
Seat 6: robertoH2O (€2.27 in chips) 
Ceribelli1705: posts small blind €0.01
cap e'bomb95: posts big blind €0.02
*** HOLE CARDS ***
Dealt to caduceus369 [5c 4d]
IsyP99: calls €0.02
KillByte00: folds 
robertoH2O: folds 
caduceus369: folds 
Ceribelli1705: folds 
cap e'bomb95: checks 
*** FLOP *** [7h 8d 6s]
cap e'bomb95: bets €0.03
IsyP99: calls €0.03
*** TURN *** [7h 8d 6s] [6h]
cap e'bomb95: bets €0.07
IsyP99: calls €0.07
*** RIVER *** [7h 8d 6s 6h] [3h]
cap e'bomb95: checks 
IsyP99: checks 
*** SHOW DOWN ***
cap e'bomb95: shows [8h 9d] (two pair, Eights and Sixes)
IsyP99: mucks hand 
cap e'bomb95 collected €0.24 from pot
*** SUMMARY ***
Total pot €0.25 | Rake €0.01 
Board [7h 8d 6s 6h 3h]
Seat 1: caduceus369 (button) folded before Flop (didn't bet)
Seat 2: Ceribelli1705 (small blind) folded before Flop
Seat 3: cap e'bomb95 (big blind) showed [8h 9d] and won (€0.24) with two pair, Eights and Sixes
Seat 4: IsyP99 mucked [Ts As]
Seat 5: KillByte00 folded before Flop (didn't bet)
Seat 6: robertoH2O folded before Flop (didn't bet)



PokerStars Zoom Hand #257988783221:  Hold'em No Limit (€0.01/€0.02) [ADM ID: M62BA304494E32ST] - 2025/10/04 0:29:03 CET [2025/10/03 18:29:03 ET]
Table 'Sirio' 6-max Seat #1 is the button
Seat 1: Ceribelli1705 (€0.53 in chips) 
Seat 2: DAMPER_KK (€2.58 in chips) 
Seat 3: Meryjuventina (€3.02 in chips) 
Seat 4: Asganaway123 (€1.39 in chips) 
Seat 5: caduceus369 (€2.49 in chips) 
Seat 6: Giampon78 (€1.95 in chips) 
DAMPER_KK: posts small blind €0.01
Meryjuventina: posts big blind €0.02
*** HOLE CARDS ***
Dealt to caduceus369 [6h Kh]
Asganaway123: folds 
caduceus369: folds 
Giampon78: folds 
Ceribelli1705: calls €0.02
DAMPER_KK: folds 
Meryjuventina: checks 
*** FLOP *** [6c Qd As]
Meryjuventina: checks 
Ceribelli1705: bets €0.08
Meryjuventina: folds 
Uncalled bet (€0.08) returned to Ceribelli1705
Ceribelli1705 collected €0.05 from pot
Ceribelli1705: doesn't show hand 
*** SUMMARY ***
Total pot €0.05 | Rake €0 
Board [6c Qd As]
Seat 1: Ceribelli1705 (button) collected (€0.05)
Seat 2: DAMPER_KK (small blind) folded before Flop
Seat 3: Meryjuventina (big blind) folded on the Flop
Seat 4: Asganaway123 folded before Flop (didn't bet)
Seat 5: caduceus369 folded before Flop (didn't bet)
Seat 6: Giampon78 folded before Flop (didn't bet)



PokerStars Zoom Hand #257988785445:  Hold'em No Limit (€0.01/€0.02) [ADM ID: M62BA304494E32ST] - 2025/10/04 0:29:14 CET [2025/10/03 18:29:14 ET]
Table 'Sirio' 6-max Seat #1 is the button
Seat 1: TangaG44 (€1.12 in chips) 
Seat 2: cuzzi68 (€1.53 in chips) 
Seat 3: Asganaway123 (€1.39 in chips) 
Seat 4: caduceus369 (€2.49 in chips) 
Seat 5: pepenero11 (€0.68 in chips) 
Seat 6: fantaasso (€3.16 in chips) 
cuzzi68: posts small blind €0.01
Asganaway123: posts big blind €0.02
*** HOLE CARDS ***
Dealt to caduceus369 [8h 9h]
caduceus369: folds 
pepenero11: folds 
fantaasso: folds 
TangaG44: folds 
cuzzi68: raises €0.04 to €0.06
Asganaway123: folds 
Uncalled bet (€0.04) returned to cuzzi68
cuzzi68 collected €0.04 from pot
cuzzi68: doesn't show hand 
*** SUMMARY ***
Total pot €0.04 | Rake €0 
Seat 1: TangaG44 (button) folded before Flop (didn't bet)
Seat 2: cuzzi68 (small blind) collected (€0.04)
Seat 3: Asganaway123 (big blind) folded before Flop
Seat 4: caduceus369 folded before Flop (didn't bet)
Seat 5: pepenero11 folded before Flop (didn't bet)
Seat 6: fantaasso folded before Flop (didn't bet)



PokerStars Zoom Hand #257988781113:  Hold'em No Limit (€0.01/€0.02) [ADM ID: M62BA304494E32ST] - 2025/10/04 0:28:53 CET [2025/10/03 18:28:53 ET]
Table 'Sirio' 6-max Seat #1 is the button
Seat 1: EasyToRule (€3.17 in chips) 
Seat 2: fantaasso (€3.17 in chips) 
Seat 3: stfuplzudonk (€2.53 in chips) 
Seat 4: criptlux (€1.31 in chips) 
Seat 5: trillycata (€1.42 in chips) 
Seat 6: caduceus369 (€2.49 in chips) 
fantaasso: posts small blind €0.01
stfuplzudonk: posts big blind €0.02
*** HOLE CARDS ***
Dealt to caduceus369 [5c 3d]
criptlux: folds 
trillycata: calls €0.02
caduceus369: folds 
EasyToRule: folds 
fantaasso: folds 
stfuplzudonk: checks 
*** FLOP *** [8d 3h 7h]
stfuplzudonk: checks 
trillycata: bets €0.05
stfuplzudonk: calls €0.05
*** TURN *** [8d 3h 7h] [9c]
stfuplzudonk: checks 
trillycata: checks 
*** RIVER *** [8d 3h 7h 9c] [2d]
stfuplzudonk: checks 
trillycata: checks 
*** SHOW DOWN ***
stfuplzudonk: shows [As 3c] (a pair of Threes)
trillycata: shows [9d Jd] (a pair of Nines)
trillycata collected €0.15 from pot
*** SUMMARY ***
Total pot €0.15 | Rake €0 
Board [8d 3h 7h 9c 2d]
Seat 1: EasyToRule (button) folded before Flop (didn't bet)
Seat 2: fantaasso (small blind) folded before Flop
Seat 3: stfuplzudonk (big blind) showed [As 3c] and lost with a pair of Threes
Seat 4: criptlux folded before Flop (didn't bet)
Seat 5: trillycata showed [9d Jd] and won (€0.15) with a pair of Nines
Seat 6: caduceus369 folded before Flop (didn't bet)



PokerStars Zoom Hand #257988784367:  Hold'em No Limit (€0.01/€0.02) [ADM ID: M62BA304494E32ST] - 2025/10/04 0:29:09 CET [2025/10/03 18:29:09 ET]
Table 'Sirio' 6-max Seat #1 is the button
Seat 1: DAMPER_KK (€2.57 in chips) 
Seat 2: fantaasso (€4.38 in chips) 
Seat 3: EasyToRule (€3.17 in chips) 
Seat 4: caduceus369 (€2.49 in chips) 
Seat 5: father2008 (€5.37 in chips) 
Seat 6: pepenero11 (€0.68 in chips) 
fantaasso: posts small blind €0.01
EasyToRule: posts big blind €0.02
*** HOLE CARDS ***
Dealt to caduceus369 [Kh 5s]
caduceus369: folds 
father2008: folds 
pepenero11: folds 
DAMPER_KK: calls €0.02
fantaasso: calls €0.01
EasyToRule: checks 
*** FLOP *** [3s Tc Th]
fantaasso: checks 
EasyToRule: checks 
DAMPER_KK: checks 
*** TURN *** [3s Tc Th] [Qh]
fantaasso: bets €0.03
EasyToRule: folds 
DAMPER_KK: calls €0.03
*** RIVER *** [3s Tc Th Qh] [Ks]
fantaasso: checks 
DAMPER_KK: bets €0.12
fantaasso: calls €0.12
*** SHOW DOWN ***
DAMPER_KK: shows [Kd 9d] (two pair, Kings and Tens)
fantaasso: mucks hand 
DAMPER_KK collected €0.35 from pot
*** SUMMARY ***
Total pot €0.36 | Rake €0.01 
Board [3s Tc Th Qh Ks]
Seat 1: DAMPER_KK (button) showed [Kd 9d] and won (€0.35) with two pair, Kings and Tens
Seat 2: fantaasso (small blind) mucked [8c Qs]
Seat 3: EasyToRule (big blind) folded on the Turn
Seat 4: caduceus369 folded before Flop (didn't bet)
Seat 5: father2008 folded before Flop (didn't bet)
Seat 6: pepenero11 folded before Flop (didn't bet)



PokerStars Zoom Hand #257988786661:  Hold'em No Limit (€0.01/€0.02) [ADM ID: M62BA304494E32ST] - 2025/10/04 0:29:20 CET [2025/10/03 18:29:20 ET]
Table 'Sirio' 6-max Seat #1 is the button
Seat 1: father2008 (€5.37 in chips) 
Seat 2: amandaknox (€2.07 in chips) 
Seat 3: caduceus369 (€2.49 in chips) 
Seat 4: fantaasso (€3.16 in chips) 
Seat 5: CIKO71131 (€0.68 in chips) 
Seat 6: iceangel2003 (€3.60 in chips) 
amandaknox: posts small blind €0.01
caduceus369: posts big blind €0.02
*** HOLE CARDS ***
Dealt to caduceus369 [9s Ks]
fantaasso: raises €0.04 to €0.06
CIKO71131: folds 
iceangel2003: folds 
father2008: folds 
amandaknox: folds 
caduceus369: calls €0.04
*** FLOP *** [2s 5s 4d]
caduceus369: checks 
fantaasso: bets €0.07
caduceus369: raises €0.13 to €0.20
fantaasso: calls €0.13
*** TURN *** [2s 5s 4d] [Kd]
caduceus369: checks 
fantaasso: checks 
*** RIVER *** [2s 5s 4d Kd] [7h]
caduceus369: bets €0.36
fantaasso: folds 
Uncalled bet (€0.36) returned to caduceus369
caduceus369 collected €0.51 from pot
caduceus369: doesn't show hand 
*** SUMMARY ***
Total pot €0.53 | Rake €0.02 
Board [2s 5s 4d Kd 7h]
Seat 1: father2008 (button) folded before Flop (didn't bet)
Seat 2: amandaknox (small blind) folded before Flop
Seat 3: caduceus369 (big blind) collected (€0.51)
Seat 4: fantaasso folded on the River
Seat 5: CIKO71131 folded before Flop (didn't bet)
Seat 6: iceangel2003 folded before Flop (didn't bet)



PokerStars Zoom Hand #257988799890:  Hold'em No Limit (€0.01/€0.02) [ADM ID: M62BA304494E32ST] - 2025/10/04 0:30:23 CET [2025/10/03 18:30:23 ET]
Table 'Sirio' 6-max Seat #1 is the button
Seat 1: caduceus369 (€2.74 in chips) 
Seat 2: bruciapelo (€3.05 in chips) 
Seat 3: CIKO71131 (€0.66 in chips) 
Seat 4: stfuplzudonk (€4.43 in chips) 
Seat 5: EasyToRule (€3.15 in chips) 
Seat 6: CacciatoreAA (€3.86 in chips) 
bruciapelo: posts small blind €0.01
CIKO71131: posts big blind €0.02
*** HOLE CARDS ***
Dealt to caduceus369 [Ac Ts]
stfuplzudonk: folds 
EasyToRule: folds 
CacciatoreAA: raises €0.06 to €0.08
caduceus369: calls €0.08
bruciapelo: folds 
CIKO71131: folds 
*** FLOP *** [3d 7h 6s]
CacciatoreAA: bets €0.04
caduceus369: calls €0.04
*** TURN *** [3d 7h 6s] [7c]
CacciatoreAA: bets €0.04
caduceus369: folds 
Uncalled bet (€0.04) returned to CacciatoreAA
CacciatoreAA collected €0.26 from pot
CacciatoreAA: doesn't show hand 
*** SUMMARY ***
Total pot €0.27 | Rake €0.01 
Board [3d 7h 6s 7c]
Seat 1: caduceus369 (button) folded on the Turn
Seat 2: bruciapelo (small blind) folded before Flop
Seat 3: CIKO71131 (big blind) folded before Flop
Seat 4: stfuplzudonk folded before Flop (didn't bet)
Seat 5: EasyToRule folded before Flop (didn't bet)
Seat 6: CacciatoreAA collected (€0.26)



PokerStars Zoom Hand #257988807185:  Hold'em No Limit (€0.01/€0.02) [ADM ID: M62BA304494E32ST] - 2025/10/04 0:30:58 CET [2025/10/03 18:30:58 ET]
Table 'Sirio' 6-max Seat #1 is the button
Seat 1: fantaasso (€4.32 in chips) 
Seat 2: caduceus369 (€2.62 in chips) 
Seat 3: KillByte00 (€2.70 in chips) 
Seat 4: CacciatoreAA (€4 in chips) 
Seat 5: stfuplzudonk (€6 in chips) 
Seat 6: father2008 (€4.43 in chips) 
caduceus369: posts small blind €0.01
KillByte00: posts big blind €0.02
*** HOLE CARDS ***
Dealt to caduceus369 [3d 9s]
CacciatoreAA: folds 
stfuplzudonk: folds 
father2008: folds 
fantaasso: folds 
caduceus369: folds 
Uncalled bet (€0.01) returned to KillByte00
KillByte00 collected €0.02 from pot
KillByte00: doesn't show hand 
*** SUMMARY ***
Total pot €0.02 | Rake €0 
Seat 1: fantaasso (button) folded before Flop (didn't bet)
Seat 2: caduceus369 (small blind) folded before Flop
Seat 3: KillByte00 (big blind) collected (€0.02)
Seat 4: CacciatoreAA folded before Flop (didn't bet)
Seat 5: stfuplzudonk folded before Flop (didn't bet)
Seat 6: father2008 folded before Flop (didn't bet)



PokerStars Zoom Hand #257988810325:  Hold'em No Limit (€0.01/€0.02) [ADM ID: M62BA304494E32ST] - 2025/10/04 0:31:13 CET [2025/10/03 18:31:13 ET]
Table 'Sirio' 6-max Seat #1 is the button
Seat 1: stfuplzudonk (€4.43 in chips) 
Seat 2: amandaknox (€2.05 in chips) 
Seat 3: KillByte00 (€2 in chips) 
Seat 4: pepenero11 (€0.62 in chips) 
Seat 5: SCOTTISHE (€0.58 in chips) 
Seat 6: caduceus369 (€2.61 in chips) 
amandaknox: posts small blind €0.01
KillByte00: posts big blind €0.02
*** HOLE CARDS ***
Dealt to caduceus369 [7s 7h]
pepenero11: folds 
SCOTTISHE: calls €0.02
caduceus369: calls €0.02
stfuplzudonk: folds 
amandaknox: calls €0.01
KillByte00: checks 
*** FLOP *** [4c 6h Ad]
amandaknox: checks 
KillByte00: checks 
SCOTTISHE: bets €0.02
caduceus369: folds 
amandaknox: folds 
KillByte00: calls €0.02
*** TURN *** [4c 6h Ad] [2h]
KillByte00: checks 
SCOTTISHE: bets €0.02
KillByte00: calls €0.02
*** RIVER *** [4c 6h Ad 2h] [7c]
KillByte00: checks 
SCOTTISHE: bets €0.06
KillByte00: folds 
Uncalled bet (€0.06) returned to SCOTTISHE
SCOTTISHE collected €0.16 from pot
SCOTTISHE: doesn't show hand 
*** SUMMARY ***
Total pot €0.16 | Rake €0 
Board [4c 6h Ad 2h 7c]
Seat 1: stfuplzudonk (button) folded before Flop (didn't bet)
Seat 2: amandaknox (small blind) folded on the Flop
Seat 3: KillByte00 (big blind) folded on the River
Seat 4: pepenero11 folded before Flop (didn't bet)
Seat 5: SCOTTISHE collected (€0.16)
Seat 6: caduceus369 folded on the Flop



PokerStars Zoom Hand #257988825433:  Hold'em No Limit (€0.01/€0.02) [ADM ID: M62BA304494E32ST] - 2025/10/04 0:32:24 CET [2025/10/03 18:32:24 ET]
Table 'Sirio' 6-max Seat #1 is the button
Seat 1: fantaasso (€4.51 in chips) 
Seat 2: KillByte00 (€2 in chips) 
Seat 3: cuzzi68 (€1.45 in chips) 
Seat 4: cap e'bomb95 (€4.85 in chips) 
Seat 5: caduceus369 (€2.59 in chips) 
Seat 6: criptlux (€3.45 in chips) 
KillByte00: posts small blind €0.01
cuzzi68: posts big blind €0.02
*** HOLE CARDS ***
Dealt to caduceus369 [7h Qc]
cap e'bomb95: folds 
caduceus369: folds 
criptlux: folds 
fantaasso: folds 
KillByte00: folds 
Uncalled bet (€0.01) returned to cuzzi68
cuzzi68 collected €0.02 from pot
cuzzi68: doesn't show hand 
*** SUMMARY ***
Total pot €0.02 | Rake €0 
Seat 1: fantaasso (button) folded before Flop (didn't bet)
Seat 2: KillByte00 (small blind) folded before Flop
Seat 3: cuzzi68 (big blind) collected (€0.02)
Seat 4: cap e'bomb95 folded before Flop (didn't bet)
Seat 5: caduceus369 folded before Flop (didn't bet)
Seat 6: criptlux folded before Flop (didn't bet)



PokerStars Zoom Hand #257988819402:  Hold'em No Limit (€0.01/€0.02) [ADM ID: M62BA304494E32ST] - 2025/10/04 0:31:55 CET [2025/10/03 18:31:55 ET]
Table 'Sirio' 6-max Seat #1 is the button
Seat 1: caduceus369 (€2.59 in chips) 
Seat 2: stfuplzudonk (€4.43 in chips) 
Seat 3: cap e'bomb95 (€4.80 in chips) 
Seat 4: Witness85906 (€5.35 in chips) 
Seat 5: Catania838 (€4.04 in chips) 
Seat 6: Giampon78 (€1.90 in chips) 
stfuplzudonk: posts small blind €0.01
cap e'bomb95: posts big blind €0.02
*** HOLE CARDS ***
Dealt to caduceus369 [9d 4h]
Witness85906: folds 
Catania838: calls €0.02
Giampon78: folds 
caduceus369 has timed out
caduceus369: folds 
stfuplzudonk: calls €0.01
cap e'bomb95: checks 
*** FLOP *** [Kh As Td]
stfuplzudonk: checks 
cap e'bomb95: checks 
Catania838: bets €0.06
stfuplzudonk: calls €0.06
cap e'bomb95: folds 
*** TURN *** [Kh As Td] [Qc]
stfuplzudonk: checks 
Catania838: bets €0.06
stfuplzudonk: calls €0.06
*** RIVER *** [Kh As Td Qc] [6s]
stfuplzudonk: checks 
Catania838: checks 
*** SHOW DOWN ***
stfuplzudonk: shows [Jh Qd] (a straight, Ten to Ace)
Catania838: mucks hand 
stfuplzudonk collected €0.29 from pot
*** SUMMARY ***
Total pot €0.30 | Rake €0.01 
Board [Kh As Td Qc 6s]
Seat 1: caduceus369 (button) folded before Flop (didn't bet)
Seat 2: stfuplzudonk (small blind) showed [Jh Qd] and won (€0.29) with a straight, Ten to Ace
Seat 3: cap e'bomb95 (big blind) folded on the Flop
Seat 4: Witness85906 folded before Flop (didn't bet)
Seat 5: Catania838 mucked [9c Ac]
Seat 6: Giampon78 folded before Flop (didn't bet)



PokerStars Zoom Hand #257988829724:  Hold'em No Limit (€0.01/€0.02) [ADM ID: M62BA304494E32ST] - 2025/10/04 0:32:44 CET [2025/10/03 18:32:44 ET]
Table 'Sirio' 6-max Seat #1 is the button
Seat 1: cap e'bomb95 (€4.78 in chips) 
Seat 2: Catania838 (€2 in chips) 
Seat 3: Matthew790 (€0.88 in chips) 
Seat 4: caduceus369 (€2.57 in chips) 
Seat 5: father2008 (€5.22 in chips) 
Seat 6: fantaasso (€4.51 in chips) 
Catania838: posts small blind €0.01
Matthew790: posts big blind €0.02
*** HOLE CARDS ***
Dealt to caduceus369 [4h Ac]
caduceus369 has timed out
caduceus369: folds 
father2008: folds 
fantaasso: folds 
cap e'bomb95: folds 
Catania838: folds 
Uncalled bet (€0.01) returned to Matthew790
Matthew790 collected €0.02 from pot
Matthew790: doesn't show hand 
*** SUMMARY ***
Total pot €0.02 | Rake €0 
Seat 1: cap e'bomb95 (button) folded before Flop (didn't bet)
Seat 2: Catania838 (small blind) folded before Flop
Seat 3: Matthew790 (big blind) collected (€0.02)
Seat 4: caduceus369 folded before Flop (didn't bet)
Seat 5: father2008 folded before Flop (didn't bet)
Seat 6: fantaasso folded before Flop (didn't bet)



PokerStars Zoom Hand #257988827523:  Hold'em No Limit (€0.01/€0.02) [ADM ID: M62BA304494E32ST] - 2025/10/04 0:32:34 CET [2025/10/03 18:32:34 ET]
Table 'Sirio' 6-max Seat #1 is the button
Seat 1: bruciapelo (€3.13 in chips) 
Seat 2: KillByte00 (€3.10 in chips) 
Seat 3: caduceus369 (€2.59 in chips) 
Seat 4: fantaasso (€4.51 in chips) 
Seat 5: mbeck65 (€2.99 in chips) 
Seat 6: pepenero11 (€0.73 in chips) 
KillByte00: posts small blind €0.01
caduceus369: posts big blind €0.02
*** HOLE CARDS ***
Dealt to caduceus369 [8h 3s]
fantaasso: folds 
mbeck65: folds 
pepenero11: raises €0.02 to €0.04
bruciapelo: folds 
KillByte00: raises €0.12 to €0.16
caduceus369: folds 
pepenero11: calls €0.12
*** FLOP *** [Qh Qs Td]
KillByte00: bets €0.11
pepenero11: calls €0.11
*** TURN *** [Qh Qs Td] [4c]
KillByte00: bets €0.40
pepenero11: raises €0.06 to €0.46 and is all-in
KillByte00: calls €0.06
*** RIVER *** [Qh Qs Td 4c] [5h]
*** SHOW DOWN ***
KillByte00: shows [Ts Kc] (two pair, Queens and Tens)
pepenero11: shows [5c 5s] (a full house, Fives full of Queens)
pepenero11 collected €1.40 from pot
*** SUMMARY ***
Total pot €1.48 | Rake €0.08 
Board [Qh Qs Td 4c 5h]
Seat 1: bruciapelo (button) folded before Flop (didn't bet)
Seat 2: KillByte00 (small blind) showed [Ts Kc] and lost with two pair, Queens and Tens
Seat 3: caduceus369 (big blind) folded before Flop
Seat 4: fantaasso folded before Flop (didn't bet)
Seat 5: mbeck65 folded before Flop (didn't bet)
Seat 6: pepenero11 showed [5c 5s] and won (€1.40) with a full house, Fives full of Queens



