PokerStars Zoom Hand #257997414990:  Hold'em No Limit (€0.01/€0.02) [ADM ID: M62BD3044A1E13PD] - 2025/10/04 19:36:10 CET [2025/10/04 13:36:10 ET]
Table 'Sirio' 6-max Seat #1 is the button
Seat 1: ADRIAN0_MEIS (€4.08 in chips) 
Seat 2: Artemis1a (€5.79 in chips) 
Seat 3: caduceus369 (€2 in chips) 
Seat 4: manch73r (€2.53 in chips) 
Seat 5: KilometroZer0 (€2 in chips) 
Seat 6: SidneyPrescott (€2 in chips) 
Artemis1a: posts small blind €0.01
caduceus369: posts big blind €0.02
*** HOLE CARDS ***
Dealt to caduceus369 [9c Js]
manch73r: folds 
KilometroZer0: folds 
SidneyPrescott: folds 
ADRIAN0_MEIS: folds 
Artemis1a: raises €0.04 to €0.06
caduceus369: folds 
Uncalled bet (€0.04) returned to Artemis1a
Artemis1a collected €0.04 from pot
Artemis1a: doesn't show hand 
*** SUMMARY ***
Total pot €0.04 | Rake €0 
Seat 1: ADRIAN0_MEIS (button) folded before Flop (didn't bet)
Seat 2: Artemis1a (small blind) collected (€0.04)
Seat 3: caduceus369 (big blind) folded before Flop
Seat 4: manch73r folded before Flop (didn't bet)
Seat 5: KilometroZer0 folded before Flop (didn't bet)
Seat 6: SidneyPrescott folded before Flop (didn't bet)



PokerStars Zoom Hand #257997419204:  Hold'em No Limit (€0.01/€0.02) [ADM ID: M62BD3044A1E13PD] - 2025/10/04 19:36:29 CET [2025/10/04 13:36:29 ET]
Table 'Sirio' 6-max Seat #1 is the button
Seat 1: caduceus369 (€1.98 in chips) 
Seat 2: Catania838 (€2.62 in chips) 
Seat 3: LolloSpino (€0.80 in chips) 
Seat 4: pylonstrip (€2.16 in chips) 
Seat 5: ivano747 (€2.45 in chips) 
Seat 6: Sorosuno (€2.04 in chips) 
Catania838: posts small blind €0.01
LolloSpino: posts big blind €0.02
*** HOLE CARDS ***
Dealt to caduceus369 [2d Tc]
pylonstrip: raises €0.02 to €0.04
ivano747: folds 
Sorosuno: folds 
caduceus369: folds 
Catania838: folds 
LolloSpino has timed out while disconnected
LolloSpino: folds 
Uncalled bet (€0.02) returned to pylonstrip
pylonstrip collected €0.05 from pot
pylonstrip: doesn't show hand 
*** SUMMARY ***
Total pot €0.05 | Rake €0 
Seat 1: caduceus369 (button) folded before Flop (didn't bet)
Seat 2: Catania838 (small blind) folded before Flop
Seat 3: LolloSpino (big blind) folded before Flop
Seat 4: pylonstrip collected (€0.05)
Seat 5: ivano747 folded before Flop (didn't bet)
Seat 6: Sorosuno folded before Flop (didn't bet)



PokerStars Zoom Hand #257997424423:  Hold'em No Limit (€0.01/€0.02) [ADM ID: M62BD3044A1E13PD] - 2025/10/04 19:36:52 CET [2025/10/04 13:36:52 ET]
Table 'Sirio' 6-max Seat #1 is the button
Seat 1: IKARO_3 (€2.64 in chips) 
Seat 2: Catania838 (€2.61 in chips) 
Seat 3: ADRIAN0_MEIS (€4.08 in chips) 
Seat 4: Artemis1a (€2.19 in chips) 
Seat 5: GanchanS7 (€3.27 in chips) 
Seat 6: caduceus369 (€1.97 in chips) 
Catania838: posts small blind €0.01
ADRIAN0_MEIS: posts big blind €0.02
*** HOLE CARDS ***
Dealt to caduceus369 [5s Ah]
Artemis1a: folds 
GanchanS7: folds 
caduceus369: raises €0.04 to €0.06
IKARO_3: folds 
Catania838: folds 
ADRIAN0_MEIS: raises €0.13 to €0.19
caduceus369: folds 
Uncalled bet (€0.13) returned to ADRIAN0_MEIS
ADRIAN0_MEIS collected €0.13 from pot
ADRIAN0_MEIS: doesn't show hand 
*** SUMMARY ***
Total pot €0.13 | Rake €0 
Seat 1: IKARO_3 (button) folded before Flop (didn't bet)
Seat 2: Catania838 (small blind) folded before Flop
Seat 3: ADRIAN0_MEIS (big blind) collected (€0.13)
Seat 4: Artemis1a folded before Flop (didn't bet)
Seat 5: GanchanS7 folded before Flop (didn't bet)
Seat 6: caduceus369 folded before Flop



PokerStars Zoom Hand #257997429950:  Hold'em No Limit (€0.01/€0.02) [ADM ID: M62BD3044A1E13PD] - 2025/10/04 19:37:17 CET [2025/10/04 13:37:17 ET]
Table 'Sirio' 6-max Seat #1 is the button
Seat 1: Artemis1a (€5.78 in chips) 
Seat 2: caduceus369 (€1.91 in chips) 
Seat 3: Manus22749 (€2.74 in chips) 
Seat 4: GanchanS7 (€2.20 in chips) 
Seat 5: IKARO_3 (€2.63 in chips) 
Seat 6: KilometroZer0 (€2.15 in chips) 
caduceus369: posts small blind €0.01
Manus22749: posts big blind €0.02
*** HOLE CARDS ***
Dealt to caduceus369 [Kd 5h]
GanchanS7: folds 
IKARO_3: folds 
KilometroZer0: folds 
Artemis1a: folds 
caduceus369: folds 
Uncalled bet (€0.01) returned to Manus22749
Manus22749 collected €0.02 from pot
Manus22749: doesn't show hand 
*** SUMMARY ***
Total pot €0.02 | Rake €0 
Seat 1: Artemis1a (button) folded before Flop (didn't bet)
Seat 2: caduceus369 (small blind) folded before Flop
Seat 3: Manus22749 (big blind) collected (€0.02)
Seat 4: GanchanS7 folded before Flop (didn't bet)
Seat 5: IKARO_3 folded before Flop (didn't bet)
Seat 6: KilometroZer0 folded before Flop (didn't bet)



PokerStars Zoom Hand #257997421780:  Hold'em No Limit (€0.01/€0.02) [ADM ID: M62BD3044A1E13PD] - 2025/10/04 19:36:40 CET [2025/10/04 13:36:40 ET]
Table 'Sirio' 6-max Seat #1 is the button
Seat 1: Parker853 (€0.69 in chips) 
Seat 2: caduceus369 (€1.98 in chips) 
Seat 3: AleBibi25 (€1.84 in chips) 
Seat 4: Artemis1a (€4.05 in chips) 
Seat 5: SidneyPrescott (€2 in chips) 
Seat 6: KilometroZer0 (€2 in chips) 
caduceus369: posts small blind €0.01
AleBibi25: posts big blind €0.02
*** HOLE CARDS ***
Dealt to caduceus369 [7d 9s]
Artemis1a has timed out
Artemis1a: folds 
SidneyPrescott: raises €0.04 to €0.06
KilometroZer0: calls €0.06
Parker853: raises €0.04 to €0.10
caduceus369: folds 
AleBibi25: calls €0.08
SidneyPrescott: calls €0.04
KilometroZer0: calls €0.04
*** FLOP *** [Jc 6c 8s]
AleBibi25: bets €0.12
SidneyPrescott: folds 
KilometroZer0: folds 
Parker853: raises €0.47 to €0.59 and is all-in
AleBibi25: calls €0.47
*** TURN *** [Jc 6c 8s] [5d]
*** RIVER *** [Jc 6c 8s 5d] [Jh]
*** SHOW DOWN ***
AleBibi25: shows [9c Qs] (a pair of Jacks)
Parker853: shows [7s 7h] (two pair, Jacks and Sevens)
Parker853 collected €1.51 from pot
*** SUMMARY ***
Total pot €1.59 | Rake €0.08 
Board [Jc 6c 8s 5d Jh]
Seat 1: Parker853 (button) showed [7s 7h] and won (€1.51) with two pair, Jacks and Sevens
Seat 2: caduceus369 (small blind) folded before Flop
Seat 3: AleBibi25 (big blind) showed [9c Qs] and lost with a pair of Jacks
Seat 4: Artemis1a folded before Flop (didn't bet)
Seat 5: SidneyPrescott folded on the Flop
Seat 6: KilometroZer0 folded on the Flop



PokerStars Zoom Hand #257997439565:  Hold'em No Limit (€0.01/€0.02) [ADM ID: M62BD3044A1E13PD] - 2025/10/04 19:38:00 CET [2025/10/04 13:38:00 ET]
Table 'Sirio' 6-max Seat #1 is the button
Seat 1: Sorosuno (€2.93 in chips) 
Seat 2: RRsanto (€2.19 in chips) 
Seat 3: caduceus369 (€1.90 in chips) 
Seat 4: GanchanS7 (€2.46 in chips) 
Seat 5: KilometroZer0 (€2.13 in chips) 
Seat 6: Artemis1a (€4.05 in chips) 
RRsanto: posts small blind €0.01
caduceus369: posts big blind €0.02
*** HOLE CARDS ***
Dealt to caduceus369 [Jd Kd]
GanchanS7: folds 
KilometroZer0: folds 
Artemis1a: folds 
Sorosuno: folds 
RRsanto: folds 
Uncalled bet (€0.01) returned to caduceus369
caduceus369 collected €0.02 from pot
caduceus369: doesn't show hand 
*** SUMMARY ***
Total pot €0.02 | Rake €0 
Seat 1: Sorosuno (button) folded before Flop (didn't bet)
Seat 2: RRsanto (small blind) folded before Flop
Seat 3: caduceus369 (big blind) collected (€0.02)
Seat 4: GanchanS7 folded before Flop (didn't bet)
Seat 5: KilometroZer0 folded before Flop (didn't bet)
Seat 6: Artemis1a folded before Flop (didn't bet)



PokerStars Zoom Hand #257997432349:  Hold'em No Limit (€0.01/€0.02) [ADM ID: M62BD3044A1E13PD] - 2025/10/04 19:37:28 CET [2025/10/04 13:37:28 ET]
Table 'Sirio' 6-max Seat #1 is the button
Seat 1: caduceus369 (€1.90 in chips) 
Seat 2: SidneyPrescott (€2 in chips) 
Seat 3: CARAPIGNA (€1.80 in chips) 
Seat 4: ADRIAN0_MEIS (€6.15 in chips) 
Seat 5: Sim_sala_bin (€0.83 in chips) 
Seat 6: LolloSpino (€0.80 in chips) 
SidneyPrescott: posts small blind €0.01
CARAPIGNA: posts big blind €0.02
*** HOLE CARDS ***
Dealt to caduceus369 [3h 2h]
ADRIAN0_MEIS: folds 
Sim_sala_bin: calls €0.02
LolloSpino: folds 
caduceus369: folds 
SidneyPrescott: calls €0.01
CARAPIGNA: checks 
*** FLOP *** [4c 6d Kd]
SidneyPrescott: checks 
CARAPIGNA: checks 
Sim_sala_bin: checks 
*** TURN *** [4c 6d Kd] [6c]
SidneyPrescott: checks 
CARAPIGNA: bets €0.06
Sim_sala_bin: folds 
SidneyPrescott: folds 
Uncalled bet (€0.06) returned to CARAPIGNA
CARAPIGNA collected €0.06 from pot
CARAPIGNA: doesn't show hand 
*** SUMMARY ***
Total pot €0.06 | Rake €0 
Board [4c 6d Kd 6c]
Seat 1: caduceus369 (button) folded before Flop (didn't bet)
Seat 2: SidneyPrescott (small blind) folded on the Turn
Seat 3: CARAPIGNA (big blind) collected (€0.06)
Seat 4: ADRIAN0_MEIS folded before Flop (didn't bet)
Seat 5: Sim_sala_bin folded on the Turn
Seat 6: LolloSpino folded before Flop (didn't bet)



PokerStars Zoom Hand #257997437308:  Hold'em No Limit (€0.01/€0.02) [ADM ID: M62BD3044A1E13PD] - 2025/10/04 19:37:50 CET [2025/10/04 13:37:50 ET]
Table 'Sirio' 6-max Seat #1 is the button
Seat 1: IKARO_3 (€2.22 in chips) 
Seat 2: Sorosuno (€2.94 in chips) 
Seat 3: ivano747 (€2.41 in chips) 
Seat 4: KilometroZer0 (€1.90 in chips) 
Seat 5: Pokopoco754 (€2.01 in chips) 
Seat 6: caduceus369 (€1.90 in chips) 
Sorosuno: posts small blind €0.01
ivano747: posts big blind €0.02
*** HOLE CARDS ***
Dealt to caduceus369 [5d 4d]
KilometroZer0: folds 
Pokopoco754: calls €0.02
caduceus369: folds 
IKARO_3: folds 
Sorosuno: folds 
ivano747: checks 
*** FLOP *** [9h 7d 7s]
ivano747: checks 
Pokopoco754: bets €0.02
ivano747: folds 
Uncalled bet (€0.02) returned to Pokopoco754
Pokopoco754 collected €0.05 from pot
Pokopoco754: doesn't show hand 
*** SUMMARY ***
Total pot €0.05 | Rake €0 
Board [9h 7d 7s]
Seat 1: IKARO_3 (button) folded before Flop (didn't bet)
Seat 2: Sorosuno (small blind) folded before Flop
Seat 3: ivano747 (big blind) folded on the Flop
Seat 4: KilometroZer0 folded before Flop (didn't bet)
Seat 5: Pokopoco754 collected (€0.05)
Seat 6: caduceus369 folded before Flop (didn't bet)



PokerStars Zoom Hand #257997445153:  Hold'em No Limit (€0.01/€0.02) [ADM ID: M62BD3044A1E13PD] - 2025/10/04 19:38:25 CET [2025/10/04 13:38:25 ET]
Table 'Sirio' 6-max Seat #1 is the button
Seat 1: IKARO_3 (€1.32 in chips) 
Seat 2: GanchanS7 (€2.23 in chips) 
Seat 3: SidneyPrescott (€2 in chips) 
Seat 4: Artemis1a (€5.78 in chips) 
Seat 5: caduceus369 (€1.91 in chips) 
Seat 6: Pokopoco754 (€2.04 in chips) 
GanchanS7: posts small blind €0.01
SidneyPrescott: posts big blind €0.02
*** HOLE CARDS ***
Dealt to caduceus369 [Js 2h]
Artemis1a: folds 
caduceus369: folds 
Pokopoco754: folds 
IKARO_3: folds 
GanchanS7: folds 
Uncalled bet (€0.01) returned to SidneyPrescott
SidneyPrescott collected €0.02 from pot
SidneyPrescott: doesn't show hand 
*** SUMMARY ***
Total pot €0.02 | Rake €0 
Seat 1: IKARO_3 (button) folded before Flop (didn't bet)
Seat 2: GanchanS7 (small blind) folded before Flop
Seat 3: SidneyPrescott (big blind) collected (€0.02)
Seat 4: Artemis1a folded before Flop (didn't bet)
Seat 5: caduceus369 folded before Flop (didn't bet)
Seat 6: Pokopoco754 folded before Flop (didn't bet)



PokerStars Zoom Hand #257997442887:  Hold'em No Limit (€0.01/€0.02) [ADM ID: M62BD3044A1E13PD] - 2025/10/04 19:38:15 CET [2025/10/04 13:38:15 ET]
Table 'Sirio' 6-max Seat #1 is the button
Seat 1: Sorosuno (€2 in chips) 
Seat 2: Gionni483 (€1.84 in chips) 
Seat 3: Sim_sala_bin (€0.81 in chips) 
Seat 4: LolloSpino (€2.01 in chips) 
Seat 5: caduceus369 (€1.91 in chips) 
Seat 6: RRsanto (€2.18 in chips) 
Gionni483: posts small blind €0.01
Sim_sala_bin: posts big blind €0.02
*** HOLE CARDS ***
Dealt to caduceus369 [9h 3d]
LolloSpino: folds 
caduceus369: folds 
RRsanto: raises €0.04 to €0.06
Sorosuno: raises €0.12 to €0.18
Gionni483: folds 
Sim_sala_bin: folds 
RRsanto: folds 
Uncalled bet (€0.12) returned to Sorosuno
Sorosuno collected €0.15 from pot
Sorosuno: doesn't show hand 
*** SUMMARY ***
Total pot €0.15 | Rake €0 
Seat 1: Sorosuno (button) collected (€0.15)
Seat 2: Gionni483 (small blind) folded before Flop
Seat 3: Sim_sala_bin (big blind) folded before Flop
Seat 4: LolloSpino folded before Flop (didn't bet)
Seat 5: caduceus369 folded before Flop (didn't bet)
Seat 6: RRsanto folded before Flop



PokerStars Zoom Hand #257997444283:  Hold'em No Limit (€0.01/€0.02) [ADM ID: M62BD3044A1E13PD] - 2025/10/04 19:38:21 CET [2025/10/04 13:38:21 ET]
Table 'Sirio' 6-max Seat #1 is the button
Seat 1: CARAPIGNA (€1.84 in chips) 
Seat 2: SidneyPrescott (€2.40 in chips) 
Seat 3: ADRIAN0_MEIS (€2 in chips) 
Seat 4: caduceus369 (€1.91 in chips) 
Seat 5: Parker853 (€1.59 in chips) 
Seat 6: Artemis1a (€1.88 in chips) 
SidneyPrescott: posts small blind €0.01
ADRIAN0_MEIS: posts big blind €0.02
*** HOLE CARDS ***
Dealt to caduceus369 [Qh 6d]
caduceus369: folds 
Parker853: folds 
Artemis1a: raises €0.05 to €0.07
CARAPIGNA: folds 
SidneyPrescott: raises €0.17 to €0.24
ADRIAN0_MEIS: folds 
Artemis1a: calls €0.17
*** FLOP *** [5d 7s Jh]
SidneyPrescott: bets €0.16
Artemis1a: folds 
Uncalled bet (€0.16) returned to SidneyPrescott
SidneyPrescott collected €0.48 from pot
SidneyPrescott: doesn't show hand 
*** SUMMARY ***
Total pot €0.50 | Rake €0.02 
Board [5d 7s Jh]
Seat 1: CARAPIGNA (button) folded before Flop (didn't bet)
Seat 2: SidneyPrescott (small blind) collected (€0.48)
Seat 3: ADRIAN0_MEIS (big blind) folded before Flop
Seat 4: caduceus369 folded before Flop (didn't bet)
Seat 5: Parker853 folded before Flop (didn't bet)
Seat 6: Artemis1a folded on the Flop



PokerStars Zoom Hand #257997447393:  Hold'em No Limit (€0.01/€0.02) [ADM ID: M62BD3044A1E13PD] - 2025/10/04 19:38:35 CET [2025/10/04 13:38:35 ET]
Table 'Sirio' 6-max Seat #1 is the button
Seat 1: KilometroZer0 (€1.88 in chips) 
Seat 2: SaTheNuts_77 (€2.91 in chips) 
Seat 3: Pokopoco754 (€2.04 in chips) 
Seat 4: caduceus369 (€1.91 in chips) 
Seat 5: RRsanto (€2.12 in chips) 
Seat 6: ivano747 (€2.38 in chips) 
SaTheNuts_77: posts small blind €0.01
Pokopoco754: posts big blind €0.02
*** HOLE CARDS ***
Dealt to caduceus369 [2h 9d]
caduceus369: folds 
RRsanto: folds 
ivano747: folds 
KilometroZer0: folds 
SaTheNuts_77: raises €0.05 to €0.07
Pokopoco754: folds 
Uncalled bet (€0.05) returned to SaTheNuts_77
SaTheNuts_77 collected €0.04 from pot
SaTheNuts_77: doesn't show hand 
*** SUMMARY ***
Total pot €0.04 | Rake €0 
Seat 1: KilometroZer0 (button) folded before Flop (didn't bet)
Seat 2: SaTheNuts_77 (small blind) collected (€0.04)
Seat 3: Pokopoco754 (big blind) folded before Flop
Seat 4: caduceus369 folded before Flop (didn't bet)
Seat 5: RRsanto folded before Flop (didn't bet)
Seat 6: ivano747 folded before Flop (didn't bet)



PokerStars Zoom Hand #257997451053:  Hold'em No Limit (€0.01/€0.02) [ADM ID: M62BD3044A1E13PD] - 2025/10/04 19:38:51 CET [2025/10/04 13:38:51 ET]
Table 'Sirio' 6-max Seat #1 is the button
Seat 1: Kazzimmino (€2.02 in chips) 
Seat 2: caduceus369 (€2 in chips) 
Seat 3: LolloSpino (€0.81 in chips) 
Seat 4: SidneyPrescott (€2.01 in chips) 
Seat 5: Artemis1a (€1.64 in chips) 
Seat 6: Sorosuno (€2.09 in chips) 
caduceus369: posts small blind €0.01
LolloSpino: posts big blind €0.02
*** HOLE CARDS ***
Dealt to caduceus369 [7c 2d]
SidneyPrescott: folds 
Artemis1a: folds 
Sorosuno: raises €0.03 to €0.05
Kazzimmino: folds 
caduceus369: folds 
LolloSpino: calls €0.03
*** FLOP *** [9d 2s Kc]
LolloSpino: checks 
Sorosuno: bets €0.06
LolloSpino: folds 
Uncalled bet (€0.06) returned to Sorosuno
Sorosuno collected €0.11 from pot
Sorosuno: doesn't show hand 
*** SUMMARY ***
Total pot €0.11 | Rake €0 
Board [9d 2s Kc]
Seat 1: Kazzimmino (button) folded before Flop (didn't bet)
Seat 2: caduceus369 (small blind) folded before Flop
Seat 3: LolloSpino (big blind) folded on the Flop
Seat 4: SidneyPrescott folded before Flop (didn't bet)
Seat 5: Artemis1a folded before Flop (didn't bet)
Seat 6: Sorosuno collected (€0.11)



PokerStars Zoom Hand #257997453028:  Hold'em No Limit (€0.01/€0.02) [ADM ID: M62BD3044A1E13PD] - 2025/10/04 19:39:00 CET [2025/10/04 13:39:00 ET]
Table 'Sirio' 6-max Seat #1 is the button
Seat 1: Wunschgast (€3.05 in chips) 
Seat 2: Pokopoco754 (€2.02 in chips) 
Seat 3: caduceus369 (€2 in chips) 
Seat 4: Artemis1a (€1.64 in chips) 
Seat 5: Kazzimmino (€2.02 in chips) 
Seat 6: ADRIAN0_MEIS (€4.08 in chips) 
Pokopoco754: posts small blind €0.01
caduceus369: posts big blind €0.02
*** HOLE CARDS ***
Dealt to caduceus369 [Qh As]
Artemis1a: folds 
Kazzimmino: folds 
ADRIAN0_MEIS: folds 
Wunschgast: folds 
Pokopoco754: calls €0.01
caduceus369: raises €0.06 to €0.08
Pokopoco754: folds 
Uncalled bet (€0.06) returned to caduceus369
caduceus369 collected €0.04 from pot
caduceus369: doesn't show hand 
*** SUMMARY ***
Total pot €0.04 | Rake €0 
Seat 1: Wunschgast (button) folded before Flop (didn't bet)
Seat 2: Pokopoco754 (small blind) folded before Flop
Seat 3: caduceus369 (big blind) collected (€0.04)
Seat 4: Artemis1a folded before Flop (didn't bet)
Seat 5: Kazzimmino folded before Flop (didn't bet)
Seat 6: ADRIAN0_MEIS folded before Flop (didn't bet)



PokerStars Zoom Hand #257997459787:  Hold'em No Limit (€0.01/€0.02) [ADM ID: M62BD3044A1E13PD] - 2025/10/04 19:39:30 CET [2025/10/04 13:39:30 ET]
Table 'Sirio' 6-max Seat #1 is the button
Seat 1: caduceus369 (€2.02 in chips) 
Seat 2: GanchanS7 (€2.20 in chips) 
Seat 3: stevalmg (€2.08 in chips) 
Seat 4: IKARO_3 (€1.58 in chips) 
Seat 5: colosso2022 (€3.12 in chips) 
Seat 6: manch73r (€3.18 in chips) 
GanchanS7: posts small blind €0.01
stevalmg: posts big blind €0.02
*** HOLE CARDS ***
Dealt to caduceus369 [4s Kc]
IKARO_3: folds 
colosso2022: raises €0.02 to €0.04
manch73r: calls €0.04
caduceus369: folds 
GanchanS7: folds 
stevalmg: calls €0.02
*** FLOP *** [Th Ah 2c]
stevalmg: checks 
colosso2022: bets €0.07
manch73r: folds 
stevalmg: folds 
Uncalled bet (€0.07) returned to colosso2022
colosso2022 collected €0.13 from pot
colosso2022: doesn't show hand 
*** SUMMARY ***
Total pot €0.13 | Rake €0 
Board [Th Ah 2c]
Seat 1: caduceus369 (button) folded before Flop (didn't bet)
Seat 2: GanchanS7 (small blind) folded before Flop
Seat 3: stevalmg (big blind) folded on the Flop
Seat 4: IKARO_3 folded before Flop (didn't bet)
Seat 5: colosso2022 collected (€0.13)
Seat 6: manch73r folded on the Flop



PokerStars Zoom Hand #257997466500:  Hold'em No Limit (€0.01/€0.02) [ADM ID: M62BD3044A1E13PD] - 2025/10/04 19:40:01 CET [2025/10/04 13:40:01 ET]
Table 'Sirio' 6-max Seat #1 is the button
Seat 1: RRsanto (€2 in chips) 
Seat 2: SidneyPrescott (€2 in chips) 
Seat 3: sisifo40 (€1.01 in chips) 
Seat 4: Artemis1a (€4.18 in chips) 
Seat 5: CARAPIGNA (€1.87 in chips) 
Seat 6: caduceus369 (€2.02 in chips) 
SidneyPrescott: posts small blind €0.01
sisifo40: posts big blind €0.02
*** HOLE CARDS ***
Dealt to caduceus369 [4s As]
Artemis1a: folds 
CARAPIGNA: folds 
caduceus369: raises €0.04 to €0.06
RRsanto: folds 
SidneyPrescott: folds 
sisifo40: calls €0.04
*** FLOP *** [Td 4c Ah]
sisifo40: checks 
caduceus369: bets €0.09
sisifo40: folds 
Uncalled bet (€0.09) returned to caduceus369
caduceus369 collected €0.13 from pot
caduceus369: doesn't show hand 
*** SUMMARY ***
Total pot €0.13 | Rake €0 
Board [Td 4c Ah]
Seat 1: RRsanto (button) folded before Flop (didn't bet)
Seat 2: SidneyPrescott (small blind) folded before Flop
Seat 3: sisifo40 (big blind) folded on the Flop
Seat 4: Artemis1a folded before Flop (didn't bet)
Seat 5: CARAPIGNA folded before Flop (didn't bet)
Seat 6: caduceus369 collected (€0.13)



PokerStars Zoom Hand #257997465152:  Hold'em No Limit (€0.01/€0.02) [ADM ID: M62BD3044A1E13PD] - 2025/10/04 19:39:54 CET [2025/10/04 13:39:54 ET]
Table 'Sirio' 6-max Seat #1 is the button
Seat 1: caduceus369 (€2.02 in chips) 
Seat 2: emidio92 (€2.73 in chips) 
Seat 3: leonnemo (€0.71 in chips) 
Seat 4: SidneyPrescott (€2 in chips) 
Seat 5: Artemis1a (€4.18 in chips) 
Seat 6: bruciapelo (€3.91 in chips) 
emidio92: posts small blind €0.01
leonnemo: posts big blind €0.02
*** HOLE CARDS ***
Dealt to caduceus369 [3h 9s]
SidneyPrescott: folds 
Artemis1a: folds 
bruciapelo: folds 
caduceus369: folds 
emidio92: raises €0.04 to €0.06
leonnemo: calls €0.04
*** FLOP *** [4d 6s 3d]
emidio92: checks 
leonnemo: checks 
*** TURN *** [4d 6s 3d] [Qh]
emidio92: bets €0.07
leonnemo: folds 
Uncalled bet (€0.07) returned to emidio92
emidio92 collected €0.12 from pot
emidio92: doesn't show hand 
*** SUMMARY ***
Total pot €0.12 | Rake €0 
Board [4d 6s 3d Qh]
Seat 1: caduceus369 (button) folded before Flop (didn't bet)
Seat 2: emidio92 (small blind) collected (€0.12)
Seat 3: leonnemo (big blind) folded on the Turn
Seat 4: SidneyPrescott folded before Flop (didn't bet)
Seat 5: Artemis1a folded before Flop (didn't bet)
Seat 6: bruciapelo folded before Flop (didn't bet)



PokerStars Zoom Hand #257997473103:  Hold'em No Limit (€0.01/€0.02) [ADM ID: M62BD3044A1E13PD] - 2025/10/04 19:40:31 CET [2025/10/04 13:40:31 ET]
Table 'Sirio' 6-max Seat #1 is the button
Seat 1: ADRIAN0_MEIS (€2.28 in chips) 
Seat 2: caduceus369 (€2.09 in chips) 
Seat 3: emidio92 (€3.65 in chips) 
Seat 4: IKARO_3 (€2.55 in chips) 
Seat 5: LolloSpino (€2.06 in chips) 
Seat 6: KilometroZer0 (€2.09 in chips) 
caduceus369: posts small blind €0.01
emidio92: posts big blind €0.02
*** HOLE CARDS ***
Dealt to caduceus369 [As 4s]
IKARO_3: folds 
LolloSpino: folds 
KilometroZer0: folds 
ADRIAN0_MEIS: folds 
caduceus369: raises €0.04 to €0.06
emidio92: folds 
Uncalled bet (€0.04) returned to caduceus369
caduceus369 collected €0.04 from pot
caduceus369: doesn't show hand 
*** SUMMARY ***
Total pot €0.04 | Rake €0 
Seat 1: ADRIAN0_MEIS (button) folded before Flop (didn't bet)
Seat 2: caduceus369 (small blind) collected (€0.04)
Seat 3: emidio92 (big blind) folded before Flop
Seat 4: IKARO_3 folded before Flop (didn't bet)
Seat 5: LolloSpino folded before Flop (didn't bet)
Seat 6: KilometroZer0 folded before Flop (didn't bet)



PokerStars Zoom Hand #257997462948:  Hold'em No Limit (€0.01/€0.02) [ADM ID: M62BD3044A1E13PD] - 2025/10/04 19:39:44 CET [2025/10/04 13:39:44 ET]
Table 'Sirio' 6-max Seat #1 is the button
Seat 1: Sorosuno (€2 in chips) 
Seat 2: RRsanto (€2.01 in chips) 
Seat 3: GanchanS7 (€3.20 in chips) 
Seat 4: caduceus369 (€2.02 in chips) 
Seat 5: ADRIAN0_MEIS (€4.02 in chips) 
Seat 6: leonnemo (€0.71 in chips) 
RRsanto: posts small blind €0.01
GanchanS7: posts big blind €0.02
*** HOLE CARDS ***
Dealt to caduceus369 [4h Tc]
caduceus369: folds 
ADRIAN0_MEIS: folds 
leonnemo: folds 
Sorosuno: raises €0.03 to €0.05
RRsanto: raises €0.13 to €0.18
GanchanS7: folds 
Sorosuno: calls €0.13
*** FLOP *** [Kd 2d Ks]
RRsanto: checks 
Sorosuno: checks 
*** TURN *** [Kd 2d Ks] [Kh]
RRsanto: bets €0.12
Sorosuno: calls €0.12
*** RIVER *** [Kd 2d Ks Kh] [Jh]
RRsanto: bets €0.44
Sorosuno: raises €0.51 to €0.95
RRsanto: calls €0.51
*** SHOW DOWN ***
Sorosuno: shows [7h Ac] (three of a kind, Kings)
RRsanto: shows [Ad Jc] (a full house, Kings full of Jacks)
RRsanto collected €2.39 from pot
*** SUMMARY ***
Total pot €2.52 | Rake €0.13 
Board [Kd 2d Ks Kh Jh]
Seat 1: Sorosuno (button) showed [7h Ac] and lost with three of a kind, Kings
Seat 2: RRsanto (small blind) showed [Ad Jc] and won (€2.39) with a full house, Kings full of Jacks
Seat 3: GanchanS7 (big blind) folded before Flop
Seat 4: caduceus369 folded before Flop (didn't bet)
Seat 5: ADRIAN0_MEIS folded before Flop (didn't bet)
Seat 6: leonnemo folded before Flop (didn't bet)



PokerStars Zoom Hand #257997477779:  Hold'em No Limit (€0.01/€0.02) [ADM ID: M62BD3044A1E13PD] - 2025/10/04 19:40:51 CET [2025/10/04 13:40:51 ET]
Table 'Sirio' 6-max Seat #1 is the button
Seat 1: KilometroZer0 (€2.05 in chips) 
Seat 2: Pokopoco754 (€1.59 in chips) 
Seat 3: caduceus369 (€2.11 in chips) 
Seat 4: IKARO_3 (€1.67 in chips) 
Seat 5: Pierleonim (€0.18 in chips) 
Seat 6: robertoH2O (€2 in chips) 
Pokopoco754: posts small blind €0.01
caduceus369: posts big blind €0.02
*** HOLE CARDS ***
Dealt to caduceus369 [7h Kd]
IKARO_3: folds 
Pierleonim: folds 
robertoH2O: raises €0.03 to €0.05
KilometroZer0: folds 
Pokopoco754: folds 
caduceus369: calls €0.03
*** FLOP *** [3h Ah Jc]
caduceus369: checks 
robertoH2O: bets €0.07
caduceus369: folds 
Uncalled bet (€0.07) returned to robertoH2O
robertoH2O collected €0.11 from pot
robertoH2O: doesn't show hand 
*** SUMMARY ***
Total pot €0.11 | Rake €0 
Board [3h Ah Jc]
Seat 1: KilometroZer0 (button) folded before Flop (didn't bet)
Seat 2: Pokopoco754 (small blind) folded before Flop
Seat 3: caduceus369 (big blind) folded on the Flop
Seat 4: IKARO_3 folded before Flop (didn't bet)
Seat 5: Pierleonim folded before Flop (didn't bet)
Seat 6: robertoH2O collected (€0.11)



PokerStars Zoom Hand #257997483357:  Hold'em No Limit (€0.01/€0.02) [ADM ID: M62BD3044A1E13PD] - 2025/10/04 19:41:17 CET [2025/10/04 13:41:17 ET]
Table 'Sirio' 6-max Seat #1 is the button
Seat 1: pylonstrip (€2 in chips) 
Seat 2: leonnemo (€0.63 in chips) 
Seat 3: SaTheNuts_77 (€2.56 in chips) 
Seat 4: RRsanto (€3.15 in chips) 
Seat 5: caduceus369 (€2.06 in chips) 
Seat 6: ADRIAN0_MEIS (€2.28 in chips) 
leonnemo: posts small blind €0.01
SaTheNuts_77: posts big blind €0.02
*** HOLE CARDS ***
Dealt to caduceus369 [8c 3c]
RRsanto: folds 
caduceus369: folds 
ADRIAN0_MEIS: raises €0.03 to €0.05
pylonstrip: folds 
leonnemo: folds 
SaTheNuts_77: folds 
Uncalled bet (€0.03) returned to ADRIAN0_MEIS
ADRIAN0_MEIS collected €0.05 from pot
ADRIAN0_MEIS: doesn't show hand 
*** SUMMARY ***
Total pot €0.05 | Rake €0 
Seat 1: pylonstrip (button) folded before Flop (didn't bet)
Seat 2: leonnemo (small blind) folded before Flop
Seat 3: SaTheNuts_77 (big blind) folded before Flop
Seat 4: RRsanto folded before Flop (didn't bet)
Seat 5: caduceus369 folded before Flop (didn't bet)
Seat 6: ADRIAN0_MEIS collected (€0.05)



PokerStars Zoom Hand #257997486726:  Hold'em No Limit (€0.01/€0.02) [ADM ID: M62BD3044A1E13PD] - 2025/10/04 19:41:32 CET [2025/10/04 13:41:32 ET]
Table 'Sirio' 6-max Seat #1 is the button
Seat 1: GanchanS7 (€2.14 in chips) 
Seat 2: caduceus369 (€2.06 in chips) 
Seat 3: emidio92 (€2.74 in chips) 
Seat 4: ivano747 (€2.30 in chips) 
Seat 5: leonnemo (€0.62 in chips) 
Seat 6: pylonstrip (€2 in chips) 
caduceus369: posts small blind €0.01
emidio92: posts big blind €0.02
*** HOLE CARDS ***
Dealt to caduceus369 [Kd As]
ivano747: folds 
leonnemo: calls €0.02
pylonstrip: folds 
GanchanS7: folds 
caduceus369: raises €0.08 to €0.10
emidio92: folds 
leonnemo: folds 
Uncalled bet (€0.08) returned to caduceus369
caduceus369 collected €0.06 from pot
caduceus369: doesn't show hand 
*** SUMMARY ***
Total pot €0.06 | Rake €0 
Seat 1: GanchanS7 (button) folded before Flop (didn't bet)
Seat 2: caduceus369 (small blind) collected (€0.06)
Seat 3: emidio92 (big blind) folded before Flop
Seat 4: ivano747 folded before Flop (didn't bet)
Seat 5: leonnemo folded before Flop
Seat 6: pylonstrip folded before Flop (didn't bet)



PokerStars Zoom Hand #257997485506:  Hold'em No Limit (€0.01/€0.02) [ADM ID: M62BD3044A1E13PD] - 2025/10/04 19:41:27 CET [2025/10/04 13:41:27 ET]
Table 'Sirio' 6-max Seat #1 is the button
Seat 1: KilometroZer0 (€1.97 in chips) 
Seat 2: SaTheNuts_77 (€2.54 in chips) 
Seat 3: CARAPIGNA (€1.84 in chips) 
Seat 4: IKARO_3 (€2.33 in chips) 
Seat 5: Wunschgast (€3.34 in chips) 
Seat 6: caduceus369 (€2.06 in chips) 
SaTheNuts_77: posts small blind €0.01
CARAPIGNA: posts big blind €0.02
*** HOLE CARDS ***
Dealt to caduceus369 [5h 7c]
IKARO_3: folds 
Wunschgast: folds 
caduceus369: folds 
KilometroZer0: folds 
SaTheNuts_77: raises €0.03 to €0.05
CARAPIGNA: folds 
Uncalled bet (€0.03) returned to SaTheNuts_77
SaTheNuts_77 collected €0.04 from pot
SaTheNuts_77: doesn't show hand 
*** SUMMARY ***
Total pot €0.04 | Rake €0 
Seat 1: KilometroZer0 (button) folded before Flop (didn't bet)
Seat 2: SaTheNuts_77 (small blind) collected (€0.04)
Seat 3: CARAPIGNA (big blind) folded before Flop
Seat 4: IKARO_3 folded before Flop (didn't bet)
Seat 5: Wunschgast folded before Flop (didn't bet)
Seat 6: caduceus369 folded before Flop (didn't bet)



PokerStars Zoom Hand #257997484207:  Hold'em No Limit (€0.01/€0.02) [ADM ID: M62BD3044A1E13PD] - 2025/10/04 19:41:21 CET [2025/10/04 13:41:21 ET]
Table 'Sirio' 6-max Seat #1 is the button
Seat 1: GanchanS7 (€3.17 in chips) 
Seat 2: ADRIAN0_MEIS (€6.04 in chips) 
Seat 3: emidio92 (€3.62 in chips) 
Seat 4: Sorosuno (€2.70 in chips) 
Seat 5: caduceus369 (€2.06 in chips) 
Seat 6: RRsanto (€3.15 in chips) 
ADRIAN0_MEIS: posts small blind €0.01
emidio92: posts big blind €0.02
*** HOLE CARDS ***
Dealt to caduceus369 [4h 5s]
Sorosuno: folds 
caduceus369: folds 
RRsanto: raises €0.04 to €0.06
GanchanS7: folds 
ADRIAN0_MEIS: raises €0.14 to €0.20
emidio92: folds 
RRsanto: calls €0.14
*** FLOP *** [5d 3s 6h]
ADRIAN0_MEIS: bets €0.30
RRsanto: folds 
Uncalled bet (€0.30) returned to ADRIAN0_MEIS
ADRIAN0_MEIS collected €0.40 from pot
ADRIAN0_MEIS: doesn't show hand 
*** SUMMARY ***
Total pot €0.42 | Rake €0.02 
Board [5d 3s 6h]
Seat 1: GanchanS7 (button) folded before Flop (didn't bet)
Seat 2: ADRIAN0_MEIS (small blind) collected (€0.40)
Seat 3: emidio92 (big blind) folded before Flop
Seat 4: Sorosuno folded before Flop (didn't bet)
Seat 5: caduceus369 folded before Flop (didn't bet)
Seat 6: RRsanto folded on the Flop



PokerStars Zoom Hand #257997491164:  Hold'em No Limit (€0.01/€0.02) [ADM ID: M62BD3044A1E13PD] - 2025/10/04 19:41:52 CET [2025/10/04 13:41:52 ET]
Table 'Sirio' 6-max Seat #1 is the button
Seat 1: Black98Demon (€2.18 in chips) 
Seat 2: GanchanS7 (€3.89 in chips) 
Seat 3: caduceus369 (€2.10 in chips) 
Seat 4: KilometroZer0 (€1.97 in chips) 
Seat 5: Manus22749 (€2.71 in chips) 
Seat 6: emidio92 (€9.73 in chips) 
GanchanS7: posts small blind €0.01
caduceus369: posts big blind €0.02
*** HOLE CARDS ***
Dealt to caduceus369 [2h Kd]
KilometroZer0: folds 
Manus22749: raises €0.04 to €0.06
emidio92: folds 
Black98Demon: folds 
GanchanS7: folds 
caduceus369: folds 
Uncalled bet (€0.04) returned to Manus22749
Manus22749 collected €0.05 from pot
Manus22749: doesn't show hand 
*** SUMMARY ***
Total pot €0.05 | Rake €0 
Seat 1: Black98Demon (button) folded before Flop (didn't bet)
Seat 2: GanchanS7 (small blind) folded before Flop
Seat 3: caduceus369 (big blind) folded before Flop
Seat 4: KilometroZer0 folded before Flop (didn't bet)
Seat 5: Manus22749 collected (€0.05)
Seat 6: emidio92 folded before Flop (didn't bet)



PokerStars Zoom Hand #257997497997:  Hold'em No Limit (€0.01/€0.02) [ADM ID: M62BD3044A1E13PD] - 2025/10/04 19:42:23 CET [2025/10/04 13:42:23 ET]
Table 'Sirio' 6-max Seat #1 is the button
Seat 1: Artemis1a (€5.87 in chips) 
Seat 2: Black98Demon (€2.84 in chips) 
Seat 3: ivano747 (€1.05 in chips) 
Seat 4: caduceus369 (€2.08 in chips) 
Seat 5: ADRIAN0_MEIS (€2.28 in chips) 
Seat 6: GanchanS7 (€2.13 in chips) 
Black98Demon: posts small blind €0.01
ivano747: posts big blind €0.02
*** HOLE CARDS ***
Dealt to caduceus369 [2s Ad]
caduceus369: folds 
ADRIAN0_MEIS: folds 
GanchanS7: folds 
Artemis1a: folds 
Black98Demon: folds 
Uncalled bet (€0.01) returned to ivano747
ivano747 collected €0.02 from pot
ivano747: doesn't show hand 
*** SUMMARY ***
Total pot €0.02 | Rake €0 
Seat 1: Artemis1a (button) folded before Flop (didn't bet)
Seat 2: Black98Demon (small blind) folded before Flop
Seat 3: ivano747 (big blind) collected (€0.02)
Seat 4: caduceus369 folded before Flop (didn't bet)
Seat 5: ADRIAN0_MEIS folded before Flop (didn't bet)
Seat 6: GanchanS7 folded before Flop (didn't bet)



PokerStars Zoom Hand #257997496202:  Hold'em No Limit (€0.01/€0.02) [ADM ID: M62BD3044A1E13PD] - 2025/10/04 19:42:15 CET [2025/10/04 13:42:15 ET]
Table 'Sirio' 6-max Seat #1 is the button
Seat 1: LolloSpino (€0.58 in chips) 
Seat 2: ADRIAN0_MEIS (€4.27 in chips) 
Seat 3: emidio92 (€3.59 in chips) 
Seat 4: nudja69 (€1.77 in chips) 
Seat 5: Sorosuno (€2.23 in chips) 
Seat 6: caduceus369 (€2.08 in chips) 
ADRIAN0_MEIS: posts small blind €0.01
emidio92: posts big blind €0.02
*** HOLE CARDS ***
Dealt to caduceus369 [8c Td]
nudja69: calls €0.02
Sorosuno: folds 
caduceus369: folds 
LolloSpino: folds 
ADRIAN0_MEIS: folds 
emidio92: checks 
*** FLOP *** [5c Qd Jd]
emidio92: checks 
nudja69: bets €0.02
emidio92: folds 
Uncalled bet (€0.02) returned to nudja69
nudja69 collected €0.05 from pot
nudja69: doesn't show hand 
*** SUMMARY ***
Total pot €0.05 | Rake €0 
Board [5c Qd Jd]
Seat 1: LolloSpino (button) folded before Flop (didn't bet)
Seat 2: ADRIAN0_MEIS (small blind) folded before Flop
Seat 3: emidio92 (big blind) folded on the Flop
Seat 4: nudja69 collected (€0.05)
Seat 5: Sorosuno folded before Flop (didn't bet)
Seat 6: caduceus369 folded before Flop (didn't bet)



PokerStars Zoom Hand #257997500056:  Hold'em No Limit (€0.01/€0.02) [ADM ID: M62BD3044A1E13PD] - 2025/10/04 19:42:32 CET [2025/10/04 13:42:32 ET]
Table 'Sirio' 6-max Seat #1 is the button
Seat 1: Sorosuno (€2.23 in chips) 
Seat 2: emidio92 (€4.56 in chips) 
Seat 3: sisifo40 (€0.96 in chips) 
Seat 4: ADRIAN0_MEIS (€5.48 in chips) 
Seat 5: caduceus369 (€2.08 in chips) 
Seat 6: Gabrielefante (€2.79 in chips) 
emidio92: posts small blind €0.01
sisifo40: posts big blind €0.02
*** HOLE CARDS ***
Dealt to caduceus369 [Tc Qs]
ADRIAN0_MEIS: folds 
caduceus369: folds 
Gabrielefante: raises €0.06 to €0.08
Sorosuno: folds 
emidio92: folds 
sisifo40: folds 
Uncalled bet (€0.06) returned to Gabrielefante
Gabrielefante collected €0.05 from pot
Gabrielefante: doesn't show hand 
*** SUMMARY ***
Total pot €0.05 | Rake €0 
Seat 1: Sorosuno (button) folded before Flop (didn't bet)
Seat 2: emidio92 (small blind) folded before Flop
Seat 3: sisifo40 (big blind) folded before Flop
Seat 4: ADRIAN0_MEIS folded before Flop (didn't bet)
Seat 5: caduceus369 folded before Flop (didn't bet)
Seat 6: Gabrielefante collected (€0.05)



PokerStars Zoom Hand #257997502938:  Hold'em No Limit (€0.01/€0.02) [ADM ID: M62BD3044A1E13PD] - 2025/10/04 19:42:45 CET [2025/10/04 13:42:45 ET]
Table 'Sirio' 6-max Seat #1 is the button
Seat 1: stevalmg (€2.22 in chips) 
Seat 2: caduceus369 (€2.08 in chips) 
Seat 3: Artemis1a (€4.05 in chips) 
Seat 4: emidio92 (€9.66 in chips) 
Seat 5: ADRIAN0_MEIS (€4.24 in chips) 
Seat 6: GanchanS7 (€3.82 in chips) 
caduceus369: posts small blind €0.01
Artemis1a: posts big blind €0.02
*** HOLE CARDS ***
Dealt to caduceus369 [4d 5h]
emidio92: raises €0.03 to €0.05
ADRIAN0_MEIS: folds 
GanchanS7: folds 
stevalmg: folds 
caduceus369: folds 
Artemis1a: folds 
Uncalled bet (€0.03) returned to emidio92
emidio92 collected €0.05 from pot
emidio92: doesn't show hand 
*** SUMMARY ***
Total pot €0.05 | Rake €0 
Seat 1: stevalmg (button) folded before Flop (didn't bet)
Seat 2: caduceus369 (small blind) folded before Flop
Seat 3: Artemis1a (big blind) folded before Flop
Seat 4: emidio92 collected (€0.05)
Seat 5: ADRIAN0_MEIS folded before Flop (didn't bet)
Seat 6: GanchanS7 folded before Flop (didn't bet)



PokerStars Zoom Hand #257997504374:  Hold'em No Limit (€0.01/€0.02) [ADM ID: M62BD3044A1E13PD] - 2025/10/04 19:42:52 CET [2025/10/04 13:42:52 ET]
Table 'Sirio' 6-max Seat #1 is the button
Seat 1: caduceus369 (€2.07 in chips) 
Seat 2: manch73r (€3.10 in chips) 
Seat 3: Sorosuno (€3.01 in chips) 
Seat 4: Wunschgast (€3.32 in chips) 
Seat 5: GanchanS7 (€2.11 in chips) 
Seat 6: KilometroZer0 (€2.27 in chips) 
manch73r: posts small blind €0.01
Sorosuno: posts big blind €0.02
*** HOLE CARDS ***
Dealt to caduceus369 [4h Ah]
Wunschgast: raises €0.04 to €0.06
GanchanS7: folds 
KilometroZer0: folds 
caduceus369: folds 
manch73r: folds 
Sorosuno: folds 
Uncalled bet (€0.04) returned to Wunschgast
Wunschgast collected €0.05 from pot
Wunschgast: doesn't show hand 
*** SUMMARY ***
Total pot €0.05 | Rake €0 
Seat 1: caduceus369 (button) folded before Flop (didn't bet)
Seat 2: manch73r (small blind) folded before Flop
Seat 3: Sorosuno (big blind) folded before Flop
Seat 4: Wunschgast collected (€0.05)
Seat 5: GanchanS7 folded before Flop (didn't bet)
Seat 6: KilometroZer0 folded before Flop (didn't bet)



PokerStars Zoom Hand #257997493505:  Hold'em No Limit (€0.01/€0.02) [ADM ID: M62BD3044A1E13PD] - 2025/10/04 19:42:03 CET [2025/10/04 13:42:03 ET]
Table 'Sirio' 6-max Seat #1 is the button
Seat 1: caduceus369 (€2.08 in chips) 
Seat 2: ivano747 (€1.06 in chips) 
Seat 3: ADRIAN0_MEIS (€6.24 in chips) 
Seat 4: SidneyPrescott (€2.70 in chips) 
Seat 5: Kazzimmino (€1.44 in chips) 
Seat 6: pylonstrip (€2 in chips) 
ivano747: posts small blind €0.01
ADRIAN0_MEIS: posts big blind €0.02
*** HOLE CARDS ***
Dealt to caduceus369 [2c 3s]
SidneyPrescott: raises €0.04 to €0.06
Kazzimmino: folds 
pylonstrip: raises €0.14 to €0.20
caduceus369: folds 
ivano747: folds 
ADRIAN0_MEIS: calls €0.18
SidneyPrescott: calls €0.14
*** FLOP *** [Ks Jd 7d]
ADRIAN0_MEIS: checks 
SidneyPrescott: checks 
pylonstrip: bets €0.12
ADRIAN0_MEIS: calls €0.12
SidneyPrescott: folds 
*** TURN *** [Ks Jd 7d] [5c]
ADRIAN0_MEIS: checks 
pylonstrip: checks 
*** RIVER *** [Ks Jd 7d 5c] [9c]
ADRIAN0_MEIS: checks 
pylonstrip: checks 
*** SHOW DOWN ***
ADRIAN0_MEIS: shows [Qh As] (high card Ace)
pylonstrip: shows [Qs Qd] (a pair of Queens)
pylonstrip collected €0.81 from pot
*** SUMMARY ***
Total pot €0.85 | Rake €0.04 
Board [Ks Jd 7d 5c 9c]
Seat 1: caduceus369 (button) folded before Flop (didn't bet)
Seat 2: ivano747 (small blind) folded before Flop
Seat 3: ADRIAN0_MEIS (big blind) showed [Qh As] and lost with high card Ace
Seat 4: SidneyPrescott folded on the Flop
Seat 5: Kazzimmino folded before Flop (didn't bet)
Seat 6: pylonstrip showed [Qs Qd] and won (€0.81) with a pair of Queens



PokerStars Zoom Hand #257997508565:  Hold'em No Limit (€0.01/€0.02) [ADM ID: M62BD3044A1E13PD] - 2025/10/04 19:43:11 CET [2025/10/04 13:43:11 ET]
Table 'Sirio' 6-max Seat #1 is the button
Seat 1: IKARO_3 (€1.67 in chips) 
Seat 2: ADRIAN0_MEIS (€5.49 in chips) 
Seat 3: caduceus369 (€2.07 in chips) 
Seat 4: RRsanto (€2.94 in chips) 
Seat 5: KilometroZer0 (€1.87 in chips) 
Seat 6: Sorosuno (€2 in chips) 
ADRIAN0_MEIS: posts small blind €0.01
caduceus369: posts big blind €0.02
*** HOLE CARDS ***
Dealt to caduceus369 [8c 8s]
RRsanto: folds 
KilometroZer0: folds 
Sorosuno: folds 
IKARO_3: folds 
ADRIAN0_MEIS: folds 
Uncalled bet (€0.01) returned to caduceus369
caduceus369 collected €0.02 from pot
caduceus369: doesn't show hand 
*** SUMMARY ***
Total pot €0.02 | Rake €0 
Seat 1: IKARO_3 (button) folded before Flop (didn't bet)
Seat 2: ADRIAN0_MEIS (small blind) folded before Flop
Seat 3: caduceus369 (big blind) collected (€0.02)
Seat 4: RRsanto folded before Flop (didn't bet)
Seat 5: KilometroZer0 folded before Flop (didn't bet)
Seat 6: Sorosuno folded before Flop (didn't bet)



PokerStars Zoom Hand #257997501405:  Hold'em No Limit (€0.01/€0.02) [ADM ID: M62BD3044A1E13PD] - 2025/10/04 19:42:38 CET [2025/10/04 13:42:38 ET]
Table 'Sirio' 6-max Seat #1 is the button
Seat 1: GanchanS7 (€2.13 in chips) 
Seat 2: Sorosuno (€2.23 in chips) 
Seat 3: Manus22749 (€2.48 in chips) 
Seat 4: caduceus369 (€2.08 in chips) 
Seat 5: ivano747 (€2.28 in chips) 
Seat 6: ADRIAN0_MEIS (€5.48 in chips) 
Sorosuno: posts small blind €0.01
Manus22749: posts big blind €0.02
*** HOLE CARDS ***
Dealt to caduceus369 [Tc 4h]
caduceus369: folds 
ivano747: raises €0.04 to €0.06
ADRIAN0_MEIS: folds 
GanchanS7: folds 
Sorosuno: raises €0.14 to €0.20
Manus22749: folds 
ivano747: folds 
Uncalled bet (€0.14) returned to Sorosuno
Sorosuno collected €0.14 from pot
Sorosuno: doesn't show hand 
*** SUMMARY ***
Total pot €0.14 | Rake €0 
Seat 1: GanchanS7 (button) folded before Flop (didn't bet)
Seat 2: Sorosuno (small blind) collected (€0.14)
Seat 3: Manus22749 (big blind) folded before Flop
Seat 4: caduceus369 folded before Flop (didn't bet)
Seat 5: ivano747 folded before Flop
Seat 6: ADRIAN0_MEIS folded before Flop (didn't bet)



PokerStars Zoom Hand #257997511440:  Hold'em No Limit (€0.01/€0.02) [ADM ID: M62BD3044A1E13PD] - 2025/10/04 19:43:23 CET [2025/10/04 13:43:23 ET]
Table 'Sirio' 6-max Seat #1 is the button
Seat 1: Artemis1a (€3.30 in chips) 
Seat 2: Sorosuno (€2 in chips) 
Seat 3: bruciapelo (€3.65 in chips) 
Seat 4: ADRIAN0_MEIS (€5.92 in chips) 
Seat 5: KilometroZer0 (€2.62 in chips) 
Seat 6: caduceus369 (€2.08 in chips) 
Sorosuno: posts small blind €0.01
bruciapelo: posts big blind €0.02
*** HOLE CARDS ***
Dealt to caduceus369 [9h Kh]
ADRIAN0_MEIS: folds 
KilometroZer0: folds 
caduceus369: raises €0.04 to €0.06
Artemis1a: folds 
Sorosuno: folds 
bruciapelo: folds 
Uncalled bet (€0.04) returned to caduceus369
caduceus369 collected €0.05 from pot
caduceus369: doesn't show hand 
*** SUMMARY ***
Total pot €0.05 | Rake €0 
Seat 1: Artemis1a (button) folded before Flop (didn't bet)
Seat 2: Sorosuno (small blind) folded before Flop
Seat 3: bruciapelo (big blind) folded before Flop
Seat 4: ADRIAN0_MEIS folded before Flop (didn't bet)
Seat 5: KilometroZer0 folded before Flop (didn't bet)
Seat 6: caduceus369 collected (€0.05)



PokerStars Zoom Hand #257997520346:  Hold'em No Limit (€0.01/€0.02) [ADM ID: M62BD3044A1E13PD] - 2025/10/04 19:44:04 CET [2025/10/04 13:44:04 ET]
Table 'Sirio' 6-max Seat #1 is the button
Seat 1: RRsanto (€2.92 in chips) 
Seat 2: Black98Demon (€2.84 in chips) 
Seat 3: KilometroZer0 (€2.33 in chips) 
Seat 4: emidio92 (€4.14 in chips) 
Seat 5: caduceus369 (€2.11 in chips) 
Seat 6: ADRIAN0_MEIS (€4.24 in chips) 
Black98Demon: posts small blind €0.01
KilometroZer0: posts big blind €0.02
*** HOLE CARDS ***
Dealt to caduceus369 [5c Ac]
emidio92: folds 
caduceus369: raises €0.04 to €0.06
ADRIAN0_MEIS: folds 
RRsanto: folds 
Black98Demon: folds 
KilometroZer0: folds 
Uncalled bet (€0.04) returned to caduceus369
caduceus369 collected €0.05 from pot
caduceus369: doesn't show hand 
*** SUMMARY ***
Total pot €0.05 | Rake €0 
Seat 1: RRsanto (button) folded before Flop (didn't bet)
Seat 2: Black98Demon (small blind) folded before Flop
Seat 3: KilometroZer0 (big blind) folded before Flop
Seat 4: emidio92 folded before Flop (didn't bet)
Seat 5: caduceus369 collected (€0.05)
Seat 6: ADRIAN0_MEIS folded before Flop (didn't bet)



PokerStars Zoom Hand #257997518797:  Hold'em No Limit (€0.01/€0.02) [ADM ID: M62BD3044A1E13PD] - 2025/10/04 19:43:57 CET [2025/10/04 13:43:57 ET]
Table 'Sirio' 6-max Seat #1 is the button
Seat 1: ivano747 (€0.90 in chips) 
Seat 2: IKARO_3 (€2.10 in chips) 
Seat 3: Manus22749 (€2.67 in chips) 
Seat 4: caduceus369 (€2.11 in chips) 
Seat 5: leonnemo (€0.61 in chips) 
Seat 6: GanchanS7 (€2.08 in chips) 
IKARO_3: posts small blind €0.01
Manus22749: posts big blind €0.02
*** HOLE CARDS ***
Dealt to caduceus369 [Jc 6c]
caduceus369: folds 
leonnemo: folds 
GanchanS7: folds 
ivano747: folds 
IKARO_3: folds 
Uncalled bet (€0.01) returned to Manus22749
Manus22749 collected €0.02 from pot
Manus22749: doesn't show hand 
*** SUMMARY ***
Total pot €0.02 | Rake €0 
Seat 1: ivano747 (button) folded before Flop (didn't bet)
Seat 2: IKARO_3 (small blind) folded before Flop
Seat 3: Manus22749 (big blind) collected (€0.02)
Seat 4: caduceus369 folded before Flop (didn't bet)
Seat 5: leonnemo folded before Flop (didn't bet)
Seat 6: GanchanS7 folded before Flop (didn't bet)



PokerStars Zoom Hand #257997523233:  Hold'em No Limit (€0.01/€0.02) [ADM ID: M62BD3044A1E13PD] - 2025/10/04 19:44:17 CET [2025/10/04 13:44:17 ET]
Table 'Sirio' 6-max Seat #1 is the button
Seat 1: emidio92 (€4.13 in chips) 
Seat 2: caduceus369 (€2.14 in chips) 
Seat 3: Black98Demon (€2.83 in chips) 
Seat 4: nudja69 (€1.86 in chips) 
Seat 5: KilometroZer0 (€2.30 in chips) 
Seat 6: Sorosuno (€2.51 in chips) 
caduceus369: posts small blind €0.01
Black98Demon: posts big blind €0.02
*** HOLE CARDS ***
Dealt to caduceus369 [6c Kh]
nudja69: folds 
KilometroZer0: folds 
Sorosuno: folds 
emidio92: folds 
caduceus369: folds 
Uncalled bet (€0.01) returned to Black98Demon
Black98Demon collected €0.02 from pot
Black98Demon: doesn't show hand 
*** SUMMARY ***
Total pot €0.02 | Rake €0 
Seat 1: emidio92 (button) folded before Flop (didn't bet)
Seat 2: caduceus369 (small blind) folded before Flop
Seat 3: Black98Demon (big blind) collected (€0.02)
Seat 4: nudja69 folded before Flop (didn't bet)
Seat 5: KilometroZer0 folded before Flop (didn't bet)
Seat 6: Sorosuno folded before Flop (didn't bet)



PokerStars Zoom Hand #257997524604:  Hold'em No Limit (€0.01/€0.02) [ADM ID: M62BD3044A1E13PD] - 2025/10/04 19:44:23 CET [2025/10/04 13:44:23 ET]
Table 'Sirio' 6-max Seat #1 is the button
Seat 1: LolloSpino (€2.29 in chips) 
Seat 2: IKARO_3 (€1.64 in chips) 
Seat 3: caduceus369 (€2.13 in chips) 
Seat 4: Catania838 (€2.50 in chips) 
Seat 5: ADRIAN0_MEIS (€5.89 in chips) 
Seat 6: KilometroZer0 (€2.30 in chips) 
IKARO_3: posts small blind €0.01
caduceus369: posts big blind €0.02
*** HOLE CARDS ***
Dealt to caduceus369 [Ks 4d]
Catania838: calls €0.02
ADRIAN0_MEIS: folds 
KilometroZer0: folds 
LolloSpino: folds 
IKARO_3: folds 
caduceus369: checks 
*** FLOP *** [7s 9h Ac]
caduceus369: checks 
Catania838: bets €0.03
caduceus369: folds 
Uncalled bet (€0.03) returned to Catania838
Catania838 collected €0.05 from pot
Catania838: doesn't show hand 
*** SUMMARY ***
Total pot €0.05 | Rake €0 
Board [7s 9h Ac]
Seat 1: LolloSpino (button) folded before Flop (didn't bet)
Seat 2: IKARO_3 (small blind) folded before Flop
Seat 3: caduceus369 (big blind) folded on the Flop
Seat 4: Catania838 collected (€0.05)
Seat 5: ADRIAN0_MEIS folded before Flop (didn't bet)
Seat 6: KilometroZer0 folded before Flop (didn't bet)



PokerStars Zoom Hand #257997529351:  Hold'em No Limit (€0.01/€0.02) [ADM ID: M62BD3044A1E13PD] - 2025/10/04 19:44:44 CET [2025/10/04 13:44:44 ET]
Table 'Sirio' 6-max Seat #1 is the button
Seat 1: caduceus369 (€2.11 in chips) 
Seat 2: SaTheNuts_77 (€4.25 in chips) 
Seat 3: stevalmg (€2 in chips) 
Seat 4: Sorosuno (€2.51 in chips) 
Seat 5: Wunschgast (€3.38 in chips) 
Seat 6: emidio92 (€9.73 in chips) 
SaTheNuts_77: posts small blind €0.01
stevalmg: posts big blind €0.02
*** HOLE CARDS ***
Dealt to caduceus369 [3h 6s]
Sorosuno: folds 
Wunschgast: folds 
emidio92: folds 
caduceus369: folds 
SaTheNuts_77: folds 
Uncalled bet (€0.01) returned to stevalmg
stevalmg collected €0.02 from pot
stevalmg: doesn't show hand 
*** SUMMARY ***
Total pot €0.02 | Rake €0 
Seat 1: caduceus369 (button) folded before Flop (didn't bet)
Seat 2: SaTheNuts_77 (small blind) folded before Flop
Seat 3: stevalmg (big blind) collected (€0.02)
Seat 4: Sorosuno folded before Flop (didn't bet)
Seat 5: Wunschgast folded before Flop (didn't bet)
Seat 6: emidio92 folded before Flop (didn't bet)



PokerStars Zoom Hand #257997530715:  Hold'em No Limit (€0.01/€0.02) [ADM ID: M62BD3044A1E13PD] - 2025/10/04 19:44:50 CET [2025/10/04 13:44:50 ET]
Table 'Sirio' 6-max Seat #1 is the button
Seat 1: ADRIAN0_MEIS (€5.92 in chips) 
Seat 2: KilometroZer0 (€1.63 in chips) 
Seat 3: GanchanS7 (€3.78 in chips) 
Seat 4: IKARO_3 (€2.06 in chips) 
Seat 5: robertoH2O (€2.11 in chips) 
Seat 6: caduceus369 (€2.11 in chips) 
KilometroZer0: posts small blind €0.01
GanchanS7: posts big blind €0.02
*** HOLE CARDS ***
Dealt to caduceus369 [6c As]
IKARO_3: folds 
robertoH2O: folds 
caduceus369: folds 
ADRIAN0_MEIS: folds 
KilometroZer0: folds 
Uncalled bet (€0.01) returned to GanchanS7
GanchanS7 collected €0.02 from pot
GanchanS7: doesn't show hand 
*** SUMMARY ***
Total pot €0.02 | Rake €0 
Seat 1: ADRIAN0_MEIS (button) folded before Flop (didn't bet)
Seat 2: KilometroZer0 (small blind) folded before Flop
Seat 3: GanchanS7 (big blind) collected (€0.02)
Seat 4: IKARO_3 folded before Flop (didn't bet)
Seat 5: robertoH2O folded before Flop (didn't bet)
Seat 6: caduceus369 folded before Flop (didn't bet)



PokerStars Zoom Hand #257997535301:  Hold'em No Limit (€0.01/€0.02) [ADM ID: M62BD3044A1E13PD] - 2025/10/04 19:45:10 CET [2025/10/04 13:45:10 ET]
Table 'Sirio' 6-max Seat #1 is the button
Seat 1: Sorosuno (€2.50 in chips) 
Seat 2: GraviiTy10 (€2.24 in chips) 
Seat 3: bruciapelo (€4.19 in chips) 
Seat 4: caduceus369 (€2.11 in chips) 
Seat 5: LolloSpino (€2.26 in chips) 
Seat 6: ADRIAN0_MEIS (€2.31 in chips) 
GraviiTy10: posts small blind €0.01
bruciapelo: posts big blind €0.02
*** HOLE CARDS ***
Dealt to caduceus369 [Kd 4c]
caduceus369: folds 
LolloSpino: folds 
ADRIAN0_MEIS: folds 
Sorosuno: folds 
GraviiTy10: folds 
Uncalled bet (€0.01) returned to bruciapelo
bruciapelo collected €0.02 from pot
bruciapelo: doesn't show hand 
*** SUMMARY ***
Total pot €0.02 | Rake €0 
Seat 1: Sorosuno (button) folded before Flop (didn't bet)
Seat 2: GraviiTy10 (small blind) folded before Flop
Seat 3: bruciapelo (big blind) collected (€0.02)
Seat 4: caduceus369 folded before Flop (didn't bet)
Seat 5: LolloSpino folded before Flop (didn't bet)
Seat 6: ADRIAN0_MEIS folded before Flop (didn't bet)



PokerStars Zoom Hand #257997536827:  Hold'em No Limit (€0.01/€0.02) [ADM ID: M62BD3044A1E13PD] - 2025/10/04 19:45:17 CET [2025/10/04 13:45:17 ET]
Table 'Sirio' 6-max Seat #1 is the button
Seat 1: Gionni483 (€3.65 in chips) 
Seat 2: emidio92 (€4.11 in chips) 
Seat 3: caduceus369 (€2.11 in chips) 
Seat 4: LolloSpino (€0.63 in chips) 
Seat 5: KilometroZer0 (€1.97 in chips) 
Seat 6: RRsanto (€2.89 in chips) 
emidio92: posts small blind €0.01
caduceus369: posts big blind €0.02
*** HOLE CARDS ***
Dealt to caduceus369 [8h 4c]
LolloSpino: folds 
KilometroZer0: raises €0.05 to €0.07
RRsanto: folds 
Gionni483: folds 
emidio92: folds 
caduceus369: folds 
Uncalled bet (€0.05) returned to KilometroZer0
KilometroZer0 collected €0.05 from pot
KilometroZer0: doesn't show hand 
*** SUMMARY ***
Total pot €0.05 | Rake €0 
Seat 1: Gionni483 (button) folded before Flop (didn't bet)
Seat 2: emidio92 (small blind) folded before Flop
Seat 3: caduceus369 (big blind) folded before Flop
Seat 4: LolloSpino folded before Flop (didn't bet)
Seat 5: KilometroZer0 collected (€0.05)
Seat 6: RRsanto folded before Flop (didn't bet)



PokerStars Zoom Hand #257997540002:  Hold'em No Limit (€0.01/€0.02) [ADM ID: M62BD3044A1E13PD] - 2025/10/04 19:45:31 CET [2025/10/04 13:45:31 ET]
Table 'Sirio' 6-max Seat #1 is the button
Seat 1: caduceus369 (€2.09 in chips) 
Seat 2: RRsanto (€2.05 in chips) 
Seat 3: GraviiTy10 (€2.23 in chips) 
Seat 4: ivano747 (€2.16 in chips) 
Seat 5: Manus22749 (€2.62 in chips) 
Seat 6: Wunschgast (€3.36 in chips) 
RRsanto: posts small blind €0.01
GraviiTy10: posts big blind €0.02
*** HOLE CARDS ***
Dealt to caduceus369 [2s Kd]
ivano747: folds 
Manus22749: folds 
Wunschgast: raises €0.04 to €0.06
caduceus369: folds 
RRsanto: folds 
GraviiTy10: folds 
Uncalled bet (€0.04) returned to Wunschgast
Wunschgast collected €0.05 from pot
Wunschgast: doesn't show hand 
*** SUMMARY ***
Total pot €0.05 | Rake €0 
Seat 1: caduceus369 (button) folded before Flop (didn't bet)
Seat 2: RRsanto (small blind) folded before Flop
Seat 3: GraviiTy10 (big blind) folded before Flop
Seat 4: ivano747 folded before Flop (didn't bet)
Seat 5: Manus22749 folded before Flop (didn't bet)
Seat 6: Wunschgast collected (€0.05)



PokerStars Zoom Hand #257997541397:  Hold'em No Limit (€0.01/€0.02) [ADM ID: M62BD3044A1E13PD] - 2025/10/04 19:45:37 CET [2025/10/04 13:45:37 ET]
Table 'Sirio' 6-max Seat #1 is the button
Seat 1: RRsanto (€2.04 in chips) 
Seat 2: Black98Demon (€2.82 in chips) 
Seat 3: LolloSpino (€0.65 in chips) 
Seat 4: Manus22749 (€2.62 in chips) 
Seat 5: caduceus369 (€2.09 in chips) 
Seat 6: Topastro27 (€2.96 in chips) 
Black98Demon: posts small blind €0.01
LolloSpino: posts big blind €0.02
*** HOLE CARDS ***
Dealt to caduceus369 [Jc Ad]
Manus22749: folds 
caduceus369: raises €0.04 to €0.06
Topastro27: folds 
RRsanto: folds 
Black98Demon: folds 
LolloSpino: folds 
Uncalled bet (€0.04) returned to caduceus369
caduceus369 collected €0.05 from pot
caduceus369: doesn't show hand 
*** SUMMARY ***
Total pot €0.05 | Rake €0 
Seat 1: RRsanto (button) folded before Flop (didn't bet)
Seat 2: Black98Demon (small blind) folded before Flop
Seat 3: LolloSpino (big blind) folded before Flop
Seat 4: Manus22749 folded before Flop (didn't bet)
Seat 5: caduceus369 collected (€0.05)
Seat 6: Topastro27 folded before Flop (didn't bet)



PokerStars Zoom Hand #257997532809:  Hold'em No Limit (€0.01/€0.02) [ADM ID: M62BD3044A1E13PD] - 2025/10/04 19:44:59 CET [2025/10/04 13:44:59 ET]
Table 'Sirio' 6-max Seat #1 is the button
Seat 1: emidio92 (€9.73 in chips) 
Seat 2: ADRIAN0_MEIS (€5.92 in chips) 
Seat 3: GanchanS7 (€2.02 in chips) 
Seat 4: KilometroZer0 (€2.28 in chips) 
Seat 5: caduceus369 (€2.11 in chips) 
Seat 6: IKARO_3 (€1.78 in chips) 
ADRIAN0_MEIS: posts small blind €0.01
GanchanS7: posts big blind €0.02
*** HOLE CARDS ***
Dealt to caduceus369 [2s 2c]
KilometroZer0: folds 
caduceus369: folds 
IKARO_3: raises €0.02 to €0.04
emidio92: folds 
ADRIAN0_MEIS: raises €0.10 to €0.14
GanchanS7: folds 
IKARO_3: calls €0.10
*** FLOP *** [4d 7h 7s]
ADRIAN0_MEIS: bets €0.16
IKARO_3: calls €0.16
*** TURN *** [4d 7h 7s] [5c]
ADRIAN0_MEIS: bets €0.44
IKARO_3: raises €1.04 to €1.48 and is all-in
ADRIAN0_MEIS: folds 
Uncalled bet (€1.04) returned to IKARO_3
IKARO_3 collected €1.42 from pot
IKARO_3: doesn't show hand 
*** SUMMARY ***
Total pot €1.50 | Rake €0.08 
Board [4d 7h 7s 5c]
Seat 1: emidio92 (button) folded before Flop (didn't bet)
Seat 2: ADRIAN0_MEIS (small blind) folded on the Turn
Seat 3: GanchanS7 (big blind) folded before Flop
Seat 4: KilometroZer0 folded before Flop (didn't bet)
Seat 5: caduceus369 folded before Flop (didn't bet)
Seat 6: IKARO_3 collected (€1.42)



PokerStars Zoom Hand #257997545811:  Hold'em No Limit (€0.01/€0.02) [ADM ID: M62BD3044A1E13PD] - 2025/10/04 19:45:57 CET [2025/10/04 13:45:57 ET]
Table 'Sirio' 6-max Seat #1 is the button
Seat 1: LolloSpino (€0.63 in chips) 
Seat 2: caduceus369 (€2.12 in chips) 
Seat 3: emidio92 (€3.55 in chips) 
Seat 4: Sorosuno (€2.75 in chips) 
Seat 5: nudja69 (€1.85 in chips) 
Seat 6: Sim_sala_bin (€0.73 in chips) 
caduceus369: posts small blind €0.01
emidio92: posts big blind €0.02
*** HOLE CARDS ***
Dealt to caduceus369 [Qs Tc]
Sorosuno: folds 
nudja69: calls €0.02
Sim_sala_bin: folds 
LolloSpino: folds 
caduceus369: raises €0.04 to €0.06
emidio92: folds 
nudja69: calls €0.04
*** FLOP *** [9h Ad Qc]
caduceus369: checks 
nudja69: bets €0.14
caduceus369: folds 
Uncalled bet (€0.14) returned to nudja69
nudja69 collected €0.14 from pot
nudja69: doesn't show hand 
*** SUMMARY ***
Total pot €0.14 | Rake €0 
Board [9h Ad Qc]
Seat 1: LolloSpino (button) folded before Flop (didn't bet)
Seat 2: caduceus369 (small blind) folded on the Flop
Seat 3: emidio92 (big blind) folded before Flop
Seat 4: Sorosuno folded before Flop (didn't bet)
Seat 5: nudja69 collected (€0.14)
Seat 6: Sim_sala_bin folded before Flop (didn't bet)



PokerStars Zoom Hand #257997555028:  Hold'em No Limit (€0.01/€0.02) [ADM ID: M62BD3044A1E13PD] - 2025/10/04 19:46:39 CET [2025/10/04 13:46:39 ET]
Table 'Sirio' 6-max Seat #1 is the button
Seat 1: Pokopoco754 (€2.27 in chips) 
Seat 2: colosso2022 (€2.73 in chips) 
Seat 3: GanchanS7 (€2.19 in chips) 
Seat 4: LolloSpino (€0.60 in chips) 
Seat 5: Topastro27 (€2.79 in chips) 
Seat 6: caduceus369 (€2.06 in chips) 
colosso2022: posts small blind €0.01
GanchanS7: posts big blind €0.02
*** HOLE CARDS ***
Dealt to caduceus369 [Ts Tc]
LolloSpino: folds 
Topastro27: folds 
caduceus369: raises €0.04 to €0.06
Pokopoco754: calls €0.06
colosso2022: raises €0.20 to €0.26
GanchanS7: folds 
caduceus369: folds 
Pokopoco754: calls €0.20
*** FLOP *** [4h 9s 3c]
colosso2022: bets €2.47 and is all-in
Pokopoco754: calls €2.01 and is all-in
Uncalled bet (€0.46) returned to colosso2022
*** TURN *** [4h 9s 3c] [5s]
*** RIVER *** [4h 9s 3c 5s] [Th]
*** SHOW DOWN ***
colosso2022: shows [Ad 8d] (high card Ace)
Pokopoco754: shows [Ac Js] (high card Ace - Jack kicker)
Pokopoco754 collected €4.37 from pot
*** SUMMARY ***
Total pot €4.62 | Rake €0.25 
Board [4h 9s 3c 5s Th]
Seat 1: Pokopoco754 (button) showed [Ac Js] and won (€4.37) with high card Ace
Seat 2: colosso2022 (small blind) showed [Ad 8d] and lost with high card Ace
Seat 3: GanchanS7 (big blind) folded before Flop
Seat 4: LolloSpino folded before Flop (didn't bet)
Seat 5: Topastro27 folded before Flop (didn't bet)
Seat 6: caduceus369 folded before Flop



PokerStars Zoom Hand #257997561310:  Hold'em No Limit (€0.01/€0.02) [ADM ID: M62BD3044A1E13PD] - 2025/10/04 19:47:07 CET [2025/10/04 13:47:07 ET]
Table 'Sirio' 6-max Seat #1 is the button
Seat 1: Wunschgast (€3.52 in chips) 
Seat 2: emidio92 (€9.66 in chips) 
Seat 3: GraviiTy10 (€2.28 in chips) 
Seat 4: pylonstrip (€2.97 in chips) 
Seat 5: caduceus369 (€2 in chips) 
Seat 6: robertoH2O (€2.15 in chips) 
emidio92: posts small blind €0.01
GraviiTy10: posts big blind €0.02
*** HOLE CARDS ***
Dealt to caduceus369 [7c Th]
pylonstrip: folds 
caduceus369: folds 
robertoH2O: folds 
Wunschgast: raises €0.03 to €0.05
emidio92: raises €0.17 to €0.22
GraviiTy10: folds 
Wunschgast: folds 
Uncalled bet (€0.17) returned to emidio92
emidio92 collected €0.12 from pot
emidio92: doesn't show hand 
*** SUMMARY ***
Total pot €0.12 | Rake €0 
Seat 1: Wunschgast (button) folded before Flop
Seat 2: emidio92 (small blind) collected (€0.12)
Seat 3: GraviiTy10 (big blind) folded before Flop
Seat 4: pylonstrip folded before Flop (didn't bet)
Seat 5: caduceus369 folded before Flop (didn't bet)
Seat 6: robertoH2O folded before Flop (didn't bet)



PokerStars Zoom Hand #257997562274:  Hold'em No Limit (€0.01/€0.02) [ADM ID: M62BD3044A1E13PD] - 2025/10/04 19:47:12 CET [2025/10/04 13:47:12 ET]
Table 'Sirio' 6-max Seat #1 is the button
Seat 1: IKARO_3 (€2.06 in chips) 
Seat 2: stevalmg (€2 in chips) 
Seat 3: ivano747 (€2.08 in chips) 
Seat 4: caduceus369 (€2 in chips) 
Seat 5: SidneyPrescott (€3.83 in chips) 
Seat 6: Sorosuno (€2.64 in chips) 
stevalmg: posts small blind €0.01
ivano747: posts big blind €0.02
*** HOLE CARDS ***
Dealt to caduceus369 [Kc 2s]
caduceus369: folds 
SidneyPrescott: folds 
Sorosuno has timed out
Sorosuno: folds 
IKARO_3: folds 
stevalmg: folds 
Uncalled bet (€0.01) returned to ivano747
ivano747 collected €0.02 from pot
ivano747: doesn't show hand 
*** SUMMARY ***
Total pot €0.02 | Rake €0 
Seat 1: IKARO_3 (button) folded before Flop (didn't bet)
Seat 2: stevalmg (small blind) folded before Flop
Seat 3: ivano747 (big blind) collected (€0.02)
Seat 4: caduceus369 folded before Flop (didn't bet)
Seat 5: SidneyPrescott folded before Flop (didn't bet)
Seat 6: Sorosuno folded before Flop (didn't bet)



PokerStars Zoom Hand #257997563417:  Hold'em No Limit (€0.01/€0.02) [ADM ID: M62BD3044A1E13PD] - 2025/10/04 19:47:17 CET [2025/10/04 13:47:17 ET]
Table 'Sirio' 6-max Seat #1 is the button
Seat 1: Artemis1a (€3.42 in chips) 
Seat 2: pylonstrip (€2.95 in chips) 
Seat 3: caduceus369 (€2 in chips) 
Seat 4: bruciapelo (€4.26 in chips) 
Seat 5: stevalmg (€1.99 in chips) 
Seat 6: sisifo40 (€0.74 in chips) 
pylonstrip: posts small blind €0.01
caduceus369: posts big blind €0.02
*** HOLE CARDS ***
Dealt to caduceus369 [2d 8c]
bruciapelo: folds 
stevalmg: folds 
sisifo40: folds 
Artemis1a: raises €0.04 to €0.06
pylonstrip: calls €0.05
caduceus369: folds 
*** FLOP *** [3c Qh Kc]
pylonstrip: checks 
Artemis1a: checks 
*** TURN *** [3c Qh Kc] [Js]
pylonstrip: checks 
Artemis1a: checks 
*** RIVER *** [3c Qh Kc Js] [6s]
pylonstrip: checks 
Artemis1a: checks 
*** SHOW DOWN ***
pylonstrip: shows [5s As] (high card Ace)
Artemis1a: shows [Ac 7s] (high card Ace - King+Queen+Jack+Seven kicker)
Artemis1a collected €0.14 from pot
*** SUMMARY ***
Total pot €0.14 | Rake €0 
Board [3c Qh Kc Js 6s]
Seat 1: Artemis1a (button) showed [Ac 7s] and won (€0.14) with high card Ace
Seat 2: pylonstrip (small blind) showed [5s As] and lost with high card Ace
Seat 3: caduceus369 (big blind) folded before Flop
Seat 4: bruciapelo folded before Flop (didn't bet)
Seat 5: stevalmg folded before Flop (didn't bet)
Seat 6: sisifo40 folded before Flop (didn't bet)



PokerStars Zoom Hand #257997566872:  Hold'em No Limit (€0.01/€0.02) [ADM ID: M62BD3044A1E13PD] - 2025/10/04 19:47:32 CET [2025/10/04 13:47:32 ET]
Table 'Sirio' 6-max Seat #1 is the button
Seat 1: caduceus369 (€2 in chips) 
Seat 2: GraviiTy10 (€2.26 in chips) 
Seat 3: TurboMuletto (€1.94 in chips) 
Seat 4: KilometroZer0 (€2.17 in chips) 
Seat 5: GanchanS7 (€3.73 in chips) 
Seat 6: emidio92 (€9.73 in chips) 
GraviiTy10: posts small blind €0.01
TurboMuletto: posts big blind €0.02
*** HOLE CARDS ***
Dealt to caduceus369 [7s As]
KilometroZer0: folds 
GanchanS7: folds 
emidio92: folds 
caduceus369: raises €0.04 to €0.06
GraviiTy10: folds 
TurboMuletto: folds 
Uncalled bet (€0.04) returned to caduceus369
caduceus369 collected €0.05 from pot
caduceus369: doesn't show hand 
*** SUMMARY ***
Total pot €0.05 | Rake €0 
Seat 1: caduceus369 (button) collected (€0.05)
Seat 2: GraviiTy10 (small blind) folded before Flop
Seat 3: TurboMuletto (big blind) folded before Flop
Seat 4: KilometroZer0 folded before Flop (didn't bet)
Seat 5: GanchanS7 folded before Flop (didn't bet)
Seat 6: emidio92 folded before Flop (didn't bet)



PokerStars Zoom Hand #257997571334:  Hold'em No Limit (€0.01/€0.02) [ADM ID: M62BD3044A1E13PD] - 2025/10/04 19:47:52 CET [2025/10/04 13:47:52 ET]
Table 'Sirio' 6-max Seat #1 is the button
Seat 1: GanchanS7 (€2.16 in chips) 
Seat 2: caduceus369 (€2.03 in chips) 
Seat 3: LolloSpino (€2.40 in chips) 
Seat 4: Artemis1a (€5.94 in chips) 
Seat 5: KilometroZer0 (€2.17 in chips) 
Seat 6: TurboMuletto (€1.92 in chips) 
caduceus369: posts small blind €0.01
LolloSpino: posts big blind €0.02
*** HOLE CARDS ***
Dealt to caduceus369 [4c 8s]
Artemis1a: folds 
KilometroZer0: folds 
TurboMuletto: folds 
GanchanS7: folds 
caduceus369: folds 
Uncalled bet (€0.01) returned to LolloSpino
LolloSpino collected €0.02 from pot
LolloSpino: doesn't show hand 
*** SUMMARY ***
Total pot €0.02 | Rake €0 
Seat 1: GanchanS7 (button) folded before Flop (didn't bet)
Seat 2: caduceus369 (small blind) folded before Flop
Seat 3: LolloSpino (big blind) collected (€0.02)
Seat 4: Artemis1a folded before Flop (didn't bet)
Seat 5: KilometroZer0 folded before Flop (didn't bet)
Seat 6: TurboMuletto folded before Flop (didn't bet)



PokerStars Zoom Hand #257997573144:  Hold'em No Limit (€0.01/€0.02) [ADM ID: M62BD3044A1E13PD] - 2025/10/04 19:48:00 CET [2025/10/04 13:48:00 ET]
Table 'Sirio' 6-max Seat #1 is the button
Seat 1: Topastro27 (€2.70 in chips) 
Seat 2: emidio92 (€2.01 in chips) 
Seat 3: Sorosuno (€4.07 in chips) 
Seat 4: KilometroZer0 (€1.95 in chips) 
Seat 5: Wunschgast (€3.47 in chips) 
Seat 6: caduceus369 (€2.02 in chips) 
emidio92: posts small blind €0.01
Sorosuno: posts big blind €0.02
*** HOLE CARDS ***
Dealt to caduceus369 [Jc 9s]
KilometroZer0: folds 
Wunschgast: folds 
caduceus369: folds 
Topastro27: folds 
emidio92: raises €0.04 to €0.06
Sorosuno: calls €0.04
*** FLOP *** [Ad 4s Jh]
emidio92: bets €0.04
Sorosuno: calls €0.04
*** TURN *** [Ad 4s Jh] [2d]
emidio92: bets €0.19
Sorosuno: folds 
Uncalled bet (€0.19) returned to emidio92
emidio92 collected €0.19 from pot
emidio92: doesn't show hand 
*** SUMMARY ***
Total pot €0.20 | Rake €0.01 
Board [Ad 4s Jh 2d]
Seat 1: Topastro27 (button) folded before Flop (didn't bet)
Seat 2: emidio92 (small blind) collected (€0.19)
Seat 3: Sorosuno (big blind) folded on the Turn
Seat 4: KilometroZer0 folded before Flop (didn't bet)
Seat 5: Wunschgast folded before Flop (didn't bet)
Seat 6: caduceus369 folded before Flop (didn't bet)



PokerStars Zoom Hand #257997575541:  Hold'em No Limit (€0.01/€0.02) [ADM ID: M62BD3044A1E13PD] - 2025/10/04 19:48:11 CET [2025/10/04 13:48:11 ET]
Table 'Sirio' 6-max Seat #1 is the button
Seat 1: Artemis1a (€5.93 in chips) 
Seat 2: caduceus369 (€2.02 in chips) 
Seat 3: bruciapelo (€4.28 in chips) 
Seat 4: MathMassacreX (€2.74 in chips) 
Seat 5: Topastro27 (€2.70 in chips) 
Seat 6: Wunschgast (€3.47 in chips) 
caduceus369: posts small blind €0.01
bruciapelo: posts big blind €0.02
*** HOLE CARDS ***
Dealt to caduceus369 [3h As]
MathMassacreX: folds 
Topastro27: folds 
Wunschgast: folds 
Artemis1a: raises €0.05 to €0.07
caduceus369: folds 
bruciapelo: calls €0.05
*** FLOP *** [2c 7c Kc]
bruciapelo: checks 
Artemis1a: checks 
*** TURN *** [2c 7c Kc] [Qh]
bruciapelo: bets €0.08
Artemis1a: folds 
Uncalled bet (€0.08) returned to bruciapelo
bruciapelo collected €0.15 from pot
bruciapelo: doesn't show hand 
*** SUMMARY ***
Total pot €0.15 | Rake €0 
Board [2c 7c Kc Qh]
Seat 1: Artemis1a (button) folded on the Turn
Seat 2: caduceus369 (small blind) folded before Flop
Seat 3: bruciapelo (big blind) collected (€0.15)
Seat 4: MathMassacreX folded before Flop (didn't bet)
Seat 5: Topastro27 folded before Flop (didn't bet)
Seat 6: Wunschgast folded before Flop (didn't bet)



PokerStars Zoom Hand #257997576881:  Hold'em No Limit (€0.01/€0.02) [ADM ID: M62BD3044A1E13PD] - 2025/10/04 19:48:17 CET [2025/10/04 13:48:17 ET]
Table 'Sirio' 6-max Seat #1 is the button
Seat 1: ADRIAN0_MEIS (€5.21 in chips) 
Seat 2: ROELLIRI972 (€0.55 in chips) 
Seat 3: caduceus369 (€2.01 in chips) 
Seat 4: jolli180 (€2.36 in chips) 
Seat 5: manch73r (€3.03 in chips) 
Seat 6: emidio92 (€3.80 in chips) 
ROELLIRI972: posts small blind €0.01
caduceus369: posts big blind €0.02
*** HOLE CARDS ***
Dealt to caduceus369 [Jc Qc]
jolli180: folds 
manch73r: folds 
emidio92: raises €0.03 to €0.05
ADRIAN0_MEIS: calls €0.05
ROELLIRI972: folds 
caduceus369: raises €0.19 to €0.24
emidio92: raises €3.56 to €3.80 and is all-in
ADRIAN0_MEIS: folds 
caduceus369: folds 
Uncalled bet (€3.56) returned to emidio92
emidio92 collected €0.54 from pot
emidio92: doesn't show hand 
*** SUMMARY ***
Total pot €0.54 | Rake €0 
Seat 1: ADRIAN0_MEIS (button) folded before Flop
Seat 2: ROELLIRI972 (small blind) folded before Flop
Seat 3: caduceus369 (big blind) folded before Flop
Seat 4: jolli180 folded before Flop (didn't bet)
Seat 5: manch73r folded before Flop (didn't bet)
Seat 6: emidio92 collected (€0.54)



PokerStars Zoom Hand #257997574457:  Hold'em No Limit (€0.01/€0.02) [ADM ID: M62BD3044A1E13PD] - 2025/10/04 19:48:06 CET [2025/10/04 13:48:06 ET]
Table 'Sirio' 6-max Seat #1 is the button
Seat 1: KilometroZer0 (€2.36 in chips) 
Seat 2: manch73r (€3.04 in chips) 
Seat 3: Black98Demon (€2.42 in chips) 
Seat 4: caduceus369 (€2.02 in chips) 
Seat 5: Pokopoco754 (€4.44 in chips) 
Seat 6: bruciapelo (€4.28 in chips) 
manch73r: posts small blind €0.01
Black98Demon: posts big blind €0.02
*** HOLE CARDS ***
Dealt to caduceus369 [7d 3c]
caduceus369: folds 
Pokopoco754: calls €0.02
bruciapelo: folds 
KilometroZer0: folds 
manch73r: folds 
Black98Demon: checks 
*** FLOP *** [6s Qh Ah]
Black98Demon: checks 
Pokopoco754: checks 
*** TURN *** [6s Qh Ah] [Th]
Black98Demon is disconnected 
Black98Demon: checks 
Pokopoco754: checks 
*** RIVER *** [6s Qh Ah Th] [Ts]
Black98Demon: checks 
Pokopoco754: checks 
*** SHOW DOWN ***
Black98Demon: shows [8h 4s] (a pair of Tens)
Pokopoco754: shows [Jc 9c] (a pair of Tens - Ace+Queen+Jack kicker)
Pokopoco754 collected €0.05 from pot
*** SUMMARY ***
Total pot €0.05 | Rake €0 
Board [6s Qh Ah Th Ts]
Seat 1: KilometroZer0 (button) folded before Flop (didn't bet)
Seat 2: manch73r (small blind) folded before Flop
Seat 3: Black98Demon (big blind) showed [8h 4s] and lost with a pair of Tens
Seat 4: caduceus369 folded before Flop (didn't bet)
Seat 5: Pokopoco754 showed [Jc 9c] and won (€0.05) with a pair of Tens
Seat 6: bruciapelo folded before Flop (didn't bet)



PokerStars Zoom Hand #257997582174:  Hold'em No Limit (€0.01/€0.02) [ADM ID: M62BD3044A1E13PD] - 2025/10/04 19:48:42 CET [2025/10/04 13:48:42 ET]
Table 'Sirio' 6-max Seat #1 is the button
Seat 1: caduceus369 (€2 in chips) 
Seat 2: Black98Demon (€3.57 in chips) 
Seat 3: GanchanS7 (€2.16 in chips) 
Seat 4: LolloSpino (€0.58 in chips) 
Seat 5: Artemis1a (€3.56 in chips) 
Seat 6: Manus22749 (€2.43 in chips) 
Black98Demon: posts small blind €0.01
GanchanS7: posts big blind €0.02
*** HOLE CARDS ***
Dealt to caduceus369 [2d 7h]
LolloSpino has timed out
LolloSpino: folds 
Artemis1a: folds 
Manus22749: folds 
caduceus369: folds 
Black98Demon: raises €0.04 to €0.06
GanchanS7: folds 
Uncalled bet (€0.04) returned to Black98Demon
Black98Demon collected €0.04 from pot
Black98Demon: doesn't show hand 
*** SUMMARY ***
Total pot €0.04 | Rake €0 
Seat 1: caduceus369 (button) folded before Flop (didn't bet)
Seat 2: Black98Demon (small blind) collected (€0.04)
Seat 3: GanchanS7 (big blind) folded before Flop
Seat 4: LolloSpino folded before Flop (didn't bet)
Seat 5: Artemis1a folded before Flop (didn't bet)
Seat 6: Manus22749 folded before Flop (didn't bet)



PokerStars Zoom Hand #257997586321:  Hold'em No Limit (€0.01/€0.02) [ADM ID: M62BD3044A1E13PD] - 2025/10/04 19:49:03 CET [2025/10/04 13:49:03 ET]
Table 'Sirio' 6-max Seat #1 is the button
Seat 1: Topastro27 (€2.88 in chips) 
Seat 2: caduceus369 (€2 in chips) 
Seat 3: manch73r (€3 in chips) 
Seat 4: robertoH2O (€2.32 in chips) 
Seat 5: Wunschgast (€3.44 in chips) 
Seat 6: emidio92 (€5.49 in chips) 
caduceus369: posts small blind €0.01
manch73r: posts big blind €0.02
*** HOLE CARDS ***
Dealt to caduceus369 [6d 4h]
robertoH2O: raises €0.03 to €0.05
Wunschgast: folds 
emidio92: folds 
Topastro27: folds 
caduceus369: folds 
manch73r: folds 
Uncalled bet (€0.03) returned to robertoH2O
robertoH2O collected €0.05 from pot
robertoH2O: doesn't show hand 
*** SUMMARY ***
Total pot €0.05 | Rake €0 
Seat 1: Topastro27 (button) folded before Flop (didn't bet)
Seat 2: caduceus369 (small blind) folded before Flop
Seat 3: manch73r (big blind) folded before Flop
Seat 4: robertoH2O collected (€0.05)
Seat 5: Wunschgast folded before Flop (didn't bet)
Seat 6: emidio92 folded before Flop (didn't bet)



PokerStars Zoom Hand #257997584274:  Hold'em No Limit (€0.01/€0.02) [ADM ID: M62BD3044A1E13PD] - 2025/10/04 19:48:53 CET [2025/10/04 13:48:53 ET]
Table 'Sirio' 6-max Seat #1 is the button
Seat 1: nudja69 (€2.01 in chips) 
Seat 2: Topastro27 (€2.89 in chips) 
Seat 3: Manus22749 (€2.43 in chips) 
Seat 4: stevalmg (€2.81 in chips) 
Seat 5: caduceus369 (€2 in chips) 
Seat 6: ALUMIX (€1 in chips) 
Topastro27: posts small blind €0.01
Manus22749: posts big blind €0.02
*** HOLE CARDS ***
Dealt to caduceus369 [Js 5s]
stevalmg: raises €0.04 to €0.06
caduceus369: folds 
ALUMIX: folds 
nudja69: raises €0.15 to €0.21
Topastro27: folds 
Manus22749: folds 
stevalmg: calls €0.15
*** FLOP *** [3c Jh 9s]
stevalmg: checks 
nudja69: bets €0.43
stevalmg: calls €0.43
*** TURN *** [3c Jh 9s] [8d]
stevalmg: checks 
nudja69: bets €1.24
stevalmg: folds 
Uncalled bet (€1.24) returned to nudja69
nudja69 collected €1.24 from pot
nudja69: doesn't show hand 
*** SUMMARY ***
Total pot €1.31 | Rake €0.07 
Board [3c Jh 9s 8d]
Seat 1: nudja69 (button) collected (€1.24)
Seat 2: Topastro27 (small blind) folded before Flop
Seat 3: Manus22749 (big blind) folded before Flop
Seat 4: stevalmg folded on the Turn
Seat 5: caduceus369 folded before Flop (didn't bet)
Seat 6: ALUMIX folded before Flop (didn't bet)



PokerStars Zoom Hand #257997583155:  Hold'em No Limit (€0.01/€0.02) [ADM ID: M62BD3044A1E13PD] - 2025/10/04 19:48:47 CET [2025/10/04 13:48:47 ET]
Table 'Sirio' 6-max Seat #1 is the button
Seat 1: Artemis1a (€3.56 in chips) 
Seat 2: IKARO_3 (€1.67 in chips) 
Seat 3: ivano747 (€1.85 in chips) 
Seat 4: emidio92 (€4.10 in chips) 
Seat 5: caduceus369 (€2 in chips) 
Seat 6: ADRIAN0_MEIS (€5.16 in chips) 
IKARO_3: posts small blind €0.01
ivano747: posts big blind €0.02
*** HOLE CARDS ***
Dealt to caduceus369 [3d 7c]
emidio92: folds 
caduceus369: folds 
ADRIAN0_MEIS: raises €0.05 to €0.07
Artemis1a: folds 
IKARO_3: calls €0.06
ivano747: folds 
*** FLOP *** [Ad 9h 4h]
IKARO_3: checks 
ADRIAN0_MEIS: bets €0.12
IKARO_3: folds 
Uncalled bet (€0.12) returned to ADRIAN0_MEIS
ADRIAN0_MEIS collected €0.16 from pot
ADRIAN0_MEIS: doesn't show hand 
*** SUMMARY ***
Total pot €0.16 | Rake €0 
Board [Ad 9h 4h]
Seat 1: Artemis1a (button) folded before Flop (didn't bet)
Seat 2: IKARO_3 (small blind) folded on the Flop
Seat 3: ivano747 (big blind) folded before Flop
Seat 4: emidio92 folded before Flop (didn't bet)
Seat 5: caduceus369 folded before Flop (didn't bet)
Seat 6: ADRIAN0_MEIS collected (€0.16)



PokerStars Zoom Hand #257997587400:  Hold'em No Limit (€0.01/€0.02) [ADM ID: M62BD3044A1E13PD] - 2025/10/04 19:49:08 CET [2025/10/04 13:49:08 ET]
Table 'Sirio' 6-max Seat #1 is the button
Seat 1: Black98Demon (€2.39 in chips) 
Seat 2: Manus22749 (€2.41 in chips) 
Seat 3: ADRIAN0_MEIS (€2.23 in chips) 
Seat 4: LolloSpino (€0.58 in chips) 
Seat 5: emidio92 (€4.13 in chips) 
Seat 6: caduceus369 (€2 in chips) 
Manus22749: posts small blind €0.01
ADRIAN0_MEIS: posts big blind €0.02
*** HOLE CARDS ***
Dealt to caduceus369 [9c Kd]
LolloSpino: raises €0.02 to €0.04
emidio92: folds 
caduceus369: folds 
Black98Demon: folds 
Manus22749: folds 
ADRIAN0_MEIS: raises €0.09 to €0.13
LolloSpino: calls €0.09
*** FLOP *** [Kc Ks Jh]
ADRIAN0_MEIS: bets €0.09
LolloSpino: folds 
Uncalled bet (€0.09) returned to ADRIAN0_MEIS
ADRIAN0_MEIS collected €0.26 from pot
ADRIAN0_MEIS: doesn't show hand 
*** SUMMARY ***
Total pot €0.27 | Rake €0.01 
Board [Kc Ks Jh]
Seat 1: Black98Demon (button) folded before Flop (didn't bet)
Seat 2: Manus22749 (small blind) folded before Flop
Seat 3: ADRIAN0_MEIS (big blind) collected (€0.26)
Seat 4: LolloSpino folded on the Flop
Seat 5: emidio92 folded before Flop (didn't bet)
Seat 6: caduceus369 folded before Flop (didn't bet)



PokerStars Zoom Hand #257997588751:  Hold'em No Limit (€0.01/€0.02) [ADM ID: M62BD3044A1E13PD] - 2025/10/04 19:49:14 CET [2025/10/04 13:49:14 ET]
Table 'Sirio' 6-max Seat #1 is the button
Seat 1: caduceus369 (€2 in chips) 
Seat 2: ivano747 (€2.03 in chips) 
Seat 3: emidio92 (€4.13 in chips) 
Seat 4: ADRIAN0_MEIS (€4.93 in chips) 
Seat 5: GanchanS7 (€3.74 in chips) 
Seat 6: manch73r (€2.98 in chips) 
ivano747: posts small blind €0.01
emidio92: posts big blind €0.02
*** HOLE CARDS ***
Dealt to caduceus369 [9c Td]
ADRIAN0_MEIS: folds 
GanchanS7: folds 
manch73r: folds 
caduceus369: folds 
ivano747: calls €0.01
emidio92: checks 
*** FLOP *** [Tc 8s 6h]
ivano747: checks 
emidio92: checks 
*** TURN *** [Tc 8s 6h] [Kh]
ivano747: bets €0.02
emidio92: calls €0.02
*** RIVER *** [Tc 8s 6h Kh] [5c]
ivano747: bets €0.04
emidio92: folds 
Uncalled bet (€0.04) returned to ivano747
ivano747 collected €0.08 from pot
ivano747: doesn't show hand 
*** SUMMARY ***
Total pot €0.08 | Rake €0 
Board [Tc 8s 6h Kh 5c]
Seat 1: caduceus369 (button) folded before Flop (didn't bet)
Seat 2: ivano747 (small blind) collected (€0.08)
Seat 3: emidio92 (big blind) folded on the River
Seat 4: ADRIAN0_MEIS folded before Flop (didn't bet)
Seat 5: GanchanS7 folded before Flop (didn't bet)
Seat 6: manch73r folded before Flop (didn't bet)



PokerStars Zoom Hand #257997590468:  Hold'em No Limit (€0.01/€0.02) [ADM ID: M62BD3044A1E13PD] - 2025/10/04 19:49:22 CET [2025/10/04 13:49:22 ET]
Table 'Sirio' 6-max Seat #1 is the button
Seat 1: emidio92 (€2.11 in chips) 
Seat 2: ivano747 (€1.83 in chips) 
Seat 3: caduceus369 (€2 in chips) 
Seat 4: SidneyPrescott (€3.47 in chips) 
Seat 5: TurboMuletto (€1.98 in chips) 
Seat 6: IKARO_3 (€2.10 in chips) 
ivano747: posts small blind €0.01
caduceus369: posts big blind €0.02
*** HOLE CARDS ***
Dealt to caduceus369 [2c Ac]
SidneyPrescott: folds 
TurboMuletto: folds 
IKARO_3: folds 
emidio92: raises €0.03 to €0.05
ivano747: folds 
caduceus369: calls €0.03
*** FLOP *** [7c Th Qs]
caduceus369: checks 
emidio92: checks 
*** TURN *** [7c Th Qs] [Jh]
caduceus369: bets €0.03
emidio92: calls €0.03
*** RIVER *** [7c Th Qs Jh] [8d]
caduceus369: checks 
emidio92: checks 
*** SHOW DOWN ***
caduceus369: shows [2c Ac] (high card Ace)
emidio92: shows [Ah 7s] (a pair of Sevens)
emidio92 collected €0.17 from pot
*** SUMMARY ***
Total pot €0.17 | Rake €0 
Board [7c Th Qs Jh 8d]
Seat 1: emidio92 (button) showed [Ah 7s] and won (€0.17) with a pair of Sevens
Seat 2: ivano747 (small blind) folded before Flop
Seat 3: caduceus369 (big blind) showed [2c Ac] and lost with high card Ace
Seat 4: SidneyPrescott folded before Flop (didn't bet)
Seat 5: TurboMuletto folded before Flop (didn't bet)
Seat 6: IKARO_3 folded before Flop (didn't bet)



PokerStars Zoom Hand #257997601964:  Hold'em No Limit (€0.01/€0.02) [ADM ID: M62BD3044A1E13PD] - 2025/10/04 19:50:13 CET [2025/10/04 13:50:13 ET]
Table 'Sirio' 6-max Seat #1 is the button
Seat 1: Topastro27 (€2.91 in chips) 
Seat 2: emidio92 (€9.69 in chips) 
Seat 3: TurboMuletto (€1.94 in chips) 
Seat 4: IKARO_3 (€1.75 in chips) 
Seat 5: sisifo40 (€0.98 in chips) 
Seat 6: caduceus369 (€2 in chips) 
emidio92: posts small blind €0.01
TurboMuletto: posts big blind €0.02
*** HOLE CARDS ***
Dealt to caduceus369 [2c 2h]
IKARO_3: raises €0.04 to €0.06
sisifo40: folds 
caduceus369: folds 
Topastro27: folds 
emidio92: folds 
TurboMuletto: folds 
Uncalled bet (€0.04) returned to IKARO_3
IKARO_3 collected €0.05 from pot
IKARO_3: doesn't show hand 
*** SUMMARY ***
Total pot €0.05 | Rake €0 
Seat 1: Topastro27 (button) folded before Flop (didn't bet)
Seat 2: emidio92 (small blind) folded before Flop
Seat 3: TurboMuletto (big blind) folded before Flop
Seat 4: IKARO_3 collected (€0.05)
Seat 5: sisifo40 folded before Flop (didn't bet)
Seat 6: caduceus369 folded before Flop (didn't bet)



PokerStars Zoom Hand #257997603055:  Hold'em No Limit (€0.01/€0.02) [ADM ID: M62BD3044A1E13PD] - 2025/10/04 19:50:18 CET [2025/10/04 13:50:18 ET]
Table 'Sirio' 6-max Seat #1 is the button
Seat 1: ADRIAN0_MEIS (€5.01 in chips) 
Seat 2: MathMassacreX (€3.24 in chips) 
Seat 3: Artemis1a (€3.53 in chips) 
Seat 4: caduceus369 (€2 in chips) 
Seat 5: ROELLIRI972 (€0.35 in chips) 
Seat 6: Topastro27 (€2.91 in chips) 
MathMassacreX: posts small blind €0.01
Artemis1a: posts big blind €0.02
*** HOLE CARDS ***
Dealt to caduceus369 [7d 6h]
caduceus369: folds 
ROELLIRI972: folds 
Topastro27: folds 
ADRIAN0_MEIS: raises €0.04 to €0.06
MathMassacreX: folds 
Artemis1a: folds 
Uncalled bet (€0.04) returned to ADRIAN0_MEIS
ADRIAN0_MEIS collected €0.05 from pot
ADRIAN0_MEIS: doesn't show hand 
*** SUMMARY ***
Total pot €0.05 | Rake €0 
Seat 1: ADRIAN0_MEIS (button) collected (€0.05)
Seat 2: MathMassacreX (small blind) folded before Flop
Seat 3: Artemis1a (big blind) folded before Flop
Seat 4: caduceus369 folded before Flop (didn't bet)
Seat 5: ROELLIRI972 folded before Flop (didn't bet)
Seat 6: Topastro27 folded before Flop (didn't bet)



PokerStars Zoom Hand #257997605135:  Hold'em No Limit (€0.01/€0.02) [ADM ID: M62BD3044A1E13PD] - 2025/10/04 19:50:27 CET [2025/10/04 13:50:27 ET]
Table 'Sirio' 6-max Seat #1 is the button
Seat 1: KilometroZer0 (€2.26 in chips) 
Seat 2: caduceus369 (€2 in chips) 
Seat 3: Topastro27 (€2.91 in chips) 
Seat 4: stevalmg (€2.28 in chips) 
Seat 5: Sorosuno (€2.31 in chips) 
Seat 6: ADRIAN0_MEIS (€5.19 in chips) 
caduceus369: posts small blind €0.01
Topastro27: posts big blind €0.02
*** HOLE CARDS ***
Dealt to caduceus369 [8c Kc]
stevalmg: folds 
Sorosuno: raises €0.03 to €0.05
ADRIAN0_MEIS: folds 
KilometroZer0: folds 
caduceus369: folds 
Topastro27: folds 
Uncalled bet (€0.03) returned to Sorosuno
Sorosuno collected €0.05 from pot
Sorosuno: doesn't show hand 
*** SUMMARY ***
Total pot €0.05 | Rake €0 
Seat 1: KilometroZer0 (button) folded before Flop (didn't bet)
Seat 2: caduceus369 (small blind) folded before Flop
Seat 3: Topastro27 (big blind) folded before Flop
Seat 4: stevalmg folded before Flop (didn't bet)
Seat 5: Sorosuno collected (€0.05)
Seat 6: ADRIAN0_MEIS folded before Flop (didn't bet)



PokerStars Zoom Hand #257997609062:  Hold'em No Limit (€0.01/€0.02) [ADM ID: M62BD3044A1E13PD] - 2025/10/04 19:50:45 CET [2025/10/04 13:50:45 ET]
Table 'Sirio' 6-max Seat #1 is the button
Seat 1: ADRIAN0_MEIS (€5.30 in chips) 
Seat 2: SidneyPrescott (€2.28 in chips) 
Seat 3: Artemis1a (€5.76 in chips) 
Seat 4: caduceus369 (€2 in chips) 
Seat 5: IKARO_3 (€1.78 in chips) 
Seat 6: RRsanto (€3.53 in chips) 
SidneyPrescott: posts small blind €0.01
Artemis1a: posts big blind €0.02
*** HOLE CARDS ***
Dealt to caduceus369 [Qc Ks]
caduceus369: raises €0.04 to €0.06
IKARO_3: folds 
RRsanto: folds 
ADRIAN0_MEIS: folds 
SidneyPrescott: folds 
Artemis1a: folds 
Uncalled bet (€0.04) returned to caduceus369
caduceus369 collected €0.05 from pot
caduceus369: doesn't show hand 
*** SUMMARY ***
Total pot €0.05 | Rake €0 
Seat 1: ADRIAN0_MEIS (button) folded before Flop (didn't bet)
Seat 2: SidneyPrescott (small blind) folded before Flop
Seat 3: Artemis1a (big blind) folded before Flop
Seat 4: caduceus369 collected (€0.05)
Seat 5: IKARO_3 folded before Flop (didn't bet)
Seat 6: RRsanto folded before Flop (didn't bet)



PokerStars Zoom Hand #257997613983:  Hold'em No Limit (€0.01/€0.02) [ADM ID: M62BD3044A1E13PD] - 2025/10/04 19:51:07 CET [2025/10/04 13:51:07 ET]
Table 'Sirio' 6-max Seat #1 is the button
Seat 1: IKARO_3 (€2.41 in chips) 
Seat 2: KilometroZer0 (€1.87 in chips) 
Seat 3: caduceus369 (€2.03 in chips) 
Seat 4: MathMassacreX (€3.05 in chips) 
Seat 5: Artemis1a (€3.46 in chips) 
Seat 6: emidio92 (€5 in chips) 
KilometroZer0: posts small blind €0.01
caduceus369: posts big blind €0.02
*** HOLE CARDS ***
Dealt to caduceus369 [5h Qc]
MathMassacreX: folds 
Artemis1a: folds 
emidio92: raises €0.03 to €0.05
IKARO_3: folds 
KilometroZer0: calls €0.04
caduceus369: folds 
*** FLOP *** [9c 2s 4s]
KilometroZer0: checks 
emidio92: checks 
*** TURN *** [9c 2s 4s] [7h]
KilometroZer0: checks 
emidio92: checks 
*** RIVER *** [9c 2s 4s 7h] [7s]
KilometroZer0: checks 
emidio92: checks 
*** SHOW DOWN ***
KilometroZer0: shows [Qh Kh] (a pair of Sevens)
emidio92: mucks hand 
KilometroZer0 collected €0.12 from pot
*** SUMMARY ***
Total pot €0.12 | Rake €0 
Board [9c 2s 4s 7h 7s]
Seat 1: IKARO_3 (button) folded before Flop (didn't bet)
Seat 2: KilometroZer0 (small blind) showed [Qh Kh] and won (€0.12) with a pair of Sevens
Seat 3: caduceus369 (big blind) folded before Flop
Seat 4: MathMassacreX folded before Flop (didn't bet)
Seat 5: Artemis1a folded before Flop (didn't bet)
Seat 6: emidio92 mucked [Th Ks]



PokerStars Zoom Hand #257997616233:  Hold'em No Limit (€0.01/€0.02) [ADM ID: M62BD3044A1E13PD] - 2025/10/04 19:51:17 CET [2025/10/04 13:51:17 ET]
Table 'Sirio' 6-max Seat #1 is the button
Seat 1: caduceus369 (€2.01 in chips) 
Seat 2: Topastro27 (€3.48 in chips) 
Seat 3: Artemis1a (€3.46 in chips) 
Seat 4: Gionni483 (€3.94 in chips) 
Seat 5: IKARO_3 (€2.41 in chips) 
Seat 6: Sim_sala_bin (€0.57 in chips) 
Topastro27: posts small blind €0.01
Artemis1a: posts big blind €0.02
*** HOLE CARDS ***
Dealt to caduceus369 [9h 3s]
Gionni483: folds 
IKARO_3: folds 
Sim_sala_bin: folds 
caduceus369: folds 
Topastro27: raises €0.04 to €0.06
Artemis1a: calls €0.04
*** FLOP *** [Qh 4s 2h]
Topastro27: checks 
Artemis1a: bets €0.02
Topastro27: calls €0.02
*** TURN *** [Qh 4s 2h] [Ks]
Topastro27: checks 
Artemis1a: checks 
*** RIVER *** [Qh 4s 2h Ks] [5d]
Topastro27: bets €0.06
Artemis1a: calls €0.06
*** SHOW DOWN ***
Topastro27: shows [Ah Qd] (a pair of Queens)
Artemis1a: mucks hand 
Topastro27 collected €0.27 from pot
*** SUMMARY ***
Total pot €0.28 | Rake €0.01 
Board [Qh 4s 2h Ks 5d]
Seat 1: caduceus369 (button) folded before Flop (didn't bet)
Seat 2: Topastro27 (small blind) showed [Ah Qd] and won (€0.27) with a pair of Queens
Seat 3: Artemis1a (big blind) mucked [Qs 8h]
Seat 4: Gionni483 folded before Flop (didn't bet)
Seat 5: IKARO_3 folded before Flop (didn't bet)
Seat 6: Sim_sala_bin folded before Flop (didn't bet)



PokerStars Zoom Hand #257997618888:  Hold'em No Limit (€0.01/€0.02) [ADM ID: M62BD3044A1E13PD] - 2025/10/04 19:51:30 CET [2025/10/04 13:51:30 ET]
Table 'Sirio' 6-max Seat #1 is the button
Seat 1: pylonstrip (€2.87 in chips) 
Seat 2: ADRIAN0_MEIS (€5.05 in chips) 
Seat 3: IKARO_3 (€0.57 in chips) 
Seat 4: Manus22749 (€2.28 in chips) 
Seat 5: Artemis1a (€3.50 in chips) 
Seat 6: caduceus369 (€2.01 in chips) 
ADRIAN0_MEIS: posts small blind €0.01
IKARO_3: posts big blind €0.02
*** HOLE CARDS ***
Dealt to caduceus369 [Ad Td]
Manus22749: folds 
Artemis1a: raises €0.02 to €0.04
caduceus369: raises €0.14 to €0.18
pylonstrip: folds 
ADRIAN0_MEIS: folds 
IKARO_3: raises €0.39 to €0.57 and is all-in
Artemis1a: folds 
caduceus369: calls €0.39
*** FLOP *** [9d Kd Jh]
*** TURN *** [9d Kd Jh] [Ts]
*** RIVER *** [9d Kd Jh Ts] [2h]
*** SHOW DOWN ***
IKARO_3: shows [7h 7d] (a pair of Sevens)
caduceus369: shows [Ad Td] (a pair of Tens)
caduceus369 collected €1.13 from pot
*** SUMMARY ***
Total pot €1.19 | Rake €0.06 
Board [9d Kd Jh Ts 2h]
Seat 1: pylonstrip (button) folded before Flop (didn't bet)
Seat 2: ADRIAN0_MEIS (small blind) folded before Flop
Seat 3: IKARO_3 (big blind) showed [7h 7d] and lost with a pair of Sevens
Seat 4: Manus22749 folded before Flop (didn't bet)
Seat 5: Artemis1a folded before Flop
Seat 6: caduceus369 showed [Ad Td] and won (€1.13) with a pair of Tens



PokerStars Zoom Hand #257997617320:  Hold'em No Limit (€0.01/€0.02) [ADM ID: M62BD3044A1E13PD] - 2025/10/04 19:51:23 CET [2025/10/04 13:51:23 ET]
Table 'Sirio' 6-max Seat #1 is the button
Seat 1: GanchanS7 (€3.71 in chips) 
Seat 2: Sim_sala_bin (€0.57 in chips) 
Seat 3: ADRIAN0_MEIS (€5.22 in chips) 
Seat 4: bruciapelo (€3.99 in chips) 
Seat 5: caduceus369 (€2.01 in chips) 
Seat 6: emidio92 (€10.02 in chips) 
Sim_sala_bin: posts small blind €0.01
ADRIAN0_MEIS: posts big blind €0.02
*** HOLE CARDS ***
Dealt to caduceus369 [5s Kc]
bruciapelo: folds 
caduceus369: folds 
emidio92: folds 
GanchanS7: folds 
Sim_sala_bin: calls €0.01
ADRIAN0_MEIS: checks 
*** FLOP *** [6d 5h 2d]
Sim_sala_bin: checks 
ADRIAN0_MEIS: checks 
*** TURN *** [6d 5h 2d] [As]
Sim_sala_bin: checks 
ADRIAN0_MEIS: checks 
*** RIVER *** [6d 5h 2d As] [Qc]
Sim_sala_bin: bets €0.08
ADRIAN0_MEIS: folds 
Uncalled bet (€0.08) returned to Sim_sala_bin
Sim_sala_bin collected €0.04 from pot
Sim_sala_bin: doesn't show hand 
*** SUMMARY ***
Total pot €0.04 | Rake €0 
Board [6d 5h 2d As Qc]
Seat 1: GanchanS7 (button) folded before Flop (didn't bet)
Seat 2: Sim_sala_bin (small blind) collected (€0.04)
Seat 3: ADRIAN0_MEIS (big blind) folded on the River
Seat 4: bruciapelo folded before Flop (didn't bet)
Seat 5: caduceus369 folded before Flop (didn't bet)
Seat 6: emidio92 folded before Flop (didn't bet)



PokerStars Zoom Hand #257997628429:  Hold'em No Limit (€0.01/€0.02) [ADM ID: M62BD3044A1E13PD] - 2025/10/04 19:52:13 CET [2025/10/04 13:52:13 ET]
Table 'Sirio' 6-max Seat #1 is the button
Seat 1: SidneyPrescott (€2.15 in chips) 
Seat 2: Sorosuno (€2.28 in chips) 
Seat 3: ADRIAN0_MEIS (€5.15 in chips) 
Seat 4: caduceus369 (€2.57 in chips) 
Seat 5: Kazzimmino (€1.83 in chips) 
Seat 6: Artemis1a (€3.46 in chips) 
Sorosuno: posts small blind €0.01
ADRIAN0_MEIS: posts big blind €0.02
*** HOLE CARDS ***
Dealt to caduceus369 [4d 9s]
caduceus369: folds 
Kazzimmino: folds 
Artemis1a: folds 
SidneyPrescott: raises €0.04 to €0.06
Sorosuno: raises €0.12 to €0.18
ADRIAN0_MEIS: folds 
SidneyPrescott: folds 
Uncalled bet (€0.12) returned to Sorosuno
Sorosuno collected €0.14 from pot
Sorosuno: doesn't show hand 
*** SUMMARY ***
Total pot €0.14 | Rake €0 
Seat 1: SidneyPrescott (button) folded before Flop
Seat 2: Sorosuno (small blind) collected (€0.14)
Seat 3: ADRIAN0_MEIS (big blind) folded before Flop
Seat 4: caduceus369 folded before Flop (didn't bet)
Seat 5: Kazzimmino folded before Flop (didn't bet)
Seat 6: Artemis1a folded before Flop (didn't bet)



PokerStars Zoom Hand #257997629756:  Hold'em No Limit (€0.01/€0.02) [ADM ID: M62BD3044A1E13PD] - 2025/10/04 19:52:19 CET [2025/10/04 13:52:19 ET]
Table 'Sirio' 6-max Seat #1 is the button
Seat 1: ROELLIRI972 (€0.29 in chips) 
Seat 2: Luciano300661 (€2.10 in chips) 
Seat 3: caduceus369 (€2.57 in chips) 
Seat 4: Artemis1a (€3.31 in chips) 
Seat 5: KilometroZer0 (€2.26 in chips) 
Seat 6: IKARO_3 (€1.51 in chips) 
Luciano300661: posts small blind €0.01
caduceus369: posts big blind €0.02
*** HOLE CARDS ***
Dealt to caduceus369 [As Qd]
Artemis1a: folds 
KilometroZer0: raises €0.05 to €0.07
IKARO_3: folds 
ROELLIRI972: folds 
Luciano300661: calls €0.06
caduceus369: raises €0.23 to €0.30
KilometroZer0: calls €0.23
Luciano300661: calls €0.23
*** FLOP *** [6c 6s 5d]
Luciano300661: checks 
caduceus369: bets €0.36
KilometroZer0: calls €0.36
Luciano300661: folds 
*** TURN *** [6c 6s 5d] [2h]
caduceus369: checks 
KilometroZer0: bets €0.77
caduceus369: folds 
Uncalled bet (€0.77) returned to KilometroZer0
KilometroZer0 collected €1.54 from pot
KilometroZer0: doesn't show hand 
*** SUMMARY ***
Total pot €1.62 | Rake €0.08 
Board [6c 6s 5d 2h]
Seat 1: ROELLIRI972 (button) folded before Flop (didn't bet)
Seat 2: Luciano300661 (small blind) folded on the Flop
Seat 3: caduceus369 (big blind) folded on the Turn
Seat 4: Artemis1a folded before Flop (didn't bet)
Seat 5: KilometroZer0 collected (€1.54)
Seat 6: IKARO_3 folded before Flop (didn't bet)



PokerStars Zoom Hand #257997644803:  Hold'em No Limit (€0.01/€0.02) [ADM ID: M62BD3044A1E13PD] - 2025/10/04 19:53:27 CET [2025/10/04 13:53:27 ET]
Table 'Sirio' 6-max Seat #1 is the button
Seat 1: Artemis1a (€5.78 in chips) 
Seat 2: caduceus369 (€2 in chips) 
Seat 3: Catania838 (€2.49 in chips) 
Seat 4: SidneyPrescott (€2.84 in chips) 
Seat 5: emidio92 (€5.37 in chips) 
Seat 6: Sim_sala_bin (€0.54 in chips) 
caduceus369: posts small blind €0.01
Catania838: posts big blind €0.02
*** HOLE CARDS ***
Dealt to caduceus369 [3h 2h]
SidneyPrescott: folds 
emidio92: folds 
Sim_sala_bin: calls €0.02
Artemis1a: raises €0.07 to €0.09
caduceus369: folds 
Catania838: folds 
Sim_sala_bin: folds 
Uncalled bet (€0.07) returned to Artemis1a
Artemis1a collected €0.07 from pot
Artemis1a: doesn't show hand 
*** SUMMARY ***
Total pot €0.07 | Rake €0 
Seat 1: Artemis1a (button) collected (€0.07)
Seat 2: caduceus369 (small blind) folded before Flop
Seat 3: Catania838 (big blind) folded before Flop
Seat 4: SidneyPrescott folded before Flop (didn't bet)
Seat 5: emidio92 folded before Flop (didn't bet)
Seat 6: Sim_sala_bin folded before Flop



PokerStars Zoom Hand #257997645994:  Hold'em No Limit (€0.01/€0.02) [ADM ID: M62BD3044A1E13PD] - 2025/10/04 19:53:32 CET [2025/10/04 13:53:32 ET]
Table 'Sirio' 6-max Seat #1 is the button
Seat 1: caduceus369 (€2 in chips) 
Seat 2: RRsanto (€3.77 in chips) 
Seat 3: GanchanS7 (€2.32 in chips) 
Seat 4: jolli180 (€1.88 in chips) 
Seat 5: manch73r (€2.86 in chips) 
Seat 6: emidio92 (€5.37 in chips) 
RRsanto: posts small blind €0.01
GanchanS7: posts big blind €0.02
*** HOLE CARDS ***
Dealt to caduceus369 [2s 7s]
jolli180: folds 
manch73r: folds 
emidio92: folds 
caduceus369: folds 
RRsanto: folds 
Uncalled bet (€0.01) returned to GanchanS7
GanchanS7 collected €0.02 from pot
GanchanS7: doesn't show hand 
*** SUMMARY ***
Total pot €0.02 | Rake €0 
Seat 1: caduceus369 (button) folded before Flop (didn't bet)
Seat 2: RRsanto (small blind) folded before Flop
Seat 3: GanchanS7 (big blind) collected (€0.02)
Seat 4: jolli180 folded before Flop (didn't bet)
Seat 5: manch73r folded before Flop (didn't bet)
Seat 6: emidio92 folded before Flop (didn't bet)



PokerStars Zoom Hand #257997649469:  Hold'em No Limit (€0.01/€0.02) [ADM ID: M62BD3044A1E13PD] - 2025/10/04 19:53:48 CET [2025/10/04 13:53:48 ET]
Table 'Sirio' 6-max Seat #1 is the button
Seat 1: Black98Demon (€3.85 in chips) 
Seat 2: Wunschgast (€3.24 in chips) 
Seat 3: Sim_sala_bin (€0.52 in chips) 
Seat 4: GanchanS7 (€3.03 in chips) 
Seat 5: caduceus369 (€2 in chips) 
Seat 6: RRsanto (€2.95 in chips) 
Wunschgast: posts small blind €0.01
Sim_sala_bin: posts big blind €0.02
*** HOLE CARDS ***
Dealt to caduceus369 [Qc Kc]
GanchanS7: folds 
caduceus369: raises €0.04 to €0.06
RRsanto: folds 
Black98Demon: calls €0.06
Wunschgast: folds 
Sim_sala_bin: folds 
*** FLOP *** [As Ah 5s]
caduceus369: bets €0.06
Black98Demon: calls €0.06
*** TURN *** [As Ah 5s] [8h]
caduceus369: checks 
Black98Demon: bets €0.20
caduceus369: folds 
Uncalled bet (€0.20) returned to Black98Demon
Black98Demon collected €0.26 from pot
Black98Demon: doesn't show hand 
*** SUMMARY ***
Total pot €0.27 | Rake €0.01 
Board [As Ah 5s 8h]
Seat 1: Black98Demon (button) collected (€0.26)
Seat 2: Wunschgast (small blind) folded before Flop
Seat 3: Sim_sala_bin (big blind) folded before Flop
Seat 4: GanchanS7 folded before Flop (didn't bet)
Seat 5: caduceus369 folded on the Turn
Seat 6: RRsanto folded before Flop (didn't bet)



PokerStars Zoom Hand #257997658977:  Hold'em No Limit (€0.01/€0.02) [ADM ID: M62BD3044A1E13PD] - 2025/10/04 19:54:31 CET [2025/10/04 13:54:31 ET]
Table 'Sirio' 6-max Seat #1 is the button
Seat 1: Luciano300661 (€1.73 in chips) 
Seat 2: caduceus369 (€2 in chips) 
Seat 3: Topastro27 (€3.55 in chips) 
Seat 4: stevalmg (€2.18 in chips) 
Seat 5: zeruell (€0.57 in chips) 
Seat 6: ALUMIX (€1.45 in chips) 
caduceus369: posts small blind €0.01
Topastro27: posts big blind €0.02
*** HOLE CARDS ***
Dealt to caduceus369 [6s 9h]
stevalmg: raises €0.04 to €0.06
zeruell: calls €0.06
ALUMIX: folds 
Luciano300661: folds 
caduceus369: folds 
Topastro27: folds 
*** FLOP *** [5h Qh 7h]
stevalmg: bets €0.08
zeruell: folds 
Uncalled bet (€0.08) returned to stevalmg
stevalmg collected €0.15 from pot
stevalmg: doesn't show hand 
*** SUMMARY ***
Total pot €0.15 | Rake €0 
Board [5h Qh 7h]
Seat 1: Luciano300661 (button) folded before Flop (didn't bet)
Seat 2: caduceus369 (small blind) folded before Flop
Seat 3: Topastro27 (big blind) folded before Flop
Seat 4: stevalmg collected (€0.15)
Seat 5: zeruell folded on the Flop
Seat 6: ALUMIX folded before Flop (didn't bet)



PokerStars Zoom Hand #257997647748:  Hold'em No Limit (€0.01/€0.02) [ADM ID: M62BD3044A1E13PD] - 2025/10/04 19:53:40 CET [2025/10/04 13:53:40 ET]
Table 'Sirio' 6-max Seat #1 is the button
Seat 1: SaTheNuts_77 (€3.07 in chips) 
Seat 2: ADRIAN0_MEIS (€5.17 in chips) 
Seat 3: Artemis1a (€1.72 in chips) 
Seat 4: vistex (€1.07 in chips) 
Seat 5: Wunschgast (€3.24 in chips) 
Seat 6: caduceus369 (€2 in chips) 
ADRIAN0_MEIS: posts small blind €0.01
Artemis1a: posts big blind €0.02
*** HOLE CARDS ***
Dealt to caduceus369 [7h Jc]
vistex: calls €0.02
Wunschgast: folds 
caduceus369: folds 
SaTheNuts_77: raises €0.07 to €0.09
ADRIAN0_MEIS: calls €0.08
Artemis1a: folds 
vistex: calls €0.07
*** FLOP *** [3h 7c 9h]
ADRIAN0_MEIS: checks 
vistex: bets €0.20
SaTheNuts_77: calls €0.20
ADRIAN0_MEIS: folds 
*** TURN *** [3h 7c 9h] [9s]
vistex: checks 
SaTheNuts_77: bets €0.84
vistex: calls €0.78 and is all-in
Uncalled bet (€0.06) returned to SaTheNuts_77
*** RIVER *** [3h 7c 9h 9s] [Ks]
*** SHOW DOWN ***
vistex: shows [4d 9d] (three of a kind, Nines)
SaTheNuts_77: shows [6h 6d] (two pair, Nines and Sixes)
vistex collected €2.13 from pot
*** SUMMARY ***
Total pot €2.25 | Rake €0.12 
Board [3h 7c 9h 9s Ks]
Seat 1: SaTheNuts_77 (button) showed [6h 6d] and lost with two pair, Nines and Sixes
Seat 2: ADRIAN0_MEIS (small blind) folded on the Flop
Seat 3: Artemis1a (big blind) folded before Flop
Seat 4: vistex showed [4d 9d] and won (€2.13) with three of a kind, Nines
Seat 5: Wunschgast folded before Flop (didn't bet)
Seat 6: caduceus369 folded before Flop (didn't bet)



PokerStars Zoom Hand #257997657598:  Hold'em No Limit (€0.01/€0.02) [ADM ID: M62BD3044A1E13PD] - 2025/10/04 19:54:25 CET [2025/10/04 13:54:25 ET]
Table 'Sirio' 6-max Seat #1 is the button
Seat 1: caduceus369 (€2 in chips) 
Seat 2: ROELLIRI972 (€0.94 in chips) 
Seat 3: nudja69 (€2.30 in chips) 
Seat 4: Gionni483 (€4.53 in chips) 
Seat 5: stevalmg (€2.18 in chips) 
Seat 6: pylonstrip (€2.70 in chips) 
ROELLIRI972: posts small blind €0.01
nudja69: posts big blind €0.02
*** HOLE CARDS ***
Dealt to caduceus369 [8h Th]
Gionni483: calls €0.02
stevalmg: folds 
pylonstrip: raises €0.06 to €0.08
caduceus369: folds 
ROELLIRI972: folds 
nudja69: calls €0.06
Gionni483: folds 
*** FLOP *** [6s 8d 6d]
nudja69: checks 
pylonstrip: bets €0.09
nudja69: folds 
Uncalled bet (€0.09) returned to pylonstrip
pylonstrip collected €0.18 from pot
pylonstrip: doesn't show hand 
*** SUMMARY ***
Total pot €0.19 | Rake €0.01 
Board [6s 8d 6d]
Seat 1: caduceus369 (button) folded before Flop (didn't bet)
Seat 2: ROELLIRI972 (small blind) folded before Flop
Seat 3: nudja69 (big blind) folded on the Flop
Seat 4: Gionni483 folded before Flop
Seat 5: stevalmg folded before Flop (didn't bet)
Seat 6: pylonstrip collected (€0.18)



PokerStars Zoom Hand #257997661614:  Hold'em No Limit (€0.01/€0.02) [ADM ID: M62BD3044A1E13PD] - 2025/10/04 19:54:43 CET [2025/10/04 13:54:43 ET]
Table 'Sirio' 6-max Seat #1 is the button
Seat 1: RRsanto (€2.86 in chips) 
Seat 2: Topastro27 (€3.53 in chips) 
Seat 3: Pallina400 (€0.84 in chips) 
Seat 4: caduceus369 (€2 in chips) 
Seat 5: Artemis1a (€5.27 in chips) 
Seat 6: KilometroZer0 (€3.07 in chips) 
Topastro27: posts small blind €0.01
Pallina400: posts big blind €0.02
*** HOLE CARDS ***
Dealt to caduceus369 [Js 6s]
caduceus369: folds 
Artemis1a: folds 
KilometroZer0: folds 
RRsanto: raises €0.04 to €0.06
Topastro27: folds 
Pallina400: calls €0.04
*** FLOP *** [As 4s 8s]
Pallina400: checks 
RRsanto: bets €0.04
Pallina400: calls €0.04
*** TURN *** [As 4s 8s] [Ah]
Pallina400: checks 
RRsanto: checks 
*** RIVER *** [As 4s 8s Ah] [9h]
Pallina400: checks 
RRsanto: checks 
*** SHOW DOWN ***
Pallina400: shows [3h 4h] (two pair, Aces and Fours)
RRsanto: shows [6d 6c] (two pair, Aces and Sixes)
RRsanto collected €0.20 from pot
*** SUMMARY ***
Total pot €0.21 | Rake €0.01 
Board [As 4s 8s Ah 9h]
Seat 1: RRsanto (button) showed [6d 6c] and won (€0.20) with two pair, Aces and Sixes
Seat 2: Topastro27 (small blind) folded before Flop
Seat 3: Pallina400 (big blind) showed [3h 4h] and lost with two pair, Aces and Fours
Seat 4: caduceus369 folded before Flop (didn't bet)
Seat 5: Artemis1a folded before Flop (didn't bet)
Seat 6: KilometroZer0 folded before Flop (didn't bet)



PokerStars Zoom Hand #257997666554:  Hold'em No Limit (€0.01/€0.02) [ADM ID: M62BD3044A1E13PD] - 2025/10/04 19:55:08 CET [2025/10/04 13:55:08 ET]
Table 'Sirio' 6-max Seat #1 is the button
Seat 1: manch73r (€2.93 in chips) 
Seat 2: Black98Demon (€2.79 in chips) 
Seat 3: Kazzimmino (€1.83 in chips) 
Seat 4: LolloSpino (€0.94 in chips) 
Seat 5: Gabrielefante (€3.10 in chips) 
Seat 6: caduceus369 (€2 in chips) 
Black98Demon: posts small blind €0.01
Kazzimmino: posts big blind €0.02
*** HOLE CARDS ***
Dealt to caduceus369 [2c Kd]
LolloSpino: folds 
Gabrielefante: folds 
caduceus369: folds 
manch73r: raises €0.02 to €0.04
Black98Demon: folds 
Kazzimmino: folds 
Uncalled bet (€0.02) returned to manch73r
manch73r collected €0.05 from pot
manch73r: doesn't show hand 
*** SUMMARY ***
Total pot €0.05 | Rake €0 
Seat 1: manch73r (button) collected (€0.05)
Seat 2: Black98Demon (small blind) folded before Flop
Seat 3: Kazzimmino (big blind) folded before Flop
Seat 4: LolloSpino folded before Flop (didn't bet)
Seat 5: Gabrielefante folded before Flop (didn't bet)
Seat 6: caduceus369 folded before Flop (didn't bet)



PokerStars Zoom Hand #257997662941:  Hold'em No Limit (€0.01/€0.02) [ADM ID: M62BD3044A1E13PD] - 2025/10/04 19:54:49 CET [2025/10/04 13:54:49 ET]
Table 'Sirio' 6-max Seat #1 is the button
Seat 1: ivano747 (€1.61 in chips) 
Seat 2: Luciano300661 (€1.73 in chips) 
Seat 3: caduceus369 (€2 in chips) 
Seat 4: LolloSpino (€3.09 in chips) 
Seat 5: ROELLIRI972 (€0.93 in chips) 
Seat 6: zeruell (€0.51 in chips) 
Luciano300661: posts small blind €0.01
caduceus369: posts big blind €0.02
*** HOLE CARDS ***
Dealt to caduceus369 [3s 7d]
LolloSpino: folds 
ROELLIRI972: folds 
zeruell: raises €0.04 to €0.06
ivano747: folds 
Luciano300661: calls €0.05
caduceus369: folds 
*** FLOP *** [3h 2s 5d]
Luciano300661: bets €1.67 and is all-in
zeruell: calls €0.45 and is all-in
Uncalled bet (€1.22) returned to Luciano300661
*** TURN *** [3h 2s 5d] [Td]
*** RIVER *** [3h 2s 5d Td] [Qc]
*** SHOW DOWN ***
Luciano300661: shows [Js 4s] (high card Queen)
zeruell: shows [As Ad] (a pair of Aces)
zeruell collected €0.99 from pot
*** SUMMARY ***
Total pot €1.04 | Rake €0.05 
Board [3h 2s 5d Td Qc]
Seat 1: ivano747 (button) folded before Flop (didn't bet)
Seat 2: Luciano300661 (small blind) showed [Js 4s] and lost with high card Queen
Seat 3: caduceus369 (big blind) folded before Flop
Seat 4: LolloSpino folded before Flop (didn't bet)
Seat 5: ROELLIRI972 folded before Flop (didn't bet)
Seat 6: zeruell showed [As Ad] and won (€0.99) with a pair of Aces



PokerStars Zoom Hand #257997656498:  Hold'em No Limit (€0.01/€0.02) [ADM ID: M62BD3044A1E13PD] - 2025/10/04 19:54:20 CET [2025/10/04 13:54:20 ET]
Table 'Sirio' 6-max Seat #1 is the button
Seat 1: ivano747 (€2.30 in chips) 
Seat 2: RRsanto (€2.87 in chips) 
Seat 3: emidio92 (€4.19 in chips) 
Seat 4: ADRIAN0_MEIS (€2.30 in chips) 
Seat 5: caduceus369 (€2 in chips) 
Seat 6: Wunschgast (€3.20 in chips) 
RRsanto: posts small blind €0.01
emidio92: posts big blind €0.02
*** HOLE CARDS ***
Dealt to caduceus369 [3d 6s]
ADRIAN0_MEIS: raises €0.04 to €0.06
caduceus369: folds 
Wunschgast: calls €0.06
ivano747: folds 
RRsanto: folds 
emidio92: calls €0.04
*** FLOP *** [2s Qd 4c]
emidio92: checks 
ADRIAN0_MEIS: checks 
Wunschgast: checks 
*** TURN *** [2s Qd 4c] [Ad]
emidio92: checks 
ADRIAN0_MEIS: checks 
Wunschgast: checks 
*** RIVER *** [2s Qd 4c Ad] [7c]
emidio92: checks 
ADRIAN0_MEIS: checks 
Wunschgast: checks 
*** SHOW DOWN ***
emidio92: shows [7s Ks] (a pair of Sevens)
ADRIAN0_MEIS: shows [8h 8s] (a pair of Eights)
Wunschgast: shows [Th Td] (a pair of Tens)
Wunschgast collected €0.18 from pot
*** SUMMARY ***
Total pot €0.19 | Rake €0.01 
Board [2s Qd 4c Ad 7c]
Seat 1: ivano747 (button) folded before Flop (didn't bet)
Seat 2: RRsanto (small blind) folded before Flop
Seat 3: emidio92 (big blind) showed [7s Ks] and lost with a pair of Sevens
Seat 4: ADRIAN0_MEIS showed [8h 8s] and lost with a pair of Eights
Seat 5: caduceus369 folded before Flop (didn't bet)
Seat 6: Wunschgast showed [Th Td] and won (€0.18) with a pair of Tens



PokerStars Zoom Hand #257997667144:  Hold'em No Limit (€0.01/€0.02) [ADM ID: M62BD3044A1E13PD] - 2025/10/04 19:55:12 CET [2025/10/04 13:55:12 ET]
Table 'Sirio' 6-max Seat #1 is the button
Seat 1: Sorosuno (€2 in chips) 
Seat 2: caduceus369 (€2 in chips) 
Seat 3: GanchanS7 (€2.32 in chips) 
Seat 4: Topastro27 (€3.52 in chips) 
Seat 5: ADRIAN0_MEIS (€6.45 in chips) 
Seat 6: Black98Demon (€2.78 in chips) 
caduceus369: posts small blind €0.01
GanchanS7: posts big blind €0.02
*** HOLE CARDS ***
Dealt to caduceus369 [Qh Kc]
Topastro27: folds 
ADRIAN0_MEIS: folds 
Black98Demon: folds 
Sorosuno: folds 
caduceus369: raises €0.04 to €0.06
GanchanS7: calls €0.04
*** FLOP *** [9h 8c 7d]
caduceus369: checks 
GanchanS7: checks 
*** TURN *** [9h 8c 7d] [Ac]
caduceus369: bets €0.04
GanchanS7: folds 
Uncalled bet (€0.04) returned to caduceus369
caduceus369 collected €0.12 from pot
caduceus369: doesn't show hand 
*** SUMMARY ***
Total pot €0.12 | Rake €0 
Board [9h 8c 7d Ac]
Seat 1: Sorosuno (button) folded before Flop (didn't bet)
Seat 2: caduceus369 (small blind) collected (€0.12)
Seat 3: GanchanS7 (big blind) folded on the Turn
Seat 4: Topastro27 folded before Flop (didn't bet)
Seat 5: ADRIAN0_MEIS folded before Flop (didn't bet)
Seat 6: Black98Demon folded before Flop (didn't bet)



PokerStars Zoom Hand #257997673237:  Hold'em No Limit (€0.01/€0.02) [ADM ID: M62BD3044A1E13PD] - 2025/10/04 19:55:56 CET [2025/10/04 13:55:56 ET]
Table 'Sirio' 6-max Seat #1 is the button
Seat 1: TurboMuletto (€1.45 in chips) 
Seat 2: SaTheNuts_77 (€2.08 in chips) 
Seat 3: caduceus369 (€2.06 in chips) 
Seat 4: Gionni483 (€4.36 in chips) 
Seat 5: GanchanS7 (€3.52 in chips) 
Seat 6: ADRIAN0_MEIS (€2.25 in chips) 
SaTheNuts_77: posts small blind €0.01
caduceus369: posts big blind €0.02
*** HOLE CARDS ***
Dealt to caduceus369 [Ks 2s]
Gionni483: folds 
GanchanS7: folds 
ADRIAN0_MEIS: folds 
TurboMuletto: folds 
SaTheNuts_77: folds 
Uncalled bet (€0.01) returned to caduceus369
caduceus369 collected €0.02 from pot
caduceus369: doesn't show hand 
*** SUMMARY ***
Total pot €0.02 | Rake €0 
Seat 1: TurboMuletto (button) folded before Flop (didn't bet)
Seat 2: SaTheNuts_77 (small blind) folded before Flop
Seat 3: caduceus369 (big blind) collected (€0.02)
Seat 4: Gionni483 folded before Flop (didn't bet)
Seat 5: GanchanS7 folded before Flop (didn't bet)
Seat 6: ADRIAN0_MEIS folded before Flop (didn't bet)



PokerStars Zoom Hand #257997672665:  Hold'em No Limit (€0.01/€0.02) [ADM ID: M62BD3044A1E13PD] - 2025/10/04 19:55:52 CET [2025/10/04 13:55:52 ET]
Table 'Sirio' 6-max Seat #1 is the button
Seat 1: emidio92 (€4.13 in chips) 
Seat 2: jolli180 (€1.77 in chips) 
Seat 3: ADRIAN0_MEIS (€6.44 in chips) 
Seat 4: caduceus369 (€2.06 in chips) 
Seat 5: GanchanS7 (€2.99 in chips) 
Seat 6: KilometroZer0 (€3.09 in chips) 
jolli180: posts small blind €0.01
ADRIAN0_MEIS: posts big blind €0.02
*** HOLE CARDS ***
Dealt to caduceus369 [2h Kh]
caduceus369: folds 
GanchanS7: folds 
KilometroZer0: raises €0.05 to €0.07
emidio92: folds 
jolli180: folds 
ADRIAN0_MEIS: folds 
Uncalled bet (€0.05) returned to KilometroZer0
KilometroZer0 collected €0.05 from pot
KilometroZer0: doesn't show hand 
*** SUMMARY ***
Total pot €0.05 | Rake €0 
Seat 1: emidio92 (button) folded before Flop (didn't bet)
Seat 2: jolli180 (small blind) folded before Flop
Seat 3: ADRIAN0_MEIS (big blind) folded before Flop
Seat 4: caduceus369 folded before Flop (didn't bet)
Seat 5: GanchanS7 folded before Flop (didn't bet)
Seat 6: KilometroZer0 collected (€0.05)



PokerStars Zoom Hand #257997671292:  Hold'em No Limit (€0.01/€0.02) [ADM ID: M62BD3044A1E13PD] - 2025/10/04 19:55:42 CET [2025/10/04 13:55:42 ET]
Table 'Sirio' 6-max Seat #1 is the button
Seat 1: Pallina400 (€0.76 in chips) 
Seat 2: KilometroZer0 (€2.38 in chips) 
Seat 3: SidneyPrescott (€2.78 in chips) 
Seat 4: GanchanS7 (€3.88 in chips) 
Seat 5: caduceus369 (€2.06 in chips) 
Seat 6: Artemis1a (€2.34 in chips) 
KilometroZer0: posts small blind €0.01
SidneyPrescott: posts big blind €0.02
*** HOLE CARDS ***
Dealt to caduceus369 [Qd Jh]
GanchanS7: folds 
caduceus369: folds 
Artemis1a: folds 
Pallina400: calls €0.02
KilometroZer0: folds 
SidneyPrescott: checks 
*** FLOP *** [Th 2c 2h]
SidneyPrescott: checks 
Pallina400: bets €0.14
SidneyPrescott: folds 
Uncalled bet (€0.14) returned to Pallina400
Pallina400 collected €0.05 from pot
Pallina400: doesn't show hand 
*** SUMMARY ***
Total pot €0.05 | Rake €0 
Board [Th 2c 2h]
Seat 1: Pallina400 (button) collected (€0.05)
Seat 2: KilometroZer0 (small blind) folded before Flop
Seat 3: SidneyPrescott (big blind) folded on the Flop
Seat 4: GanchanS7 folded before Flop (didn't bet)
Seat 5: caduceus369 folded before Flop (didn't bet)
Seat 6: Artemis1a folded before Flop (didn't bet)



PokerStars Zoom Hand #257997675592:  Hold'em No Limit (€0.01/€0.02) [ADM ID: M62BD3044A1E13PD] - 2025/10/04 19:56:13 CET [2025/10/04 13:56:13 ET]
Table 'Sirio' 6-max Seat #1 is the button
Seat 1: emidio92 (€9.90 in chips) 
Seat 2: manch73r (€2.97 in chips) 
Seat 3: Catania838 (€3.63 in chips) 
Seat 4: ADRIAN0_MEIS (€2.24 in chips) 
Seat 5: Black98Demon (€2.82 in chips) 
Seat 6: caduceus369 (€2.07 in chips) 
manch73r: posts small blind €0.01
Catania838: posts big blind €0.02
*** HOLE CARDS ***
Dealt to caduceus369 [3h 6d]
ADRIAN0_MEIS: folds 
Black98Demon: folds 
caduceus369: folds 
Catania838 is disconnected 
emidio92: raises €0.03 to €0.05
manch73r: folds 
Catania838 has timed out while disconnected
Catania838: folds 
Uncalled bet (€0.03) returned to emidio92
emidio92 collected €0.05 from pot
emidio92: doesn't show hand 
*** SUMMARY ***
Total pot €0.05 | Rake €0 
Seat 1: emidio92 (button) collected (€0.05)
Seat 2: manch73r (small blind) folded before Flop
Seat 3: Catania838 (big blind) folded before Flop
Seat 4: ADRIAN0_MEIS folded before Flop (didn't bet)
Seat 5: Black98Demon folded before Flop (didn't bet)
Seat 6: caduceus369 folded before Flop (didn't bet)



PokerStars Zoom Hand #257997674680:  Hold'em No Limit (€0.01/€0.02) [ADM ID: M62BD3044A1E13PD] - 2025/10/04 19:56:07 CET [2025/10/04 13:56:07 ET]
Table 'Sirio' 6-max Seat #1 is the button
Seat 1: caduceus369 (€2.07 in chips) 
Seat 2: ghosto69 (€1.90 in chips) 
Seat 3: GanchanS7 (€2.99 in chips) 
Seat 4: KilometroZer0 (€3.10 in chips) 
Seat 5: RRsanto (€3.98 in chips) 
Seat 6: vistex (€2.02 in chips) 
ghosto69: posts small blind €0.01
GanchanS7: posts big blind €0.02
*** HOLE CARDS ***
Dealt to caduceus369 [3s 6s]
KilometroZer0: folds 
RRsanto: raises €0.04 to €0.06
vistex: calls €0.06
caduceus369: folds 
ghosto69: raises €0.20 to €0.26
GanchanS7: folds 
RRsanto: calls €0.20
vistex: calls €0.20
*** FLOP *** [Ac 7h 8h]
ghosto69: bets €0.59
RRsanto: raises €3.13 to €3.72 and is all-in
vistex: folds 
ghosto69: calls €1.05 and is all-in
Uncalled bet (€2.08) returned to RRsanto
*** TURN *** [Ac 7h 8h] [5d]
*** RIVER *** [Ac 7h 8h 5d] [5s]
*** SHOW DOWN ***
ghosto69: shows [Ks Ad] (two pair, Aces and Fives)
RRsanto: shows [As 8s] (two pair, Aces and Eights)
RRsanto collected €3.86 from pot
*** SUMMARY ***
Total pot €4.08 | Rake €0.22 
Board [Ac 7h 8h 5d 5s]
Seat 1: caduceus369 (button) folded before Flop (didn't bet)
Seat 2: ghosto69 (small blind) showed [Ks Ad] and lost with two pair, Aces and Fives
Seat 3: GanchanS7 (big blind) folded before Flop
Seat 4: KilometroZer0 folded before Flop (didn't bet)
Seat 5: RRsanto showed [As 8s] and won (€3.86) with two pair, Aces and Eights
Seat 6: vistex folded on the Flop



PokerStars Zoom Hand #257997677891:  Hold'em No Limit (€0.01/€0.02) [ADM ID: M62BD3044A1E13PD] - 2025/10/04 19:56:30 CET [2025/10/04 13:56:30 ET]
Table 'Sirio' 6-max Seat #1 is the button
Seat 1: Topastro27 (€3.53 in chips) 
Seat 2: caduceus369 (€2.07 in chips) 
Seat 3: ivano747 (€2 in chips) 
Seat 4: emidio92 (€5.53 in chips) 
Seat 5: SidneyPrescott (€2.75 in chips) 
Seat 6: ADRIAN0_MEIS (€5.05 in chips) 
caduceus369: posts small blind €0.01
ivano747: posts big blind €0.02
*** HOLE CARDS ***
Dealt to caduceus369 [Tc Qs]
emidio92: folds 
SidneyPrescott: folds 
ADRIAN0_MEIS: raises €0.04 to €0.06
Topastro27: folds 
caduceus369: folds 
ivano747: folds 
Uncalled bet (€0.04) returned to ADRIAN0_MEIS
ADRIAN0_MEIS collected €0.05 from pot
ADRIAN0_MEIS: doesn't show hand 
*** SUMMARY ***
Total pot €0.05 | Rake €0 
Seat 1: Topastro27 (button) folded before Flop (didn't bet)
Seat 2: caduceus369 (small blind) folded before Flop
Seat 3: ivano747 (big blind) folded before Flop
Seat 4: emidio92 folded before Flop (didn't bet)
Seat 5: SidneyPrescott folded before Flop (didn't bet)
Seat 6: ADRIAN0_MEIS collected (€0.05)



PokerStars Zoom Hand #257997676784:  Hold'em No Limit (€0.01/€0.02) [ADM ID: M62BD3044A1E13PD] - 2025/10/04 19:56:22 CET [2025/10/04 13:56:22 ET]
Table 'Sirio' 6-max Seat #1 is the button
Seat 1: GanchanS7 (€2.97 in chips) 
Seat 2: LolloSpino (€1.27 in chips) 
Seat 3: manch73r (€2.96 in chips) 
Seat 4: caduceus369 (€2.07 in chips) 
Seat 5: ADRIAN0_MEIS (€6.41 in chips) 
Seat 6: Artemis1a (€5.24 in chips) 
LolloSpino: posts small blind €0.01
manch73r: posts big blind €0.02
*** HOLE CARDS ***
Dealt to caduceus369 [Ah Tc]
caduceus369: folds 
ADRIAN0_MEIS: folds 
Artemis1a: raises €0.04 to €0.06
GanchanS7: folds 
LolloSpino: folds 
manch73r: folds 
Uncalled bet (€0.04) returned to Artemis1a
Artemis1a collected €0.05 from pot
Artemis1a: doesn't show hand 
*** SUMMARY ***
Total pot €0.05 | Rake €0 
Seat 1: GanchanS7 (button) folded before Flop (didn't bet)
Seat 2: LolloSpino (small blind) folded before Flop
Seat 3: manch73r (big blind) folded before Flop
Seat 4: caduceus369 folded before Flop (didn't bet)
Seat 5: ADRIAN0_MEIS folded before Flop (didn't bet)
Seat 6: Artemis1a collected (€0.05)



PokerStars Zoom Hand #257997679334:  Hold'em No Limit (€0.01/€0.02) [ADM ID: M62BD3044A1E13PD] - 2025/10/04 19:56:40 CET [2025/10/04 13:56:40 ET]
Table 'Sirio' 6-max Seat #1 is the button
Seat 1: Gabrielefante (€3.04 in chips) 
Seat 2: ivano747 (€1.98 in chips) 
Seat 3: caduceus369 (€2.06 in chips) 
Seat 4: emidio92 (€4.33 in chips) 
Seat 5: MathMassacreX (€3.22 in chips) 
Seat 6: GanchanS7 (€2.97 in chips) 
ivano747: posts small blind €0.01
caduceus369: posts big blind €0.02
*** HOLE CARDS ***
Dealt to caduceus369 [Ac 3d]
emidio92: raises €0.03 to €0.05
MathMassacreX: folds 
GanchanS7: folds 
Gabrielefante: folds 
ivano747: folds 
caduceus369: calls €0.03
*** FLOP *** [Qc Kc Kh]
caduceus369: checks 
emidio92: bets €0.03
caduceus369: folds 
Uncalled bet (€0.03) returned to emidio92
emidio92 collected €0.11 from pot
emidio92: doesn't show hand 
*** SUMMARY ***
Total pot €0.11 | Rake €0 
Board [Qc Kc Kh]
Seat 1: Gabrielefante (button) folded before Flop (didn't bet)
Seat 2: ivano747 (small blind) folded before Flop
Seat 3: caduceus369 (big blind) folded on the Flop
Seat 4: emidio92 collected (€0.11)
Seat 5: MathMassacreX folded before Flop (didn't bet)
Seat 6: GanchanS7 folded before Flop (didn't bet)



PokerStars Zoom Hand #257997683017:  Hold'em No Limit (€0.01/€0.02) [ADM ID: M62BD3044A1E13PD] - 2025/10/04 19:57:06 CET [2025/10/04 13:57:06 ET]
Table 'Sirio' 6-max Seat #1 is the button
Seat 1: caduceus369 (€2.01 in chips) 
Seat 2: sisifo40 (€1 in chips) 
Seat 3: Artemis1a (€5.27 in chips) 
Seat 4: ROELLIRI972 (€1.07 in chips) 
Seat 5: zeruell (€0.87 in chips) 
Seat 6: Topastro27 (€3.52 in chips) 
sisifo40: posts small blind €0.01
Artemis1a: posts big blind €0.02
*** HOLE CARDS ***
Dealt to caduceus369 [7h Kh]
ROELLIRI972: folds 
zeruell: folds 
Topastro27: folds 
caduceus369: raises €0.04 to €0.06
sisifo40: folds 
Artemis1a: calls €0.04
*** FLOP *** [2c 4s Jh]
Artemis1a: checks 
caduceus369: checks 
*** TURN *** [2c 4s Jh] [Ac]
Artemis1a: checks 
caduceus369: bets €0.04
Artemis1a: folds 
Uncalled bet (€0.04) returned to caduceus369
caduceus369 collected €0.13 from pot
caduceus369: doesn't show hand 
*** SUMMARY ***
Total pot €0.13 | Rake €0 
Board [2c 4s Jh Ac]
Seat 1: caduceus369 (button) collected (€0.13)
Seat 2: sisifo40 (small blind) folded before Flop
Seat 3: Artemis1a (big blind) folded on the Turn
Seat 4: ROELLIRI972 folded before Flop (didn't bet)
Seat 5: zeruell folded before Flop (didn't bet)
Seat 6: Topastro27 folded before Flop (didn't bet)



PokerStars Zoom Hand #257997687434:  Hold'em No Limit (€0.01/€0.02) [ADM ID: M62BD3044A1E13PD] - 2025/10/04 19:57:37 CET [2025/10/04 13:57:37 ET]
Table 'Sirio' 6-max Seat #1 is the button
Seat 1: ADRIAN0_MEIS (€4.90 in chips) 
Seat 2: Warterror90 (€1.98 in chips) 
Seat 3: ROELLIRI972 (€1.06 in chips) 
Seat 4: Luciano300661 (€1.19 in chips) 
Seat 5: TurboMuletto (€1.11 in chips) 
Seat 6: caduceus369 (€2.08 in chips) 
Warterror90: posts small blind €0.01
ROELLIRI972: posts big blind €0.02
*** HOLE CARDS ***
Dealt to caduceus369 [2d 8h]
Luciano300661: folds 
TurboMuletto: folds 
caduceus369: folds 
ADRIAN0_MEIS: folds 
Warterror90: folds 
Uncalled bet (€0.01) returned to ROELLIRI972
ROELLIRI972 collected €0.02 from pot
ROELLIRI972: doesn't show hand 
*** SUMMARY ***
Total pot €0.02 | Rake €0 
Seat 1: ADRIAN0_MEIS (button) folded before Flop (didn't bet)
Seat 2: Warterror90 (small blind) folded before Flop
Seat 3: ROELLIRI972 (big blind) collected (€0.02)
Seat 4: Luciano300661 folded before Flop (didn't bet)
Seat 5: TurboMuletto folded before Flop (didn't bet)
Seat 6: caduceus369 folded before Flop (didn't bet)



PokerStars Zoom Hand #257997689465:  Hold'em No Limit (€0.01/€0.02) [ADM ID: M62BD3044A1E13PD] - 2025/10/04 19:57:51 CET [2025/10/04 13:57:51 ET]
Table 'Sirio' 6-max Seat #1 is the button
Seat 1: rounders121282 (€2.04 in chips) 
Seat 2: ADRIAN0_MEIS (€2.18 in chips) 
Seat 3: GanchanS7 (€2.25 in chips) 
Seat 4: Topastro27 (€3.44 in chips) 
Seat 5: caduceus369 (€2.08 in chips) 
Seat 6: Wunschgast (€3.24 in chips) 
ADRIAN0_MEIS: posts small blind €0.01
GanchanS7: posts big blind €0.02
*** HOLE CARDS ***
Dealt to caduceus369 [Qh Jc]
Topastro27: folds 
caduceus369: raises €0.04 to €0.06
Wunschgast: calls €0.06
rounders121282: calls €0.06
ADRIAN0_MEIS: folds 
GanchanS7: folds 
*** FLOP *** [Ad Ks 9h]
caduceus369: checks 
Wunschgast: checks 
rounders121282: checks 
*** TURN *** [Ad Ks 9h] [4c]
caduceus369: bets €0.04
Wunschgast: folds 
rounders121282: calls €0.04
*** RIVER *** [Ad Ks 9h 4c] [Kc]
caduceus369: bets €0.10
rounders121282: raises €0.48 to €0.58
caduceus369: folds 
Uncalled bet (€0.48) returned to rounders121282
rounders121282 collected €0.47 from pot
rounders121282: doesn't show hand 
*** SUMMARY ***
Total pot €0.49 | Rake €0.02 
Board [Ad Ks 9h 4c Kc]
Seat 1: rounders121282 (button) collected (€0.47)
Seat 2: ADRIAN0_MEIS (small blind) folded before Flop
Seat 3: GanchanS7 (big blind) folded before Flop
Seat 4: Topastro27 folded before Flop (didn't bet)
Seat 5: caduceus369 folded on the River
Seat 6: Wunschgast folded on the Turn



PokerStars Zoom Hand #257997698510:  Hold'em No Limit (€0.01/€0.02) [ADM ID: M62BD3044A1E13PD] - 2025/10/04 19:58:55 CET [2025/10/04 13:58:55 ET]
Table 'Sirio' 6-max Seat #1 is the button
Seat 1: ADRIAN0_MEIS (€4.82 in chips) 
Seat 2: caduceus369 (€2 in chips) 
Seat 3: Giuggiola64 (€0.90 in chips) 
Seat 4: Wunschgast (€3.15 in chips) 
Seat 5: GanchanS7 (€3.73 in chips) 
Seat 6: ghosto69 (€3.53 in chips) 
caduceus369: posts small blind €0.01
Giuggiola64: posts big blind €0.02
*** HOLE CARDS ***
Dealt to caduceus369 [7s 3d]
Wunschgast: folds 
GanchanS7: folds 
ghosto69: folds 
ADRIAN0_MEIS: folds 
caduceus369: folds 
Uncalled bet (€0.01) returned to Giuggiola64
Giuggiola64 collected €0.02 from pot
Giuggiola64: doesn't show hand 
*** SUMMARY ***
Total pot €0.02 | Rake €0 
Seat 1: ADRIAN0_MEIS (button) folded before Flop (didn't bet)
Seat 2: caduceus369 (small blind) folded before Flop
Seat 3: Giuggiola64 (big blind) collected (€0.02)
Seat 4: Wunschgast folded before Flop (didn't bet)
Seat 5: GanchanS7 folded before Flop (didn't bet)
Seat 6: ghosto69 folded before Flop (didn't bet)



PokerStars Zoom Hand #257997700792:  Hold'em No Limit (€0.01/€0.02) [ADM ID: M62BD3044A1E13PD] - 2025/10/04 19:59:11 CET [2025/10/04 13:59:11 ET]
Table 'Sirio' 6-max Seat #1 is the button
Seat 1: Giuggiola64 (€0.91 in chips) 
Seat 2: GanchanS7 (€4.08 in chips) 
Seat 3: caduceus369 (€2 in chips) 
Seat 4: Warterror90 (€2.19 in chips) 
Seat 5: Wunschgast (€3.15 in chips) 
Seat 6: emidio92 (€6.15 in chips) 
GanchanS7: posts small blind €0.01
caduceus369: posts big blind €0.02
*** HOLE CARDS ***
Dealt to caduceus369 [3c 6d]
Warterror90: folds 
Wunschgast: folds 
emidio92: folds 
Giuggiola64: folds 
GanchanS7: folds 
Uncalled bet (€0.01) returned to caduceus369
caduceus369 collected €0.02 from pot
caduceus369: doesn't show hand 
*** SUMMARY ***
Total pot €0.02 | Rake €0 
Seat 1: Giuggiola64 (button) folded before Flop (didn't bet)
Seat 2: GanchanS7 (small blind) folded before Flop
Seat 3: caduceus369 (big blind) collected (€0.02)
Seat 4: Warterror90 folded before Flop (didn't bet)
Seat 5: Wunschgast folded before Flop (didn't bet)
Seat 6: emidio92 folded before Flop (didn't bet)



PokerStars Zoom Hand #257997699973:  Hold'em No Limit (€0.01/€0.02) [ADM ID: M62BD3044A1E13PD] - 2025/10/04 19:59:05 CET [2025/10/04 13:59:05 ET]
Table 'Sirio' 6-max Seat #1 is the button
Seat 1: potodds1979 (€2 in chips) 
Seat 2: ADRIAN0_MEIS (€4.82 in chips) 
Seat 3: TurboMuletto (€1.07 in chips) 
Seat 4: caduceus369 (€2 in chips) 
Seat 5: Warterror90 (€2.19 in chips) 
Seat 6: LolloSpino (€1.10 in chips) 
ADRIAN0_MEIS: posts small blind €0.01
TurboMuletto: posts big blind €0.02
*** HOLE CARDS ***
Dealt to caduceus369 [As 2d]
caduceus369: folds 
Warterror90: folds 
LolloSpino: raises €0.02 to €0.04
potodds1979: folds 
ADRIAN0_MEIS: folds 
TurboMuletto: calls €0.02
*** FLOP *** [9h 5h 9c]
TurboMuletto: checks 
LolloSpino: checks 
*** TURN *** [9h 5h 9c] [2s]
TurboMuletto: bets €0.02
LolloSpino: calls €0.02
*** RIVER *** [9h 5h 9c 2s] [7d]
TurboMuletto: bets €0.08
LolloSpino: folds 
Uncalled bet (€0.08) returned to TurboMuletto
TurboMuletto collected €0.13 from pot
TurboMuletto: doesn't show hand 
*** SUMMARY ***
Total pot €0.13 | Rake €0 
Board [9h 5h 9c 2s 7d]
Seat 1: potodds1979 (button) folded before Flop (didn't bet)
Seat 2: ADRIAN0_MEIS (small blind) folded before Flop
Seat 3: TurboMuletto (big blind) collected (€0.13)
Seat 4: caduceus369 folded before Flop (didn't bet)
Seat 5: Warterror90 folded before Flop (didn't bet)
Seat 6: LolloSpino folded on the River



PokerStars Zoom Hand #257997697660:  Hold'em No Limit (€0.01/€0.02) [ADM ID: M62BD3044A1E13PD] - 2025/10/04 19:58:49 CET [2025/10/04 13:58:49 ET]
Table 'Sirio' 6-max Seat #1 is the button
Seat 1: SidneyPrescott (€7.42 in chips) 
Seat 2: Topastro27 (€3.41 in chips) 
Seat 3: ADRIAN0_MEIS (€6.29 in chips) 
Seat 4: ghosto69 (€1.53 in chips) 
Seat 5: caduceus369 (€2 in chips) 
Seat 6: RRsanto (€2.01 in chips) 
Topastro27: posts small blind €0.01
ADRIAN0_MEIS: posts big blind €0.02
*** HOLE CARDS ***
Dealt to caduceus369 [2h 5s]
ghosto69: folds 
caduceus369: folds 
RRsanto: raises €0.04 to €0.06
SidneyPrescott: folds 
Topastro27: folds 
ADRIAN0_MEIS: calls €0.04
*** FLOP *** [8d Ts 9d]
ADRIAN0_MEIS: checks 
RRsanto: bets €0.10
ADRIAN0_MEIS: calls €0.10
*** TURN *** [8d Ts 9d] [4c]
ADRIAN0_MEIS: checks 
RRsanto: bets €0.24
ADRIAN0_MEIS: calls €0.24
*** RIVER *** [8d Ts 9d 4c] [7d]
ADRIAN0_MEIS: checks 
RRsanto: checks 
*** SHOW DOWN ***
ADRIAN0_MEIS: shows [Td Ah] (a pair of Tens)
RRsanto: shows [As Ac] (a pair of Aces)
RRsanto collected €0.77 from pot
*** SUMMARY ***
Total pot €0.81 | Rake €0.04 
Board [8d Ts 9d 4c 7d]
Seat 1: SidneyPrescott (button) folded before Flop (didn't bet)
Seat 2: Topastro27 (small blind) folded before Flop
Seat 3: ADRIAN0_MEIS (big blind) showed [Td Ah] and lost with a pair of Tens
Seat 4: ghosto69 folded before Flop (didn't bet)
Seat 5: caduceus369 folded before Flop (didn't bet)
Seat 6: RRsanto showed [As Ac] and won (€0.77) with a pair of Aces



PokerStars Zoom Hand #257997703012:  Hold'em No Limit (€0.01/€0.02) [ADM ID: M62BD3044A1E13PD] - 2025/10/04 19:59:26 CET [2025/10/04 13:59:26 ET]
Table 'Sirio' 6-max Seat #1 is the button
Seat 1: caduceus369 (€2.01 in chips) 
Seat 2: potodds1979 (€2 in chips) 
Seat 3: vckjakcon97 (€1 in chips) 
Seat 4: Black98Demon (€2.49 in chips) 
Seat 5: jolli180 (€1.82 in chips) 
Seat 6: GanchanS7 (€3.73 in chips) 
potodds1979: posts small blind €0.01
vckjakcon97: posts big blind €0.02
*** HOLE CARDS ***
Dealt to caduceus369 [Js Ks]
Black98Demon: raises €0.03 to €0.05
jolli180: folds 
GanchanS7: folds 
caduceus369: raises €0.09 to €0.14
potodds1979: folds 
vckjakcon97: folds 
Black98Demon: folds 
Uncalled bet (€0.09) returned to caduceus369
caduceus369 collected €0.13 from pot
caduceus369: doesn't show hand 
*** SUMMARY ***
Total pot €0.13 | Rake €0 
Seat 1: caduceus369 (button) collected (€0.13)
Seat 2: potodds1979 (small blind) folded before Flop
Seat 3: vckjakcon97 (big blind) folded before Flop
Seat 4: Black98Demon folded before Flop
Seat 5: jolli180 folded before Flop (didn't bet)
Seat 6: GanchanS7 folded before Flop (didn't bet)



PokerStars Zoom Hand #257997705971:  Hold'em No Limit (€0.01/€0.02) [ADM ID: M62BD3044A1E13PD] - 2025/10/04 19:59:47 CET [2025/10/04 13:59:47 ET]
Table 'Sirio' 6-max Seat #1 is the button
Seat 1: TurboMuletto (€1.14 in chips) 
Seat 2: Wunschgast (€3.13 in chips) 
Seat 3: LolloSpino (€1.03 in chips) 
Seat 4: jolli180 (€1.80 in chips) 
Seat 5: ADRIAN0_MEIS (€5.02 in chips) 
Seat 6: caduceus369 (€2.09 in chips) 
Wunschgast: posts small blind €0.01
LolloSpino: posts big blind €0.02
*** HOLE CARDS ***
Dealt to caduceus369 [9s 5c]
jolli180: folds 
ADRIAN0_MEIS: folds 
caduceus369: folds 
TurboMuletto: folds 
Wunschgast: raises €0.04 to €0.06
LolloSpino: calls €0.04
*** FLOP *** [9c 2s 3d]
Wunschgast: checks 
LolloSpino: checks 
*** TURN *** [9c 2s 3d] [4d]
Wunschgast: checks 
LolloSpino: checks 
*** RIVER *** [9c 2s 3d 4d] [2h]
Wunschgast: checks 
LolloSpino: checks 
*** SHOW DOWN ***
Wunschgast: shows [Kh Qc] (a pair of Deuces)
LolloSpino: shows [Ac 8c] (a pair of Deuces - Ace kicker)
LolloSpino collected €0.12 from pot
*** SUMMARY ***
Total pot €0.12 | Rake €0 
Board [9c 2s 3d 4d 2h]
Seat 1: TurboMuletto (button) folded before Flop (didn't bet)
Seat 2: Wunschgast (small blind) showed [Kh Qc] and lost with a pair of Deuces
Seat 3: LolloSpino (big blind) showed [Ac 8c] and won (€0.12) with a pair of Deuces
Seat 4: jolli180 folded before Flop (didn't bet)
Seat 5: ADRIAN0_MEIS folded before Flop (didn't bet)
Seat 6: caduceus369 folded before Flop (didn't bet)



PokerStars Zoom Hand #257997706459:  Hold'em No Limit (€0.01/€0.02) [ADM ID: M62BD3044A1E13PD] - 2025/10/04 19:59:50 CET [2025/10/04 13:59:50 ET]
Table 'Sirio' 6-max Seat #1 is the button
Seat 1: ghosto69 (€3.50 in chips) 
Seat 2: jolli180 (€1.80 in chips) 
Seat 3: pylonstrip (€3.37 in chips) 
Seat 4: vistex (€1.86 in chips) 
Seat 5: caduceus369 (€2.09 in chips) 
Seat 6: Artemis1a (€5.23 in chips) 
jolli180: posts small blind €0.01
pylonstrip: posts big blind €0.02
*** HOLE CARDS ***
Dealt to caduceus369 [Ah As]
vistex: folds 
caduceus369: raises €0.04 to €0.06
Artemis1a: calls €0.06
ghosto69: folds 
jolli180: folds 
pylonstrip has timed out
pylonstrip: folds 
*** FLOP *** [7s 5s Tc]
caduceus369: checks 
Artemis1a: checks 
*** TURN *** [7s 5s Tc] [Qd]
caduceus369: checks 
Artemis1a: bets €0.15
caduceus369: calls €0.15
*** RIVER *** [7s 5s Tc Qd] [Ks]
caduceus369: bets €0.22
Artemis1a: calls €0.22
*** SHOW DOWN ***
caduceus369: shows [Ah As] (a pair of Aces)
Artemis1a: shows [Qh Kc] (two pair, Kings and Queens)
Artemis1a collected €0.85 from pot
*** SUMMARY ***
Total pot €0.89 | Rake €0.04 
Board [7s 5s Tc Qd Ks]
Seat 1: ghosto69 (button) folded before Flop (didn't bet)
Seat 2: jolli180 (small blind) folded before Flop
Seat 3: pylonstrip (big blind) folded before Flop
Seat 4: vistex folded before Flop (didn't bet)
Seat 5: caduceus369 showed [Ah As] and lost with a pair of Aces
Seat 6: Artemis1a showed [Qh Kc] and won (€0.85) with two pair, Kings and Queens



PokerStars Zoom Hand #257997722438:  Hold'em No Limit (€0.01/€0.02) [ADM ID: M62BD3044A1E13PD] - 2025/10/04 20:01:25 CET [2025/10/04 14:01:25 ET]
Table 'Sirio' 6-max Seat #1 is the button
Seat 1: RRsanto (€2 in chips) 
Seat 2: Black98Demon (€2.27 in chips) 
Seat 3: willydag94 (€1.16 in chips) 
Seat 4: caduceus369 (€2 in chips) 
Seat 5: GanchanS7 (€4.05 in chips) 
Seat 6: robertoH2O (€2.03 in chips) 
Black98Demon: posts small blind €0.01
willydag94: posts big blind €0.02
*** HOLE CARDS ***
Dealt to caduceus369 [Jc 2c]
caduceus369: folds 
GanchanS7 has timed out
GanchanS7: folds 
robertoH2O: folds 
RRsanto: folds 
Black98Demon: folds 
Uncalled bet (€0.01) returned to willydag94
willydag94 collected €0.02 from pot
willydag94: doesn't show hand 
*** SUMMARY ***
Total pot €0.02 | Rake €0 
Seat 1: RRsanto (button) folded before Flop (didn't bet)
Seat 2: Black98Demon (small blind) folded before Flop
Seat 3: willydag94 (big blind) collected (€0.02)
Seat 4: caduceus369 folded before Flop (didn't bet)
Seat 5: GanchanS7 folded before Flop (didn't bet)
Seat 6: robertoH2O folded before Flop (didn't bet)



PokerStars Zoom Hand #257997723994:  Hold'em No Limit (€0.01/€0.02) [ADM ID: M62BD3044A1E13PD] - 2025/10/04 20:01:33 CET [2025/10/04 14:01:33 ET]
Table 'Sirio' 6-max Seat #1 is the button
Seat 1: caduceus369 (€2 in chips) 
Seat 2: ADRIAN0_MEIS (€2.21 in chips) 
Seat 3: Ceribelli1705 (€1.10 in chips) 
Seat 4: KilometroZer0 (€2.66 in chips) 
Seat 5: robertoH2O (€2.03 in chips) 
Seat 6: sisifo40 (€1 in chips) 
ADRIAN0_MEIS: posts small blind €0.01
Ceribelli1705: posts big blind €0.02
*** HOLE CARDS ***
Dealt to caduceus369 [9h Kd]
KilometroZer0: folds 
robertoH2O: raises €0.03 to €0.05
sisifo40: folds 
caduceus369: folds 
ADRIAN0_MEIS: folds 
Ceribelli1705: folds 
Uncalled bet (€0.03) returned to robertoH2O
robertoH2O collected €0.05 from pot
robertoH2O: doesn't show hand 
*** SUMMARY ***
Total pot €0.05 | Rake €0 
Seat 1: caduceus369 (button) folded before Flop (didn't bet)
Seat 2: ADRIAN0_MEIS (small blind) folded before Flop
Seat 3: Ceribelli1705 (big blind) folded before Flop
Seat 4: KilometroZer0 folded before Flop (didn't bet)
Seat 5: robertoH2O collected (€0.05)
Seat 6: sisifo40 folded before Flop (didn't bet)



PokerStars Zoom Hand #257997723015:  Hold'em No Limit (€0.01/€0.02) [ADM ID: M62BD3044A1E13PD] - 2025/10/04 20:01:28 CET [2025/10/04 14:01:28 ET]
Table 'Sirio' 6-max Seat #1 is the button
Seat 1: Giuggiola64 (€0.73 in chips) 
Seat 2: caduceus369 (€2 in chips) 
Seat 3: LolloSpino (€2.99 in chips) 
Seat 4: Warterror90 (€1.92 in chips) 
Seat 5: GanchanS7 (€2.90 in chips) 
Seat 6: rounders121282 (€2.65 in chips) 
caduceus369: posts small blind €0.01
LolloSpino: posts big blind €0.02
*** HOLE CARDS ***
Dealt to caduceus369 [4h 9c]
Warterror90: folds 
GanchanS7: folds 
rounders121282: calls €0.02
Giuggiola64: folds 
caduceus369: folds 
LolloSpino: checks 
*** FLOP *** [Kh Ts Js]
LolloSpino: checks 
rounders121282: checks 
*** TURN *** [Kh Ts Js] [Jc]
LolloSpino: checks 
rounders121282: checks 
*** RIVER *** [Kh Ts Js Jc] [2c]
LolloSpino: checks 
rounders121282: checks 
*** SHOW DOWN ***
LolloSpino: shows [Ah 3s] (a pair of Jacks)
rounders121282: mucks hand 
LolloSpino collected €0.05 from pot
*** SUMMARY ***
Total pot €0.05 | Rake €0 
Board [Kh Ts Js Jc 2c]
Seat 1: Giuggiola64 (button) folded before Flop (didn't bet)
Seat 2: caduceus369 (small blind) folded before Flop
Seat 3: LolloSpino (big blind) showed [Ah 3s] and won (€0.05) with a pair of Jacks
Seat 4: Warterror90 folded before Flop (didn't bet)
Seat 5: GanchanS7 folded before Flop (didn't bet)
Seat 6: rounders121282 mucked [8s 7s]



PokerStars Zoom Hand #257997726199:  Hold'em No Limit (€0.01/€0.02) [ADM ID: M62BD3044A1E13PD] - 2025/10/04 20:01:44 CET [2025/10/04 14:01:44 ET]
Table 'Sirio' 6-max Seat #1 is the button
Seat 1: willydag94 (€1.17 in chips) 
Seat 2: ghosto69 (€1.15 in chips) 
Seat 3: caduceus369 (€2 in chips) 
Seat 4: ADRIAN0_MEIS (€5.84 in chips) 
Seat 5: emidio92 (€5.91 in chips) 
Seat 6: Wunschgast (€3.01 in chips) 
ghosto69: posts small blind €0.01
caduceus369: posts big blind €0.02
*** HOLE CARDS ***
Dealt to caduceus369 [6h 2s]
ADRIAN0_MEIS: folds 
emidio92: folds 
Wunschgast: folds 
willydag94: raises €0.03 to €0.05
ghosto69: folds 
caduceus369: folds 
Uncalled bet (€0.03) returned to willydag94
willydag94 collected €0.05 from pot
willydag94: doesn't show hand 
*** SUMMARY ***
Total pot €0.05 | Rake €0 
Seat 1: willydag94 (button) collected (€0.05)
Seat 2: ghosto69 (small blind) folded before Flop
Seat 3: caduceus369 (big blind) folded before Flop
Seat 4: ADRIAN0_MEIS folded before Flop (didn't bet)
Seat 5: emidio92 folded before Flop (didn't bet)
Seat 6: Wunschgast folded before Flop (didn't bet)



PokerStars Zoom Hand #257997728890:  Hold'em No Limit (€0.01/€0.02) [ADM ID: M62BD3044A1E13PD] - 2025/10/04 20:01:58 CET [2025/10/04 14:01:58 ET]
Table 'Sirio' 6-max Seat #1 is the button
Seat 1: KilometroZer0 (€2.64 in chips) 
Seat 2: Artemis1a (€2.05 in chips) 
Seat 3: Wunschgast (€3.01 in chips) 
Seat 4: Gabrielefante (€2.92 in chips) 
Seat 5: ADRIAN0_MEIS (€2.20 in chips) 
Seat 6: caduceus369 (€2 in chips) 
Artemis1a: posts small blind €0.01
Wunschgast: posts big blind €0.02
*** HOLE CARDS ***
Dealt to caduceus369 [3c Td]
Gabrielefante: folds 
ADRIAN0_MEIS: folds 
caduceus369: folds 
KilometroZer0: folds 
Artemis1a: folds 
Uncalled bet (€0.01) returned to Wunschgast
Wunschgast collected €0.02 from pot
Wunschgast: doesn't show hand 
*** SUMMARY ***
Total pot €0.02 | Rake €0 
Seat 1: KilometroZer0 (button) folded before Flop (didn't bet)
Seat 2: Artemis1a (small blind) folded before Flop
Seat 3: Wunschgast (big blind) collected (€0.02)
Seat 4: Gabrielefante folded before Flop (didn't bet)
Seat 5: ADRIAN0_MEIS folded before Flop (didn't bet)
Seat 6: caduceus369 folded before Flop (didn't bet)



PokerStars Zoom Hand #257997730447:  Hold'em No Limit (€0.01/€0.02) [ADM ID: M62BD3044A1E13PD] - 2025/10/04 20:02:05 CET [2025/10/04 14:02:05 ET]
Table 'Sirio' 6-max Seat #1 is the button
Seat 1: emidio92 (€2.03 in chips) 
Seat 2: Gabrielefante (€2.92 in chips) 
Seat 3: GanchanS7 (€2.21 in chips) 
Seat 4: willydag94 (€1.20 in chips) 
Seat 5: caduceus369 (€2 in chips) 
Seat 6: robertoH2O (€2.09 in chips) 
Gabrielefante: posts small blind €0.01
GanchanS7: posts big blind €0.02
*** HOLE CARDS ***
Dealt to caduceus369 [As 7s]
willydag94: folds 
caduceus369: raises €0.04 to €0.06
robertoH2O: folds 
emidio92: folds 
Gabrielefante: calls €0.05
GanchanS7: folds 
*** FLOP *** [Kh 8c Ad]
Gabrielefante: checks 
caduceus369: bets €0.09
Gabrielefante: folds 
Uncalled bet (€0.09) returned to caduceus369
caduceus369 collected €0.14 from pot
caduceus369: doesn't show hand 
*** SUMMARY ***
Total pot €0.14 | Rake €0 
Board [Kh 8c Ad]
Seat 1: emidio92 (button) folded before Flop (didn't bet)
Seat 2: Gabrielefante (small blind) folded on the Flop
Seat 3: GanchanS7 (big blind) folded before Flop
Seat 4: willydag94 folded before Flop (didn't bet)
Seat 5: caduceus369 collected (€0.14)
Seat 6: robertoH2O folded before Flop (didn't bet)



PokerStars Zoom Hand #257997737432:  Hold'em No Limit (€0.01/€0.02) [ADM ID: M62BD3044A1E13PD] - 2025/10/04 20:02:36 CET [2025/10/04 14:02:36 ET]
Table 'Sirio' 6-max Seat #1 is the button
Seat 1: willydag94 (€1.17 in chips) 
Seat 2: caduceus369 (€2.08 in chips) 
Seat 3: KilometroZer0 (€1.97 in chips) 
Seat 4: Giuggiola64 (€1.22 in chips) 
Seat 5: SaTheNuts_77 (€0.51 in chips) 
Seat 6: Artemis1a (€7.37 in chips) 
caduceus369: posts small blind €0.01
KilometroZer0: posts big blind €0.02
*** HOLE CARDS ***
Dealt to caduceus369 [Ah 5c]
Giuggiola64: folds 
SaTheNuts_77: folds 
Artemis1a: folds 
willydag94: folds 
caduceus369: raises €0.04 to €0.06
KilometroZer0: folds 
Uncalled bet (€0.04) returned to caduceus369
caduceus369 collected €0.04 from pot
caduceus369: doesn't show hand 
*** SUMMARY ***
Total pot €0.04 | Rake €0 
Seat 1: willydag94 (button) folded before Flop (didn't bet)
Seat 2: caduceus369 (small blind) collected (€0.04)
Seat 3: KilometroZer0 (big blind) folded before Flop
Seat 4: Giuggiola64 folded before Flop (didn't bet)
Seat 5: SaTheNuts_77 folded before Flop (didn't bet)
Seat 6: Artemis1a folded before Flop (didn't bet)



PokerStars Zoom Hand #257997741939:  Hold'em No Limit (€0.01/€0.02) [ADM ID: M62BD3044A1E13PD] - 2025/10/04 20:02:56 CET [2025/10/04 14:02:56 ET]
Table 'Sirio' 6-max Seat #1 is the button
Seat 1: KilometroZer0 (€1.95 in chips) 
Seat 2: emidio92 (€5.88 in chips) 
Seat 3: RRsanto (€2 in chips) 
Seat 4: caduceus369 (€2.10 in chips) 
Seat 5: ADRIAN0_MEIS (€5.23 in chips) 
Seat 6: Ceribelli1705 (€0.98 in chips) 
emidio92: posts small blind €0.01
RRsanto: posts big blind €0.02
*** HOLE CARDS ***
Dealt to caduceus369 [Ts Jh]
caduceus369: folds 
Ceribelli1705 is disconnected 
ADRIAN0_MEIS: folds 
Ceribelli1705 has timed out while disconnected
Ceribelli1705: folds 
KilometroZer0: folds 
emidio92: folds 
Uncalled bet (€0.01) returned to RRsanto
RRsanto collected €0.02 from pot
RRsanto: doesn't show hand 
*** SUMMARY ***
Total pot €0.02 | Rake €0 
Seat 1: KilometroZer0 (button) folded before Flop (didn't bet)
Seat 2: emidio92 (small blind) folded before Flop
Seat 3: RRsanto (big blind) collected (€0.02)
Seat 4: caduceus369 folded before Flop (didn't bet)
Seat 5: ADRIAN0_MEIS folded before Flop (didn't bet)
Seat 6: Ceribelli1705 folded before Flop (didn't bet)



PokerStars Zoom Hand #257997743328:  Hold'em No Limit (€0.01/€0.02) [ADM ID: M62BD3044A1E13PD] - 2025/10/04 20:03:02 CET [2025/10/04 14:03:02 ET]
Table 'Sirio' 6-max Seat #1 is the button
Seat 1: caduceus369 (€2.10 in chips) 
Seat 2: Wunschgast (€3.07 in chips) 
Seat 3: Warterror90 (€2 in chips) 
Seat 4: ghosto69 (€3.88 in chips) 
Seat 5: robertoH2O (€2.18 in chips) 
Seat 6: LolloSpino (€1.07 in chips) 
Wunschgast: posts small blind €0.01
Warterror90: posts big blind €0.02
*** HOLE CARDS ***
Dealt to caduceus369 [Kh Ts]
ghosto69: folds 
robertoH2O: folds 
LolloSpino: folds 
caduceus369: raises €0.04 to €0.06
Wunschgast: folds 
Warterror90: raises €0.17 to €0.23
caduceus369: folds 
Uncalled bet (€0.17) returned to Warterror90
Warterror90 collected €0.13 from pot
Warterror90: doesn't show hand 
*** SUMMARY ***
Total pot €0.13 | Rake €0 
Seat 1: caduceus369 (button) folded before Flop
Seat 2: Wunschgast (small blind) folded before Flop
Seat 3: Warterror90 (big blind) collected (€0.13)
Seat 4: ghosto69 folded before Flop (didn't bet)
Seat 5: robertoH2O folded before Flop (didn't bet)
Seat 6: LolloSpino folded before Flop (didn't bet)



PokerStars Zoom Hand #257997749804:  Hold'em No Limit (€0.01/€0.02) [ADM ID: M62BD3044A1E13PD] - 2025/10/04 20:03:32 CET [2025/10/04 14:03:32 ET]
Table 'Sirio' 6-max Seat #1 is the button
Seat 1: Luciano300661 (€2.03 in chips) 
Seat 2: LolloSpino (€1.05 in chips) 
Seat 3: caduceus369 (€2.04 in chips) 
Seat 4: rounders121282 (€4.16 in chips) 
Seat 5: KilometroZer0 (€3.15 in chips) 
Seat 6: Wunschgast (€3.04 in chips) 
LolloSpino: posts small blind €0.01
caduceus369: posts big blind €0.02
*** HOLE CARDS ***
Dealt to caduceus369 [4s 3c]
rounders121282: folds 
KilometroZer0: folds 
Wunschgast: folds 
Luciano300661: folds 
LolloSpino: folds 
Uncalled bet (€0.01) returned to caduceus369
caduceus369 collected €0.02 from pot
caduceus369: doesn't show hand 
*** SUMMARY ***
Total pot €0.02 | Rake €0 
Seat 1: Luciano300661 (button) folded before Flop (didn't bet)
Seat 2: LolloSpino (small blind) folded before Flop
Seat 3: caduceus369 (big blind) collected (€0.02)
Seat 4: rounders121282 folded before Flop (didn't bet)
Seat 5: KilometroZer0 folded before Flop (didn't bet)
Seat 6: Wunschgast folded before Flop (didn't bet)



PokerStars Zoom Hand #257997754366:  Hold'em No Limit (€0.01/€0.02) [ADM ID: M62BD3044A1E13PD] - 2025/10/04 20:03:53 CET [2025/10/04 14:03:53 ET]
Table 'Sirio' 6-max Seat #1 is the button
Seat 1: Artemis1a (€1.98 in chips) 
Seat 2: Warterror90 (€3.43 in chips) 
Seat 3: GanchanS7 (€2.91 in chips) 
Seat 4: KilometroZer0 (€3.15 in chips) 
Seat 5: Gabrielefante (€2.92 in chips) 
Seat 6: caduceus369 (€2.05 in chips) 
Warterror90: posts small blind €0.01
GanchanS7: posts big blind €0.02
*** HOLE CARDS ***
Dealt to caduceus369 [6h 5c]
KilometroZer0: folds 
Gabrielefante: raises €0.04 to €0.06
caduceus369: folds 
Artemis1a: raises €0.15 to €0.21
Warterror90: folds 
GanchanS7: folds 
Gabrielefante: folds 
Uncalled bet (€0.15) returned to Artemis1a
Artemis1a collected €0.15 from pot
Artemis1a: doesn't show hand 
*** SUMMARY ***
Total pot €0.15 | Rake €0 
Seat 1: Artemis1a (button) collected (€0.15)
Seat 2: Warterror90 (small blind) folded before Flop
Seat 3: GanchanS7 (big blind) folded before Flop
Seat 4: KilometroZer0 folded before Flop (didn't bet)
Seat 5: Gabrielefante folded before Flop
Seat 6: caduceus369 folded before Flop (didn't bet)



PokerStars Zoom Hand #257997761121:  Hold'em No Limit (€0.01/€0.02) [ADM ID: M62BD3044A1E13PD] - 2025/10/04 20:04:23 CET [2025/10/04 14:04:23 ET]
Table 'Sirio' 6-max Seat #1 is the button
Seat 1: vckjakcon97 (€1.95 in chips) 
Seat 2: Artemis1a (€2.07 in chips) 
Seat 3: caduceus369 (€2.04 in chips) 
Seat 4: potodds1979 (€2.03 in chips) 
Seat 5: Black98Demon (€3.12 in chips) 
Seat 6: SaTheNuts_77 (€0.58 in chips) 
Artemis1a: posts small blind €0.01
caduceus369: posts big blind €0.02
*** HOLE CARDS ***
Dealt to caduceus369 [2d 6h]
potodds1979: folds 
Black98Demon: folds 
SaTheNuts_77: raises €0.56 to €0.58 and is all-in
vckjakcon97: folds 
Artemis1a: folds 
caduceus369: folds 
Uncalled bet (€0.56) returned to SaTheNuts_77
SaTheNuts_77 collected €0.05 from pot
SaTheNuts_77: doesn't show hand 
*** SUMMARY ***
Total pot €0.05 | Rake €0 
Seat 1: vckjakcon97 (button) folded before Flop (didn't bet)
Seat 2: Artemis1a (small blind) folded before Flop
Seat 3: caduceus369 (big blind) folded before Flop
Seat 4: potodds1979 folded before Flop (didn't bet)
Seat 5: Black98Demon folded before Flop (didn't bet)
Seat 6: SaTheNuts_77 collected (€0.05)



PokerStars Zoom Hand #257997756614:  Hold'em No Limit (€0.01/€0.02) [ADM ID: M62BD3044A1E13PD] - 2025/10/04 20:04:03 CET [2025/10/04 14:04:03 ET]
Table 'Sirio' 6-max Seat #1 is the button
Seat 1: KilometroZer0 (€3.15 in chips) 
Seat 2: emidio92 (€10.23 in chips) 
Seat 3: vckjakcon97 (€1.98 in chips) 
Seat 4: LolloSpino (€1.03 in chips) 
Seat 5: caduceus369 (€2.05 in chips) 
Seat 6: ghosto69 (€3.93 in chips) 
emidio92: posts small blind €0.01
vckjakcon97: posts big blind €0.02
*** HOLE CARDS ***
Dealt to caduceus369 [Kd 9d]
LolloSpino: raises €0.02 to €0.04
caduceus369: folds 
ghosto69: folds 
KilometroZer0 has timed out
KilometroZer0: folds 
emidio92: raises €0.16 to €0.20
vckjakcon97: folds 
LolloSpino: folds 
Uncalled bet (€0.16) returned to emidio92
emidio92 collected €0.10 from pot
emidio92: doesn't show hand 
*** SUMMARY ***
Total pot €0.10 | Rake €0 
Seat 1: KilometroZer0 (button) folded before Flop (didn't bet)
Seat 2: emidio92 (small blind) collected (€0.10)
Seat 3: vckjakcon97 (big blind) folded before Flop
Seat 4: LolloSpino folded before Flop
Seat 5: caduceus369 folded before Flop (didn't bet)
Seat 6: ghosto69 folded before Flop (didn't bet)



PokerStars Zoom Hand #257997758173:  Hold'em No Limit (€0.01/€0.02) [ADM ID: M62BD3044A1E13PD] - 2025/10/04 20:04:10 CET [2025/10/04 14:04:10 ET]
Table 'Sirio' 6-max Seat #1 is the button
Seat 1: manch73r (€3.05 in chips) 
Seat 2: Artemis1a (€1.94 in chips) 
Seat 3: emidio92 (€2 in chips) 
Seat 4: caduceus369 (€2.05 in chips) 
Seat 5: potodds1979 (€2.03 in chips) 
Seat 6: Gionni483 (€4 in chips) 
Artemis1a: posts small blind €0.01
emidio92: posts big blind €0.02
*** HOLE CARDS ***
Dealt to caduceus369 [8h 3s]
caduceus369: folds 
potodds1979: folds 
Gionni483: calls €0.02
manch73r: folds 
Artemis1a: folds 
emidio92: checks 
*** FLOP *** [9s Ah Qh]
emidio92: bets €0.05
Gionni483: calls €0.05
*** TURN *** [9s Ah Qh] [7c]
emidio92: bets €0.15
Gionni483: raises €3.78 to €3.93 and is all-in
emidio92: calls €1.78 and is all-in
Uncalled bet (€2) returned to Gionni483
*** RIVER *** [9s Ah Qh 7c] [Jc]
*** SHOW DOWN ***
emidio92: shows [9c Qs] (two pair, Queens and Nines)
Gionni483: shows [7s Ad] (two pair, Aces and Sevens)
Gionni483 collected €3.79 from pot
*** SUMMARY ***
Total pot €4.01 | Rake €0.22 
Board [9s Ah Qh 7c Jc]
Seat 1: manch73r (button) folded before Flop (didn't bet)
Seat 2: Artemis1a (small blind) folded before Flop
Seat 3: emidio92 (big blind) showed [9c Qs] and lost with two pair, Queens and Nines
Seat 4: caduceus369 folded before Flop (didn't bet)
Seat 5: potodds1979 folded before Flop (didn't bet)
Seat 6: Gionni483 showed [7s Ad] and won (€3.79) with two pair, Aces and Sevens



PokerStars Zoom Hand #257997759053:  Hold'em No Limit (€0.01/€0.02) [ADM ID: M62BD3044A1E13PD] - 2025/10/04 20:04:13 CET [2025/10/04 14:04:13 ET]
Table 'Sirio' 6-max Seat #1 is the button
Seat 1: RRsanto (€2.26 in chips) 
Seat 2: caduceus369 (€2.05 in chips) 
Seat 3: manch73r (€3.05 in chips) 
Seat 4: GanchanS7 (€3.50 in chips) 
Seat 5: ghosto69 (€3.93 in chips) 
Seat 6: Giuggiola64 (€1.16 in chips) 
caduceus369: posts small blind €0.01
manch73r: posts big blind €0.02
*** HOLE CARDS ***
Dealt to caduceus369 [9s 8h]
GanchanS7 has timed out
GanchanS7: folds 
ghosto69: folds 
Giuggiola64: folds 
RRsanto: raises €0.04 to €0.06
caduceus369: folds 
manch73r: calls €0.04
*** FLOP *** [5s Qs 2c]
manch73r: checks 
RRsanto: checks 
*** TURN *** [5s Qs 2c] [7h]
manch73r: checks 
RRsanto: checks 
*** RIVER *** [5s Qs 2c 7h] [Jc]
manch73r: checks 
RRsanto: checks 
*** SHOW DOWN ***
manch73r: shows [3s 3h] (a pair of Threes)
RRsanto: mucks hand 
manch73r collected €0.13 from pot
*** SUMMARY ***
Total pot €0.13 | Rake €0 
Board [5s Qs 2c 7h Jc]
Seat 1: RRsanto (button) mucked [8d Td]
Seat 2: caduceus369 (small blind) folded before Flop
Seat 3: manch73r (big blind) showed [3s 3h] and won (€0.13) with a pair of Threes
Seat 4: GanchanS7 folded before Flop (didn't bet)
Seat 5: ghosto69 folded before Flop (didn't bet)
Seat 6: Giuggiola64 folded before Flop (didn't bet)



PokerStars Zoom Hand #257997759975:  Hold'em No Limit (€0.01/€0.02) [ADM ID: M62BD3044A1E13PD] - 2025/10/04 20:04:18 CET [2025/10/04 14:04:18 ET]
Table 'Sirio' 6-max Seat #1 is the button
Seat 1: Artemis1a (€7.25 in chips) 
Seat 2: Giuggiola64 (€1.16 in chips) 
Seat 3: eleonora50 (€1.50 in chips) 
Seat 4: caduceus369 (€2.04 in chips) 
Seat 5: vckjakcon97 (€1.95 in chips) 
Seat 6: Gabrielefante (€2.86 in chips) 
Giuggiola64: posts small blind €0.01
eleonora50: posts big blind €0.02
*** HOLE CARDS ***
Dealt to caduceus369 [3d 2s]
caduceus369: folds 
vckjakcon97: folds 
Gabrielefante: folds 
Artemis1a: folds 
Giuggiola64: calls €0.01
eleonora50: checks 
*** FLOP *** [7c 5s Jd]
Giuggiola64: checks 
eleonora50: checks 
*** TURN *** [7c 5s Jd] [4h]
Giuggiola64: checks 
eleonora50: checks 
*** RIVER *** [7c 5s Jd 4h] [8h]
Giuggiola64: checks 
eleonora50: checks 
*** SHOW DOWN ***
Giuggiola64: shows [Ad Qh] (high card Ace)
eleonora50: shows [4s 3c] (a pair of Fours)
eleonora50 collected €0.04 from pot
*** SUMMARY ***
Total pot €0.04 | Rake €0 
Board [7c 5s Jd 4h 8h]
Seat 1: Artemis1a (button) folded before Flop (didn't bet)
Seat 2: Giuggiola64 (small blind) showed [Ad Qh] and lost with high card Ace
Seat 3: eleonora50 (big blind) showed [4s 3c] and won (€0.04) with a pair of Fours
Seat 4: caduceus369 folded before Flop (didn't bet)
Seat 5: vckjakcon97 folded before Flop (didn't bet)
Seat 6: Gabrielefante folded before Flop (didn't bet)



PokerStars Zoom Hand #257997764291:  Hold'em No Limit (€0.01/€0.02) [ADM ID: M62BD3044A1E13PD] - 2025/10/04 20:04:37 CET [2025/10/04 14:04:37 ET]
Table 'Sirio' 6-max Seat #1 is the button
Seat 1: caduceus369 (€2.02 in chips) 
Seat 2: emidio92 (€6.13 in chips) 
Seat 3: Artemis1a (€2.06 in chips) 
Seat 4: SaTheNuts_77 (€0.61 in chips) 
Seat 5: KilometroZer0 (€2.33 in chips) 
Seat 6: robertoH2O (€2.37 in chips) 
emidio92: posts small blind €0.01
Artemis1a: posts big blind €0.02
*** HOLE CARDS ***
Dealt to caduceus369 [Qh Ah]
SaTheNuts_77: folds 
KilometroZer0 has timed out
KilometroZer0: folds 
robertoH2O: folds 
caduceus369: raises €0.04 to €0.06
emidio92: folds 
Artemis1a: folds 
Uncalled bet (€0.04) returned to caduceus369
caduceus369 collected €0.05 from pot
caduceus369: doesn't show hand 
*** SUMMARY ***
Total pot €0.05 | Rake €0 
Seat 1: caduceus369 (button) collected (€0.05)
Seat 2: emidio92 (small blind) folded before Flop
Seat 3: Artemis1a (big blind) folded before Flop
Seat 4: SaTheNuts_77 folded before Flop (didn't bet)
Seat 5: KilometroZer0 folded before Flop (didn't bet)
Seat 6: robertoH2O folded before Flop (didn't bet)



PokerStars Zoom Hand #257997774189:  Hold'em No Limit (€0.01/€0.02) [ADM ID: M62BD3044A1E13PD] - 2025/10/04 20:05:20 CET [2025/10/04 14:05:20 ET]
Table 'Sirio' 6-max Seat #1 is the button
Seat 1: caduceus369 (€2.04 in chips) 
Seat 2: Artemis1a (€1.91 in chips) 
Seat 3: Black98Demon (€2.21 in chips) 
Seat 4: jolli180 (€0.75 in chips) 
Seat 5: robertoH2O (€2.37 in chips) 
Seat 6: eleonora50 (€1.51 in chips) 
Artemis1a: posts small blind €0.01
Black98Demon: posts big blind €0.02
*** HOLE CARDS ***
Dealt to caduceus369 [5c Tc]
jolli180: folds 
robertoH2O: folds 
eleonora50: folds 
caduceus369: folds 
Artemis1a: folds 
Uncalled bet (€0.01) returned to Black98Demon
Black98Demon collected €0.02 from pot
Black98Demon: doesn't show hand 
*** SUMMARY ***
Total pot €0.02 | Rake €0 
Seat 1: caduceus369 (button) folded before Flop (didn't bet)
Seat 2: Artemis1a (small blind) folded before Flop
Seat 3: Black98Demon (big blind) collected (€0.02)
Seat 4: jolli180 folded before Flop (didn't bet)
Seat 5: robertoH2O folded before Flop (didn't bet)
Seat 6: eleonora50 folded before Flop (didn't bet)



PokerStars Zoom Hand #257997772125:  Hold'em No Limit (€0.01/€0.02) [ADM ID: M62BD3044A1E13PD] - 2025/10/04 20:05:11 CET [2025/10/04 14:05:11 ET]
Table 'Sirio' 6-max Seat #1 is the button
Seat 1: GanchanS7 (€2.91 in chips) 
Seat 2: caduceus369 (€2.05 in chips) 
Seat 3: jolli180 (€0.77 in chips) 
Seat 4: rounders121282 (€4.14 in chips) 
Seat 5: RRsanto (€2.17 in chips) 
Seat 6: Black98Demon (€2.21 in chips) 
caduceus369: posts small blind €0.01
jolli180: posts big blind €0.02
*** HOLE CARDS ***
Dealt to caduceus369 [9h 3h]
rounders121282: calls €0.02
RRsanto: raises €0.06 to €0.08
Black98Demon: folds 
GanchanS7: folds 
caduceus369: folds 
jolli180: folds 
rounders121282: calls €0.06
*** FLOP *** [6d 2s 4h]
rounders121282: checks 
RRsanto: bets €0.06
rounders121282: calls €0.06
*** TURN *** [6d 2s 4h] [6h]
rounders121282: checks 
RRsanto: bets €0.15
rounders121282: folds 
Uncalled bet (€0.15) returned to RRsanto
RRsanto collected €0.30 from pot
RRsanto: doesn't show hand 
*** SUMMARY ***
Total pot €0.31 | Rake €0.01 
Board [6d 2s 4h 6h]
Seat 1: GanchanS7 (button) folded before Flop (didn't bet)
Seat 2: caduceus369 (small blind) folded before Flop
Seat 3: jolli180 (big blind) folded before Flop
Seat 4: rounders121282 folded on the Turn
Seat 5: RRsanto collected (€0.30)
Seat 6: Black98Demon folded before Flop (didn't bet)



PokerStars Zoom Hand #257997770801:  Hold'em No Limit (€0.01/€0.02) [ADM ID: M62BD3044A1E13PD] - 2025/10/04 20:05:05 CET [2025/10/04 14:05:05 ET]
Table 'Sirio' 6-max Seat #1 is the button
Seat 1: Black98Demon (€2.21 in chips) 
Seat 2: RRsanto (€2.04 in chips) 
Seat 3: vistex (€3.61 in chips) 
Seat 4: ghosto69 (€3.85 in chips) 
Seat 5: Gionni483 (€5.78 in chips) 
Seat 6: caduceus369 (€2.05 in chips) 
RRsanto: posts small blind €0.01
vistex: posts big blind €0.02
*** HOLE CARDS ***
Dealt to caduceus369 [3h 7h]
ghosto69: folds 
Gionni483: calls €0.02
caduceus369: folds 
Black98Demon: folds 
RRsanto: folds 
vistex: checks 
*** FLOP *** [9d 9c Ks]
vistex: checks 
Gionni483: checks 
*** TURN *** [9d 9c Ks] [9s]
vistex: checks 
Gionni483: checks 
*** RIVER *** [9d 9c Ks 9s] [7s]
vistex: checks 
Gionni483: bets €0.05
vistex: folds 
Uncalled bet (€0.05) returned to Gionni483
Gionni483 collected €0.05 from pot
Gionni483: doesn't show hand 
*** SUMMARY ***
Total pot €0.05 | Rake €0 
Board [9d 9c Ks 9s 7s]
Seat 1: Black98Demon (button) folded before Flop (didn't bet)
Seat 2: RRsanto (small blind) folded before Flop
Seat 3: vistex (big blind) folded on the River
Seat 4: ghosto69 folded before Flop (didn't bet)
Seat 5: Gionni483 collected (€0.05)
Seat 6: caduceus369 folded before Flop (didn't bet)



PokerStars Zoom Hand #257997777583:  Hold'em No Limit (€0.01/€0.02) [ADM ID: M62BD3044A1E13PD] - 2025/10/04 20:05:35 CET [2025/10/04 14:05:35 ET]
Table 'Sirio' 6-max Seat #1 is the button
Seat 1: SaTheNuts_77 (€0.67 in chips) 
Seat 2: ghosto69 (€1.31 in chips) 
Seat 3: caduceus369 (€2.04 in chips) 
Seat 4: RRsanto (€2.06 in chips) 
Seat 5: Black98Demon (€2.22 in chips) 
Seat 6: GanchanS7 (€2.55 in chips) 
ghosto69: posts small blind €0.01
caduceus369: posts big blind €0.02
*** HOLE CARDS ***
Dealt to caduceus369 [As Qc]
RRsanto: folds 
Black98Demon: folds 
GanchanS7: folds 
SaTheNuts_77: folds 
ghosto69: folds 
Uncalled bet (€0.01) returned to caduceus369
caduceus369 collected €0.02 from pot
caduceus369: doesn't show hand 
*** SUMMARY ***
Total pot €0.02 | Rake €0 
Seat 1: SaTheNuts_77 (button) folded before Flop (didn't bet)
Seat 2: ghosto69 (small blind) folded before Flop
Seat 3: caduceus369 (big blind) collected (€0.02)
Seat 4: RRsanto folded before Flop (didn't bet)
Seat 5: Black98Demon folded before Flop (didn't bet)
Seat 6: GanchanS7 folded before Flop (didn't bet)



PokerStars Zoom Hand #257997780327:  Hold'em No Limit (€0.01/€0.02) [ADM ID: M62BD3044A1E13PD] - 2025/10/04 20:05:47 CET [2025/10/04 14:05:47 ET]
Table 'Sirio' 6-max Seat #1 is the button
Seat 1: Black98Demon (€2.22 in chips) 
Seat 2: GanchanS7 (€4 in chips) 
Seat 3: sisifo40 (€1.13 in chips) 
Seat 4: Artemis1a (€1.90 in chips) 
Seat 5: caduceus369 (€2.05 in chips) 
Seat 6: zeruell (€0.55 in chips) 
GanchanS7: posts small blind €0.01
sisifo40: posts big blind €0.02
*** HOLE CARDS ***
Dealt to caduceus369 [Th 7c]
Artemis1a: raises €0.05 to €0.07
caduceus369: folds 
zeruell: folds 
Black98Demon: folds 
GanchanS7: folds 
sisifo40: folds 
Uncalled bet (€0.05) returned to Artemis1a
Artemis1a collected €0.05 from pot
Artemis1a: doesn't show hand 
*** SUMMARY ***
Total pot €0.05 | Rake €0 
Seat 1: Black98Demon (button) folded before Flop (didn't bet)
Seat 2: GanchanS7 (small blind) folded before Flop
Seat 3: sisifo40 (big blind) folded before Flop
Seat 4: Artemis1a collected (€0.05)
Seat 5: caduceus369 folded before Flop (didn't bet)
Seat 6: zeruell folded before Flop (didn't bet)



PokerStars Zoom Hand #257997786050:  Hold'em No Limit (€0.01/€0.02) [ADM ID: M62BD3044A1E13PD] - 2025/10/04 20:06:12 CET [2025/10/04 14:06:12 ET]
Table 'Sirio' 6-max Seat #1 is the button
Seat 1: Wunschgast (€3.01 in chips) 
Seat 2: Black98Demon (€2.20 in chips) 
Seat 3: caduceus369 (€2.04 in chips) 
Seat 4: Artemis1a (€2.04 in chips) 
Seat 5: RRsanto (€2.30 in chips) 
Seat 6: Warterror90 (€2.25 in chips) 
Black98Demon: posts small blind €0.01
caduceus369: posts big blind €0.02
*** HOLE CARDS ***
Dealt to caduceus369 [4h 6d]
Artemis1a: folds 
RRsanto: folds 
Warterror90: raises €0.04 to €0.06
Wunschgast: folds 
Black98Demon: folds 
caduceus369: folds 
Uncalled bet (€0.04) returned to Warterror90
Warterror90 collected €0.05 from pot
Warterror90: doesn't show hand 
*** SUMMARY ***
Total pot €0.05 | Rake €0 
Seat 1: Wunschgast (button) folded before Flop (didn't bet)
Seat 2: Black98Demon (small blind) folded before Flop
Seat 3: caduceus369 (big blind) folded before Flop
Seat 4: Artemis1a folded before Flop (didn't bet)
Seat 5: RRsanto folded before Flop (didn't bet)
Seat 6: Warterror90 collected (€0.05)



PokerStars Zoom Hand #257997782837:  Hold'em No Limit (€0.01/€0.02) [ADM ID: M62BD3044A1E13PD] - 2025/10/04 20:05:58 CET [2025/10/04 14:05:58 ET]
Table 'Sirio' 6-max Seat #1 is the button
Seat 1: ghosto69 (€1.30 in chips) 
Seat 2: caduceus369 (€2.05 in chips) 
Seat 3: eleonora50 (€1.49 in chips) 
Seat 4: LolloSpino (€2.90 in chips) 
Seat 5: KilometroZer0 (€2.33 in chips) 
Seat 6: jolli180 (€0.77 in chips) 
caduceus369: posts small blind €0.01
eleonora50: posts big blind €0.02
*** HOLE CARDS ***
Dealt to caduceus369 [Td 6h]
LolloSpino: raises €0.02 to €0.04
KilometroZer0: folds 
jolli180: folds 
ghosto69: raises €0.02 to €0.06
caduceus369: folds 
eleonora50: folds 
LolloSpino: calls €0.02
*** FLOP *** [9d Jd 2c]
LolloSpino: checks 
ghosto69: bets €0.05
LolloSpino: calls €0.05
*** TURN *** [9d Jd 2c] [Qc]
LolloSpino: checks 
ghosto69: checks 
*** RIVER *** [9d Jd 2c Qc] [9c]
LolloSpino: checks 
ghosto69: checks 
*** SHOW DOWN ***
LolloSpino: shows [Jh Ks] (two pair, Jacks and Nines)
ghosto69: shows [Js Ad] (two pair, Jacks and Nines - Ace kicker)
ghosto69 collected €0.24 from pot
*** SUMMARY ***
Total pot €0.25 | Rake €0.01 
Board [9d Jd 2c Qc 9c]
Seat 1: ghosto69 (button) showed [Js Ad] and won (€0.24) with two pair, Jacks and Nines
Seat 2: caduceus369 (small blind) folded before Flop
Seat 3: eleonora50 (big blind) folded before Flop
Seat 4: LolloSpino showed [Jh Ks] and lost with two pair, Jacks and Nines
Seat 5: KilometroZer0 folded before Flop (didn't bet)
Seat 6: jolli180 folded before Flop (didn't bet)



PokerStars Zoom Hand #257997781266:  Hold'em No Limit (€0.01/€0.02) [ADM ID: M62BD3044A1E13PD] - 2025/10/04 20:05:51 CET [2025/10/04 14:05:51 ET]
Table 'Sirio' 6-max Seat #1 is the button
Seat 1: emidio92 (€5.93 in chips) 
Seat 2: RRsanto (€2.04 in chips) 
Seat 3: manch73r (€3.08 in chips) 
Seat 4: Black98Demon (€2.22 in chips) 
Seat 5: Luciano300661 (€2.18 in chips) 
Seat 6: caduceus369 (€2.05 in chips) 
RRsanto: posts small blind €0.01
manch73r: posts big blind €0.02
*** HOLE CARDS ***
Dealt to caduceus369 [7h Ts]
Black98Demon: folds 
Luciano300661: folds 
caduceus369: folds 
emidio92: raises €0.03 to €0.05
RRsanto: folds 
manch73r: calls €0.03
*** FLOP *** [6h Qc Kd]
manch73r: checks 
emidio92: checks 
*** TURN *** [6h Qc Kd] [9c]
manch73r: checks 
emidio92: checks 
*** RIVER *** [6h Qc Kd 9c] [2s]
manch73r: checks 
emidio92: checks 
*** SHOW DOWN ***
manch73r: shows [7d 6d] (a pair of Sixes)
emidio92: shows [As 6s] (a pair of Sixes - Ace kicker)
emidio92 collected €0.11 from pot
*** SUMMARY ***
Total pot €0.11 | Rake €0 
Board [6h Qc Kd 9c 2s]
Seat 1: emidio92 (button) showed [As 6s] and won (€0.11) with a pair of Sixes
Seat 2: RRsanto (small blind) folded before Flop
Seat 3: manch73r (big blind) showed [7d 6d] and lost with a pair of Sixes
Seat 4: Black98Demon folded before Flop (didn't bet)
Seat 5: Luciano300661 folded before Flop (didn't bet)
Seat 6: caduceus369 folded before Flop (didn't bet)



PokerStars Zoom Hand #257997784627:  Hold'em No Limit (€0.01/€0.02) [ADM ID: M62BD3044A1E13PD] - 2025/10/04 20:06:06 CET [2025/10/04 14:06:06 ET]
Table 'Sirio' 6-max Seat #1 is the button
Seat 1: Giuggiola64 (€1.19 in chips) 
Seat 2: emidio92 (€2.09 in chips) 
Seat 3: Black98Demon (€3.45 in chips) 
Seat 4: caduceus369 (€2.04 in chips) 
Seat 5: GanchanS7 (€2.89 in chips) 
Seat 6: KilometroZer0 (€2.66 in chips) 
emidio92: posts small blind €0.01
Black98Demon: posts big blind €0.02
*** HOLE CARDS ***
Dealt to caduceus369 [3c 2s]
caduceus369: folds 
GanchanS7: folds 
KilometroZer0: folds 
Giuggiola64: calls €0.02
emidio92: folds 
Black98Demon: checks 
*** FLOP *** [2h 7h 9s]
Black98Demon: checks 
Giuggiola64: checks 
*** TURN *** [2h 7h 9s] [6s]
Black98Demon: checks 
Giuggiola64: checks 
*** RIVER *** [2h 7h 9s 6s] [Td]
Black98Demon: checks 
Giuggiola64: bets €0.04
Black98Demon: folds 
Uncalled bet (€0.04) returned to Giuggiola64
Giuggiola64 collected €0.05 from pot
Giuggiola64: doesn't show hand 
*** SUMMARY ***
Total pot €0.05 | Rake €0 
Board [2h 7h 9s 6s Td]
Seat 1: Giuggiola64 (button) collected (€0.05)
Seat 2: emidio92 (small blind) folded before Flop
Seat 3: Black98Demon (big blind) folded on the River
Seat 4: caduceus369 folded before Flop (didn't bet)
Seat 5: GanchanS7 folded before Flop (didn't bet)
Seat 6: KilometroZer0 folded before Flop (didn't bet)



PokerStars Zoom Hand #257997788771:  Hold'em No Limit (€0.01/€0.02) [ADM ID: M62BD3044A1E13PD] - 2025/10/04 20:06:24 CET [2025/10/04 14:06:24 ET]
Table 'Sirio' 6-max Seat #1 is the button
Seat 1: vistex (€3.61 in chips) 
Seat 2: emidio92 (€10.24 in chips) 
Seat 3: vckjakcon97 (€1 in chips) 
Seat 4: Black98Demon (€2.19 in chips) 
Seat 5: Artemis1a (€1.93 in chips) 
Seat 6: caduceus369 (€2.02 in chips) 
emidio92: posts small blind €0.01
vckjakcon97: posts big blind €0.02
*** HOLE CARDS ***
Dealt to caduceus369 [7s 8d]
Black98Demon: folds 
Artemis1a: folds 
caduceus369: folds 
vistex: raises €0.04 to €0.06
emidio92: raises €0.18 to €0.24
vckjakcon97: folds 
vistex: calls €0.18
*** FLOP *** [9d 4c Td]
emidio92: bets €0.19
vistex: calls €0.19
*** TURN *** [9d 4c Td] [6d]
emidio92: checks 
vistex: checks 
*** RIVER *** [9d 4c Td 6d] [2d]
emidio92: checks 
vistex: checks 
*** SHOW DOWN ***
emidio92: shows [Th Jh] (a pair of Tens)
vistex: shows [Ks Qd] (a flush, Queen high)
vistex collected €0.84 from pot
*** SUMMARY ***
Total pot €0.88 | Rake €0.04 
Board [9d 4c Td 6d 2d]
Seat 1: vistex (button) showed [Ks Qd] and won (€0.84) with a flush, Queen high
Seat 2: emidio92 (small blind) showed [Th Jh] and lost with a pair of Tens
Seat 3: vckjakcon97 (big blind) folded before Flop
Seat 4: Black98Demon folded before Flop (didn't bet)
Seat 5: Artemis1a folded before Flop (didn't bet)
Seat 6: caduceus369 folded before Flop (didn't bet)



PokerStars Zoom Hand #257997790312:  Hold'em No Limit (€0.01/€0.02) [ADM ID: M62BD3044A1E13PD] - 2025/10/04 20:06:31 CET [2025/10/04 14:06:31 ET]
Table 'Sirio' 6-max Seat #1 is the button
Seat 1: caduceus369 (€2.02 in chips) 
Seat 2: Black98Demon (€3.43 in chips) 
Seat 3: GanchanS7 (€2.48 in chips) 
Seat 4: Artemis1a (€1.93 in chips) 
Seat 5: SaTheNuts_77 (€0.76 in chips) 
Seat 6: ghosto69 (€3.74 in chips) 
Black98Demon: posts small blind €0.01
GanchanS7: posts big blind €0.02
*** HOLE CARDS ***
Dealt to caduceus369 [3s 4d]
Artemis1a: raises €0.04 to €0.06
SaTheNuts_77: folds 
ghosto69: calls €0.06
caduceus369: folds 
Black98Demon: folds 
GanchanS7: folds 
*** FLOP *** [9h 7c Td]
Artemis1a: bets €0.08
ghosto69: calls €0.08
*** TURN *** [9h 7c Td] [Qs]
Artemis1a: checks 
ghosto69: checks 
*** RIVER *** [9h 7c Td Qs] [Qd]
Artemis1a: checks 
ghosto69: checks 
*** SHOW DOWN ***
Artemis1a: shows [8d 9d] (two pair, Queens and Nines)
ghosto69: mucks hand 
Artemis1a collected €0.30 from pot
*** SUMMARY ***
Total pot €0.31 | Rake €0.01 
Board [9h 7c Td Qs Qd]
Seat 1: caduceus369 (button) folded before Flop (didn't bet)
Seat 2: Black98Demon (small blind) folded before Flop
Seat 3: GanchanS7 (big blind) folded before Flop
Seat 4: Artemis1a showed [8d 9d] and won (€0.30) with two pair, Queens and Nines
Seat 5: SaTheNuts_77 folded before Flop (didn't bet)
Seat 6: ghosto69 mucked [8c Ac]



PokerStars Zoom Hand #257997792352:  Hold'em No Limit (€0.01/€0.02) [ADM ID: M62BD3044A1E13PD] - 2025/10/04 20:06:40 CET [2025/10/04 14:06:40 ET]
Table 'Sirio' 6-max Seat #1 is the button
Seat 1: Black98Demon (€3.42 in chips) 
Seat 2: MathMassacreX (€2.55 in chips) 
Seat 3: Wunschgast (€3 in chips) 
Seat 4: GanchanS7 (€2.46 in chips) 
Seat 5: caduceus369 (€2.02 in chips) 
Seat 6: Artemis1a (€2.03 in chips) 
MathMassacreX: posts small blind €0.01
Wunschgast: posts big blind €0.02
*** HOLE CARDS ***
Dealt to caduceus369 [4s 4h]
GanchanS7: raises €0.03 to €0.05
caduceus369: calls €0.05
Artemis1a: folds 
Black98Demon: folds 
MathMassacreX: folds 
Wunschgast: calls €0.03
*** FLOP *** [2h 6d 2d]
Wunschgast: checks 
GanchanS7: bets €0.11
caduceus369: folds 
Wunschgast: folds 
Uncalled bet (€0.11) returned to GanchanS7
GanchanS7 collected €0.16 from pot
GanchanS7: doesn't show hand 
*** SUMMARY ***
Total pot €0.16 | Rake €0 
Board [2h 6d 2d]
Seat 1: Black98Demon (button) folded before Flop (didn't bet)
Seat 2: MathMassacreX (small blind) folded before Flop
Seat 3: Wunschgast (big blind) folded on the Flop
Seat 4: GanchanS7 collected (€0.16)
Seat 5: caduceus369 folded on the Flop
Seat 6: Artemis1a folded before Flop (didn't bet)



PokerStars Zoom Hand #257997801449:  Hold'em No Limit (€0.01/€0.02) [ADM ID: M62BD3044A1E13PD] - 2025/10/04 20:07:20 CET [2025/10/04 14:07:20 ET]
Table 'Sirio' 6-max Seat #1 is the button
Seat 1: Gabrielefante (€2.67 in chips) 
Seat 2: SaTheNuts_77 (€1.47 in chips) 
Seat 3: Artemis1a (€6.59 in chips) 
Seat 4: RRsanto (€2.80 in chips) 
Seat 5: caduceus369 (€2 in chips) 
Seat 6: GanchanS7 (€2.57 in chips) 
SaTheNuts_77: posts small blind €0.01
Artemis1a: posts big blind €0.02
*** HOLE CARDS ***
Dealt to caduceus369 [4d 3h]
RRsanto: folds 
caduceus369: folds 
GanchanS7: folds 
Gabrielefante: folds 
SaTheNuts_77: folds 
Uncalled bet (€0.01) returned to Artemis1a
Artemis1a collected €0.02 from pot
Artemis1a: doesn't show hand 
*** SUMMARY ***
Total pot €0.02 | Rake €0 
Seat 1: Gabrielefante (button) folded before Flop (didn't bet)
Seat 2: SaTheNuts_77 (small blind) folded before Flop
Seat 3: Artemis1a (big blind) collected (€0.02)
Seat 4: RRsanto folded before Flop (didn't bet)
Seat 5: caduceus369 folded before Flop (didn't bet)
Seat 6: GanchanS7 folded before Flop (didn't bet)



PokerStars Zoom Hand #257997802535:  Hold'em No Limit (€0.01/€0.02) [ADM ID: M62BD3044A1E13PD] - 2025/10/04 20:07:25 CET [2025/10/04 14:07:25 ET]
Table 'Sirio' 6-max Seat #1 is the button
Seat 1: SaTheNuts_77 (€1.46 in chips) 
Seat 2: caduceus369 (€2 in chips) 
Seat 3: Warterror90 (€2.18 in chips) 
Seat 4: KilometroZer0 (€2.91 in chips) 
Seat 5: manch73r (€3.12 in chips) 
Seat 6: RRsanto (€2.80 in chips) 
caduceus369: posts small blind €0.01
Warterror90: posts big blind €0.02
*** HOLE CARDS ***
Dealt to caduceus369 [Kd Jc]
KilometroZer0: folds 
manch73r: folds 
RRsanto: folds 
SaTheNuts_77: folds 
caduceus369: folds 
Uncalled bet (€0.01) returned to Warterror90
Warterror90 collected €0.02 from pot
Warterror90: doesn't show hand 
*** SUMMARY ***
Total pot €0.02 | Rake €0 
Seat 1: SaTheNuts_77 (button) folded before Flop (didn't bet)
Seat 2: caduceus369 (small blind) folded before Flop
Seat 3: Warterror90 (big blind) collected (€0.02)
Seat 4: KilometroZer0 folded before Flop (didn't bet)
Seat 5: manch73r folded before Flop (didn't bet)
Seat 6: RRsanto folded before Flop (didn't bet)



PokerStars Zoom Hand #257997805612:  Hold'em No Limit (€0.01/€0.02) [ADM ID: M62BD3044A1E13PD] - 2025/10/04 20:07:39 CET [2025/10/04 14:07:39 ET]
Table 'Sirio' 6-max Seat #1 is the button
Seat 1: GanchanS7 (€2.56 in chips) 
Seat 2: Warterror90 (€3.49 in chips) 
Seat 3: Wunschgast (€2.94 in chips) 
Seat 4: caduceus369 (€2 in chips) 
Seat 5: Artemis1a (€2.04 in chips) 
Seat 6: RRsanto (€2.37 in chips) 
Warterror90: posts small blind €0.01
Wunschgast: posts big blind €0.02
*** HOLE CARDS ***
Dealt to caduceus369 [7c Js]
caduceus369: folds 
Artemis1a: folds 
RRsanto: folds 
GanchanS7: folds 
Warterror90: folds 
Uncalled bet (€0.01) returned to Wunschgast
Wunschgast collected €0.02 from pot
Wunschgast: doesn't show hand 
*** SUMMARY ***
Total pot €0.02 | Rake €0 
Seat 1: GanchanS7 (button) folded before Flop (didn't bet)
Seat 2: Warterror90 (small blind) folded before Flop
Seat 3: Wunschgast (big blind) collected (€0.02)
Seat 4: caduceus369 folded before Flop (didn't bet)
Seat 5: Artemis1a folded before Flop (didn't bet)
Seat 6: RRsanto folded before Flop (didn't bet)



PokerStars Zoom Hand #257997808458:  Hold'em No Limit (€0.01/€0.02) [ADM ID: M62BD3044A1E13PD] - 2025/10/04 20:07:52 CET [2025/10/04 14:07:52 ET]
Table 'Sirio' 6-max Seat #1 is the button
Seat 1: Warterror90 (€3.48 in chips) 
Seat 2: Artemis1a (€2.04 in chips) 
Seat 3: caduceus369 (€2 in chips) 
Seat 4: KilometroZer0 (€1.66 in chips) 
Seat 5: vckjakcon97 (€1 in chips) 
Seat 6: LolloSpino (€0.89 in chips) 
Artemis1a: posts small blind €0.01
caduceus369: posts big blind €0.02
*** HOLE CARDS ***
Dealt to caduceus369 [3h 8d]
KilometroZer0: folds 
vckjakcon97: folds 
LolloSpino: folds 
Warterror90: folds 
Artemis1a: folds 
Uncalled bet (€0.01) returned to caduceus369
caduceus369 collected €0.02 from pot
caduceus369: doesn't show hand 
*** SUMMARY ***
Total pot €0.02 | Rake €0 
Seat 1: Warterror90 (button) folded before Flop (didn't bet)
Seat 2: Artemis1a (small blind) folded before Flop
Seat 3: caduceus369 (big blind) collected (€0.02)
Seat 4: KilometroZer0 folded before Flop (didn't bet)
Seat 5: vckjakcon97 folded before Flop (didn't bet)
Seat 6: LolloSpino folded before Flop (didn't bet)



PokerStars Zoom Hand #257997804549:  Hold'em No Limit (€0.01/€0.02) [ADM ID: M62BD3044A1E13PD] - 2025/10/04 20:07:34 CET [2025/10/04 14:07:34 ET]
Table 'Sirio' 6-max Seat #1 is the button
Seat 1: Artemis1a (€6.60 in chips) 
Seat 2: LolloSpino (€0.90 in chips) 
Seat 3: GanchanS7 (€2.88 in chips) 
Seat 4: Wunschgast (€2.94 in chips) 
Seat 5: RRsanto (€2.37 in chips) 
Seat 6: caduceus369 (€2 in chips) 
LolloSpino: posts small blind €0.01
GanchanS7: posts big blind €0.02
*** HOLE CARDS ***
Dealt to caduceus369 [4d Qs]
Wunschgast: folds 
RRsanto: folds 
caduceus369: folds 
Artemis1a: raises €0.06 to €0.08
LolloSpino: folds 
GanchanS7: calls €0.06
*** FLOP *** [7d Kd Ah]
GanchanS7: checks 
Artemis1a: bets €0.17
GanchanS7: calls €0.17
*** TURN *** [7d Kd Ah] [Jh]
GanchanS7: checks 
Artemis1a: bets €0.49
GanchanS7: folds 
Uncalled bet (€0.49) returned to Artemis1a
Artemis1a collected €0.49 from pot
Artemis1a: doesn't show hand 
*** SUMMARY ***
Total pot €0.51 | Rake €0.02 
Board [7d Kd Ah Jh]
Seat 1: Artemis1a (button) collected (€0.49)
Seat 2: LolloSpino (small blind) folded before Flop
Seat 3: GanchanS7 (big blind) folded on the Turn
Seat 4: Wunschgast folded before Flop (didn't bet)
Seat 5: RRsanto folded before Flop (didn't bet)
Seat 6: caduceus369 folded before Flop (didn't bet)



PokerStars Zoom Hand #257997812997:  Hold'em No Limit (€0.01/€0.02) [ADM ID: M62BD3044A1E13PD] - 2025/10/04 20:08:12 CET [2025/10/04 14:08:12 ET]
Table 'Sirio' 6-max Seat #1 is the button
Seat 1: caduceus369 (€2.01 in chips) 
Seat 2: GanchanS7 (€3.44 in chips) 
Seat 3: ghosto69 (€1.49 in chips) 
Seat 4: emidio92 (€10.19 in chips) 
Seat 5: SaTheNuts_77 (€1.52 in chips) 
Seat 6: potodds1979 (€2 in chips) 
GanchanS7: posts small blind €0.01
ghosto69: posts big blind €0.02
*** HOLE CARDS ***
Dealt to caduceus369 [3h 5c]
emidio92: folds 
SaTheNuts_77: folds 
potodds1979: raises €0.04 to €0.06
caduceus369: folds 
GanchanS7: folds 
ghosto69: folds 
Uncalled bet (€0.04) returned to potodds1979
potodds1979 collected €0.05 from pot
potodds1979: doesn't show hand 
*** SUMMARY ***
Total pot €0.05 | Rake €0 
Seat 1: caduceus369 (button) folded before Flop (didn't bet)
Seat 2: GanchanS7 (small blind) folded before Flop
Seat 3: ghosto69 (big blind) folded before Flop
Seat 4: emidio92 folded before Flop (didn't bet)
Seat 5: SaTheNuts_77 folded before Flop (didn't bet)
Seat 6: potodds1979 collected (€0.05)



PokerStars Zoom Hand #257997811893:  Hold'em No Limit (€0.01/€0.02) [ADM ID: M62BD3044A1E13PD] - 2025/10/04 20:08:07 CET [2025/10/04 14:08:07 ET]
Table 'Sirio' 6-max Seat #1 is the button
Seat 1: RRsanto (€2.73 in chips) 
Seat 2: emidio92 (€2 in chips) 
Seat 3: Black98Demon (€3.76 in chips) 
Seat 4: caduceus369 (€2.01 in chips) 
Seat 5: potodds1979 (€2 in chips) 
Seat 6: SaTheNuts_77 (€1.52 in chips) 
emidio92: posts small blind €0.01
Black98Demon: posts big blind €0.02
*** HOLE CARDS ***
Dealt to caduceus369 [2h Qc]
caduceus369: folds 
potodds1979: folds 
SaTheNuts_77: folds 
RRsanto: raises €0.04 to €0.06
emidio92: raises €0.18 to €0.24
Black98Demon: folds 
RRsanto: calls €0.18
*** FLOP *** [As Qs Js]
emidio92: bets €0.36
RRsanto: folds 
Uncalled bet (€0.36) returned to emidio92
emidio92 collected €0.48 from pot
emidio92: doesn't show hand 
*** SUMMARY ***
Total pot €0.50 | Rake €0.02 
Board [As Qs Js]
Seat 1: RRsanto (button) folded on the Flop
Seat 2: emidio92 (small blind) collected (€0.48)
Seat 3: Black98Demon (big blind) folded before Flop
Seat 4: caduceus369 folded before Flop (didn't bet)
Seat 5: potodds1979 folded before Flop (didn't bet)
Seat 6: SaTheNuts_77 folded before Flop (didn't bet)



PokerStars Zoom Hand #257997815344:  Hold'em No Limit (€0.01/€0.02) [ADM ID: M62BD3044A1E13PD] - 2025/10/04 20:08:22 CET [2025/10/04 14:08:22 ET]
Table 'Sirio' 6-max Seat #1 is the button
Seat 1: vistex (€4.42 in chips) 
Seat 2: LolloSpino (€2.68 in chips) 
Seat 3: sisifo40 (€1.03 in chips) 
Seat 4: Artemis1a (€5.37 in chips) 
Seat 5: caduceus369 (€2.01 in chips) 
Seat 6: emidio92 (€5.90 in chips) 
LolloSpino: posts small blind €0.01
sisifo40: posts big blind €0.02
*** HOLE CARDS ***
Dealt to caduceus369 [4c As]
Artemis1a: folds 
caduceus369: folds 
emidio92: folds 
vistex: calls €0.02
LolloSpino has timed out while disconnected
LolloSpino: folds 
sisifo40: checks 
*** FLOP *** [7h Qd Qh]
sisifo40: checks 
vistex: bets €0.04
sisifo40: folds 
Uncalled bet (€0.04) returned to vistex
vistex collected €0.05 from pot
vistex: doesn't show hand 
*** SUMMARY ***
Total pot €0.05 | Rake €0 
Board [7h Qd Qh]
Seat 1: vistex (button) collected (€0.05)
Seat 2: LolloSpino (small blind) folded before Flop
Seat 3: sisifo40 (big blind) folded on the Flop
Seat 4: Artemis1a folded before Flop (didn't bet)
Seat 5: caduceus369 folded before Flop (didn't bet)
Seat 6: emidio92 folded before Flop (didn't bet)



PokerStars Zoom Hand #257997816871:  Hold'em No Limit (€0.01/€0.02) [ADM ID: M62BD3044A1E13PD] - 2025/10/04 20:08:29 CET [2025/10/04 14:08:29 ET]
Table 'Sirio' 6-max Seat #1 is the button
Seat 1: ghosto69 (€3.63 in chips) 
Seat 2: caduceus369 (€2.01 in chips) 
Seat 3: Artemis1a (€5.37 in chips) 
Seat 4: ADRIAN0_MEIS (€5.81 in chips) 
Seat 5: GanchanS7 (€2.63 in chips) 
Seat 6: Wunschgast (€2.86 in chips) 
caduceus369: posts small blind €0.01
Artemis1a: posts big blind €0.02
*** HOLE CARDS ***
Dealt to caduceus369 [Qs 8d]
ADRIAN0_MEIS: folds 
GanchanS7: folds 
Wunschgast: raises €0.04 to €0.06
ghosto69: folds 
caduceus369: folds 
Artemis1a: calls €0.04
*** FLOP *** [5d 8s 6h]
Artemis1a: checks 
Wunschgast: checks 
*** TURN *** [5d 8s 6h] [6s]
Artemis1a: checks 
Wunschgast: checks 
*** RIVER *** [5d 8s 6h 6s] [Jh]
Artemis1a: bets €0.13
Wunschgast: folds 
Uncalled bet (€0.13) returned to Artemis1a
Artemis1a collected €0.13 from pot
Artemis1a: doesn't show hand 
*** SUMMARY ***
Total pot €0.13 | Rake €0 
Board [5d 8s 6h 6s Jh]
Seat 1: ghosto69 (button) folded before Flop (didn't bet)
Seat 2: caduceus369 (small blind) folded before Flop
Seat 3: Artemis1a (big blind) collected (€0.13)
Seat 4: ADRIAN0_MEIS folded before Flop (didn't bet)
Seat 5: GanchanS7 folded before Flop (didn't bet)
Seat 6: Wunschgast folded on the River



PokerStars Zoom Hand #257997819850:  Hold'em No Limit (€0.01/€0.02) [ADM ID: M62BD3044A1E13PD] - 2025/10/04 20:08:42 CET [2025/10/04 14:08:42 ET]
Table 'Sirio' 6-max Seat #1 is the button
Seat 1: Artemis1a (€1.97 in chips) 
Seat 2: ghosto69 (€3.63 in chips) 
Seat 3: caduceus369 (€2 in chips) 
Seat 4: ADRIAN0_MEIS (€5.23 in chips) 
Seat 5: RRsanto (€2.49 in chips) 
Seat 6: GanchanS7 (€3.97 in chips) 
ghosto69: posts small blind €0.01
caduceus369: posts big blind €0.02
*** HOLE CARDS ***
Dealt to caduceus369 [Ts 6h]
ADRIAN0_MEIS: folds 
RRsanto: raises €0.04 to €0.06
GanchanS7: calls €0.06
Artemis1a: folds 
ghosto69: folds 
caduceus369: folds 
*** FLOP *** [8s Ks 7h]
RRsanto: bets €0.05
GanchanS7: calls €0.05
*** TURN *** [8s Ks 7h] [8d]
RRsanto: checks 
GanchanS7: bets €0.06
RRsanto: folds 
Uncalled bet (€0.06) returned to GanchanS7
GanchanS7 collected €0.24 from pot
GanchanS7: doesn't show hand 
*** SUMMARY ***
Total pot €0.25 | Rake €0.01 
Board [8s Ks 7h 8d]
Seat 1: Artemis1a (button) folded before Flop (didn't bet)
Seat 2: ghosto69 (small blind) folded before Flop
Seat 3: caduceus369 (big blind) folded before Flop
Seat 4: ADRIAN0_MEIS folded before Flop (didn't bet)
Seat 5: RRsanto folded on the Turn
Seat 6: GanchanS7 collected (€0.24)



PokerStars Zoom Hand #257997828339:  Hold'em No Limit (€0.01/€0.02) [ADM ID: M62BD3044A1E13PD] - 2025/10/04 20:09:20 CET [2025/10/04 14:09:20 ET]
Table 'Sirio' 6-max Seat #1 is the button
Seat 1: caduceus369 (€2 in chips) 
Seat 2: RRsanto (€2.26 in chips) 
Seat 3: Warterror90 (€2.44 in chips) 
Seat 4: robertoH2O (€2.67 in chips) 
Seat 5: eleonora50 (€1.34 in chips) 
Seat 6: emidio92 (€2.25 in chips) 
RRsanto: posts small blind €0.01
Warterror90: posts big blind €0.02
*** HOLE CARDS ***
Dealt to caduceus369 [8s 2h]
robertoH2O: folds 
eleonora50: folds 
emidio92: raises €0.03 to €0.05
caduceus369: folds 
RRsanto: folds 
Warterror90: folds 
Uncalled bet (€0.03) returned to emidio92
emidio92 collected €0.05 from pot
emidio92: doesn't show hand 
*** SUMMARY ***
Total pot €0.05 | Rake €0 
Seat 1: caduceus369 (button) folded before Flop (didn't bet)
Seat 2: RRsanto (small blind) folded before Flop
Seat 3: Warterror90 (big blind) folded before Flop
Seat 4: robertoH2O folded before Flop (didn't bet)
Seat 5: eleonora50 folded before Flop (didn't bet)
Seat 6: emidio92 collected (€0.05)



PokerStars Zoom Hand #257997858031:  Hold'em No Limit (€0.01/€0.02) [ADM ID: M62BD3044A1E13PD] - 2025/10/04 20:11:32 CET [2025/10/04 14:11:32 ET]
Table 'Sirio' 6-max Seat #1 is the button
Seat 1: ghosto69 (€1.43 in chips) 
Seat 2: IKARO_3 (€1.98 in chips) 
Seat 3: GanchanS7 (€3.44 in chips) 
Seat 4: caduceus369 (€2 in chips) 
Seat 5: jolli180 (€0.41 in chips) 
Seat 6: SaTheNuts_77 (€1.71 in chips) 
IKARO_3: posts small blind €0.01
GanchanS7: posts big blind €0.02
*** HOLE CARDS ***
Dealt to caduceus369 [3d Tc]
caduceus369: folds 
jolli180: folds 
SaTheNuts_77: folds 
ghosto69: folds 
IKARO_3: raises €0.04 to €0.06
GanchanS7: folds 
Uncalled bet (€0.04) returned to IKARO_3
IKARO_3 collected €0.04 from pot
IKARO_3: doesn't show hand 
*** SUMMARY ***
Total pot €0.04 | Rake €0 
Seat 1: ghosto69 (button) folded before Flop (didn't bet)
Seat 2: IKARO_3 (small blind) collected (€0.04)
Seat 3: GanchanS7 (big blind) folded before Flop
Seat 4: caduceus369 folded before Flop (didn't bet)
Seat 5: jolli180 folded before Flop (didn't bet)
Seat 6: SaTheNuts_77 folded before Flop (didn't bet)



PokerStars Zoom Hand #257997855074:  Hold'em No Limit (€0.01/€0.02) [ADM ID: M62BD3044A1E13PD] - 2025/10/04 20:11:19 CET [2025/10/04 14:11:19 ET]
Table 'Sirio' 6-max Seat #1 is the button
Seat 1: vckjakcon97 (€1.09 in chips) 
Seat 2: emidio92 (€6.09 in chips) 
Seat 3: Warterror90 (€2.65 in chips) 
Seat 4: panzapelata (€1.72 in chips) 
Seat 5: ROELLIRI972 (€0.71 in chips) 
Seat 6: caduceus369 (€2 in chips) 
emidio92: posts small blind €0.01
Warterror90: posts big blind €0.02
*** HOLE CARDS ***
Dealt to caduceus369 [7s 6h]
panzapelata: raises €0.04 to €0.06
ROELLIRI972: calls €0.06
caduceus369: folds 
vckjakcon97: folds 
emidio92: folds 
Warterror90: folds 
*** FLOP *** [4s 8d 2c]
panzapelata: bets €0.15
ROELLIRI972: raises €0.15 to €0.30
panzapelata: raises €1.36 to €1.66 and is all-in
ROELLIRI972: calls €0.35 and is all-in
Uncalled bet (€1.01) returned to panzapelata
*** TURN *** [4s 8d 2c] [3s]
*** RIVER *** [4s 8d 2c 3s] [Kc]
*** SHOW DOWN ***
panzapelata: shows [Ks Kd] (three of a kind, Kings)
ROELLIRI972: shows [7c 7d] (a pair of Sevens)
panzapelata collected €1.38 from pot
*** SUMMARY ***
Total pot €1.45 | Rake €0.07 
Board [4s 8d 2c 3s Kc]
Seat 1: vckjakcon97 (button) folded before Flop (didn't bet)
Seat 2: emidio92 (small blind) folded before Flop
Seat 3: Warterror90 (big blind) folded before Flop
Seat 4: panzapelata showed [Ks Kd] and won (€1.38) with three of a kind, Kings
Seat 5: ROELLIRI972 showed [7c 7d] and lost with a pair of Sevens
Seat 6: caduceus369 folded before Flop (didn't bet)



PokerStars Zoom Hand #257997856460:  Hold'em No Limit (€0.01/€0.02) [ADM ID: M62BD3044A1E13PD] - 2025/10/04 20:11:25 CET [2025/10/04 14:11:25 ET]
Table 'Sirio' 6-max Seat #1 is the button
Seat 1: _KKaneki_522 (€2.85 in chips) 
Seat 2: pallone1969 (€0.91 in chips) 
Seat 3: vckjakcon97 (€1.09 in chips) 
Seat 4: eleonora50 (€1.32 in chips) 
Seat 5: caduceus369 (€2 in chips) 
Seat 6: RRsanto (€2 in chips) 
pallone1969: posts small blind €0.01
vckjakcon97: posts big blind €0.02
*** HOLE CARDS ***
Dealt to caduceus369 [4d 9h]
eleonora50: folds 
caduceus369: folds 
RRsanto: folds 
_KKaneki_522: raises €0.02 to €0.04
pallone1969: folds 
vckjakcon97: calls €0.02
*** FLOP *** [8c 4h 6c]
vckjakcon97: bets €0.09
_KKaneki_522: raises €0.14 to €0.23
vckjakcon97: calls €0.14
*** TURN *** [8c 4h 6c] [5s]
vckjakcon97: bets €0.52
_KKaneki_522: folds 
Uncalled bet (€0.52) returned to vckjakcon97
vckjakcon97 collected €0.52 from pot
vckjakcon97: doesn't show hand 
*** SUMMARY ***
Total pot €0.55 | Rake €0.03 
Board [8c 4h 6c 5s]
Seat 1: _KKaneki_522 (button) folded on the Turn
Seat 2: pallone1969 (small blind) folded before Flop
Seat 3: vckjakcon97 (big blind) collected (€0.52)
Seat 4: eleonora50 folded before Flop (didn't bet)
Seat 5: caduceus369 folded before Flop (didn't bet)
Seat 6: RRsanto folded before Flop (didn't bet)



PokerStars Zoom Hand #257997859758:  Hold'em No Limit (€0.01/€0.02) [ADM ID: M62BD3044A1E13PD] - 2025/10/04 20:11:39 CET [2025/10/04 14:11:39 ET]
Table 'Sirio' 6-max Seat #1 is the button
Seat 1: emidio92 (€2.35 in chips) 
Seat 2: caduceus369 (€2 in chips) 
Seat 3: potodds1979 (€2 in chips) 
Seat 4: ADRIAN0_MEIS (€5.17 in chips) 
Seat 5: darkodiablo (€1.16 in chips) 
Seat 6: panzapelata (€1.96 in chips) 
caduceus369: posts small blind €0.01
potodds1979: posts big blind €0.02
*** HOLE CARDS ***
Dealt to caduceus369 [Ts 3s]
ADRIAN0_MEIS: raises €0.03 to €0.05
darkodiablo: calls €0.05
panzapelata: calls €0.05
emidio92: folds 
caduceus369: folds 
potodds1979: raises €0.23 to €0.28
ADRIAN0_MEIS: folds 
darkodiablo: folds 
panzapelata: folds 
Uncalled bet (€0.23) returned to potodds1979
potodds1979 collected €0.21 from pot
potodds1979: doesn't show hand 
*** SUMMARY ***
Total pot €0.21 | Rake €0 
Seat 1: emidio92 (button) folded before Flop (didn't bet)
Seat 2: caduceus369 (small blind) folded before Flop
Seat 3: potodds1979 (big blind) collected (€0.21)
Seat 4: ADRIAN0_MEIS folded before Flop
Seat 5: darkodiablo folded before Flop
Seat 6: panzapelata folded before Flop



PokerStars Zoom Hand #257997861909:  Hold'em No Limit (€0.01/€0.02) [ADM ID: M62BD3044A1E13PD] - 2025/10/04 20:11:49 CET [2025/10/04 14:11:49 ET]
Table 'Sirio' 6-max Seat #1 is the button
Seat 1: Luciano300661 (€0.33 in chips) 
Seat 2: Artemis1a (€5.39 in chips) 
Seat 3: emidio92 (€10.16 in chips) 
Seat 4: caduceus369 (€2 in chips) 
Seat 5: RRsanto (€2.05 in chips) 
Seat 6: vistex (€2.78 in chips) 
Artemis1a: posts small blind €0.01
emidio92: posts big blind €0.02
*** HOLE CARDS ***
Dealt to caduceus369 [3d 7c]
caduceus369: folds 
RRsanto: folds 
vistex: calls €0.02
Luciano300661: calls €0.02
Artemis1a: folds 
emidio92: checks 
*** FLOP *** [7s As 9c]
emidio92: checks 
vistex: checks 
Luciano300661: checks 
*** TURN *** [7s As 9c] [Jh]
emidio92: checks 
vistex: checks 
Luciano300661: bets €0.02
emidio92: folds 
vistex: folds 
Uncalled bet (€0.02) returned to Luciano300661
Luciano300661 collected €0.07 from pot
Luciano300661: doesn't show hand 
*** SUMMARY ***
Total pot €0.07 | Rake €0 
Board [7s As 9c Jh]
Seat 1: Luciano300661 (button) collected (€0.07)
Seat 2: Artemis1a (small blind) folded before Flop
Seat 3: emidio92 (big blind) folded on the Turn
Seat 4: caduceus369 folded before Flop (didn't bet)
Seat 5: RRsanto folded before Flop (didn't bet)
Seat 6: vistex folded on the Turn



PokerStars Zoom Hand #257997863097:  Hold'em No Limit (€0.01/€0.02) [ADM ID: M62BD3044A1E13PD] - 2025/10/04 20:11:54 CET [2025/10/04 14:11:54 ET]
Table 'Sirio' 6-max Seat #1 is the button
Seat 1: ADRIAN0_MEIS (€5.03 in chips) 
Seat 2: Wunschgast (€2.66 in chips) 
Seat 3: caduceus369 (€2 in chips) 
Seat 4: GanchanS7 (€2.39 in chips) 
Seat 5: emidio92 (€2.35 in chips) 
Seat 6: panzapelata (€2.39 in chips) 
Wunschgast: posts small blind €0.01
caduceus369: posts big blind €0.02
*** HOLE CARDS ***
Dealt to caduceus369 [9d Ts]
GanchanS7: folds 
emidio92: folds 
panzapelata: raises €0.04 to €0.06
ADRIAN0_MEIS: folds 
Wunschgast: folds 
caduceus369: calls €0.04
*** FLOP *** [9c Jh 8c]
caduceus369: checks 
panzapelata: checks 
*** TURN *** [9c Jh 8c] [4c]
caduceus369: checks 
panzapelata: bets €0.07
caduceus369: calls €0.07
*** RIVER *** [9c Jh 8c 4c] [Qh]
caduceus369: bets €0.19
panzapelata: folds 
Uncalled bet (€0.19) returned to caduceus369
caduceus369 collected €0.26 from pot
caduceus369: doesn't show hand 
*** SUMMARY ***
Total pot €0.27 | Rake €0.01 
Board [9c Jh 8c 4c Qh]
Seat 1: ADRIAN0_MEIS (button) folded before Flop (didn't bet)
Seat 2: Wunschgast (small blind) folded before Flop
Seat 3: caduceus369 (big blind) collected (€0.26)
Seat 4: GanchanS7 folded before Flop (didn't bet)
Seat 5: emidio92 folded before Flop (didn't bet)
Seat 6: panzapelata folded on the River



PokerStars Zoom Hand #257997874287:  Hold'em No Limit (€0.01/€0.02) [ADM ID: M62BD3044A1E13PD] - 2025/10/04 20:12:44 CET [2025/10/04 14:12:44 ET]
Table 'Sirio' 6-max Seat #1 is the button
Seat 1: caduceus369 (€2.13 in chips) 
Seat 2: RRsanto (€2.05 in chips) 
Seat 3: potodds1979 (€2.07 in chips) 
Seat 4: Artemis1a (€5.36 in chips) 
Seat 5: vckjakcon97 (€1.39 in chips) 
Seat 6: Pier821 (€0.89 in chips) 
RRsanto: posts small blind €0.01
potodds1979: posts big blind €0.02
*** HOLE CARDS ***
Dealt to caduceus369 [6d 5s]
Artemis1a: folds 
vckjakcon97: folds 
Pier821: calls €0.02
caduceus369: folds 
RRsanto: folds 
potodds1979: raises €0.06 to €0.08
Pier821: calls €0.06
*** FLOP *** [3s 2d 8d]
potodds1979: bets €0.09
Pier821: folds 
Uncalled bet (€0.09) returned to potodds1979
potodds1979 collected €0.17 from pot
potodds1979: doesn't show hand 
*** SUMMARY ***
Total pot €0.17 | Rake €0 
Board [3s 2d 8d]
Seat 1: caduceus369 (button) folded before Flop (didn't bet)
Seat 2: RRsanto (small blind) folded before Flop
Seat 3: potodds1979 (big blind) collected (€0.17)
Seat 4: Artemis1a folded before Flop (didn't bet)
Seat 5: vckjakcon97 folded before Flop (didn't bet)
Seat 6: Pier821 folded on the Flop



PokerStars Zoom Hand #257997876352:  Hold'em No Limit (€0.01/€0.02) [ADM ID: M62BD3044A1E13PD] - 2025/10/04 20:12:53 CET [2025/10/04 14:12:53 ET]
Table 'Sirio' 6-max Seat #1 is the button
Seat 1: Warterror90 (€2.83 in chips) 
Seat 2: Artemis1a (€5.36 in chips) 
Seat 3: vistex (€2.74 in chips) 
Seat 4: IKARO_3 (€2.01 in chips) 
Seat 5: emidio92 (€2.37 in chips) 
Seat 6: caduceus369 (€2.13 in chips) 
Artemis1a: posts small blind €0.01
vistex: posts big blind €0.02
*** HOLE CARDS ***
Dealt to caduceus369 [Ad Qc]
IKARO_3: folds 
emidio92: folds 
caduceus369: raises €0.04 to €0.06
Warterror90: raises €0.12 to €0.18
Artemis1a: folds 
vistex: folds 
caduceus369: calls €0.12
*** FLOP *** [3d 3s As]
caduceus369: checks 
Warterror90: checks 
*** TURN *** [3d 3s As] [9h]
caduceus369: checks 
Warterror90: bets €0.13
caduceus369: calls €0.13
*** RIVER *** [3d 3s As 9h] [6d]
caduceus369: checks 
Warterror90: bets €0.64
caduceus369: calls €0.64
*** SHOW DOWN ***
Warterror90: shows [Kd Qs] (a pair of Threes)
caduceus369: shows [Ad Qc] (two pair, Aces and Threes)
caduceus369 collected €1.83 from pot
*** SUMMARY ***
Total pot €1.93 | Rake €0.10 
Board [3d 3s As 9h 6d]
Seat 1: Warterror90 (button) showed [Kd Qs] and lost with a pair of Threes
Seat 2: Artemis1a (small blind) folded before Flop
Seat 3: vistex (big blind) folded before Flop
Seat 4: IKARO_3 folded before Flop (didn't bet)
Seat 5: emidio92 folded before Flop (didn't bet)
Seat 6: caduceus369 showed [Ad Qc] and won (€1.83) with two pair, Aces and Threes



PokerStars Zoom Hand #257997893396:  Hold'em No Limit (€0.01/€0.02) [ADM ID: M62BD3044A1E13PD] - 2025/10/04 20:14:09 CET [2025/10/04 14:14:09 ET]
Table 'Sirio' 6-max Seat #1 is the button
Seat 1: emidio92 (€6.30 in chips) 
Seat 2: caduceus369 (€3.01 in chips) 
Seat 3: kAllSeMPRE73 (€1.16 in chips) 
Seat 4: Pier821 (€0.74 in chips) 
Seat 5: Wunschgast (€2.64 in chips) 
Seat 6: RRsanto (€2 in chips) 
caduceus369: posts small blind €0.01
kAllSeMPRE73: posts big blind €0.02
*** HOLE CARDS ***
Dealt to caduceus369 [4s Td]
Pier821: calls €0.02
Wunschgast: folds 
RRsanto: folds 
emidio92: folds 
caduceus369: folds 
kAllSeMPRE73: raises €1.14 to €1.16 and is all-in
Pier821: calls €0.72 and is all-in
Uncalled bet (€0.42) returned to kAllSeMPRE73
*** FLOP *** [7c Kh Qh]
*** TURN *** [7c Kh Qh] [Kc]
*** RIVER *** [7c Kh Qh Kc] [3d]
*** SHOW DOWN ***
kAllSeMPRE73: shows [Ad Qc] (two pair, Kings and Queens)
Pier821: shows [As 8h] (a pair of Kings)
kAllSeMPRE73 collected €1.41 from pot
*** SUMMARY ***
Total pot €1.49 | Rake €0.08 
Board [7c Kh Qh Kc 3d]
Seat 1: emidio92 (button) folded before Flop (didn't bet)
Seat 2: caduceus369 (small blind) folded before Flop
Seat 3: kAllSeMPRE73 (big blind) showed [Ad Qc] and won (€1.41) with two pair, Kings and Queens
Seat 4: Pier821 showed [As 8h] and lost with a pair of Kings
Seat 5: Wunschgast folded before Flop (didn't bet)
Seat 6: RRsanto folded before Flop (didn't bet)



PokerStars Zoom Hand #257997895561:  Hold'em No Limit (€0.01/€0.02) [ADM ID: M62BD3044A1E13PD] - 2025/10/04 20:14:19 CET [2025/10/04 14:14:19 ET]
Table 'Sirio' 6-max Seat #1 is the button
Seat 1: ghosto69 (€3.24 in chips) 
Seat 2: GanchanS7 (€2.40 in chips) 
Seat 3: panzapelata (€2.02 in chips) 
Seat 4: emidio92 (€6.07 in chips) 
Seat 5: caduceus369 (€3 in chips) 
Seat 6: ADRIAN0_MEIS (€2.31 in chips) 
GanchanS7: posts small blind €0.01
panzapelata: posts big blind €0.02
*** HOLE CARDS ***
Dealt to caduceus369 [3s 8d]
emidio92: folds 
caduceus369: folds 
ADRIAN0_MEIS: folds 
ghosto69: folds 
GanchanS7: folds 
Uncalled bet (€0.01) returned to panzapelata
panzapelata collected €0.02 from pot
panzapelata: doesn't show hand 
*** SUMMARY ***
Total pot €0.02 | Rake €0 
Seat 1: ghosto69 (button) folded before Flop (didn't bet)
Seat 2: GanchanS7 (small blind) folded before Flop
Seat 3: panzapelata (big blind) collected (€0.02)
Seat 4: emidio92 folded before Flop (didn't bet)
Seat 5: caduceus369 folded before Flop (didn't bet)
Seat 6: ADRIAN0_MEIS folded before Flop (didn't bet)



PokerStars Zoom Hand #257997899735:  Hold'em No Limit (€0.01/€0.02) [ADM ID: M62BD3044A1E13PD] - 2025/10/04 20:14:37 CET [2025/10/04 14:14:37 ET]
Table 'Sirio' 6-max Seat #1 is the button
Seat 1: Artemis1a (€8.93 in chips) 
Seat 2: kAllSeMPRE73 (€1.83 in chips) 
Seat 3: caduceus369 (€3 in chips) 
Seat 4: IKARO_3 (€2.02 in chips) 
Seat 5: emidio92 (€2.41 in chips) 
Seat 6: panzapelata (€2.53 in chips) 
kAllSeMPRE73: posts small blind €0.01
caduceus369: posts big blind €0.02
*** HOLE CARDS ***
Dealt to caduceus369 [Kd 4s]
IKARO_3: folds 
emidio92: folds 
panzapelata: raises €0.05 to €0.07
Artemis1a: folds 
kAllSeMPRE73: folds 
caduceus369: folds 
Uncalled bet (€0.05) returned to panzapelata
panzapelata collected €0.05 from pot
panzapelata: doesn't show hand 
*** SUMMARY ***
Total pot €0.05 | Rake €0 
Seat 1: Artemis1a (button) folded before Flop (didn't bet)
Seat 2: kAllSeMPRE73 (small blind) folded before Flop
Seat 3: caduceus369 (big blind) folded before Flop
Seat 4: IKARO_3 folded before Flop (didn't bet)
Seat 5: emidio92 folded before Flop (didn't bet)
Seat 6: panzapelata collected (€0.05)



PokerStars Zoom Hand #257997903568:  Hold'em No Limit (€0.01/€0.02) [ADM ID: M62BD3044A1E13PD] - 2025/10/04 20:14:54 CET [2025/10/04 14:14:54 ET]
Table 'Sirio' 6-max Seat #1 is the button
Seat 1: capzanetti444 (€1.06 in chips) 
Seat 2: panzapelata (€2.27 in chips) 
Seat 3: GanchanS7 (€2.60 in chips) 
Seat 4: emidio92 (€10.39 in chips) 
Seat 5: caduceus369 (€2.98 in chips) 
Seat 6: Orly811 (€0.91 in chips) 
panzapelata: posts small blind €0.01
GanchanS7: posts big blind €0.02
*** HOLE CARDS ***
Dealt to caduceus369 [Js Kd]
emidio92: folds 
caduceus369: raises €0.04 to €0.06
Orly811: calls €0.06
capzanetti444: calls €0.06
panzapelata: folds 
GanchanS7: folds 
*** FLOP *** [2c As 3s]
caduceus369: bets €0.10
Orly811: calls €0.10
capzanetti444: folds 
*** TURN *** [2c As 3s] [Ts]
caduceus369: checks 
Orly811: bets €0.75 and is all-in
caduceus369: folds 
Uncalled bet (€0.75) returned to Orly811
Orly811 collected €0.39 from pot
Orly811: doesn't show hand 
*** SUMMARY ***
Total pot €0.41 | Rake €0.02 
Board [2c As 3s Ts]
Seat 1: capzanetti444 (button) folded on the Flop
Seat 2: panzapelata (small blind) folded before Flop
Seat 3: GanchanS7 (big blind) folded before Flop
Seat 4: emidio92 folded before Flop (didn't bet)
Seat 5: caduceus369 folded on the Turn
Seat 6: Orly811 collected (€0.39)



PokerStars Zoom Hand #257997912881:  Hold'em No Limit (€0.01/€0.02) [ADM ID: M62BD3044A1E13PD] - 2025/10/04 20:15:35 CET [2025/10/04 14:15:35 ET]
Table 'Sirio' 6-max Seat #1 is the button
Seat 1: IKARO_3 (€2.12 in chips) 
Seat 2: vckjakcon97 (€1.09 in chips) 
Seat 3: potodds1979 (€2 in chips) 
Seat 4: emidio92 (€2.46 in chips) 
Seat 5: ADRIAN0_MEIS (€4.04 in chips) 
Seat 6: caduceus369 (€2.82 in chips) 
vckjakcon97: posts small blind €0.01
potodds1979: posts big blind €0.02
*** HOLE CARDS ***
Dealt to caduceus369 [Ah 4s]
emidio92: folds 
ADRIAN0_MEIS: folds 
caduceus369: folds 
IKARO_3: folds 
vckjakcon97: folds 
Uncalled bet (€0.01) returned to potodds1979
potodds1979 collected €0.02 from pot
potodds1979: doesn't show hand 
*** SUMMARY ***
Total pot €0.02 | Rake €0 
Seat 1: IKARO_3 (button) folded before Flop (didn't bet)
Seat 2: vckjakcon97 (small blind) folded before Flop
Seat 3: potodds1979 (big blind) collected (€0.02)
Seat 4: emidio92 folded before Flop (didn't bet)
Seat 5: ADRIAN0_MEIS folded before Flop (didn't bet)
Seat 6: caduceus369 folded before Flop (didn't bet)



PokerStars Zoom Hand #257997911111:  Hold'em No Limit (€0.01/€0.02) [ADM ID: M62BD3044A1E13PD] - 2025/10/04 20:15:27 CET [2025/10/04 14:15:27 ET]
Table 'Sirio' 6-max Seat #1 is the button
Seat 1: caduceus369 (€2.82 in chips) 
Seat 2: robertoH2O (€3.14 in chips) 
Seat 3: ADRIAN0_MEIS (€5.08 in chips) 
Seat 4: darkodiablo (€1.48 in chips) 
Seat 5: emidio92 (€2.46 in chips) 
Seat 6: Wunschgast (€2.96 in chips) 
robertoH2O: posts small blind €0.01
ADRIAN0_MEIS: posts big blind €0.02
*** HOLE CARDS ***
Dealt to caduceus369 [7c Ts]
darkodiablo: calls €0.02
emidio92: folds 
Wunschgast: raises €0.04 to €0.06
caduceus369: folds 
robertoH2O: folds 
ADRIAN0_MEIS: folds 
darkodiablo: calls €0.04
*** FLOP *** [8d 6d Th]
darkodiablo: checks 
Wunschgast: bets €0.11
darkodiablo: folds 
Uncalled bet (€0.11) returned to Wunschgast
Wunschgast collected €0.15 from pot
Wunschgast: doesn't show hand 
*** SUMMARY ***
Total pot €0.15 | Rake €0 
Board [8d 6d Th]
Seat 1: caduceus369 (button) folded before Flop (didn't bet)
Seat 2: robertoH2O (small blind) folded before Flop
Seat 3: ADRIAN0_MEIS (big blind) folded before Flop
Seat 4: darkodiablo folded on the Flop
Seat 5: emidio92 folded before Flop (didn't bet)
Seat 6: Wunschgast collected (€0.15)



PokerStars Zoom Hand #257997914926:  Hold'em No Limit (€0.01/€0.02) [ADM ID: M62BD3044A1E13PD] - 2025/10/04 20:15:44 CET [2025/10/04 14:15:44 ET]
Table 'Sirio' 6-max Seat #1 is the button
Seat 1: gattapone81 (€1.17 in chips) 
Seat 2: trisco66 (€1.98 in chips) 
Seat 3: GIacius (€2 in chips) 
Seat 4: caduceus369 (€2.82 in chips) 
Seat 5: Pufface13 (€2.44 in chips) 
Seat 6: zeruell (€0.93 in chips) 
trisco66: posts small blind €0.01
GIacius: posts big blind €0.02
*** HOLE CARDS ***
Dealt to caduceus369 [Kh 9h]
caduceus369: raises €0.04 to €0.06
Pufface13: folds 
zeruell: folds 
gattapone81: calls €0.06
trisco66: folds 
GIacius: folds 
*** FLOP *** [Ad 3h 9c]
caduceus369: checks 
gattapone81: checks 
*** TURN *** [Ad 3h 9c] [Td]
caduceus369: checks 
gattapone81: checks 
*** RIVER *** [Ad 3h 9c Td] [Qc]
caduceus369: checks 
gattapone81: checks 
*** SHOW DOWN ***
caduceus369: shows [Kh 9h] (a pair of Nines)
gattapone81: mucks hand 
caduceus369 collected €0.15 from pot
*** SUMMARY ***
Total pot €0.15 | Rake €0 
Board [Ad 3h 9c Td Qc]
Seat 1: gattapone81 (button) mucked [Jh 4h]
Seat 2: trisco66 (small blind) folded before Flop
Seat 3: GIacius (big blind) folded before Flop
Seat 4: caduceus369 showed [Kh 9h] and won (€0.15) with a pair of Nines
Seat 5: Pufface13 folded before Flop (didn't bet)
Seat 6: zeruell folded before Flop (didn't bet)



PokerStars Zoom Hand #257997924837:  Hold'em No Limit (€0.01/€0.02) [ADM ID: M62BD3044A1E13PD] - 2025/10/04 20:16:27 CET [2025/10/04 14:16:27 ET]
Table 'Sirio' 6-max Seat #1 is the button
Seat 1: panzapelata (€0.60 in chips) 
Seat 2: caduceus369 (€2.91 in chips) 
Seat 3: ADRIAN0_MEIS (€5.05 in chips) 
Seat 4: zeruell (€0.90 in chips) 
Seat 5: Artemis1a (€2.51 in chips) 
Seat 6: IKARO_3 (€2.01 in chips) 
caduceus369: posts small blind €0.01
ADRIAN0_MEIS: posts big blind €0.02
*** HOLE CARDS ***
Dealt to caduceus369 [2c 3s]
zeruell: folds 
Artemis1a: raises €0.04 to €0.06
IKARO_3: folds 
panzapelata: folds 
caduceus369: folds 
ADRIAN0_MEIS: folds 
Uncalled bet (€0.04) returned to Artemis1a
Artemis1a collected €0.05 from pot
Artemis1a: doesn't show hand 
*** SUMMARY ***
Total pot €0.05 | Rake €0 
Seat 1: panzapelata (button) folded before Flop (didn't bet)
Seat 2: caduceus369 (small blind) folded before Flop
Seat 3: ADRIAN0_MEIS (big blind) folded before Flop
Seat 4: zeruell folded before Flop (didn't bet)
Seat 5: Artemis1a collected (€0.05)
Seat 6: IKARO_3 folded before Flop (didn't bet)



PokerStars Zoom Hand #257997927378:  Hold'em No Limit (€0.01/€0.02) [ADM ID: M62BD3044A1E13PD] - 2025/10/04 20:16:39 CET [2025/10/04 14:16:39 ET]
Table 'Sirio' 6-max Seat #1 is the button
Seat 1: de_toro_76 (€1.97 in chips) 
Seat 2: RRsanto (€2.01 in chips) 
Seat 3: IKARO_3 (€2.01 in chips) 
Seat 4: GIacius (€2 in chips) 
Seat 5: ADRIAN0_MEIS (€5.03 in chips) 
Seat 6: caduceus369 (€2.90 in chips) 
RRsanto: posts small blind €0.01
IKARO_3: posts big blind €0.02
*** HOLE CARDS ***
Dealt to caduceus369 [9h Qc]
GIacius: folds 
ADRIAN0_MEIS: raises €0.05 to €0.07
caduceus369: folds 
de_toro_76: folds 
RRsanto: folds 
IKARO_3: folds 
Uncalled bet (€0.05) returned to ADRIAN0_MEIS
ADRIAN0_MEIS collected €0.05 from pot
ADRIAN0_MEIS: doesn't show hand 
*** SUMMARY ***
Total pot €0.05 | Rake €0 
Seat 1: de_toro_76 (button) folded before Flop (didn't bet)
Seat 2: RRsanto (small blind) folded before Flop
Seat 3: IKARO_3 (big blind) folded before Flop
Seat 4: GIacius folded before Flop (didn't bet)
Seat 5: ADRIAN0_MEIS collected (€0.05)
Seat 6: caduceus369 folded before Flop (didn't bet)



PokerStars Zoom Hand #257997929176:  Hold'em No Limit (€0.01/€0.02) [ADM ID: M62BD3044A1E13PD] - 2025/10/04 20:16:47 CET [2025/10/04 14:16:47 ET]
Table 'Sirio' 6-max Seat #1 is the button
Seat 1: ghosto69 (€2.06 in chips) 
Seat 2: GanchanS7 (€2.58 in chips) 
Seat 3: caduceus369 (€2.90 in chips) 
Seat 4: trisco66 (€1.87 in chips) 
Seat 5: GIacius (€2 in chips) 
Seat 6: Artemis1a (€2.54 in chips) 
GanchanS7: posts small blind €0.01
caduceus369: posts big blind €0.02
*** HOLE CARDS ***
Dealt to caduceus369 [6s 3s]
trisco66: folds 
GIacius: folds 
Artemis1a: folds 
ghosto69: folds 
GanchanS7: folds 
Uncalled bet (€0.01) returned to caduceus369
caduceus369 collected €0.02 from pot
caduceus369: doesn't show hand 
*** SUMMARY ***
Total pot €0.02 | Rake €0 
Seat 1: ghosto69 (button) folded before Flop (didn't bet)
Seat 2: GanchanS7 (small blind) folded before Flop
Seat 3: caduceus369 (big blind) collected (€0.02)
Seat 4: trisco66 folded before Flop (didn't bet)
Seat 5: GIacius folded before Flop (didn't bet)
Seat 6: Artemis1a folded before Flop (didn't bet)



PokerStars Zoom Hand #257997932377:  Hold'em No Limit (€0.01/€0.02) [ADM ID: M62BD3044A1E13PD] - 2025/10/04 20:17:01 CET [2025/10/04 14:17:01 ET]
Table 'Sirio' 6-max Seat #1 is the button
Seat 1: rounders121282 (€3.53 in chips) 
Seat 2: Artemis1a (€8.83 in chips) 
Seat 3: Warterror90 (€1.65 in chips) 
Seat 4: darkodiablo (€1.36 in chips) 
Seat 5: caduceus369 (€2.91 in chips) 
Seat 6: emidio92 (€5.86 in chips) 
Artemis1a: posts small blind €0.01
Warterror90: posts big blind €0.02
*** HOLE CARDS ***
Dealt to caduceus369 [3c Qc]
darkodiablo: folds 
caduceus369: folds 
emidio92: folds 
rounders121282: calls €0.02
Artemis1a: folds 
Warterror90: checks 
*** FLOP *** [Qh Jd Qd]
Warterror90: checks 
rounders121282: checks 
*** TURN *** [Qh Jd Qd] [9s]
Warterror90: bets €0.03
rounders121282: folds 
Uncalled bet (€0.03) returned to Warterror90
Warterror90 collected €0.05 from pot
Warterror90: doesn't show hand 
*** SUMMARY ***
Total pot €0.05 | Rake €0 
Board [Qh Jd Qd 9s]
Seat 1: rounders121282 (button) folded on the Turn
Seat 2: Artemis1a (small blind) folded before Flop
Seat 3: Warterror90 (big blind) collected (€0.05)
Seat 4: darkodiablo folded before Flop (didn't bet)
Seat 5: caduceus369 folded before Flop (didn't bet)
Seat 6: emidio92 folded before Flop (didn't bet)



PokerStars Zoom Hand #257997933685:  Hold'em No Limit (€0.01/€0.02) [ADM ID: M62BD3044A1E13PD] - 2025/10/04 20:17:07 CET [2025/10/04 14:17:07 ET]
Table 'Sirio' 6-max Seat #1 is the button
Seat 1: caduceus369 (€2.91 in chips) 
Seat 2: darkodiablo (€1.36 in chips) 
Seat 3: ADRIAN0_MEIS (€4.01 in chips) 
Seat 4: Warterror90 (€2.47 in chips) 
Seat 5: willydag94 (€2.39 in chips) 
Seat 6: Orly811 (€1.14 in chips) 
darkodiablo: posts small blind €0.01
ADRIAN0_MEIS: posts big blind €0.02
*** HOLE CARDS ***
Dealt to caduceus369 [Kh Jh]
Warterror90: folds 
willydag94: raises €0.04 to €0.06
Orly811: folds 
caduceus369: raises €0.12 to €0.18
darkodiablo: folds 
ADRIAN0_MEIS: folds 
willydag94: calls €0.12
*** FLOP *** [7h Jd 6d]
willydag94: checks 
caduceus369: bets €0.22
willydag94: calls €0.22
*** TURN *** [7h Jd 6d] [8d]
willydag94: checks 
caduceus369: checks 
*** RIVER *** [7h Jd 6d 8d] [Kc]
willydag94: bets €0.57
caduceus369: folds 
Uncalled bet (€0.57) returned to willydag94
willydag94 collected €0.79 from pot
willydag94: doesn't show hand 
*** SUMMARY ***
Total pot €0.83 | Rake €0.04 
Board [7h Jd 6d 8d Kc]
Seat 1: caduceus369 (button) folded on the River
Seat 2: darkodiablo (small blind) folded before Flop
Seat 3: ADRIAN0_MEIS (big blind) folded before Flop
Seat 4: Warterror90 folded before Flop (didn't bet)
Seat 5: willydag94 collected (€0.79)
Seat 6: Orly811 folded before Flop (didn't bet)



PokerStars Zoom Hand #257997952526:  Hold'em No Limit (€0.01/€0.02) [ADM ID: M62BD3044A1E13PD] - 2025/10/04 20:18:30 CET [2025/10/04 14:18:30 ET]
Table 'Sirio' 6-max Seat #1 is the button
Seat 1: N0thingforU (€2.01 in chips) 
Seat 2: RRsanto (€2.93 in chips) 
Seat 3: Artemis1a (€2.42 in chips) 
Seat 4: caduceus369 (€2.51 in chips) 
Seat 5: GanchanS7 (€2.57 in chips) 
Seat 6: MathMassacreX (€4.29 in chips) 
RRsanto: posts small blind €0.01
Artemis1a: posts big blind €0.02
*** HOLE CARDS ***
Dealt to caduceus369 [Td Kd]
caduceus369: raises €0.04 to €0.06
GanchanS7: folds 
MathMassacreX: calls €0.06
N0thingforU: folds 
RRsanto: folds 
Artemis1a: calls €0.04
*** FLOP *** [5c 8s 8c]
Artemis1a: checks 
caduceus369: checks 
MathMassacreX: checks 
*** TURN *** [5c 8s 8c] [Ah]
Artemis1a: bets €0.09
caduceus369: folds 
MathMassacreX: folds 
Uncalled bet (€0.09) returned to Artemis1a
Artemis1a collected €0.18 from pot
Artemis1a: doesn't show hand 
*** SUMMARY ***
Total pot €0.19 | Rake €0.01 
Board [5c 8s 8c Ah]
Seat 1: N0thingforU (button) folded before Flop (didn't bet)
Seat 2: RRsanto (small blind) folded before Flop
Seat 3: Artemis1a (big blind) collected (€0.18)
Seat 4: caduceus369 folded on the Turn
Seat 5: GanchanS7 folded before Flop (didn't bet)
Seat 6: MathMassacreX folded on the Turn



PokerStars Zoom Hand #257997951596:  Hold'em No Limit (€0.01/€0.02) [ADM ID: M62BD3044A1E13PD] - 2025/10/04 20:18:26 CET [2025/10/04 14:18:26 ET]
Table 'Sirio' 6-max Seat #1 is the button
Seat 1: ADRIAN0_MEIS (€5.73 in chips) 
Seat 2: GIacius (€2 in chips) 
Seat 3: Artemis1a (€8.86 in chips) 
Seat 4: caduceus369 (€2.51 in chips) 
Seat 5: GanchanS7 (€4.15 in chips) 
Seat 6: IKARO_3 (€1.80 in chips) 
GIacius: posts small blind €0.01
Artemis1a: posts big blind €0.02
*** HOLE CARDS ***
Dealt to caduceus369 [5d 4h]
caduceus369: folds 
GanchanS7: folds 
IKARO_3: folds 
ADRIAN0_MEIS: folds 
GIacius: folds 
Uncalled bet (€0.01) returned to Artemis1a
Artemis1a collected €0.02 from pot
Artemis1a: doesn't show hand 
*** SUMMARY ***
Total pot €0.02 | Rake €0 
Seat 1: ADRIAN0_MEIS (button) folded before Flop (didn't bet)
Seat 2: GIacius (small blind) folded before Flop
Seat 3: Artemis1a (big blind) collected (€0.02)
Seat 4: caduceus369 folded before Flop (didn't bet)
Seat 5: GanchanS7 folded before Flop (didn't bet)
Seat 6: IKARO_3 folded before Flop (didn't bet)



PokerStars Zoom Hand #257997957498:  Hold'em No Limit (€0.01/€0.02) [ADM ID: M62BD3044A1E13PD] - 2025/10/04 20:18:52 CET [2025/10/04 14:18:52 ET]
Table 'Sirio' 6-max Seat #1 is the button
Seat 1: ADRIAN0_MEIS (€2.23 in chips) 
Seat 2: caduceus369 (€2.45 in chips) 
Seat 3: ghosto69 (€3.69 in chips) 
Seat 4: darkodiablo (€1.25 in chips) 
Seat 5: Chia9711 (€0.86 in chips) 
Seat 6: MiticoDepa (€1.98 in chips) 
caduceus369: posts small blind €0.01
ghosto69: posts big blind €0.02
*** HOLE CARDS ***
Dealt to caduceus369 [Jh Kh]
darkodiablo: folds 
Chia9711: folds 
MiticoDepa: folds 
ADRIAN0_MEIS: folds 
caduceus369: raises €0.04 to €0.06
ghosto69: folds 
Uncalled bet (€0.04) returned to caduceus369
caduceus369 collected €0.04 from pot
caduceus369: doesn't show hand 
*** SUMMARY ***
Total pot €0.04 | Rake €0 
Seat 1: ADRIAN0_MEIS (button) folded before Flop (didn't bet)
Seat 2: caduceus369 (small blind) collected (€0.04)
Seat 3: ghosto69 (big blind) folded before Flop
Seat 4: darkodiablo folded before Flop (didn't bet)
Seat 5: Chia9711 folded before Flop (didn't bet)
Seat 6: MiticoDepa folded before Flop (didn't bet)



PokerStars Zoom Hand #257997964920:  Hold'em No Limit (€0.01/€0.02) [ADM ID: M62BD3044A1E13PD] - 2025/10/04 20:19:25 CET [2025/10/04 14:19:25 ET]
Table 'Sirio' 6-max Seat #1 is the button
Seat 1: IKARO_3 (€2.18 in chips) 
Seat 2: panzapelata (€2.80 in chips) 
Seat 3: caduceus369 (€2.47 in chips) 
Seat 4: ADRIAN0_MEIS (€2.23 in chips) 
Seat 5: GIacius (€2.04 in chips) 
Seat 6: Wunschgast (€2.65 in chips) 
panzapelata: posts small blind €0.01
caduceus369: posts big blind €0.02
*** HOLE CARDS ***
Dealt to caduceus369 [4d 5h]
ADRIAN0_MEIS: folds 
GIacius: folds 
Wunschgast: folds 
IKARO_3: folds 
panzapelata: folds 
Uncalled bet (€0.01) returned to caduceus369
caduceus369 collected €0.02 from pot
caduceus369: doesn't show hand 
*** SUMMARY ***
Total pot €0.02 | Rake €0 
Seat 1: IKARO_3 (button) folded before Flop (didn't bet)
Seat 2: panzapelata (small blind) folded before Flop
Seat 3: caduceus369 (big blind) collected (€0.02)
Seat 4: ADRIAN0_MEIS folded before Flop (didn't bet)
Seat 5: GIacius folded before Flop (didn't bet)
Seat 6: Wunschgast folded before Flop (didn't bet)



PokerStars Zoom Hand #257997969775:  Hold'em No Limit (€0.01/€0.02) [ADM ID: M62BD3044A1E13PD] - 2025/10/04 20:19:46 CET [2025/10/04 14:19:46 ET]
Table 'Sirio' 6-max Seat #1 is the button
Seat 1: GIacius (€2.29 in chips) 
Seat 2: MathMassacreX (€4.29 in chips) 
Seat 3: Chia9711 (€0.99 in chips) 
Seat 4: panzapelata (€0.68 in chips) 
Seat 5: N0thingforU (€2 in chips) 
Seat 6: caduceus369 (€2.48 in chips) 
MathMassacreX: posts small blind €0.01
Chia9711: posts big blind €0.02
*** HOLE CARDS ***
Dealt to caduceus369 [9d 5c]
panzapelata: folds 
N0thingforU: folds 
caduceus369: folds 
GIacius: folds 
MathMassacreX: folds 
Uncalled bet (€0.01) returned to Chia9711
Chia9711 collected €0.02 from pot
Chia9711: doesn't show hand 
*** SUMMARY ***
Total pot €0.02 | Rake €0 
Seat 1: GIacius (button) folded before Flop (didn't bet)
Seat 2: MathMassacreX (small blind) folded before Flop
Seat 3: Chia9711 (big blind) collected (€0.02)
Seat 4: panzapelata folded before Flop (didn't bet)
Seat 5: N0thingforU folded before Flop (didn't bet)
Seat 6: caduceus369 folded before Flop (didn't bet)



PokerStars Zoom Hand #257997971210:  Hold'em No Limit (€0.01/€0.02) [ADM ID: M62BD3044A1E13PD] - 2025/10/04 20:19:52 CET [2025/10/04 14:19:52 ET]
Table 'Sirio' 6-max Seat #1 is the button
Seat 1: caduceus369 (€2.48 in chips) 
Seat 2: GanchanS7 (€2.59 in chips) 
Seat 3: willydag94 (€2.96 in chips) 
Seat 4: panzapelata (€1.51 in chips) 
Seat 5: ghosto69 (€3.67 in chips) 
Seat 6: de_toro_76 (€1.95 in chips) 
GanchanS7: posts small blind €0.01
willydag94: posts big blind €0.02
*** HOLE CARDS ***
Dealt to caduceus369 [4c 7c]
panzapelata: folds 
ghosto69: folds 
de_toro_76: raises €0.05 to €0.07
caduceus369: folds 
GanchanS7: folds 
willydag94: folds 
Uncalled bet (€0.05) returned to de_toro_76
de_toro_76 collected €0.05 from pot
de_toro_76: doesn't show hand 
*** SUMMARY ***
Total pot €0.05 | Rake €0 
Seat 1: caduceus369 (button) folded before Flop (didn't bet)
Seat 2: GanchanS7 (small blind) folded before Flop
Seat 3: willydag94 (big blind) folded before Flop
Seat 4: panzapelata folded before Flop (didn't bet)
Seat 5: ghosto69 folded before Flop (didn't bet)
Seat 6: de_toro_76 collected (€0.05)



PokerStars Zoom Hand #257997972521:  Hold'em No Limit (€0.01/€0.02) [ADM ID: M62BD3044A1E13PD] - 2025/10/04 20:19:58 CET [2025/10/04 14:19:58 ET]
Table 'Sirio' 6-max Seat #1 is the button
Seat 1: N0thingforU (€2 in chips) 
Seat 2: ADRIAN0_MEIS (€6.28 in chips) 
Seat 3: Pufface13 (€2.52 in chips) 
Seat 4: Artemis1a (€1.93 in chips) 
Seat 5: caduceus369 (€2.48 in chips) 
Seat 6: rounders121282 (€2.01 in chips) 
ADRIAN0_MEIS: posts small blind €0.01
Pufface13: posts big blind €0.02
*** HOLE CARDS ***
Dealt to caduceus369 [4s 7d]
Artemis1a: folds 
caduceus369: folds 
rounders121282: folds 
N0thingforU: folds 
ADRIAN0_MEIS: raises €0.04 to €0.06
Pufface13: raises €0.06 to €0.12
ADRIAN0_MEIS: calls €0.06
*** FLOP *** [8d Kd 3h]
ADRIAN0_MEIS: checks 
Pufface13: bets €0.23
ADRIAN0_MEIS: folds 
Uncalled bet (€0.23) returned to Pufface13
Pufface13 collected €0.23 from pot
Pufface13: doesn't show hand 
*** SUMMARY ***
Total pot €0.24 | Rake €0.01 
Board [8d Kd 3h]
Seat 1: N0thingforU (button) folded before Flop (didn't bet)
Seat 2: ADRIAN0_MEIS (small blind) folded on the Flop
Seat 3: Pufface13 (big blind) collected (€0.23)
Seat 4: Artemis1a folded before Flop (didn't bet)
Seat 5: caduceus369 folded before Flop (didn't bet)
Seat 6: rounders121282 folded before Flop (didn't bet)



PokerStars Zoom Hand #257997973780:  Hold'em No Limit (€0.01/€0.02) [ADM ID: M62BD3044A1E13PD] - 2025/10/04 20:20:04 CET [2025/10/04 14:20:04 ET]
Table 'Sirio' 6-max Seat #1 is the button
Seat 1: GIacius (€2.02 in chips) 
Seat 2: Gabrielefante (€4.42 in chips) 
Seat 3: caduceus369 (€2.48 in chips) 
Seat 4: Artemis1a (€2.66 in chips) 
Seat 5: darkodiablo (€1.15 in chips) 
Seat 6: RRsanto (€2.98 in chips) 
Gabrielefante: posts small blind €0.01
caduceus369: posts big blind €0.02
*** HOLE CARDS ***
Dealt to caduceus369 [Js Tc]
Artemis1a: folds 
darkodiablo: folds 
RRsanto: folds 
GIacius: raises €0.03 to €0.05
Gabrielefante: calls €0.04
caduceus369: calls €0.03
*** FLOP *** [3h Kd 5h]
Gabrielefante: checks 
caduceus369: checks 
GIacius: bets €0.05
Gabrielefante: folds 
caduceus369: folds 
Uncalled bet (€0.05) returned to GIacius
GIacius collected €0.15 from pot
GIacius: doesn't show hand 
*** SUMMARY ***
Total pot €0.15 | Rake €0 
Board [3h Kd 5h]
Seat 1: GIacius (button) collected (€0.15)
Seat 2: Gabrielefante (small blind) folded on the Flop
Seat 3: caduceus369 (big blind) folded on the Flop
Seat 4: Artemis1a folded before Flop (didn't bet)
Seat 5: darkodiablo folded before Flop (didn't bet)
Seat 6: RRsanto folded before Flop (didn't bet)



PokerStars Zoom Hand #257997982245:  Hold'em No Limit (€0.01/€0.02) [ADM ID: M62BD3044A1E13PD] - 2025/10/04 20:20:41 CET [2025/10/04 14:20:41 ET]
Table 'Sirio' 6-max Seat #1 is the button
Seat 1: VagALiss (€2.43 in chips) 
Seat 2: caduceus369 (€2.43 in chips) 
Seat 3: RRsanto (€2 in chips) 
Seat 4: GanchanS7 (€3.31 in chips) 
Seat 5: gattapone81 (€1.22 in chips) 
Seat 6: ghosto69 (€1.78 in chips) 
caduceus369: posts small blind €0.01
RRsanto: posts big blind €0.02
*** HOLE CARDS ***
Dealt to caduceus369 [2h 3h]
GanchanS7: folds 
gattapone81: folds 
ghosto69: folds 
VagALiss: raises €0.03 to €0.05
caduceus369: folds 
RRsanto: folds 
Uncalled bet (€0.03) returned to VagALiss
VagALiss collected €0.05 from pot
VagALiss: doesn't show hand 
*** SUMMARY ***
Total pot €0.05 | Rake €0 
Seat 1: VagALiss (button) collected (€0.05)
Seat 2: caduceus369 (small blind) folded before Flop
Seat 3: RRsanto (big blind) folded before Flop
Seat 4: GanchanS7 folded before Flop (didn't bet)
Seat 5: gattapone81 folded before Flop (didn't bet)
Seat 6: ghosto69 folded before Flop (didn't bet)



PokerStars Zoom Hand #257997986221:  Hold'em No Limit (€0.01/€0.02) [ADM ID: M62BD3044A1E13PD] - 2025/10/04 20:20:59 CET [2025/10/04 14:20:59 ET]
Table 'Sirio' 6-max Seat #1 is the button
Seat 1: caduceus369 (€2.42 in chips) 
Seat 2: MathMassacreX (€4.50 in chips) 
Seat 3: GraviiTy10 (€2 in chips) 
Seat 4: maxedrum68 (€2 in chips) 
Seat 5: RRsanto (€2.98 in chips) 
Seat 6: GanchanS7 (€2.56 in chips) 
MathMassacreX: posts small blind €0.01
GraviiTy10: posts big blind €0.02
*** HOLE CARDS ***
Dealt to caduceus369 [5h Qc]
maxedrum68: folds 
RRsanto: folds 
GanchanS7: raises €0.03 to €0.05
caduceus369: folds 
MathMassacreX: folds 
GraviiTy10: folds 
Uncalled bet (€0.03) returned to GanchanS7
GanchanS7 collected €0.05 from pot
GanchanS7: doesn't show hand 
*** SUMMARY ***
Total pot €0.05 | Rake €0 
Seat 1: caduceus369 (button) folded before Flop (didn't bet)
Seat 2: MathMassacreX (small blind) folded before Flop
Seat 3: GraviiTy10 (big blind) folded before Flop
Seat 4: maxedrum68 folded before Flop (didn't bet)
Seat 5: RRsanto folded before Flop (didn't bet)
Seat 6: GanchanS7 collected (€0.05)



PokerStars Zoom Hand #257997984368:  Hold'em No Limit (€0.01/€0.02) [ADM ID: M62BD3044A1E13PD] - 2025/10/04 20:20:51 CET [2025/10/04 14:20:51 ET]
Table 'Sirio' 6-max Seat #1 is the button
Seat 1: IKARO_3 (€1.80 in chips) 
Seat 2: rounders121282 (€2.15 in chips) 
Seat 3: GIacius (€2 in chips) 
Seat 4: gattapone81 (€1.22 in chips) 
Seat 5: caduceus369 (€2.42 in chips) 
Seat 6: Artemis1a (€4.58 in chips) 
rounders121282: posts small blind €0.01
GIacius: posts big blind €0.02
*** HOLE CARDS ***
Dealt to caduceus369 [2s 3s]
gattapone81: calls €0.02
caduceus369: folds 
Artemis1a: folds 
IKARO_3: folds 
rounders121282: calls €0.01
GIacius: checks 
*** FLOP *** [Th 8h Ad]
rounders121282: checks 
GIacius: checks 
gattapone81: checks 
*** TURN *** [Th 8h Ad] [3h]
rounders121282: checks 
GIacius: checks 
gattapone81: checks 
*** RIVER *** [Th 8h Ad 3h] [Qs]
rounders121282: bets €0.06
GIacius: folds 
gattapone81: folds 
Uncalled bet (€0.06) returned to rounders121282
rounders121282 collected €0.06 from pot
rounders121282: doesn't show hand 
*** SUMMARY ***
Total pot €0.06 | Rake €0 
Board [Th 8h Ad 3h Qs]
Seat 1: IKARO_3 (button) folded before Flop (didn't bet)
Seat 2: rounders121282 (small blind) collected (€0.06)
Seat 3: GIacius (big blind) folded on the River
Seat 4: gattapone81 folded on the River
Seat 5: caduceus369 folded before Flop (didn't bet)
Seat 6: Artemis1a folded before Flop (didn't bet)



PokerStars Zoom Hand #257997995713:  Hold'em No Limit (€0.01/€0.02) [ADM ID: M62BD3044A1E13PD] - 2025/10/04 20:21:42 CET [2025/10/04 14:21:42 ET]
Table 'Sirio' 6-max Seat #1 is the button
Seat 1: rounders121282 (€2.19 in chips) 
Seat 2: caduceus369 (€2.42 in chips) 
Seat 3: vckjakcon97 (€0.99 in chips) 
Seat 4: MathMassacreX (€4.49 in chips) 
Seat 5: IKARO_3 (€3.03 in chips) 
Seat 6: CREMISSA (€1.98 in chips) 
caduceus369: posts small blind €0.01
vckjakcon97: posts big blind €0.02
*** HOLE CARDS ***
Dealt to caduceus369 [2s 7c]
MathMassacreX: folds 
IKARO_3: folds 
CREMISSA: folds 
rounders121282: folds 
caduceus369: folds 
Uncalled bet (€0.01) returned to vckjakcon97
vckjakcon97 collected €0.02 from pot
vckjakcon97: doesn't show hand 
*** SUMMARY ***
Total pot €0.02 | Rake €0 
Seat 1: rounders121282 (button) folded before Flop (didn't bet)
Seat 2: caduceus369 (small blind) folded before Flop
Seat 3: vckjakcon97 (big blind) collected (€0.02)
Seat 4: MathMassacreX folded before Flop (didn't bet)
Seat 5: IKARO_3 folded before Flop (didn't bet)
Seat 6: CREMISSA folded before Flop (didn't bet)



PokerStars Zoom Hand #257997992685:  Hold'em No Limit (€0.01/€0.02) [ADM ID: M62BD3044A1E13PD] - 2025/10/04 20:21:28 CET [2025/10/04 14:21:28 ET]
Table 'Sirio' 6-max Seat #1 is the button
Seat 1: ghosto69 (€3.67 in chips) 
Seat 2: ADRIAN0_MEIS (€4.99 in chips) 
Seat 3: GanchanS7 (€2.20 in chips) 
Seat 4: MathMassacreX (€4.49 in chips) 
Seat 5: GIacius (€2.20 in chips) 
Seat 6: caduceus369 (€2.42 in chips) 
ADRIAN0_MEIS: posts small blind €0.01
GanchanS7: posts big blind €0.02
*** HOLE CARDS ***
Dealt to caduceus369 [9c 3c]
MathMassacreX: folds 
GIacius: raises €0.02 to €0.04
caduceus369: folds 
ghosto69: folds 
ADRIAN0_MEIS: folds 
GanchanS7: folds 
Uncalled bet (€0.02) returned to GIacius
GIacius collected €0.05 from pot
GIacius: doesn't show hand 
*** SUMMARY ***
Total pot €0.05 | Rake €0 
Seat 1: ghosto69 (button) folded before Flop (didn't bet)
Seat 2: ADRIAN0_MEIS (small blind) folded before Flop
Seat 3: GanchanS7 (big blind) folded before Flop
Seat 4: MathMassacreX folded before Flop (didn't bet)
Seat 5: GIacius collected (€0.05)
Seat 6: caduceus369 folded before Flop (didn't bet)



PokerStars Zoom Hand #257997997065:  Hold'em No Limit (€0.01/€0.02) [ADM ID: M62BD3044A1E13PD] - 2025/10/04 20:21:48 CET [2025/10/04 14:21:48 ET]
Table 'Sirio' 6-max Seat #1 is the button
Seat 1: GraviiTy10 (€1.96 in chips) 
Seat 2: MathMassacreX (€4.49 in chips) 
Seat 3: panzapelata (€1.72 in chips) 
Seat 4: caduceus369 (€2.41 in chips) 
Seat 5: capzanetti444 (€0.64 in chips) 
Seat 6: VagALiss (€2.43 in chips) 
MathMassacreX: posts small blind €0.01
panzapelata: posts big blind €0.02
*** HOLE CARDS ***
Dealt to caduceus369 [9c 5c]
caduceus369: folds 
capzanetti444: folds 
VagALiss: folds 
GraviiTy10: raises €0.02 to €0.04
MathMassacreX: folds 
panzapelata: folds 
Uncalled bet (€0.02) returned to GraviiTy10
GraviiTy10 collected €0.05 from pot
GraviiTy10: doesn't show hand 
*** SUMMARY ***
Total pot €0.05 | Rake €0 
Seat 1: GraviiTy10 (button) collected (€0.05)
Seat 2: MathMassacreX (small blind) folded before Flop
Seat 3: panzapelata (big blind) folded before Flop
Seat 4: caduceus369 folded before Flop (didn't bet)
Seat 5: capzanetti444 folded before Flop (didn't bet)
Seat 6: VagALiss folded before Flop (didn't bet)



PokerStars Zoom Hand #257997997934:  Hold'em No Limit (€0.01/€0.02) [ADM ID: M62BD3044A1E13PD] - 2025/10/04 20:21:52 CET [2025/10/04 14:21:52 ET]
Table 'Sirio' 6-max Seat #1 is the button
Seat 1: caduceus369 (€2.41 in chips) 
Seat 2: IKARO_3 (€3.03 in chips) 
Seat 3: panzapelata (€1.72 in chips) 
Seat 4: GanchanS7 (€2.58 in chips) 
Seat 5: Pufface13 (€1.77 in chips) 
Seat 6: GIacius (€2.20 in chips) 
IKARO_3: posts small blind €0.01
panzapelata: posts big blind €0.02
*** HOLE CARDS ***
Dealt to caduceus369 [6s 9c]
GanchanS7: folds 
Pufface13: calls €0.02
GIacius: folds 
caduceus369: folds 
IKARO_3: folds 
panzapelata: checks 
*** FLOP *** [Ks 9d Ah]
panzapelata: checks 
Pufface13: checks 
*** TURN *** [Ks 9d Ah] [Qs]
panzapelata: checks 
Pufface13: checks 
*** RIVER *** [Ks 9d Ah Qs] [Qh]
panzapelata: checks 
Pufface13: checks 
*** SHOW DOWN ***
panzapelata: shows [4h Td] (a pair of Queens)
Pufface13: mucks hand 
panzapelata collected €0.05 from pot
*** SUMMARY ***
Total pot €0.05 | Rake €0 
Board [Ks 9d Ah Qs Qh]
Seat 1: caduceus369 (button) folded before Flop (didn't bet)
Seat 2: IKARO_3 (small blind) folded before Flop
Seat 3: panzapelata (big blind) showed [4h Td] and won (€0.05) with a pair of Queens
Seat 4: GanchanS7 folded before Flop (didn't bet)
Seat 5: Pufface13 mucked [5s 4s]
Seat 6: GIacius folded before Flop (didn't bet)



PokerStars Zoom Hand #257997991178:  Hold'em No Limit (€0.01/€0.02) [ADM ID: M62BD3044A1E13PD] - 2025/10/04 20:21:21 CET [2025/10/04 14:21:21 ET]
Table 'Sirio' 6-max Seat #1 is the button
Seat 1: cino63 (€1.15 in chips) 
Seat 2: maxedrum68 (€1.98 in chips) 
Seat 3: Warterror90 (€3.62 in chips) 
Seat 4: caduceus369 (€2.42 in chips) 
Seat 5: willydag94 (€2.48 in chips) 
Seat 6: IKARO_3 (€1.79 in chips) 
maxedrum68: posts small blind €0.01
Warterror90: posts big blind €0.02
*** HOLE CARDS ***
Dealt to caduceus369 [8h 3d]
caduceus369: folds 
willydag94: folds 
IKARO_3 has timed out
IKARO_3: folds 
cino63: calls €0.02
maxedrum68: calls €0.01
Warterror90: raises €0.04 to €0.06
cino63: calls €0.04
maxedrum68: calls €0.04
*** FLOP *** [6h As Qh]
maxedrum68: checks 
Warterror90: checks 
cino63: bets €0.09
maxedrum68: calls €0.09
Warterror90: calls €0.09
*** TURN *** [6h As Qh] [9d]
maxedrum68: checks 
Warterror90: checks 
cino63: bets €0.14
maxedrum68: folds 
Warterror90: raises €3.33 to €3.47 and is all-in
cino63: folds 
Uncalled bet (€3.33) returned to Warterror90
Warterror90 collected €0.69 from pot
Warterror90: doesn't show hand 
*** SUMMARY ***
Total pot €0.73 | Rake €0.04 
Board [6h As Qh 9d]
Seat 1: cino63 (button) folded on the Turn
Seat 2: maxedrum68 (small blind) folded on the Turn
Seat 3: Warterror90 (big blind) collected (€0.69)
Seat 4: caduceus369 folded before Flop (didn't bet)
Seat 5: willydag94 folded before Flop (didn't bet)
Seat 6: IKARO_3 folded before Flop (didn't bet)



PokerStars Zoom Hand #257998005956:  Hold'em No Limit (€0.01/€0.02) [ADM ID: M62BD3044A1E13PD] - 2025/10/04 20:22:28 CET [2025/10/04 14:22:28 ET]
Table 'Sirio' 6-max Seat #1 is the button
Seat 1: willydag94 (€2.68 in chips) 
Seat 2: caduceus369 (€2.39 in chips) 
Seat 3: shakthi (€2.06 in chips) 
Seat 4: Warterror90 (€1.66 in chips) 
Seat 5: ADRIAN0_MEIS (€4.96 in chips) 
Seat 6: cino63 (€0.86 in chips) 
caduceus369: posts small blind €0.01
shakthi: posts big blind €0.02
*** HOLE CARDS ***
Dealt to caduceus369 [4s 9h]
Warterror90: folds 
ADRIAN0_MEIS: raises €0.05 to €0.07
cino63: folds 
willydag94: folds 
caduceus369: folds 
shakthi: folds 
Uncalled bet (€0.05) returned to ADRIAN0_MEIS
ADRIAN0_MEIS collected €0.05 from pot
ADRIAN0_MEIS: doesn't show hand 
*** SUMMARY ***
Total pot €0.05 | Rake €0 
Seat 1: willydag94 (button) folded before Flop (didn't bet)
Seat 2: caduceus369 (small blind) folded before Flop
Seat 3: shakthi (big blind) folded before Flop
Seat 4: Warterror90 folded before Flop (didn't bet)
Seat 5: ADRIAN0_MEIS collected (€0.05)
Seat 6: cino63 folded before Flop (didn't bet)



PokerStars Zoom Hand #257997999057:  Hold'em No Limit (€0.01/€0.02) [ADM ID: M62BD3044A1E13PD] - 2025/10/04 20:21:57 CET [2025/10/04 14:21:57 ET]
Table 'Sirio' 6-max Seat #1 is the button
Seat 1: VagALiss (€2.43 in chips) 
Seat 2: GIacius (€2.20 in chips) 
Seat 3: caduceus369 (€2.41 in chips) 
Seat 4: Gabrielefante (€4.40 in chips) 
Seat 5: ADRIAN0_MEIS (€4.98 in chips) 
Seat 6: de_toro_76 (€2.03 in chips) 
GIacius: posts small blind €0.01
caduceus369: posts big blind €0.02
*** HOLE CARDS ***
Dealt to caduceus369 [2c Ts]
Gabrielefante: calls €0.02
ADRIAN0_MEIS: folds 
de_toro_76: folds 
VagALiss: folds 
GIacius: calls €0.01
caduceus369: checks 
*** FLOP *** [3c Ks 8h]
GIacius: checks 
caduceus369: checks 
Gabrielefante: checks 
*** TURN *** [3c Ks 8h] [3s]
GIacius: bets €0.03
caduceus369: folds 
Gabrielefante: calls €0.03
*** RIVER *** [3c Ks 8h 3s] [3h]
GIacius: bets €0.06
Gabrielefante: folds 
Uncalled bet (€0.06) returned to GIacius
GIacius collected €0.12 from pot
GIacius: doesn't show hand 
*** SUMMARY ***
Total pot €0.12 | Rake €0 
Board [3c Ks 8h 3s 3h]
Seat 1: VagALiss (button) folded before Flop (didn't bet)
Seat 2: GIacius (small blind) collected (€0.12)
Seat 3: caduceus369 (big blind) folded on the Turn
Seat 4: Gabrielefante folded on the River
Seat 5: ADRIAN0_MEIS folded before Flop (didn't bet)
Seat 6: de_toro_76 folded before Flop (didn't bet)



PokerStars Zoom Hand #257997994098:  Hold'em No Limit (€0.01/€0.02) [ADM ID: M62BD3044A1E13PD] - 2025/10/04 20:21:34 CET [2025/10/04 14:21:34 ET]
Table 'Sirio' 6-max Seat #1 is the button
Seat 1: vckjakcon97 (€0.99 in chips) 
Seat 2: N0thingforU (€2 in chips) 
Seat 3: shakthi (€2 in chips) 
Seat 4: Artemis1a (€8.78 in chips) 
Seat 5: caduceus369 (€2.42 in chips) 
Seat 6: GIacius (€2.11 in chips) 
N0thingforU: posts small blind €0.01
shakthi: posts big blind €0.02
*** HOLE CARDS ***
Dealt to caduceus369 [4d 4c]
Artemis1a: raises €0.04 to €0.06
caduceus369: folds 
GIacius: raises €0.14 to €0.20
vckjakcon97: folds 
N0thingforU: calls €0.19
shakthi: folds 
Artemis1a: calls €0.14
*** FLOP *** [As Qc 6c]
N0thingforU: checks 
Artemis1a: checks 
GIacius: bets €0.18
N0thingforU: calls €0.18
Artemis1a: folds 
*** TURN *** [As Qc 6c] [Jd]
N0thingforU: checks 
GIacius: checks 
*** RIVER *** [As Qc 6c Jd] [3h]
N0thingforU: checks 
GIacius: bets €0.33
N0thingforU: calls €0.33
*** SHOW DOWN ***
GIacius: shows [Ks Ah] (a pair of Aces)
N0thingforU: mucks hand 
GIacius collected €1.55 from pot
*** SUMMARY ***
Total pot €1.64 | Rake €0.09 
Board [As Qc 6c Jd 3h]
Seat 1: vckjakcon97 (button) folded before Flop (didn't bet)
Seat 2: N0thingforU (small blind) mucked [Td Ad]
Seat 3: shakthi (big blind) folded before Flop
Seat 4: Artemis1a folded on the Flop
Seat 5: caduceus369 folded before Flop (didn't bet)
Seat 6: GIacius showed [Ks Ah] and won (€1.55) with a pair of Aces



PokerStars Zoom Hand #257998007281:  Hold'em No Limit (€0.01/€0.02) [ADM ID: M62BD3044A1E13PD] - 2025/10/04 20:22:34 CET [2025/10/04 14:22:34 ET]
Table 'Sirio' 6-max Seat #1 is the button
Seat 1: Warterror90 (€4.02 in chips) 
Seat 2: GanchanS7 (€2.17 in chips) 
Seat 3: de_toro_76 (€2.03 in chips) 
Seat 4: caduceus369 (€2.38 in chips) 
Seat 5: Artemis1a (€3.66 in chips) 
Seat 6: trisco66 (€1.58 in chips) 
GanchanS7: posts small blind €0.01
de_toro_76: posts big blind €0.02
*** HOLE CARDS ***
Dealt to caduceus369 [Kh Jd]
caduceus369: raises €0.04 to €0.06
Artemis1a: folds 
trisco66: folds 
Warterror90: folds 
GanchanS7: folds 
de_toro_76: folds 
Uncalled bet (€0.04) returned to caduceus369
caduceus369 collected €0.05 from pot
caduceus369: doesn't show hand 
*** SUMMARY ***
Total pot €0.05 | Rake €0 
Seat 1: Warterror90 (button) folded before Flop (didn't bet)
Seat 2: GanchanS7 (small blind) folded before Flop
Seat 3: de_toro_76 (big blind) folded before Flop
Seat 4: caduceus369 collected (€0.05)
Seat 5: Artemis1a folded before Flop (didn't bet)
Seat 6: trisco66 folded before Flop (didn't bet)



PokerStars Zoom Hand #257997989243:  Hold'em No Limit (€0.01/€0.02) [ADM ID: M62BD3044A1E13PD] - 2025/10/04 20:21:13 CET [2025/10/04 14:21:13 ET]
Table 'Sirio' 6-max Seat #1 is the button
Seat 1: RRsanto (€2.98 in chips) 
Seat 2: cino63 (€1.16 in chips) 
Seat 3: ADRIAN0_MEIS (€7.24 in chips) 
Seat 4: GIacius (€2.24 in chips) 
Seat 5: GanchanS7 (€2.20 in chips) 
Seat 6: caduceus369 (€2.42 in chips) 
cino63: posts small blind €0.01
ADRIAN0_MEIS: posts big blind €0.02
*** HOLE CARDS ***
Dealt to caduceus369 [Th 4d]
GIacius: raises €0.02 to €0.04
GanchanS7: folds 
caduceus369: folds 
RRsanto: raises €0.14 to €0.18
cino63: folds 
ADRIAN0_MEIS: raises €0.20 to €0.38
GIacius: folds 
RRsanto: calls €0.20
*** FLOP *** [Kd Ac 7s]
ADRIAN0_MEIS: bets €0.42
RRsanto: calls €0.42
*** TURN *** [Kd Ac 7s] [6d]
ADRIAN0_MEIS: checks 
RRsanto: bets €0.51
ADRIAN0_MEIS: folds 
Uncalled bet (€0.51) returned to RRsanto
RRsanto collected €1.56 from pot
RRsanto: doesn't show hand 
*** SUMMARY ***
Total pot €1.65 | Rake €0.09 
Board [Kd Ac 7s 6d]
Seat 1: RRsanto (button) collected (€1.56)
Seat 2: cino63 (small blind) folded before Flop
Seat 3: ADRIAN0_MEIS (big blind) folded on the Turn
Seat 4: GIacius folded before Flop
Seat 5: GanchanS7 folded before Flop (didn't bet)
Seat 6: caduceus369 folded before Flop (didn't bet)



PokerStars Zoom Hand #257998011958:  Hold'em No Limit (€0.01/€0.02) [ADM ID: M62BD3044A1E13PD] - 2025/10/04 20:22:55 CET [2025/10/04 14:22:55 ET]
Table 'Sirio' 6-max Seat #1 is the button
Seat 1: GIacius (€2.95 in chips) 
Seat 2: Gabrielefante (€4.33 in chips) 
Seat 3: N0thingforU (€2 in chips) 
Seat 4: MathMassacreX (€4.55 in chips) 
Seat 5: Artemis1a (€1.59 in chips) 
Seat 6: caduceus369 (€2.41 in chips) 
Gabrielefante: posts small blind €0.01
N0thingforU: posts big blind €0.02
*** HOLE CARDS ***
Dealt to caduceus369 [5s As]
MathMassacreX: folds 
Artemis1a: folds 
caduceus369: raises €0.04 to €0.06
GIacius: raises €0.14 to €0.20
Gabrielefante: folds 
N0thingforU: folds 
caduceus369: calls €0.14
*** FLOP *** [7h 3d Jd]
caduceus369: checks 
GIacius: bets €0.14
caduceus369: raises €0.28 to €0.42
GIacius: calls €0.28
*** TURN *** [7h 3d Jd] [Qc]
caduceus369: checks 
GIacius: bets €0.61
caduceus369: folds 
Uncalled bet (€0.61) returned to GIacius
GIacius collected €1.21 from pot
GIacius: doesn't show hand 
*** SUMMARY ***
Total pot €1.27 | Rake €0.06 
Board [7h 3d Jd Qc]
Seat 1: GIacius (button) collected (€1.21)
Seat 2: Gabrielefante (small blind) folded before Flop
Seat 3: N0thingforU (big blind) folded before Flop
Seat 4: MathMassacreX folded before Flop (didn't bet)
Seat 5: Artemis1a folded before Flop (didn't bet)
Seat 6: caduceus369 folded on the Turn



PokerStars Zoom Hand #257998028158:  Hold'em No Limit (€0.01/€0.02) [ADM ID: M62BD3044A1E13PD] - 2025/10/04 20:24:09 CET [2025/10/04 14:24:09 ET]
Table 'Sirio' 6-max Seat #1 is the button
Seat 1: RRsanto (€3.81 in chips) 
Seat 2: vckjakcon97 (€1 in chips) 
Seat 3: ghosto69 (€3.07 in chips) 
Seat 4: panzapelata (€1.91 in chips) 
Seat 5: caduceus369 (€2 in chips) 
Seat 6: wilchesempre (€1.88 in chips) 
vckjakcon97: posts small blind €0.01
ghosto69: posts big blind €0.02
*** HOLE CARDS ***
Dealt to caduceus369 [2h 2c]
panzapelata: folds 
caduceus369: folds 
wilchesempre: folds 
RRsanto: raises €0.04 to €0.06
vckjakcon97: folds 
ghosto69: folds 
Uncalled bet (€0.04) returned to RRsanto
RRsanto collected €0.05 from pot
RRsanto: doesn't show hand 
*** SUMMARY ***
Total pot €0.05 | Rake €0 
Seat 1: RRsanto (button) collected (€0.05)
Seat 2: vckjakcon97 (small blind) folded before Flop
Seat 3: ghosto69 (big blind) folded before Flop
Seat 4: panzapelata folded before Flop (didn't bet)
Seat 5: caduceus369 folded before Flop (didn't bet)
Seat 6: wilchesempre folded before Flop (didn't bet)



PokerStars Zoom Hand #257998031647:  Hold'em No Limit (€0.01/€0.02) [ADM ID: M62BD3044A1E13PD] - 2025/10/04 20:24:25 CET [2025/10/04 14:24:25 ET]
Table 'Sirio' 6-max Seat #1 is the button
Seat 1: Artemis1a (€8.85 in chips) 
Seat 2: potodds1979 (€2.05 in chips) 
Seat 3: caduceus369 (€2 in chips) 
Seat 4: Warterror90 (€1.81 in chips) 
Seat 5: Manus22749 (€0.92 in chips) 
Seat 6: cino63 (€1.60 in chips) 
potodds1979: posts small blind €0.01
caduceus369: posts big blind €0.02
*** HOLE CARDS ***
Dealt to caduceus369 [Qh 6h]
Warterror90: folds 
Manus22749: raises €0.04 to €0.06
cino63: folds 
Artemis1a: folds 
potodds1979: folds 
caduceus369: folds 
Uncalled bet (€0.04) returned to Manus22749
Manus22749 collected €0.05 from pot
Manus22749: doesn't show hand 
*** SUMMARY ***
Total pot €0.05 | Rake €0 
Seat 1: Artemis1a (button) folded before Flop (didn't bet)
Seat 2: potodds1979 (small blind) folded before Flop
Seat 3: caduceus369 (big blind) folded before Flop
Seat 4: Warterror90 folded before Flop (didn't bet)
Seat 5: Manus22749 collected (€0.05)
Seat 6: cino63 folded before Flop (didn't bet)



PokerStars Zoom Hand #257998029089:  Hold'em No Limit (€0.01/€0.02) [ADM ID: M62BD3044A1E13PD] - 2025/10/04 20:24:14 CET [2025/10/04 14:24:14 ET]
Table 'Sirio' 6-max Seat #1 is the button
Seat 1: trisco66 (€0.69 in chips) 
Seat 2: pallone1969 (€1.79 in chips) 
Seat 3: panzapelata (€1.91 in chips) 
Seat 4: IKARO_3 (€0.95 in chips) 
Seat 5: caduceus369 (€2 in chips) 
Seat 6: Manus22749 (€0.93 in chips) 
pallone1969: posts small blind €0.01
panzapelata: posts big blind €0.02
*** HOLE CARDS ***
Dealt to caduceus369 [Kc 4h]
IKARO_3: folds 
caduceus369: folds 
Manus22749: folds 
trisco66: raises €0.08 to €0.10
pallone1969: folds 
panzapelata: calls €0.08
*** FLOP *** [6h 7h 6d]
panzapelata: checks 
trisco66: bets €0.20
panzapelata: folds 
Uncalled bet (€0.20) returned to trisco66
trisco66 collected €0.20 from pot
trisco66: doesn't show hand 
*** SUMMARY ***
Total pot €0.21 | Rake €0.01 
Board [6h 7h 6d]
Seat 1: trisco66 (button) collected (€0.20)
Seat 2: pallone1969 (small blind) folded before Flop
Seat 3: panzapelata (big blind) folded on the Flop
Seat 4: IKARO_3 folded before Flop (didn't bet)
Seat 5: caduceus369 folded before Flop (didn't bet)
Seat 6: Manus22749 folded before Flop (didn't bet)



PokerStars Zoom Hand #257998035822:  Hold'em No Limit (€0.01/€0.02) [ADM ID: M62BD3044A1E13PD] - 2025/10/04 20:24:45 CET [2025/10/04 14:24:45 ET]
Table 'Sirio' 6-max Seat #1 is the button
Seat 1: IKARO_3 (€3.05 in chips) 
Seat 2: caduceus369 (€2 in chips) 
Seat 3: Manus22749 (€0.95 in chips) 
Seat 4: GanchanS7 (€4.13 in chips) 
Seat 5: pallone1969 (€1.70 in chips) 
Seat 6: potodds1979 (€2.02 in chips) 
caduceus369: posts small blind €0.01
Manus22749: posts big blind €0.02
*** HOLE CARDS ***
Dealt to caduceus369 [4d 7d]
GanchanS7: folds 
pallone1969: folds 
potodds1979: folds 
IKARO_3: folds 
caduceus369: folds 
Uncalled bet (€0.01) returned to Manus22749
Manus22749 collected €0.02 from pot
Manus22749: doesn't show hand 
*** SUMMARY ***
Total pot €0.02 | Rake €0 
Seat 1: IKARO_3 (button) folded before Flop (didn't bet)
Seat 2: caduceus369 (small blind) folded before Flop
Seat 3: Manus22749 (big blind) collected (€0.02)
Seat 4: GanchanS7 folded before Flop (didn't bet)
Seat 5: pallone1969 folded before Flop (didn't bet)
Seat 6: potodds1979 folded before Flop (didn't bet)



PokerStars Zoom Hand #257998036835:  Hold'em No Limit (€0.01/€0.02) [ADM ID: M62BD3044A1E13PD] - 2025/10/04 20:24:50 CET [2025/10/04 14:24:50 ET]
Table 'Sirio' 6-max Seat #1 is the button
Seat 1: Artemis1a (€1.92 in chips) 
Seat 2: de_toro_76 (€3.96 in chips) 
Seat 3: GanchanS7 (€4.13 in chips) 
Seat 4: kAllSeMPRE73 (€1.23 in chips) 
Seat 5: panzapelata (€1.99 in chips) 
Seat 6: caduceus369 (€2 in chips) 
de_toro_76: posts small blind €0.01
GanchanS7: posts big blind €0.02
*** HOLE CARDS ***
Dealt to caduceus369 [4c 2c]
kAllSeMPRE73: folds 
panzapelata: folds 
caduceus369: folds 
Artemis1a: folds 
de_toro_76: folds 
Uncalled bet (€0.01) returned to GanchanS7
GanchanS7 collected €0.02 from pot
GanchanS7: doesn't show hand 
*** SUMMARY ***
Total pot €0.02 | Rake €0 
Seat 1: Artemis1a (button) folded before Flop (didn't bet)
Seat 2: de_toro_76 (small blind) folded before Flop
Seat 3: GanchanS7 (big blind) collected (€0.02)
Seat 4: kAllSeMPRE73 folded before Flop (didn't bet)
Seat 5: panzapelata folded before Flop (didn't bet)
Seat 6: caduceus369 folded before Flop (didn't bet)



PokerStars Zoom Hand #257998038595:  Hold'em No Limit (€0.01/€0.02) [ADM ID: M62BD3044A1E13PD] - 2025/10/04 20:24:58 CET [2025/10/04 14:24:58 ET]
Table 'Sirio' 6-max Seat #1 is the button
Seat 1: Manus22749 (€0.96 in chips) 
Seat 2: IKARO_3 (€2.23 in chips) 
Seat 3: panzapelata (€1.90 in chips) 
Seat 4: Warterror90 (€1.81 in chips) 
Seat 5: caduceus369 (€2 in chips) 
Seat 6: de_toro_76 (€3.95 in chips) 
IKARO_3: posts small blind €0.01
panzapelata: posts big blind €0.02
*** HOLE CARDS ***
Dealt to caduceus369 [Ad Qs]
Warterror90: folds 
caduceus369: raises €0.04 to €0.06
de_toro_76: folds 
Manus22749: folds 
IKARO_3: folds 
panzapelata: folds 
Uncalled bet (€0.04) returned to caduceus369
caduceus369 collected €0.05 from pot
caduceus369: doesn't show hand 
*** SUMMARY ***
Total pot €0.05 | Rake €0 
Seat 1: Manus22749 (button) folded before Flop (didn't bet)
Seat 2: IKARO_3 (small blind) folded before Flop
Seat 3: panzapelata (big blind) folded before Flop
Seat 4: Warterror90 folded before Flop (didn't bet)
Seat 5: caduceus369 collected (€0.05)
Seat 6: de_toro_76 folded before Flop (didn't bet)



PokerStars Zoom Hand #257998041680:  Hold'em No Limit (€0.01/€0.02) [ADM ID: M62BD3044A1E13PD] - 2025/10/04 20:25:12 CET [2025/10/04 14:25:12 ET]
Table 'Sirio' 6-max Seat #1 is the button
Seat 1: IKARO_3 (€0.95 in chips) 
Seat 2: shakthi (€2.08 in chips) 
Seat 3: caduceus369 (€2.03 in chips) 
Seat 4: ghosto69 (€3.02 in chips) 
Seat 5: panzapelata (€1.88 in chips) 
Seat 6: ADRIAN0_MEIS (€6.25 in chips) 
shakthi: posts small blind €0.01
caduceus369: posts big blind €0.02
*** HOLE CARDS ***
Dealt to caduceus369 [Qd 4c]
ghosto69: folds 
panzapelata: folds 
ADRIAN0_MEIS: folds 
IKARO_3: folds 
shakthi: raises €0.02 to €0.04
caduceus369: folds 
Uncalled bet (€0.02) returned to shakthi
shakthi collected €0.04 from pot
shakthi: doesn't show hand 
*** SUMMARY ***
Total pot €0.04 | Rake €0 
Seat 1: IKARO_3 (button) folded before Flop (didn't bet)
Seat 2: shakthi (small blind) collected (€0.04)
Seat 3: caduceus369 (big blind) folded before Flop
Seat 4: ghosto69 folded before Flop (didn't bet)
Seat 5: panzapelata folded before Flop (didn't bet)
Seat 6: ADRIAN0_MEIS folded before Flop (didn't bet)



PokerStars Zoom Hand #257998027040:  Hold'em No Limit (€0.01/€0.02) [ADM ID: M62BD3044A1E13PD] - 2025/10/04 20:24:04 CET [2025/10/04 14:24:04 ET]
Table 'Sirio' 6-max Seat #1 is the button
Seat 1: caduceus369 (€2 in chips) 
Seat 2: GanchanS7 (€2.14 in chips) 
Seat 3: ADRIAN0_MEIS (€2.23 in chips) 
Seat 4: Wunschgast (€3.09 in chips) 
Seat 5: panzapelata (€2.03 in chips) 
Seat 6: VagALiss (€2.02 in chips) 
GanchanS7: posts small blind €0.01
ADRIAN0_MEIS: posts big blind €0.02
*** HOLE CARDS ***
Dealt to caduceus369 [6c Td]
Wunschgast: raises €0.04 to €0.06
panzapelata: folds 
VagALiss: folds 
caduceus369: folds 
GanchanS7: folds 
ADRIAN0_MEIS: calls €0.04
*** FLOP *** [3h 2h Qh]
ADRIAN0_MEIS: checks 
Wunschgast: checks 
*** TURN *** [3h 2h Qh] [8c]
ADRIAN0_MEIS: bets €0.07
Wunschgast: raises €0.14 to €0.21
ADRIAN0_MEIS: calls €0.14
*** RIVER *** [3h 2h Qh 8c] [2c]
ADRIAN0_MEIS: checks 
Wunschgast: bets €0.40
ADRIAN0_MEIS: calls €0.40
*** SHOW DOWN ***
Wunschgast: shows [Ad Jh] (a pair of Deuces)
ADRIAN0_MEIS: shows [Qc Jc] (two pair, Queens and Deuces)
ADRIAN0_MEIS collected €1.28 from pot
*** SUMMARY ***
Total pot €1.35 | Rake €0.07 
Board [3h 2h Qh 8c 2c]
Seat 1: caduceus369 (button) folded before Flop (didn't bet)
Seat 2: GanchanS7 (small blind) folded before Flop
Seat 3: ADRIAN0_MEIS (big blind) showed [Qc Jc] and won (€1.28) with two pair, Queens and Deuces
Seat 4: Wunschgast showed [Ad Jh] and lost with a pair of Deuces
Seat 5: panzapelata folded before Flop (didn't bet)
Seat 6: VagALiss folded before Flop (didn't bet)



PokerStars Zoom Hand #257998046910:  Hold'em No Limit (€0.01/€0.02) [ADM ID: M62BD3044A1E13PD] - 2025/10/04 20:25:36 CET [2025/10/04 14:25:36 ET]
Table 'Sirio' 6-max Seat #1 is the button
Seat 1: caduceus369 (€2.01 in chips) 
Seat 2: ghosto69 (€3.69 in chips) 
Seat 3: trisco66 (€0.84 in chips) 
Seat 4: IKARO_3 (€0.95 in chips) 
Seat 5: vckjakcon97 (€0.95 in chips) 
Seat 6: panzapelata (€1.78 in chips) 
ghosto69: posts small blind €0.01
trisco66: posts big blind €0.02
*** HOLE CARDS ***
Dealt to caduceus369 [Jd Ac]
IKARO_3: folds 
vckjakcon97: folds 
panzapelata: folds 
caduceus369: raises €0.04 to €0.06
ghosto69: folds 
trisco66: folds 
Uncalled bet (€0.04) returned to caduceus369
caduceus369 collected €0.05 from pot
caduceus369: doesn't show hand 
*** SUMMARY ***
Total pot €0.05 | Rake €0 
Seat 1: caduceus369 (button) collected (€0.05)
Seat 2: ghosto69 (small blind) folded before Flop
Seat 3: trisco66 (big blind) folded before Flop
Seat 4: IKARO_3 folded before Flop (didn't bet)
Seat 5: vckjakcon97 folded before Flop (didn't bet)
Seat 6: panzapelata folded before Flop (didn't bet)



PokerStars Zoom Hand #257998056709:  Hold'em No Limit (€0.01/€0.02) [ADM ID: M62BD3044A1E13PD] - 2025/10/04 20:26:21 CET [2025/10/04 14:26:21 ET]
Table 'Sirio' 6-max Seat #1 is the button
Seat 1: potodds1979 (€2.18 in chips) 
Seat 2: Orly811 (€1.45 in chips) 
Seat 3: Wunschgast (€2.39 in chips) 
Seat 4: caduceus369 (€2.03 in chips) 
Seat 5: GIacius (€2.19 in chips) 
Seat 6: GanchanS7 (€3.27 in chips) 
Orly811: posts small blind €0.01
Wunschgast: posts big blind €0.02
*** HOLE CARDS ***
Dealt to caduceus369 [Th Jd]
caduceus369: folds 
GIacius: raises €0.02 to €0.04
GanchanS7: folds 
potodds1979: folds 
Orly811: folds 
Wunschgast: folds 
Uncalled bet (€0.02) returned to GIacius
GIacius collected €0.05 from pot
GIacius: doesn't show hand 
*** SUMMARY ***
Total pot €0.05 | Rake €0 
Seat 1: potodds1979 (button) folded before Flop (didn't bet)
Seat 2: Orly811 (small blind) folded before Flop
Seat 3: Wunschgast (big blind) folded before Flop
Seat 4: caduceus369 folded before Flop (didn't bet)
Seat 5: GIacius collected (€0.05)
Seat 6: GanchanS7 folded before Flop (didn't bet)



PokerStars Zoom Hand #257998058279:  Hold'em No Limit (€0.01/€0.02) [ADM ID: M62BD3044A1E13PD] - 2025/10/04 20:26:28 CET [2025/10/04 14:26:28 ET]
Table 'Sirio' 6-max Seat #1 is the button
Seat 1: caduceus369 (€2.03 in chips) 
Seat 2: RRsanto (€2 in chips) 
Seat 3: Gabrielefante (€4.42 in chips) 
Seat 4: GanchanS7 (€2.10 in chips) 
Seat 5: Manus22749 (€0.81 in chips) 
Seat 6: trisco66 (€0.81 in chips) 
RRsanto: posts small blind €0.01
Gabrielefante: posts big blind €0.02
*** HOLE CARDS ***
Dealt to caduceus369 [Jh 2c]
GanchanS7: folds 
Manus22749: folds 
trisco66: folds 
caduceus369: folds 
RRsanto: folds 
Uncalled bet (€0.01) returned to Gabrielefante
Gabrielefante collected €0.02 from pot
Gabrielefante: doesn't show hand 
*** SUMMARY ***
Total pot €0.02 | Rake €0 
Seat 1: caduceus369 (button) folded before Flop (didn't bet)
Seat 2: RRsanto (small blind) folded before Flop
Seat 3: Gabrielefante (big blind) collected (€0.02)
Seat 4: GanchanS7 folded before Flop (didn't bet)
Seat 5: Manus22749 folded before Flop (didn't bet)
Seat 6: trisco66 folded before Flop (didn't bet)



PokerStars Zoom Hand #257998052185:  Hold'em No Limit (€0.01/€0.02) [ADM ID: M62BD3044A1E13PD] - 2025/10/04 20:26:00 CET [2025/10/04 14:26:00 ET]
Table 'Sirio' 6-max Seat #1 is the button
Seat 1: capzanetti444 (€1.75 in chips) 
Seat 2: caduceus369 (€2.04 in chips) 
Seat 3: MathMassacreX (€2 in chips) 
Seat 4: Chia9711 (€0.88 in chips) 
Seat 5: ADRIAN0_MEIS (€6.50 in chips) 
Seat 6: wilchesempre (€1.60 in chips) 
caduceus369: posts small blind €0.01
MathMassacreX: posts big blind €0.02
*** HOLE CARDS ***
Dealt to caduceus369 [4d Qd]
Chia9711: calls €0.02
ADRIAN0_MEIS: calls €0.02
wilchesempre: folds 
capzanetti444: folds 
caduceus369: folds 
MathMassacreX: checks 
*** FLOP *** [2h Js Qs]
MathMassacreX: checks 
Chia9711: checks 
ADRIAN0_MEIS: checks 
*** TURN *** [2h Js Qs] [Qh]
MathMassacreX: checks 
Chia9711: bets €0.02
ADRIAN0_MEIS: calls €0.02
MathMassacreX: calls €0.02
*** RIVER *** [2h Js Qs Qh] [Jh]
MathMassacreX: checks 
Chia9711: bets €0.02
ADRIAN0_MEIS: calls €0.02
MathMassacreX: folds 
*** SHOW DOWN ***
Chia9711: shows [3c Ad] (two pair, Queens and Jacks)
ADRIAN0_MEIS: mucks hand 
Chia9711 collected €0.17 from pot
*** SUMMARY ***
Total pot €0.17 | Rake €0 
Board [2h Js Qs Qh Jh]
Seat 1: capzanetti444 (button) folded before Flop (didn't bet)
Seat 2: caduceus369 (small blind) folded before Flop
Seat 3: MathMassacreX (big blind) folded on the River
Seat 4: Chia9711 showed [3c Ad] and won (€0.17) with two pair, Queens and Jacks
Seat 5: ADRIAN0_MEIS mucked [9c 9s]
Seat 6: wilchesempre folded before Flop (didn't bet)



PokerStars Zoom Hand #257998054226:  Hold'em No Limit (€0.01/€0.02) [ADM ID: M62BD3044A1E13PD] - 2025/10/04 20:26:09 CET [2025/10/04 14:26:09 ET]
Table 'Sirio' 6-max Seat #1 is the button
Seat 1: IKARO_3 (€0.93 in chips) 
Seat 2: Clint934 (€1.48 in chips) 
Seat 3: rounders121282 (€2.21 in chips) 
Seat 4: caduceus369 (€2.03 in chips) 
Seat 5: GanchanS7 (€2.52 in chips) 
Seat 6: ADRIAN0_MEIS (€2.83 in chips) 
Clint934: posts small blind €0.01
rounders121282: posts big blind €0.02
*** HOLE CARDS ***
Dealt to caduceus369 [3h 7c]
caduceus369: folds 
GanchanS7: folds 
ADRIAN0_MEIS: raises €0.05 to €0.07
IKARO_3: folds 
Clint934: folds 
rounders121282: folds 
Uncalled bet (€0.05) returned to ADRIAN0_MEIS
ADRIAN0_MEIS collected €0.05 from pot
ADRIAN0_MEIS: doesn't show hand 
*** SUMMARY ***
Total pot €0.05 | Rake €0 
Seat 1: IKARO_3 (button) folded before Flop (didn't bet)
Seat 2: Clint934 (small blind) folded before Flop
Seat 3: rounders121282 (big blind) folded before Flop
Seat 4: caduceus369 folded before Flop (didn't bet)
Seat 5: GanchanS7 folded before Flop (didn't bet)
Seat 6: ADRIAN0_MEIS collected (€0.05)



PokerStars Zoom Hand #257998059343:  Hold'em No Limit (€0.01/€0.02) [ADM ID: M62BD3044A1E13PD] - 2025/10/04 20:26:33 CET [2025/10/04 14:26:33 ET]
Table 'Sirio' 6-max Seat #1 is the button
Seat 1: panzapelata (€3.49 in chips) 
Seat 2: vckjakcon97 (€1.03 in chips) 
Seat 3: caduceus369 (€2.03 in chips) 
Seat 4: potodds1979 (€2.18 in chips) 
Seat 5: shakthi (€2.16 in chips) 
Seat 6: flippone78 (€1.17 in chips) 
vckjakcon97: posts small blind €0.01
caduceus369: posts big blind €0.02
*** HOLE CARDS ***
Dealt to caduceus369 [Ks 8h]
potodds1979: folds 
shakthi: folds 
flippone78: raises €0.03 to €0.05
panzapelata: calls €0.05
vckjakcon97: raises €0.98 to €1.03 and is all-in
caduceus369: folds 
flippone78: raises €0.14 to €1.17 and is all-in
panzapelata: folds 
Uncalled bet (€0.14) returned to flippone78
*** FLOP *** [Kh 4c Ac]
*** TURN *** [Kh 4c Ac] [6h]
*** RIVER *** [Kh 4c Ac 6h] [Ts]
*** SHOW DOWN ***
vckjakcon97: shows [Jc Jh] (a pair of Jacks)
flippone78: shows [Jd As] (a pair of Aces)
flippone78 collected €2.02 from pot
*** SUMMARY ***
Total pot €2.13 | Rake €0.11 
Board [Kh 4c Ac 6h Ts]
Seat 1: panzapelata (button) folded before Flop
Seat 2: vckjakcon97 (small blind) showed [Jc Jh] and lost with a pair of Jacks
Seat 3: caduceus369 (big blind) folded before Flop
Seat 4: potodds1979 folded before Flop (didn't bet)
Seat 5: shakthi folded before Flop (didn't bet)
Seat 6: flippone78 showed [Jd As] and won (€2.02) with a pair of Aces



PokerStars Zoom Hand #257998063414:  Hold'em No Limit (€0.01/€0.02) [ADM ID: M62BD3044A1E13PD] - 2025/10/04 20:26:51 CET [2025/10/04 14:26:51 ET]
Table 'Sirio' 6-max Seat #1 is the button
Seat 1: GanchanS7 (€3.27 in chips) 
Seat 2: potodds1979 (€2.18 in chips) 
Seat 3: panzapelata (€1.77 in chips) 
Seat 4: GIacius (€2.22 in chips) 
Seat 5: Clint934 (€1.47 in chips) 
Seat 6: caduceus369 (€2.01 in chips) 
potodds1979: posts small blind €0.01
panzapelata: posts big blind €0.02
*** HOLE CARDS ***
Dealt to caduceus369 [2s 9c]
GIacius: folds 
Clint934: folds 
caduceus369: folds 
GanchanS7: folds 
potodds1979: raises €0.04 to €0.06
panzapelata: folds 
Uncalled bet (€0.04) returned to potodds1979
potodds1979 collected €0.04 from pot
potodds1979: doesn't show hand 
*** SUMMARY ***
Total pot €0.04 | Rake €0 
Seat 1: GanchanS7 (button) folded before Flop (didn't bet)
Seat 2: potodds1979 (small blind) collected (€0.04)
Seat 3: panzapelata (big blind) folded before Flop
Seat 4: GIacius folded before Flop (didn't bet)
Seat 5: Clint934 folded before Flop (didn't bet)
Seat 6: caduceus369 folded before Flop (didn't bet)



PokerStars Zoom Hand #257998065669:  Hold'em No Limit (€0.01/€0.02) [ADM ID: M62BD3044A1E13PD] - 2025/10/04 20:27:01 CET [2025/10/04 14:27:01 ET]
Table 'Sirio' 6-max Seat #1 is the button
Seat 1: GanchanS7 (€4.33 in chips) 
Seat 2: caduceus369 (€2.01 in chips) 
Seat 3: GIacius (€2.22 in chips) 
Seat 4: ADRIAN0_MEIS (€3.27 in chips) 
Seat 5: IKARO_3 (€0.92 in chips) 
Seat 6: RRsanto (€6.46 in chips) 
caduceus369: posts small blind €0.01
GIacius: posts big blind €0.02
*** HOLE CARDS ***
Dealt to caduceus369 [4c 2c]
ADRIAN0_MEIS: folds 
IKARO_3: folds 
RRsanto: folds 
GanchanS7: folds 
caduceus369: folds 
Uncalled bet (€0.01) returned to GIacius
GIacius collected €0.02 from pot
GIacius: doesn't show hand 
*** SUMMARY ***
Total pot €0.02 | Rake €0 
Seat 1: GanchanS7 (button) folded before Flop (didn't bet)
Seat 2: caduceus369 (small blind) folded before Flop
Seat 3: GIacius (big blind) collected (€0.02)
Seat 4: ADRIAN0_MEIS folded before Flop (didn't bet)
Seat 5: IKARO_3 folded before Flop (didn't bet)
Seat 6: RRsanto folded before Flop (didn't bet)



PokerStars Zoom Hand #257998064547:  Hold'em No Limit (€0.01/€0.02) [ADM ID: M62BD3044A1E13PD] - 2025/10/04 20:26:56 CET [2025/10/04 14:26:56 ET]
Table 'Sirio' 6-max Seat #1 is the button
Seat 1: de_toro_76 (€3.90 in chips) 
Seat 2: Wunschgast (€2.37 in chips) 
Seat 3: ghosto69 (€3.88 in chips) 
Seat 4: caduceus369 (€2.01 in chips) 
Seat 5: VagALiss (€1.88 in chips) 
Seat 6: Clint934 (€1.47 in chips) 
Wunschgast: posts small blind €0.01
ghosto69: posts big blind €0.02
*** HOLE CARDS ***
Dealt to caduceus369 [6h 8s]
caduceus369: folds 
VagALiss: folds 
Clint934: calls €0.02
de_toro_76: folds 
Wunschgast: folds 
ghosto69: checks 
*** FLOP *** [3d Kc 5d]
ghosto69: bets €0.02
Clint934: calls €0.02
*** TURN *** [3d Kc 5d] [2c]
ghosto69: bets €0.04
Clint934: folds 
Uncalled bet (€0.04) returned to ghosto69
ghosto69 collected €0.09 from pot
ghosto69: doesn't show hand 
*** SUMMARY ***
Total pot €0.09 | Rake €0 
Board [3d Kc 5d 2c]
Seat 1: de_toro_76 (button) folded before Flop (didn't bet)
Seat 2: Wunschgast (small blind) folded before Flop
Seat 3: ghosto69 (big blind) collected (€0.09)
Seat 4: caduceus369 folded before Flop (didn't bet)
Seat 5: VagALiss folded before Flop (didn't bet)
Seat 6: Clint934 folded on the Turn



PokerStars Zoom Hand #257998069583:  Hold'em No Limit (€0.01/€0.02) [ADM ID: M62BD3044A1E13PD] - 2025/10/04 20:27:19 CET [2025/10/04 14:27:19 ET]
Table 'Sirio' 6-max Seat #1 is the button
Seat 1: rounders121282 (€2.16 in chips) 
Seat 2: wilchesempre (€2 in chips) 
Seat 3: potodds1979 (€2.20 in chips) 
Seat 4: ADRIAN0_MEIS (€2.87 in chips) 
Seat 5: vckjakcon97 (€1 in chips) 
Seat 6: caduceus369 (€2 in chips) 
wilchesempre: posts small blind €0.01
potodds1979: posts big blind €0.02
*** HOLE CARDS ***
Dealt to caduceus369 [7c Kd]
ADRIAN0_MEIS: raises €0.05 to €0.07
vckjakcon97: folds 
caduceus369: folds 
rounders121282: folds 
wilchesempre: folds 
potodds1979: folds 
Uncalled bet (€0.05) returned to ADRIAN0_MEIS
ADRIAN0_MEIS collected €0.05 from pot
ADRIAN0_MEIS: doesn't show hand 
*** SUMMARY ***
Total pot €0.05 | Rake €0 
Seat 1: rounders121282 (button) folded before Flop (didn't bet)
Seat 2: wilchesempre (small blind) folded before Flop
Seat 3: potodds1979 (big blind) folded before Flop
Seat 4: ADRIAN0_MEIS collected (€0.05)
Seat 5: vckjakcon97 folded before Flop (didn't bet)
Seat 6: caduceus369 folded before Flop (didn't bet)



PokerStars Zoom Hand #257998071291:  Hold'em No Limit (€0.01/€0.02) [ADM ID: M62BD3044A1E13PD] - 2025/10/04 20:27:27 CET [2025/10/04 14:27:27 ET]
Table 'Sirio' 6-max Seat #1 is the button
Seat 1: GIacius (€2.57 in chips) 
Seat 2: ADRIAN0_MEIS (€6.47 in chips) 
Seat 3: Clint934 (€1.43 in chips) 
Seat 4: Artemis1a (€3.77 in chips) 
Seat 5: caduceus369 (€2 in chips) 
Seat 6: CREMISSA (€2.05 in chips) 
ADRIAN0_MEIS: posts small blind €0.01
Clint934: posts big blind €0.02
*** HOLE CARDS ***
Dealt to caduceus369 [3s 8c]
Artemis1a: folds 
caduceus369: folds 
CREMISSA: folds 
GIacius: folds 
ADRIAN0_MEIS: folds 
Uncalled bet (€0.01) returned to Clint934
Clint934 collected €0.02 from pot
Clint934: doesn't show hand 
*** SUMMARY ***
Total pot €0.02 | Rake €0 
Seat 1: GIacius (button) folded before Flop (didn't bet)
Seat 2: ADRIAN0_MEIS (small blind) folded before Flop
Seat 3: Clint934 (big blind) collected (€0.02)
Seat 4: Artemis1a folded before Flop (didn't bet)
Seat 5: caduceus369 folded before Flop (didn't bet)
Seat 6: CREMISSA folded before Flop (didn't bet)



PokerStars Zoom Hand #257998072403:  Hold'em No Limit (€0.01/€0.02) [ADM ID: M62BD3044A1E13PD] - 2025/10/04 20:27:32 CET [2025/10/04 14:27:32 ET]
Table 'Sirio' 6-max Seat #1 is the button
Seat 1: ADRIAN0_MEIS (€6.39 in chips) 
Seat 2: GanchanS7 (€4.33 in chips) 
Seat 3: caduceus369 (€2 in chips) 
Seat 4: CREMISSA (€2.05 in chips) 
Seat 5: darkodiablo (€1.13 in chips) 
Seat 6: shakthi (€2.21 in chips) 
GanchanS7: posts small blind €0.01
caduceus369: posts big blind €0.02
*** HOLE CARDS ***
Dealt to caduceus369 [Qc Qd]
CREMISSA: folds 
darkodiablo: folds 
shakthi: folds 
ADRIAN0_MEIS: raises €0.05 to €0.07
GanchanS7: folds 
caduceus369: raises €0.17 to €0.24
ADRIAN0_MEIS: calls €0.17
*** FLOP *** [Kc 2d Tc]
caduceus369: checks 
ADRIAN0_MEIS: checks 
*** TURN *** [Kc 2d Tc] [5s]
caduceus369: bets €0.20
ADRIAN0_MEIS: raises €0.29 to €0.49
caduceus369: calls €0.29
*** RIVER *** [Kc 2d Tc 5s] [8h]
caduceus369: checks 
ADRIAN0_MEIS: bets €0.46
caduceus369: raises €0.81 to €1.27 and is all-in
ADRIAN0_MEIS: folds 
Uncalled bet (€0.81) returned to caduceus369
caduceus369 collected €2.26 from pot
caduceus369: doesn't show hand 
*** SUMMARY ***
Total pot €2.39 | Rake €0.13 
Board [Kc 2d Tc 5s 8h]
Seat 1: ADRIAN0_MEIS (button) folded on the River
Seat 2: GanchanS7 (small blind) folded before Flop
Seat 3: caduceus369 (big blind) collected (€2.26)
Seat 4: CREMISSA folded before Flop (didn't bet)
Seat 5: darkodiablo folded before Flop (didn't bet)
Seat 6: shakthi folded before Flop (didn't bet)



PokerStars Zoom Hand #257998098286:  Hold'em No Limit (€0.01/€0.02) [ADM ID: M62BD3044A1E13PD] - 2025/10/04 20:29:33 CET [2025/10/04 14:29:33 ET]
Table 'Sirio' 6-max Seat #1 is the button
Seat 1: caduceus369 (€3.07 in chips) 
Seat 2: GanchanS7 (€2.67 in chips) 
Seat 3: ghosto69 (€3.35 in chips) 
Seat 4: wilchesempre (€1.95 in chips) 
Seat 5: ADRIAN0_MEIS (€3.31 in chips) 
Seat 6: Manus22749 (€0.70 in chips) 
GanchanS7: posts small blind €0.01
ghosto69: posts big blind €0.02
*** HOLE CARDS ***
Dealt to caduceus369 [Ks Qh]
wilchesempre: raises €0.04 to €0.06
ADRIAN0_MEIS: folds 
Manus22749: folds 
caduceus369: raises €0.10 to €0.16
GanchanS7: folds 
ghosto69: folds 
wilchesempre: folds 
Uncalled bet (€0.10) returned to caduceus369
caduceus369 collected €0.15 from pot
caduceus369: doesn't show hand 
*** SUMMARY ***
Total pot €0.15 | Rake €0 
Seat 1: caduceus369 (button) collected (€0.15)
Seat 2: GanchanS7 (small blind) folded before Flop
Seat 3: ghosto69 (big blind) folded before Flop
Seat 4: wilchesempre folded before Flop
Seat 5: ADRIAN0_MEIS folded before Flop (didn't bet)
Seat 6: Manus22749 folded before Flop (didn't bet)



PokerStars Zoom Hand #257998106556:  Hold'em No Limit (€0.01/€0.02) [ADM ID: M62BD3044A1E13PD] - 2025/10/04 20:30:10 CET [2025/10/04 14:30:10 ET]
Table 'Sirio' 6-max Seat #1 is the button
Seat 1: de_toro_76 (€0.69 in chips) 
Seat 2: vckjakcon97 (€1.11 in chips) 
Seat 3: ADRIAN0_MEIS (€4.85 in chips) 
Seat 4: caduceus369 (€3.16 in chips) 
Seat 5: Chia9711 (€1.41 in chips) 
Seat 6: panzapelata (€3.72 in chips) 
vckjakcon97: posts small blind €0.01
ADRIAN0_MEIS: posts big blind €0.02
*** HOLE CARDS ***
Dealt to caduceus369 [Qh Qs]
caduceus369: raises €0.04 to €0.06
Chia9711: calls €0.06
panzapelata: calls €0.06
de_toro_76: folds 
vckjakcon97: raises €1.05 to €1.11 and is all-in
ADRIAN0_MEIS: folds 
caduceus369: calls €1.05
Chia9711: folds 
panzapelata: folds 
*** FLOP *** [2s 6d As]
*** TURN *** [2s 6d As] [Ah]
*** RIVER *** [2s 6d As Ah] [Kh]
*** SHOW DOWN ***
vckjakcon97: shows [4c 4s] (two pair, Aces and Fours)
caduceus369: shows [Qh Qs] (two pair, Aces and Queens)
caduceus369 collected €2.24 from pot
*** SUMMARY ***
Total pot €2.36 | Rake €0.12 
Board [2s 6d As Ah Kh]
Seat 1: de_toro_76 (button) folded before Flop (didn't bet)
Seat 2: vckjakcon97 (small blind) showed [4c 4s] and lost with two pair, Aces and Fours
Seat 3: ADRIAN0_MEIS (big blind) folded before Flop
Seat 4: caduceus369 showed [Qh Qs] and won (€2.24) with two pair, Aces and Queens
Seat 5: Chia9711 folded before Flop
Seat 6: panzapelata folded before Flop



PokerStars Zoom Hand #257998114204:  Hold'em No Limit (€0.01/€0.02) [ADM ID: M62BD3044A1E13PD] - 2025/10/04 20:30:45 CET [2025/10/04 14:30:45 ET]
Table 'Sirio' 6-max Seat #1 is the button
Seat 1: wilchesempre (€2.09 in chips) 
Seat 2: caduceus369 (€4.29 in chips) 
Seat 3: GIacius (€2.02 in chips) 
Seat 4: ghosto69 (€3.77 in chips) 
Seat 5: panzapelata (€3.66 in chips) 
Seat 6: flippone78 (€1.50 in chips) 
caduceus369: posts small blind €0.01
GIacius: posts big blind €0.02
*** HOLE CARDS ***
Dealt to caduceus369 [7c 3h]
ghosto69: folds 
panzapelata: folds 
flippone78: folds 
wilchesempre: folds 
caduceus369: folds 
Uncalled bet (€0.01) returned to GIacius
GIacius collected €0.02 from pot
GIacius: doesn't show hand 
*** SUMMARY ***
Total pot €0.02 | Rake €0 
Seat 1: wilchesempre (button) folded before Flop (didn't bet)
Seat 2: caduceus369 (small blind) folded before Flop
Seat 3: GIacius (big blind) collected (€0.02)
Seat 4: ghosto69 folded before Flop (didn't bet)
Seat 5: panzapelata folded before Flop (didn't bet)
Seat 6: flippone78 folded before Flop (didn't bet)



PokerStars Zoom Hand #257998116899:  Hold'em No Limit (€0.01/€0.02) [ADM ID: M62BD3044A1E13PD] - 2025/10/04 20:30:57 CET [2025/10/04 14:30:57 ET]
Table 'Sirio' 6-max Seat #1 is the button
Seat 1: Artemis1a (€3.77 in chips) 
Seat 2: GIacius (€4.29 in chips) 
Seat 3: potodds1979 (€2.20 in chips) 
Seat 4: caduceus369 (€4.28 in chips) 
Seat 5: flippone78 (€1.50 in chips) 
Seat 6: ADRIAN0_MEIS (€5.17 in chips) 
GIacius: posts small blind €0.01
potodds1979: posts big blind €0.02
*** HOLE CARDS ***
Dealt to caduceus369 [As 9s]
caduceus369: raises €0.04 to €0.06
flippone78: folds 
ADRIAN0_MEIS: folds 
Artemis1a: folds 
GIacius: folds 
potodds1979: raises €0.13 to €0.19
caduceus369: calls €0.13
*** FLOP *** [7d Ad Kc]
potodds1979: bets €0.19
caduceus369: calls €0.19
*** TURN *** [7d Ad Kc] [7c]
potodds1979: bets €0.73
caduceus369: calls €0.73
*** RIVER *** [7d Ad Kc 7c] [5h]
potodds1979: bets €1.09 and is all-in
caduceus369: calls €1.09
*** SHOW DOWN ***
potodds1979: shows [Kd Ac] (two pair, Aces and Kings)
caduceus369: shows [As 9s] (two pair, Aces and Sevens)
potodds1979 collected €4.17 from pot
*** SUMMARY ***
Total pot €4.41 | Rake €0.24 
Board [7d Ad Kc 7c 5h]
Seat 1: Artemis1a (button) folded before Flop (didn't bet)
Seat 2: GIacius (small blind) folded before Flop
Seat 3: potodds1979 (big blind) showed [Kd Ac] and won (€4.17) with two pair, Aces and Kings
Seat 4: caduceus369 showed [As 9s] and lost with two pair, Aces and Sevens
Seat 5: flippone78 folded before Flop (didn't bet)
Seat 6: ADRIAN0_MEIS folded before Flop (didn't bet)



PokerStars Zoom Hand #257998136519:  Hold'em No Limit (€0.01/€0.02) [ADM ID: M62BD3044A1E13PD] - 2025/10/04 20:32:25 CET [2025/10/04 14:32:25 ET]
Table 'Sirio' 6-max Seat #1 is the button
Seat 1: RRsanto (€2 in chips) 
Seat 2: ADRIAN0_MEIS (€3.26 in chips) 
Seat 3: IKARO_3 (€2.36 in chips) 
Seat 4: Wunschgast (€3.86 in chips) 
Seat 5: caduceus369 (€2.08 in chips) 
Seat 6: nicolobs (€2 in chips) 
ADRIAN0_MEIS: posts small blind €0.01
IKARO_3: posts big blind €0.02
*** HOLE CARDS ***
Dealt to caduceus369 [Ks Kc]
Wunschgast: folds 
caduceus369: raises €0.04 to €0.06
nicolobs: folds 
RRsanto: raises €0.12 to €0.18
ADRIAN0_MEIS: folds 
IKARO_3: folds 
caduceus369: raises €0.40 to €0.58
RRsanto: folds 
Uncalled bet (€0.40) returned to caduceus369
caduceus369 collected €0.39 from pot
caduceus369: doesn't show hand 
*** SUMMARY ***
Total pot €0.39 | Rake €0 
Seat 1: RRsanto (button) folded before Flop
Seat 2: ADRIAN0_MEIS (small blind) folded before Flop
Seat 3: IKARO_3 (big blind) folded before Flop
Seat 4: Wunschgast folded before Flop (didn't bet)
Seat 5: caduceus369 collected (€0.39)
Seat 6: nicolobs folded before Flop (didn't bet)



PokerStars Zoom Hand #257998147670:  Hold'em No Limit (€0.01/€0.02) [ADM ID: M62BD3044A1E13PD] - 2025/10/04 20:33:15 CET [2025/10/04 14:33:15 ET]
Table 'Sirio' 6-max Seat #1 is the button
Seat 1: ADRIAN0_MEIS (€4.56 in chips) 
Seat 2: vckjakcon97 (€2.08 in chips) 
Seat 3: caduceus369 (€2.29 in chips) 
Seat 4: panzapelata (€3.57 in chips) 
Seat 5: flippone78 (€1.40 in chips) 
Seat 6: ghosto69 (€3.77 in chips) 
vckjakcon97: posts small blind €0.01
caduceus369: posts big blind €0.02
*** HOLE CARDS ***
Dealt to caduceus369 [6h Qh]
panzapelata: folds 
flippone78: raises €0.03 to €0.05
ghosto69: calls €0.05
ADRIAN0_MEIS: folds 
vckjakcon97: folds 
caduceus369: folds 
*** FLOP *** [2h 7c 4h]
flippone78: checks 
ghosto69: bets €0.04
flippone78: folds 
Uncalled bet (€0.04) returned to ghosto69
ghosto69 collected €0.13 from pot
ghosto69: doesn't show hand 
*** SUMMARY ***
Total pot €0.13 | Rake €0 
Board [2h 7c 4h]
Seat 1: ADRIAN0_MEIS (button) folded before Flop (didn't bet)
Seat 2: vckjakcon97 (small blind) folded before Flop
Seat 3: caduceus369 (big blind) folded before Flop
Seat 4: panzapelata folded before Flop (didn't bet)
Seat 5: flippone78 folded on the Flop
Seat 6: ghosto69 collected (€0.13)



PokerStars Zoom Hand #257998151053:  Hold'em No Limit (€0.01/€0.02) [ADM ID: M62BD3044A1E13PD] - 2025/10/04 20:33:31 CET [2025/10/04 14:33:31 ET]
Table 'Sirio' 6-max Seat #1 is the button
Seat 1: caduceus369 (€2.27 in chips) 
Seat 2: RRsanto (€2 in chips) 
Seat 3: Goal779 (€1.09 in chips) 
Seat 4: willydag94 (€2.44 in chips) 
Seat 5: GIacius (€2.08 in chips) 
Seat 6: IKARO_3 (€2.41 in chips) 
RRsanto: posts small blind €0.01
Goal779: posts big blind €0.02
*** HOLE CARDS ***
Dealt to caduceus369 [3c Kd]
willydag94: folds 
GIacius: folds 
IKARO_3: folds 
caduceus369: folds 
RRsanto: folds 
Uncalled bet (€0.01) returned to Goal779
Goal779 collected €0.02 from pot
Goal779: doesn't show hand 
*** SUMMARY ***
Total pot €0.02 | Rake €0 
Seat 1: caduceus369 (button) folded before Flop (didn't bet)
Seat 2: RRsanto (small blind) folded before Flop
Seat 3: Goal779 (big blind) collected (€0.02)
Seat 4: willydag94 folded before Flop (didn't bet)
Seat 5: GIacius folded before Flop (didn't bet)
Seat 6: IKARO_3 folded before Flop (didn't bet)



PokerStars Zoom Hand #257998152785:  Hold'em No Limit (€0.01/€0.02) [ADM ID: M62BD3044A1E13PD] - 2025/10/04 20:33:39 CET [2025/10/04 14:33:39 ET]
Table 'Sirio' 6-max Seat #1 is the button
Seat 1: amigliaccio (€2.15 in chips) 
Seat 2: CIKO71131 (€0.88 in chips) 
Seat 3: GIacius (€2.08 in chips) 
Seat 4: GanchanS7 (€4.10 in chips) 
Seat 5: Artemis1a (€3.80 in chips) 
Seat 6: caduceus369 (€2.27 in chips) 
CIKO71131: posts small blind €0.01
GIacius: posts big blind €0.02
*** HOLE CARDS ***
Dealt to caduceus369 [8h 8c]
GanchanS7: folds 
Artemis1a: folds 
caduceus369: raises €0.04 to €0.06
amigliaccio: folds 
CIKO71131: calls €0.05
GIacius: calls €0.04
*** FLOP *** [6h Js Kd]
CIKO71131: checks 
GIacius: bets €0.09
caduceus369: folds 
CIKO71131: folds 
Uncalled bet (€0.09) returned to GIacius
GIacius collected €0.18 from pot
GIacius: doesn't show hand 
*** SUMMARY ***
Total pot €0.18 | Rake €0 
Board [6h Js Kd]
Seat 1: amigliaccio (button) folded before Flop (didn't bet)
Seat 2: CIKO71131 (small blind) folded on the Flop
Seat 3: GIacius (big blind) collected (€0.18)
Seat 4: GanchanS7 folded before Flop (didn't bet)
Seat 5: Artemis1a folded before Flop (didn't bet)
Seat 6: caduceus369 folded on the Flop



PokerStars Zoom Hand #257998162778:  Hold'em No Limit (€0.01/€0.02) [ADM ID: M62BD3044A1E13PD] - 2025/10/04 20:34:23 CET [2025/10/04 14:34:23 ET]
Table 'Sirio' 6-max Seat #1 is the button
Seat 1: Gabrielefante (€4.29 in chips) 
Seat 2: caduceus369 (€2.21 in chips) 
Seat 3: panzapelata (€3.69 in chips) 
Seat 4: IKARO_3 (€0.55 in chips) 
Seat 5: potodds1979 (€2.01 in chips) 
Seat 6: GanchanS7 (€4.08 in chips) 
caduceus369: posts small blind €0.01
panzapelata: posts big blind €0.02
*** HOLE CARDS ***
Dealt to caduceus369 [8s Qh]
IKARO_3: folds 
potodds1979: folds 
GanchanS7: folds 
Gabrielefante: folds 
caduceus369: folds 
Uncalled bet (€0.01) returned to panzapelata
panzapelata collected €0.02 from pot
panzapelata: doesn't show hand 
*** SUMMARY ***
Total pot €0.02 | Rake €0 
Seat 1: Gabrielefante (button) folded before Flop (didn't bet)
Seat 2: caduceus369 (small blind) folded before Flop
Seat 3: panzapelata (big blind) collected (€0.02)
Seat 4: IKARO_3 folded before Flop (didn't bet)
Seat 5: potodds1979 folded before Flop (didn't bet)
Seat 6: GanchanS7 folded before Flop (didn't bet)



PokerStars Zoom Hand #257998161048:  Hold'em No Limit (€0.01/€0.02) [ADM ID: M62BD3044A1E13PD] - 2025/10/04 20:34:16 CET [2025/10/04 14:34:16 ET]
Table 'Sirio' 6-max Seat #1 is the button
Seat 1: Wunschgast (€3.85 in chips) 
Seat 2: vckjakcon97 (€0.99 in chips) 
Seat 3: VagALiss (€1.67 in chips) 
Seat 4: caduceus369 (€2.21 in chips) 
Seat 5: willydag94 (€2.41 in chips) 
Seat 6: panzapelata (€3.69 in chips) 
vckjakcon97: posts small blind €0.01
VagALiss: posts big blind €0.02
*** HOLE CARDS ***
Dealt to caduceus369 [9s Ac]
caduceus369: folds 
willydag94: raises €0.04 to €0.06
panzapelata: folds 
Wunschgast: calls €0.06
vckjakcon97: folds 
VagALiss: folds 
*** FLOP *** [6d 5c 5d]
willydag94: checks 
Wunschgast: bets €0.11
willydag94: folds 
Uncalled bet (€0.11) returned to Wunschgast
Wunschgast collected €0.15 from pot
Wunschgast: doesn't show hand 
*** SUMMARY ***
Total pot €0.15 | Rake €0 
Board [6d 5c 5d]
Seat 1: Wunschgast (button) collected (€0.15)
Seat 2: vckjakcon97 (small blind) folded before Flop
Seat 3: VagALiss (big blind) folded before Flop
Seat 4: caduceus369 folded before Flop (didn't bet)
Seat 5: willydag94 folded on the Flop
Seat 6: panzapelata folded before Flop (didn't bet)



PokerStars Zoom Hand #257998164068:  Hold'em No Limit (€0.01/€0.02) [ADM ID: M62BD3044A1E13PD] - 2025/10/04 20:34:29 CET [2025/10/04 14:34:29 ET]
Table 'Sirio' 6-max Seat #1 is the button
Seat 1: ADRIAN0_MEIS (€4.53 in chips) 
Seat 2: vckjakcon97 (€0.96 in chips) 
Seat 3: Chia9711 (€1.60 in chips) 
Seat 4: CIKO71131 (€0.82 in chips) 
Seat 5: caduceus369 (€2.20 in chips) 
Seat 6: ghosto69 (€3.81 in chips) 
vckjakcon97: posts small blind €0.01
Chia9711: posts big blind €0.02
*** HOLE CARDS ***
Dealt to caduceus369 [8c As]
CIKO71131: raises €0.04 to €0.06
caduceus369: folds 
ghosto69: folds 
ADRIAN0_MEIS: folds 
vckjakcon97: folds 
Chia9711: folds 
Uncalled bet (€0.04) returned to CIKO71131
CIKO71131 collected €0.05 from pot
CIKO71131: doesn't show hand 
*** SUMMARY ***
Total pot €0.05 | Rake €0 
Seat 1: ADRIAN0_MEIS (button) folded before Flop (didn't bet)
Seat 2: vckjakcon97 (small blind) folded before Flop
Seat 3: Chia9711 (big blind) folded before Flop
Seat 4: CIKO71131 collected (€0.05)
Seat 5: caduceus369 folded before Flop (didn't bet)
Seat 6: ghosto69 folded before Flop (didn't bet)



PokerStars Zoom Hand #257998165184:  Hold'em No Limit (€0.01/€0.02) [ADM ID: M62BD3044A1E13PD] - 2025/10/04 20:34:34 CET [2025/10/04 14:34:34 ET]
Table 'Sirio' 6-max Seat #1 is the button
Seat 1: caduceus369 (€2.20 in chips) 
Seat 2: potodds1979 (€2.01 in chips) 
Seat 3: pallone1969 (€1.57 in chips) 
Seat 4: Gabrielefante (€4.28 in chips) 
Seat 5: ghosto69 (€3.81 in chips) 
Seat 6: vckjakcon97 (€0.95 in chips) 
potodds1979: posts small blind €0.01
pallone1969: posts big blind €0.02
*** HOLE CARDS ***
Dealt to caduceus369 [Qd 3s]
Gabrielefante: folds 
ghosto69: folds 
vckjakcon97: raises €0.93 to €0.95 and is all-in
caduceus369: folds 
potodds1979: folds 
pallone1969: folds 
Uncalled bet (€0.93) returned to vckjakcon97
vckjakcon97 collected €0.05 from pot
vckjakcon97: doesn't show hand 
*** SUMMARY ***
Total pot €0.05 | Rake €0 
Seat 1: caduceus369 (button) folded before Flop (didn't bet)
Seat 2: potodds1979 (small blind) folded before Flop
Seat 3: pallone1969 (big blind) folded before Flop
Seat 4: Gabrielefante folded before Flop (didn't bet)
Seat 5: ghosto69 folded before Flop (didn't bet)
Seat 6: vckjakcon97 collected (€0.05)



PokerStars Zoom Hand #257998166235:  Hold'em No Limit (€0.01/€0.02) [ADM ID: M62BD3044A1E13PD] - 2025/10/04 20:34:39 CET [2025/10/04 14:34:39 ET]
Table 'Sirio' 6-max Seat #1 is the button
Seat 1: ghosto69 (€3.81 in chips) 
Seat 2: Artemis1a (€1.99 in chips) 
Seat 3: caduceus369 (€2.20 in chips) 
Seat 4: ADRIAN0_MEIS (€4.53 in chips) 
Seat 5: GanchanS7 (€3.28 in chips) 
Seat 6: GIacius (€6.80 in chips) 
Artemis1a: posts small blind €0.01
caduceus369: posts big blind €0.02
*** HOLE CARDS ***
Dealt to caduceus369 [4s 4c]
ADRIAN0_MEIS: raises €0.05 to €0.07
GanchanS7: folds 
GIacius: folds 
ghosto69: folds 
Artemis1a: folds 
caduceus369: calls €0.05
*** FLOP *** [6d Ah 3h]
caduceus369: checks 
ADRIAN0_MEIS: bets €0.11
caduceus369: folds 
Uncalled bet (€0.11) returned to ADRIAN0_MEIS
ADRIAN0_MEIS collected €0.15 from pot
ADRIAN0_MEIS: doesn't show hand 
*** SUMMARY ***
Total pot €0.15 | Rake €0 
Board [6d Ah 3h]
Seat 1: ghosto69 (button) folded before Flop (didn't bet)
Seat 2: Artemis1a (small blind) folded before Flop
Seat 3: caduceus369 (big blind) folded on the Flop
Seat 4: ADRIAN0_MEIS collected (€0.15)
Seat 5: GanchanS7 folded before Flop (didn't bet)
Seat 6: GIacius folded before Flop (didn't bet)



PokerStars Zoom Hand #257998175640:  Hold'em No Limit (€0.01/€0.02) [ADM ID: M62BD3044A1E13PD] - 2025/10/04 20:35:21 CET [2025/10/04 14:35:21 ET]
Table 'Sirio' 6-max Seat #1 is the button
Seat 1: GanchanS7 (€3.26 in chips) 
Seat 2: caduceus369 (€2.13 in chips) 
Seat 3: Clint934 (€1.32 in chips) 
Seat 4: nicolobs (€2 in chips) 
Seat 5: N0thingforU (€2 in chips) 
Seat 6: ADRIAN0_MEIS (€4.61 in chips) 
caduceus369: posts small blind €0.01
Clint934: posts big blind €0.02
*** HOLE CARDS ***
Dealt to caduceus369 [2c 9d]
nicolobs: folds 
N0thingforU: folds 
ADRIAN0_MEIS: folds 
GanchanS7: folds 
caduceus369: folds 
Uncalled bet (€0.01) returned to Clint934
Clint934 collected €0.02 from pot
Clint934: doesn't show hand 
*** SUMMARY ***
Total pot €0.02 | Rake €0 
Seat 1: GanchanS7 (button) folded before Flop (didn't bet)
Seat 2: caduceus369 (small blind) folded before Flop
Seat 3: Clint934 (big blind) collected (€0.02)
Seat 4: nicolobs folded before Flop (didn't bet)
Seat 5: N0thingforU folded before Flop (didn't bet)
Seat 6: ADRIAN0_MEIS folded before Flop (didn't bet)



PokerStars Zoom Hand #257998174076:  Hold'em No Limit (€0.01/€0.02) [ADM ID: M62BD3044A1E13PD] - 2025/10/04 20:35:14 CET [2025/10/04 14:35:14 ET]
Table 'Sirio' 6-max Seat #1 is the button
Seat 1: IKARO_3 (€1.05 in chips) 
Seat 2: capzanetti444 (€2.21 in chips) 
Seat 3: ADRIAN0_MEIS (€2.37 in chips) 
Seat 4: caduceus369 (€2.13 in chips) 
Seat 5: panzapelata (€1.14 in chips) 
Seat 6: VagALiss (€1.65 in chips) 
capzanetti444: posts small blind €0.01
ADRIAN0_MEIS: posts big blind €0.02
*** HOLE CARDS ***
Dealt to caduceus369 [6c Js]
caduceus369: folds 
panzapelata: calls €0.02
VagALiss: folds 
IKARO_3: folds 
capzanetti444: calls €0.01
ADRIAN0_MEIS: checks 
*** FLOP *** [8s As 2d]
capzanetti444: bets €0.06
ADRIAN0_MEIS: folds 
panzapelata: folds 
Uncalled bet (€0.06) returned to capzanetti444
capzanetti444 collected €0.06 from pot
capzanetti444: doesn't show hand 
*** SUMMARY ***
Total pot €0.06 | Rake €0 
Board [8s As 2d]
Seat 1: IKARO_3 (button) folded before Flop (didn't bet)
Seat 2: capzanetti444 (small blind) collected (€0.06)
Seat 3: ADRIAN0_MEIS (big blind) folded on the Flop
Seat 4: caduceus369 folded before Flop (didn't bet)
Seat 5: panzapelata folded on the Flop
Seat 6: VagALiss folded before Flop (didn't bet)



PokerStars Zoom Hand #257998180516:  Hold'em No Limit (€0.01/€0.02) [ADM ID: M62BD3044A1E13PD] - 2025/10/04 20:35:43 CET [2025/10/04 14:35:43 ET]
Table 'Sirio' 6-max Seat #1 is the button
Seat 1: Artemis1a (€3.83 in chips) 
Seat 2: Wunschgast (€3.85 in chips) 
Seat 3: VagALiss (€1.64 in chips) 
Seat 4: ghosto69 (€2.87 in chips) 
Seat 5: ADRIAN0_MEIS (€4.58 in chips) 
Seat 6: caduceus369 (€2.12 in chips) 
Wunschgast: posts small blind €0.01
VagALiss: posts big blind €0.02
*** HOLE CARDS ***
Dealt to caduceus369 [2s 8s]
ghosto69: folds 
ADRIAN0_MEIS: folds 
caduceus369: folds 
Artemis1a: folds 
Wunschgast: folds 
Uncalled bet (€0.01) returned to VagALiss
VagALiss collected €0.02 from pot
VagALiss: doesn't show hand 
*** SUMMARY ***
Total pot €0.02 | Rake €0 
Seat 1: Artemis1a (button) folded before Flop (didn't bet)
Seat 2: Wunschgast (small blind) folded before Flop
Seat 3: VagALiss (big blind) collected (€0.02)
Seat 4: ghosto69 folded before Flop (didn't bet)
Seat 5: ADRIAN0_MEIS folded before Flop (didn't bet)
Seat 6: caduceus369 folded before Flop (didn't bet)



PokerStars Zoom Hand #257998172964:  Hold'em No Limit (€0.01/€0.02) [ADM ID: M62BD3044A1E13PD] - 2025/10/04 20:35:09 CET [2025/10/04 14:35:09 ET]
Table 'Sirio' 6-max Seat #1 is the button
Seat 1: RRsanto (€2.10 in chips) 
Seat 2: rounders121282 (€1.79 in chips) 
Seat 3: ghosto69 (€2.89 in chips) 
Seat 4: ADRIAN0_MEIS (€2.37 in chips) 
Seat 5: pallone1969 (€2.30 in chips) 
Seat 6: caduceus369 (€2.13 in chips) 
rounders121282: posts small blind €0.01
ghosto69: posts big blind €0.02
*** HOLE CARDS ***
Dealt to caduceus369 [4s Ah]
ADRIAN0_MEIS: folds 
pallone1969: calls €0.02
caduceus369: folds 
RRsanto: raises €0.06 to €0.08
rounders121282: calls €0.07
ghosto69: folds 
pallone1969: calls €0.06
*** FLOP *** [7s Ks 2d]
rounders121282: checks 
pallone1969: bets €0.25
RRsanto: folds 
rounders121282: folds 
Uncalled bet (€0.25) returned to pallone1969
pallone1969 collected €0.25 from pot
pallone1969: doesn't show hand 
*** SUMMARY ***
Total pot €0.26 | Rake €0.01 
Board [7s Ks 2d]
Seat 1: RRsanto (button) folded on the Flop
Seat 2: rounders121282 (small blind) folded on the Flop
Seat 3: ghosto69 (big blind) folded before Flop
Seat 4: ADRIAN0_MEIS folded before Flop (didn't bet)
Seat 5: pallone1969 collected (€0.25)
Seat 6: caduceus369 folded before Flop (didn't bet)



PokerStars Zoom Hand #257998182474:  Hold'em No Limit (€0.01/€0.02) [ADM ID: M62BD3044A1E13PD] - 2025/10/04 20:35:51 CET [2025/10/04 14:35:51 ET]
Table 'Sirio' 6-max Seat #1 is the button
Seat 1: ADRIAN0_MEIS (€4.58 in chips) 
Seat 2: GanchanS7 (€3.26 in chips) 
Seat 3: caduceus369 (€2.12 in chips) 
Seat 4: Wunschgast (€3.84 in chips) 
Seat 5: Artemis1a (€1.96 in chips) 
Seat 6: IKARO_3 (€0.61 in chips) 
GanchanS7: posts small blind €0.01
caduceus369: posts big blind €0.02
*** HOLE CARDS ***
Dealt to caduceus369 [As Tc]
Wunschgast: folds 
Artemis1a: raises €0.02 to €0.04
IKARO_3: folds 
ADRIAN0_MEIS: folds 
GanchanS7: folds 
caduceus369: calls €0.02
*** FLOP *** [2s Js 6h]
caduceus369: checks 
Artemis1a: bets €0.09
caduceus369: folds 
Uncalled bet (€0.09) returned to Artemis1a
Artemis1a collected €0.09 from pot
Artemis1a: doesn't show hand 
*** SUMMARY ***
Total pot €0.09 | Rake €0 
Board [2s Js 6h]
Seat 1: ADRIAN0_MEIS (button) folded before Flop (didn't bet)
Seat 2: GanchanS7 (small blind) folded before Flop
Seat 3: caduceus369 (big blind) folded on the Flop
Seat 4: Wunschgast folded before Flop (didn't bet)
Seat 5: Artemis1a collected (€0.09)
Seat 6: IKARO_3 folded before Flop (didn't bet)



PokerStars Zoom Hand #257998187490:  Hold'em No Limit (€0.01/€0.02) [ADM ID: M62BD3044A1E13PD] - 2025/10/04 20:36:14 CET [2025/10/04 14:36:14 ET]
Table 'Sirio' 6-max Seat #1 is the button
Seat 1: ghosto69 (€3.80 in chips) 
Seat 2: Chia9711 (€1.95 in chips) 
Seat 3: ADRIAN0_MEIS (€3.37 in chips) 
Seat 4: gattapone81 (€0.07 in chips) 
Seat 5: Artemis1a (€3.77 in chips) 
Seat 6: caduceus369 (€2.08 in chips) 
Chia9711: posts small blind €0.01
ADRIAN0_MEIS: posts big blind €0.02
*** HOLE CARDS ***
Dealt to caduceus369 [Ac Kh]
gattapone81: folds 
Artemis1a: folds 
caduceus369: raises €0.04 to €0.06
ghosto69: folds 
Chia9711: folds 
ADRIAN0_MEIS: folds 
Uncalled bet (€0.04) returned to caduceus369
caduceus369 collected €0.05 from pot
caduceus369: doesn't show hand 
*** SUMMARY ***
Total pot €0.05 | Rake €0 
Seat 1: ghosto69 (button) folded before Flop (didn't bet)
Seat 2: Chia9711 (small blind) folded before Flop
Seat 3: ADRIAN0_MEIS (big blind) folded before Flop
Seat 4: gattapone81 folded before Flop (didn't bet)
Seat 5: Artemis1a folded before Flop (didn't bet)
Seat 6: caduceus369 collected (€0.05)



PokerStars Zoom Hand #257998177902:  Hold'em No Limit (€0.01/€0.02) [ADM ID: M62BD3044A1E13PD] - 2025/10/04 20:35:31 CET [2025/10/04 14:35:31 ET]
Table 'Sirio' 6-max Seat #1 is the button
Seat 1: caduceus369 (€2.12 in chips) 
Seat 2: VagALiss (€1.65 in chips) 
Seat 3: ADRIAN0_MEIS (€4.85 in chips) 
Seat 4: amigliaccio (€2.09 in chips) 
Seat 5: Wunschgast (€3.85 in chips) 
Seat 6: pallone1969 (€1.52 in chips) 
VagALiss: posts small blind €0.01
ADRIAN0_MEIS: posts big blind €0.02
*** HOLE CARDS ***
Dealt to caduceus369 [8s 4s]
amigliaccio: calls €0.02
Wunschgast: folds 
pallone1969: calls €0.02
caduceus369: folds 
VagALiss: folds 
ADRIAN0_MEIS: checks 
*** FLOP *** [5c Qs 9h]
ADRIAN0_MEIS: checks 
amigliaccio: checks 
pallone1969: bets €0.02
ADRIAN0_MEIS: folds 
amigliaccio: calls €0.02
*** TURN *** [5c Qs 9h] [Qd]
amigliaccio: checks 
pallone1969: bets €0.04
amigliaccio: calls €0.04
*** RIVER *** [5c Qs 9h Qd] [7c]
amigliaccio: checks 
pallone1969: bets €0.02
amigliaccio: calls €0.02
*** SHOW DOWN ***
pallone1969: shows [7s 9d] (two pair, Queens and Nines)
amigliaccio: mucks hand 
pallone1969 collected €0.22 from pot
*** SUMMARY ***
Total pot €0.23 | Rake €0.01 
Board [5c Qs 9h Qd 7c]
Seat 1: caduceus369 (button) folded before Flop (didn't bet)
Seat 2: VagALiss (small blind) folded before Flop
Seat 3: ADRIAN0_MEIS (big blind) folded on the Flop
Seat 4: amigliaccio mucked [Ah 5h]
Seat 5: Wunschgast folded before Flop (didn't bet)
Seat 6: pallone1969 showed [7s 9d] and won (€0.22) with two pair, Queens and Nines



PokerStars Zoom Hand #257998191045:  Hold'em No Limit (€0.01/€0.02) [ADM ID: M62BD3044A1E13PD] - 2025/10/04 20:36:30 CET [2025/10/04 14:36:30 ET]
Table 'Sirio' 6-max Seat #1 is the button
Seat 1: Chia9711 (€1.94 in chips) 
Seat 2: ghosto69 (€3.80 in chips) 
Seat 3: panzapelata (€1.11 in chips) 
Seat 4: Gabrielefante (€4.25 in chips) 
Seat 5: caduceus369 (€2.11 in chips) 
Seat 6: GIacius (€2.39 in chips) 
ghosto69: posts small blind €0.01
panzapelata: posts big blind €0.02
*** HOLE CARDS ***
Dealt to caduceus369 [5c Ad]
Gabrielefante: folds 
caduceus369: raises €0.04 to €0.06
GIacius: folds 
Chia9711: folds 
ghosto69: folds 
panzapelata: folds 
Uncalled bet (€0.04) returned to caduceus369
caduceus369 collected €0.05 from pot
caduceus369: doesn't show hand 
*** SUMMARY ***
Total pot €0.05 | Rake €0 
Seat 1: Chia9711 (button) folded before Flop (didn't bet)
Seat 2: ghosto69 (small blind) folded before Flop
Seat 3: panzapelata (big blind) folded before Flop
Seat 4: Gabrielefante folded before Flop (didn't bet)
Seat 5: caduceus369 collected (€0.05)
Seat 6: GIacius folded before Flop (didn't bet)



PokerStars Zoom Hand #257998193868:  Hold'em No Limit (€0.01/€0.02) [ADM ID: M62BD3044A1E13PD] - 2025/10/04 20:36:43 CET [2025/10/04 14:36:43 ET]
Table 'Sirio' 6-max Seat #1 is the button
Seat 1: Goal779 (€1 in chips) 
Seat 2: caduceus369 (€2.14 in chips) 
Seat 3: shakthi (€2.21 in chips) 
Seat 4: Artemis1a (€3.76 in chips) 
Seat 5: capzanetti444 (€2.30 in chips) 
Seat 6: GanchanS7 (€2 in chips) 
caduceus369: posts small blind €0.01
shakthi: posts big blind €0.02
*** HOLE CARDS ***
Dealt to caduceus369 [6h Ts]
Artemis1a: folds 
capzanetti444: calls €0.02
GanchanS7: folds 
Goal779: raises €0.10 to €0.12
caduceus369: folds 
shakthi: folds 
capzanetti444: calls €0.10
*** FLOP *** [7d 6d Kh]
capzanetti444: checks 
Goal779: bets €0.14
capzanetti444: folds 
Uncalled bet (€0.14) returned to Goal779
Goal779 collected €0.26 from pot
Goal779: doesn't show hand 
*** SUMMARY ***
Total pot €0.27 | Rake €0.01 
Board [7d 6d Kh]
Seat 1: Goal779 (button) collected (€0.26)
Seat 2: caduceus369 (small blind) folded before Flop
Seat 3: shakthi (big blind) folded before Flop
Seat 4: Artemis1a folded before Flop (didn't bet)
Seat 5: capzanetti444 folded on the Flop
Seat 6: GanchanS7 folded before Flop (didn't bet)



PokerStars Zoom Hand #257998196238:  Hold'em No Limit (€0.01/€0.02) [ADM ID: M62BD3044A1E13PD] - 2025/10/04 20:36:54 CET [2025/10/04 14:36:54 ET]
Table 'Sirio' 6-max Seat #1 is the button
Seat 1: GanchanS7 (€4.25 in chips) 
Seat 2: VagALiss (€1.83 in chips) 
Seat 3: Clint934 (€1.29 in chips) 
Seat 4: RRsanto (€2 in chips) 
Seat 5: caduceus369 (€2.13 in chips) 
Seat 6: GIacius (€2.39 in chips) 
VagALiss: posts small blind €0.01
Clint934: posts big blind €0.02
*** HOLE CARDS ***
Dealt to caduceus369 [5c 4c]
RRsanto: folds 
caduceus369: folds 
GIacius: raises €0.03 to €0.05
GanchanS7: folds 
VagALiss: folds 
Clint934: folds 
Uncalled bet (€0.03) returned to GIacius
GIacius collected €0.05 from pot
GIacius: doesn't show hand 
*** SUMMARY ***
Total pot €0.05 | Rake €0 
Seat 1: GanchanS7 (button) folded before Flop (didn't bet)
Seat 2: VagALiss (small blind) folded before Flop
Seat 3: Clint934 (big blind) folded before Flop
Seat 4: RRsanto folded before Flop (didn't bet)
Seat 5: caduceus369 folded before Flop (didn't bet)
Seat 6: GIacius collected (€0.05)



PokerStars Zoom Hand #257998200691:  Hold'em No Limit (€0.01/€0.02) [ADM ID: M62BD3044A1E13PD] - 2025/10/04 20:37:14 CET [2025/10/04 14:37:14 ET]
Table 'Sirio' 6-max Seat #1 is the button
Seat 1: amigliaccio (€1.95 in chips) 
Seat 2: GanchanS7 (€2.83 in chips) 
Seat 3: Wunschgast (€3.76 in chips) 
Seat 4: caduceus369 (€2.13 in chips) 
Seat 5: nicolobs (€2 in chips) 
Seat 6: willydag94 (€2.64 in chips) 
GanchanS7: posts small blind €0.01
Wunschgast: posts big blind €0.02
*** HOLE CARDS ***
Dealt to caduceus369 [Kd Ac]
caduceus369: raises €0.04 to €0.06
nicolobs: folds 
willydag94: folds 
amigliaccio: folds 
GanchanS7: folds 
Wunschgast: folds 
Uncalled bet (€0.04) returned to caduceus369
caduceus369 collected €0.05 from pot
caduceus369: doesn't show hand 
*** SUMMARY ***
Total pot €0.05 | Rake €0 
Seat 1: amigliaccio (button) folded before Flop (didn't bet)
Seat 2: GanchanS7 (small blind) folded before Flop
Seat 3: Wunschgast (big blind) folded before Flop
Seat 4: caduceus369 collected (€0.05)
Seat 5: nicolobs folded before Flop (didn't bet)
Seat 6: willydag94 folded before Flop (didn't bet)



PokerStars Zoom Hand #257998205653:  Hold'em No Limit (€0.01/€0.02) [ADM ID: M62BD3044A1E13PD] - 2025/10/04 20:37:37 CET [2025/10/04 14:37:37 ET]
Table 'Sirio' 6-max Seat #1 is the button
Seat 1: willydag94 (€2.62 in chips) 
Seat 2: amigliaccio (€1.93 in chips) 
Seat 3: caduceus369 (€2.16 in chips) 
Seat 4: GIacius (€5.23 in chips) 
Seat 5: potodds1979 (€2.14 in chips) 
Seat 6: GanchanS7 (€4.25 in chips) 
amigliaccio: posts small blind €0.01
caduceus369: posts big blind €0.02
*** HOLE CARDS ***
Dealt to caduceus369 [Qh 7d]
GIacius: raises €0.02 to €0.04
potodds1979: folds 
GanchanS7: folds 
willydag94: folds 
amigliaccio: folds 
caduceus369: calls €0.02
*** FLOP *** [Tc 2c Th]
caduceus369: checks 
GIacius: checks 
*** TURN *** [Tc 2c Th] [3s]
caduceus369: bets €0.03
GIacius: calls €0.03
*** RIVER *** [Tc 2c Th 3s] [9h]
caduceus369: bets €0.06
GIacius: raises €0.37 to €0.43
caduceus369: folds 
Uncalled bet (€0.37) returned to GIacius
GIacius collected €0.26 from pot
GIacius: doesn't show hand 
*** SUMMARY ***
Total pot €0.27 | Rake €0.01 
Board [Tc 2c Th 3s 9h]
Seat 1: willydag94 (button) folded before Flop (didn't bet)
Seat 2: amigliaccio (small blind) folded before Flop
Seat 3: caduceus369 (big blind) folded on the River
Seat 4: GIacius collected (€0.26)
Seat 5: potodds1979 folded before Flop (didn't bet)
Seat 6: GanchanS7 folded before Flop (didn't bet)



PokerStars Zoom Hand #257998217343:  Hold'em No Limit (€0.01/€0.02) [ADM ID: M62BD3044A1E13PD] - 2025/10/04 20:38:30 CET [2025/10/04 14:38:30 ET]
Table 'Sirio' 6-max Seat #1 is the button
Seat 1: caduceus369 (€2.03 in chips) 
Seat 2: IKARO_3 (€0.93 in chips) 
Seat 3: Chia9711 (€2.10 in chips) 
Seat 4: GanchanS7 (€2.08 in chips) 
Seat 5: amigliaccio (€1.89 in chips) 
Seat 6: Warterror90 (€1.06 in chips) 
IKARO_3: posts small blind €0.01
Chia9711: posts big blind €0.02
*** HOLE CARDS ***
Dealt to caduceus369 [As Qc]
GanchanS7 has timed out
GanchanS7: folds 
amigliaccio: folds 
Warterror90: folds 
caduceus369: raises €0.04 to €0.06
IKARO_3: folds 
Chia9711: calls €0.04
*** FLOP *** [Ts Kh 3h]
Chia9711: checks 
caduceus369: bets €0.06
Chia9711: folds 
Uncalled bet (€0.06) returned to caduceus369
caduceus369 collected €0.13 from pot
caduceus369: doesn't show hand 
*** SUMMARY ***
Total pot €0.13 | Rake €0 
Board [Ts Kh 3h]
Seat 1: caduceus369 (button) collected (€0.13)
Seat 2: IKARO_3 (small blind) folded before Flop
Seat 3: Chia9711 (big blind) folded on the Flop
Seat 4: GanchanS7 folded before Flop (didn't bet)
Seat 5: amigliaccio folded before Flop (didn't bet)
Seat 6: Warterror90 folded before Flop (didn't bet)



PokerStars Zoom Hand #257998224401:  Hold'em No Limit (€0.01/€0.02) [ADM ID: M62BD3044A1E13PD] - 2025/10/04 20:39:02 CET [2025/10/04 14:39:02 ET]
Table 'Sirio' 6-max Seat #1 is the button
Seat 1: Ragusa81 (€0.68 in chips) 
Seat 2: flippone78 (€1.98 in chips) 
Seat 3: gattapone81 (€0.11 in chips) 
Seat 4: Wunschgast (€3.61 in chips) 
Seat 5: VagALiss (€1.77 in chips) 
Seat 6: caduceus369 (€2.10 in chips) 
flippone78: posts small blind €0.01
gattapone81: posts big blind €0.02
*** HOLE CARDS ***
Dealt to caduceus369 [Ac 6d]
Wunschgast: folds 
VagALiss: folds 
caduceus369: raises €0.04 to €0.06
Ragusa81: folds 
flippone78: folds 
gattapone81: calls €0.04
*** FLOP *** [Jh 9d 4h]
gattapone81: checks 
caduceus369: checks 
*** TURN *** [Jh 9d 4h] [5c]
gattapone81: checks 
caduceus369: checks 
*** RIVER *** [Jh 9d 4h 5c] [Qd]
gattapone81: checks 
caduceus369: checks 
*** SHOW DOWN ***
gattapone81: shows [3h Kc] (high card King)
caduceus369: shows [Ac 6d] (high card Ace)
caduceus369 collected €0.13 from pot
*** SUMMARY ***
Total pot €0.13 | Rake €0 
Board [Jh 9d 4h 5c Qd]
Seat 1: Ragusa81 (button) folded before Flop (didn't bet)
Seat 2: flippone78 (small blind) folded before Flop
Seat 3: gattapone81 (big blind) showed [3h Kc] and lost with high card King
Seat 4: Wunschgast folded before Flop (didn't bet)
Seat 5: VagALiss folded before Flop (didn't bet)
Seat 6: caduceus369 showed [Ac 6d] and won (€0.13) with high card Ace



PokerStars Zoom Hand #257998231813:  Hold'em No Limit (€0.01/€0.02) [ADM ID: M62BD3044A1E13PD] - 2025/10/04 20:39:35 CET [2025/10/04 14:39:35 ET]
Table 'Sirio' 6-max Seat #1 is the button
Seat 1: caduceus369 (€2.17 in chips) 
Seat 2: GanchanS7 (€3.20 in chips) 
Seat 3: flippone78 (€2 in chips) 
Seat 4: IKARO_3 (€1.06 in chips) 
Seat 5: Artemis1a (€3.31 in chips) 
Seat 6: gattapone81 (€0.05 in chips) 
GanchanS7: posts small blind €0.01
flippone78: posts big blind €0.02
*** HOLE CARDS ***
Dealt to caduceus369 [Th Kh]
IKARO_3: raises €0.04 to €0.06
Artemis1a: folds 
gattapone81: folds 
caduceus369: raises €0.12 to €0.18
GanchanS7: folds 
flippone78: folds 
IKARO_3: raises €0.88 to €1.06 and is all-in
caduceus369: folds 
Uncalled bet (€0.88) returned to IKARO_3
IKARO_3 collected €0.39 from pot
IKARO_3: doesn't show hand 
*** SUMMARY ***
Total pot €0.39 | Rake €0 
Seat 1: caduceus369 (button) folded before Flop
Seat 2: GanchanS7 (small blind) folded before Flop
Seat 3: flippone78 (big blind) folded before Flop
Seat 4: IKARO_3 collected (€0.39)
Seat 5: Artemis1a folded before Flop (didn't bet)
Seat 6: gattapone81 folded before Flop (didn't bet)



PokerStars Zoom Hand #257998239233:  Hold'em No Limit (€0.01/€0.02) [ADM ID: M62BD3044A1E13PD] - 2025/10/04 20:40:09 CET [2025/10/04 14:40:09 ET]
Table 'Sirio' 6-max Seat #1 is the button
Seat 1: monsterc99 (€0.71 in chips) 
Seat 2: RRsanto (€2 in chips) 
Seat 3: Ragusa81 (€0.68 in chips) 
Seat 4: caduceus369 (€2 in chips) 
Seat 5: shakthi (€2 in chips) 
Seat 6: nicolobs (€2.83 in chips) 
RRsanto: posts small blind €0.01
Ragusa81: posts big blind €0.02
*** HOLE CARDS ***
Dealt to caduceus369 [6d As]
caduceus369: folds 
shakthi: raises €0.02 to €0.04
nicolobs: raises €0.12 to €0.16
monsterc99: folds 
RRsanto: folds 
Ragusa81: folds 
shakthi: folds 
Uncalled bet (€0.12) returned to nicolobs
nicolobs collected €0.11 from pot
nicolobs: doesn't show hand 
*** SUMMARY ***
Total pot €0.11 | Rake €0 
Seat 1: monsterc99 (button) folded before Flop (didn't bet)
Seat 2: RRsanto (small blind) folded before Flop
Seat 3: Ragusa81 (big blind) folded before Flop
Seat 4: caduceus369 folded before Flop (didn't bet)
Seat 5: shakthi folded before Flop
Seat 6: nicolobs collected (€0.11)



PokerStars Zoom Hand #257998240591:  Hold'em No Limit (€0.01/€0.02) [ADM ID: M62BD3044A1E13PD] - 2025/10/04 20:40:15 CET [2025/10/04 14:40:15 ET]
Table 'Sirio' 6-max Seat #1 is the button
Seat 1: trisco66 (€0.93 in chips) 
Seat 2: caduceus369 (€2 in chips) 
Seat 3: vckjakcon97 (€1.10 in chips) 
Seat 4: monsterc99 (€0.71 in chips) 
Seat 5: ADRIAN0_MEIS (€4.54 in chips) 
Seat 6: Gabrielefante (€4.28 in chips) 
caduceus369: posts small blind €0.01
vckjakcon97: posts big blind €0.02
*** HOLE CARDS ***
Dealt to caduceus369 [6c Th]
monsterc99: folds 
ADRIAN0_MEIS: folds 
Gabrielefante: raises €0.04 to €0.06
trisco66: folds 
caduceus369: folds 
vckjakcon97: folds 
Uncalled bet (€0.04) returned to Gabrielefante
Gabrielefante collected €0.05 from pot
Gabrielefante: doesn't show hand 
*** SUMMARY ***
Total pot €0.05 | Rake €0 
Seat 1: trisco66 (button) folded before Flop (didn't bet)
Seat 2: caduceus369 (small blind) folded before Flop
Seat 3: vckjakcon97 (big blind) folded before Flop
Seat 4: monsterc99 folded before Flop (didn't bet)
Seat 5: ADRIAN0_MEIS folded before Flop (didn't bet)
Seat 6: Gabrielefante collected (€0.05)



PokerStars Zoom Hand #257998242170:  Hold'em No Limit (€0.01/€0.02) [ADM ID: M62BD3044A1E13PD] - 2025/10/04 20:40:22 CET [2025/10/04 14:40:22 ET]
Table 'Sirio' 6-max Seat #1 is the button
Seat 1: Ragusa81 (€0.66 in chips) 
Seat 2: Artemis1a (€3 in chips) 
Seat 3: caduceus369 (€2 in chips) 
Seat 4: RRsanto (€2 in chips) 
Seat 5: GanchanS7 (€2.76 in chips) 
Seat 6: ADRIAN0_MEIS (€4.54 in chips) 
Artemis1a: posts small blind €0.01
caduceus369: posts big blind €0.02
*** HOLE CARDS ***
Dealt to caduceus369 [4c 4h]
RRsanto: folds 
GanchanS7: folds 
ADRIAN0_MEIS: folds 
Ragusa81: calls €0.02
Artemis1a: raises €0.08 to €0.10
caduceus369: folds 
Ragusa81: calls €0.08
*** FLOP *** [Tc 8d 5s]
Artemis1a: bets €0.11
Ragusa81: folds 
Uncalled bet (€0.11) returned to Artemis1a
Artemis1a collected €0.21 from pot
Artemis1a: doesn't show hand 
*** SUMMARY ***
Total pot €0.22 | Rake €0.01 
Board [Tc 8d 5s]
Seat 1: Ragusa81 (button) folded on the Flop
Seat 2: Artemis1a (small blind) collected (€0.21)
Seat 3: caduceus369 (big blind) folded before Flop
Seat 4: RRsanto folded before Flop (didn't bet)
Seat 5: GanchanS7 folded before Flop (didn't bet)
Seat 6: ADRIAN0_MEIS folded before Flop (didn't bet)



PokerStars Zoom Hand #257998251130:  Hold'em No Limit (€0.01/€0.02) [ADM ID: M62BD3044A1E13PD] - 2025/10/04 20:41:03 CET [2025/10/04 14:41:03 ET]
Table 'Sirio' 6-max Seat #1 is the button
Seat 1: caduceus369 (€2 in chips) 
Seat 2: panzapelata (€1.41 in chips) 
Seat 3: Artemis1a (€3.28 in chips) 
Seat 4: Chia9711 (€1.98 in chips) 
Seat 5: GanchanS7 (€3.94 in chips) 
Seat 6: vckjakcon97 (€1.10 in chips) 
panzapelata: posts small blind €0.01
Artemis1a: posts big blind €0.02
*** HOLE CARDS ***
Dealt to caduceus369 [Tc Qs]
Chia9711: folds 
GanchanS7: folds 
vckjakcon97: folds 
caduceus369: raises €0.04 to €0.06
panzapelata: folds 
Artemis1a: folds 
Uncalled bet (€0.04) returned to caduceus369
caduceus369 collected €0.05 from pot
caduceus369: doesn't show hand 
*** SUMMARY ***
Total pot €0.05 | Rake €0 
Seat 1: caduceus369 (button) collected (€0.05)
Seat 2: panzapelata (small blind) folded before Flop
Seat 3: Artemis1a (big blind) folded before Flop
Seat 4: Chia9711 folded before Flop (didn't bet)
Seat 5: GanchanS7 folded before Flop (didn't bet)
Seat 6: vckjakcon97 folded before Flop (didn't bet)



PokerStars Zoom Hand #257998246713:  Hold'em No Limit (€0.01/€0.02) [ADM ID: M62BD3044A1E13PD] - 2025/10/04 20:40:43 CET [2025/10/04 14:40:43 ET]
Table 'Sirio' 6-max Seat #1 is the button
Seat 1: ADRIAN0_MEIS (€4.98 in chips) 
Seat 2: Black98Demon (€2.13 in chips) 
Seat 3: Gabrielefante (€4.30 in chips) 
Seat 4: panzapelata (€1.50 in chips) 
Seat 5: caduceus369 (€2 in chips) 
Seat 6: IKARO_3 (€1.27 in chips) 
Black98Demon: posts small blind €0.01
Gabrielefante: posts big blind €0.02
*** HOLE CARDS ***
Dealt to caduceus369 [Qc 9d]
panzapelata: folds 
caduceus369: folds 
IKARO_3: folds 
ADRIAN0_MEIS: raises €0.04 to €0.06
Black98Demon: folds 
Gabrielefante: calls €0.04
*** FLOP *** [7h 3c 7d]
Gabrielefante: checks 
ADRIAN0_MEIS: bets €0.07
Gabrielefante: folds 
Uncalled bet (€0.07) returned to ADRIAN0_MEIS
ADRIAN0_MEIS collected €0.13 from pot
ADRIAN0_MEIS: doesn't show hand 
*** SUMMARY ***
Total pot €0.13 | Rake €0 
Board [7h 3c 7d]
Seat 1: ADRIAN0_MEIS (button) collected (€0.13)
Seat 2: Black98Demon (small blind) folded before Flop
Seat 3: Gabrielefante (big blind) folded on the Flop
Seat 4: panzapelata folded before Flop (didn't bet)
Seat 5: caduceus369 folded before Flop (didn't bet)
Seat 6: IKARO_3 folded before Flop (didn't bet)



PokerStars Zoom Hand #257998249138:  Hold'em No Limit (€0.01/€0.02) [ADM ID: M62BD3044A1E13PD] - 2025/10/04 20:40:54 CET [2025/10/04 14:40:54 ET]
Table 'Sirio' 6-max Seat #1 is the button
Seat 1: panzapelata (€1.81 in chips) 
Seat 2: caduceus369 (€2 in chips) 
Seat 3: GanchanS7 (€5 in chips) 
Seat 4: capzanetti444 (€2.19 in chips) 
Seat 5: IKARO_3 (€1.27 in chips) 
Seat 6: ghosto69 (€3.40 in chips) 
caduceus369: posts small blind €0.01
GanchanS7: posts big blind €0.02
*** HOLE CARDS ***
Dealt to caduceus369 [3c 4c]
capzanetti444: calls €0.02
IKARO_3: folds 
ghosto69: folds 
panzapelata: folds 
caduceus369: folds 
GanchanS7: checks 
*** FLOP *** [2c Ts Qs]
GanchanS7: checks 
capzanetti444: bets €0.14
GanchanS7: folds 
Uncalled bet (€0.14) returned to capzanetti444
capzanetti444 collected €0.05 from pot
capzanetti444: doesn't show hand 
*** SUMMARY ***
Total pot €0.05 | Rake €0 
Board [2c Ts Qs]
Seat 1: panzapelata (button) folded before Flop (didn't bet)
Seat 2: caduceus369 (small blind) folded before Flop
Seat 3: GanchanS7 (big blind) folded on the Flop
Seat 4: capzanetti444 collected (€0.05)
Seat 5: IKARO_3 folded before Flop (didn't bet)
Seat 6: ghosto69 folded before Flop (didn't bet)



PokerStars Zoom Hand #257998254828:  Hold'em No Limit (€0.01/€0.02) [ADM ID: M62BD3044A1E13PD] - 2025/10/04 20:41:20 CET [2025/10/04 14:41:20 ET]
Table 'Sirio' 6-max Seat #1 is the button
Seat 1: shakthi (€1.63 in chips) 
Seat 2: ghosto69 (€3.77 in chips) 
Seat 3: GanchanS7 (€3.94 in chips) 
Seat 4: ADRIAN0_MEIS (€3.81 in chips) 
Seat 5: Artemis1a (€3.41 in chips) 
Seat 6: caduceus369 (€2.03 in chips) 
ghosto69: posts small blind €0.01
GanchanS7: posts big blind €0.02
*** HOLE CARDS ***
Dealt to caduceus369 [Qh Jd]
ADRIAN0_MEIS: folds 
Artemis1a: folds 
caduceus369: raises €0.04 to €0.06
shakthi: calls €0.06
ghosto69: folds 
GanchanS7: calls €0.04
*** FLOP *** [Ts 7c 2c]
GanchanS7: checks 
caduceus369: checks 
shakthi: checks 
*** TURN *** [Ts 7c 2c] [Ks]
GanchanS7: bets €0.05
caduceus369: calls €0.05
shakthi: folds 
*** RIVER *** [Ts 7c 2c Ks] [4c]
GanchanS7: bets €0.13
caduceus369: folds 
Uncalled bet (€0.13) returned to GanchanS7
GanchanS7 collected €0.28 from pot
GanchanS7: doesn't show hand 
*** SUMMARY ***
Total pot €0.29 | Rake €0.01 
Board [Ts 7c 2c Ks 4c]
Seat 1: shakthi (button) folded on the Turn
Seat 2: ghosto69 (small blind) folded before Flop
Seat 3: GanchanS7 (big blind) collected (€0.28)
Seat 4: ADRIAN0_MEIS folded before Flop (didn't bet)
Seat 5: Artemis1a folded before Flop (didn't bet)
Seat 6: caduceus369 folded on the River



PokerStars Zoom Hand #257998269929:  Hold'em No Limit (€0.01/€0.02) [ADM ID: M62BD3044A1E13PD] - 2025/10/04 20:42:30 CET [2025/10/04 14:42:30 ET]
Table 'Sirio' 6-max Seat #1 is the button
Seat 1: ADRIAN0_MEIS (€5.04 in chips) 
Seat 2: pietr056 (€1.53 in chips) 
Seat 3: panzapelata (€1.47 in chips) 
Seat 4: ghosto69 (€3.32 in chips) 
Seat 5: amigliaccio (€1.87 in chips) 
Seat 6: caduceus369 (€2 in chips) 
pietr056: posts small blind €0.01
panzapelata: posts big blind €0.02
*** HOLE CARDS ***
Dealt to caduceus369 [4d 2h]
ghosto69: folds 
amigliaccio: folds 
caduceus369: folds 
ADRIAN0_MEIS: folds 
pietr056: folds 
Uncalled bet (€0.01) returned to panzapelata
panzapelata collected €0.02 from pot
panzapelata: doesn't show hand 
*** SUMMARY ***
Total pot €0.02 | Rake €0 
Seat 1: ADRIAN0_MEIS (button) folded before Flop (didn't bet)
Seat 2: pietr056 (small blind) folded before Flop
Seat 3: panzapelata (big blind) collected (€0.02)
Seat 4: ghosto69 folded before Flop (didn't bet)
Seat 5: amigliaccio folded before Flop (didn't bet)
Seat 6: caduceus369 folded before Flop (didn't bet)



PokerStars Zoom Hand #257998268234:  Hold'em No Limit (€0.01/€0.02) [ADM ID: M62BD3044A1E13PD] - 2025/10/04 20:42:22 CET [2025/10/04 14:42:22 ET]
Table 'Sirio' 6-max Seat #1 is the button
Seat 1: N0thingforU (€2 in chips) 
Seat 2: Wind9force (€3.50 in chips) 
Seat 3: ghosto69 (€3.85 in chips) 
Seat 4: ADRIAN0_MEIS (€5.04 in chips) 
Seat 5: caduceus369 (€2 in chips) 
Seat 6: RRsanto (€2.02 in chips) 
Wind9force: posts small blind €0.01
ghosto69: posts big blind €0.02
*** HOLE CARDS ***
Dealt to caduceus369 [8c Kc]
ADRIAN0_MEIS: folds 
caduceus369: folds 
RRsanto: raises €0.04 to €0.06
N0thingforU: folds 
Wind9force: calls €0.05
ghosto69: folds 
*** FLOP *** [5d 4s Kd]
Wind9force: checks 
RRsanto: checks 
*** TURN *** [5d 4s Kd] [4d]
Wind9force: checks 
RRsanto: bets €0.07
Wind9force: calls €0.07
*** RIVER *** [5d 4s Kd 4d] [7h]
Wind9force: checks 
RRsanto: checks 
*** SHOW DOWN ***
Wind9force: shows [Qd Qc] (two pair, Queens and Fours)
RRsanto: mucks hand 
Wind9force collected €0.27 from pot
*** SUMMARY ***
Total pot €0.28 | Rake €0.01 
Board [5d 4s Kd 4d 7h]
Seat 1: N0thingforU (button) folded before Flop (didn't bet)
Seat 2: Wind9force (small blind) showed [Qd Qc] and won (€0.27) with two pair, Queens and Fours
Seat 3: ghosto69 (big blind) folded before Flop
Seat 4: ADRIAN0_MEIS folded before Flop (didn't bet)
Seat 5: caduceus369 folded before Flop (didn't bet)
Seat 6: RRsanto mucked [9c Ad]



PokerStars Zoom Hand #257998271101:  Hold'em No Limit (€0.01/€0.02) [ADM ID: M62BD3044A1E13PD] - 2025/10/04 20:42:35 CET [2025/10/04 14:42:35 ET]
Table 'Sirio' 6-max Seat #1 is the button
Seat 1: amigliaccio (€1.87 in chips) 
Seat 2: monsterc99 (€0.75 in chips) 
Seat 3: ADRIAN0_MEIS (€5.04 in chips) 
Seat 4: caduceus369 (€2 in chips) 
Seat 5: ghosto69 (€3.32 in chips) 
Seat 6: IKARO_3 (€1.24 in chips) 
monsterc99: posts small blind €0.01
ADRIAN0_MEIS: posts big blind €0.02
*** HOLE CARDS ***
Dealt to caduceus369 [4c 5s]
caduceus369: folds 
ghosto69: folds 
IKARO_3: folds 
amigliaccio: folds 
monsterc99: calls €0.01
ADRIAN0_MEIS: checks 
*** FLOP *** [2s 6d 8h]
monsterc99: bets €0.04
ADRIAN0_MEIS: folds 
Uncalled bet (€0.04) returned to monsterc99
monsterc99 collected €0.04 from pot
monsterc99: doesn't show hand 
*** SUMMARY ***
Total pot €0.04 | Rake €0 
Board [2s 6d 8h]
Seat 1: amigliaccio (button) folded before Flop (didn't bet)
Seat 2: monsterc99 (small blind) collected (€0.04)
Seat 3: ADRIAN0_MEIS (big blind) folded on the Flop
Seat 4: caduceus369 folded before Flop (didn't bet)
Seat 5: ghosto69 folded before Flop (didn't bet)
Seat 6: IKARO_3 folded before Flop (didn't bet)



PokerStars Zoom Hand #257998275550:  Hold'em No Limit (€0.01/€0.02) [ADM ID: M62BD3044A1E13PD] - 2025/10/04 20:42:55 CET [2025/10/04 14:42:55 ET]
Table 'Sirio' 6-max Seat #1 is the button
Seat 1: VagALiss (€1.86 in chips) 
Seat 2: N0thingforU (€2 in chips) 
Seat 3: caduceus369 (€2 in chips) 
Seat 4: panzapelata (€1.32 in chips) 
Seat 5: vckjakcon97 (€1.26 in chips) 
Seat 6: lucpri (€1.20 in chips) 
N0thingforU: posts small blind €0.01
caduceus369: posts big blind €0.02
*** HOLE CARDS ***
Dealt to caduceus369 [8d Js]
panzapelata: folds 
vckjakcon97: folds 
lucpri: calls €0.02
VagALiss: folds 
N0thingforU: folds 
caduceus369: checks 
*** FLOP *** [9s 5s Th]
caduceus369: checks 
lucpri: checks 
*** TURN *** [9s 5s Th] [Qh]
caduceus369: bets €0.07
lucpri: folds 
Uncalled bet (€0.07) returned to caduceus369
caduceus369 collected €0.05 from pot
caduceus369: doesn't show hand 
*** SUMMARY ***
Total pot €0.05 | Rake €0 
Board [9s 5s Th Qh]
Seat 1: VagALiss (button) folded before Flop (didn't bet)
Seat 2: N0thingforU (small blind) folded before Flop
Seat 3: caduceus369 (big blind) collected (€0.05)
Seat 4: panzapelata folded before Flop (didn't bet)
Seat 5: vckjakcon97 folded before Flop (didn't bet)
Seat 6: lucpri folded on the Turn



PokerStars Zoom Hand #257998282457:  Hold'em No Limit (€0.01/€0.02) [ADM ID: M62BD3044A1E13PD] - 2025/10/04 20:43:26 CET [2025/10/04 14:43:26 ET]
Table 'Sirio' 6-max Seat #1 is the button
Seat 1: Warterror90 (€1.69 in chips) 
Seat 2: caduceus369 (€2.03 in chips) 
Seat 3: ADRIAN0_MEIS (€5.16 in chips) 
Seat 4: IKARO_3 (€1.58 in chips) 
Seat 5: RRsanto (€2 in chips) 
Seat 6: N0thingforU (€2 in chips) 
caduceus369: posts small blind €0.01
ADRIAN0_MEIS: posts big blind €0.02
*** HOLE CARDS ***
Dealt to caduceus369 [6d 9h]
IKARO_3: folds 
RRsanto: raises €0.04 to €0.06
N0thingforU: folds 
Warterror90: folds 
caduceus369: folds 
ADRIAN0_MEIS: folds 
Uncalled bet (€0.04) returned to RRsanto
RRsanto collected €0.05 from pot
RRsanto: doesn't show hand 
*** SUMMARY ***
Total pot €0.05 | Rake €0 
Seat 1: Warterror90 (button) folded before Flop (didn't bet)
Seat 2: caduceus369 (small blind) folded before Flop
Seat 3: ADRIAN0_MEIS (big blind) folded before Flop
Seat 4: IKARO_3 folded before Flop (didn't bet)
Seat 5: RRsanto collected (€0.05)
Seat 6: N0thingforU folded before Flop (didn't bet)



PokerStars Zoom Hand #257998284588:  Hold'em No Limit (€0.01/€0.02) [ADM ID: M62BD3044A1E13PD] - 2025/10/04 20:43:36 CET [2025/10/04 14:43:36 ET]
Table 'Sirio' 6-max Seat #1 is the button
Seat 1: Chia9711 (€1.42 in chips) 
Seat 2: GanchanS7 (€4.08 in chips) 
Seat 3: RRsanto (€2.97 in chips) 
Seat 4: caduceus369 (€2.02 in chips) 
Seat 5: shakthi (€1.82 in chips) 
Seat 6: vckjakcon97 (€1.26 in chips) 
GanchanS7: posts small blind €0.01
RRsanto: posts big blind €0.02
*** HOLE CARDS ***
Dealt to caduceus369 [Kd Ts]
caduceus369: folds 
shakthi: folds 
vckjakcon97: folds 
Chia9711: folds 
GanchanS7: folds 
Uncalled bet (€0.01) returned to RRsanto
RRsanto collected €0.02 from pot
RRsanto: doesn't show hand 
*** SUMMARY ***
Total pot €0.02 | Rake €0 
Seat 1: Chia9711 (button) folded before Flop (didn't bet)
Seat 2: GanchanS7 (small blind) folded before Flop
Seat 3: RRsanto (big blind) collected (€0.02)
Seat 4: caduceus369 folded before Flop (didn't bet)
Seat 5: shakthi folded before Flop (didn't bet)
Seat 6: vckjakcon97 folded before Flop (didn't bet)



PokerStars Zoom Hand #257998285628:  Hold'em No Limit (€0.01/€0.02) [ADM ID: M62BD3044A1E13PD] - 2025/10/04 20:43:41 CET [2025/10/04 14:43:41 ET]
Table 'Sirio' 6-max Seat #1 is the button
Seat 1: ADRIAN0_MEIS (€5.14 in chips) 
Seat 2: RRsanto (€2.03 in chips) 
Seat 3: caduceus369 (€2.02 in chips) 
Seat 4: pallone1969 (€1.58 in chips) 
Seat 5: panzapelata (€1.23 in chips) 
Seat 6: trisco66 (€1.68 in chips) 
RRsanto: posts small blind €0.01
caduceus369: posts big blind €0.02
*** HOLE CARDS ***
Dealt to caduceus369 [7c 4h]
pallone1969: folds 
panzapelata: folds 
trisco66: raises €0.10 to €0.12
ADRIAN0_MEIS: folds 
RRsanto: folds 
caduceus369: folds 
Uncalled bet (€0.10) returned to trisco66
trisco66 collected €0.05 from pot
trisco66: doesn't show hand 
*** SUMMARY ***
Total pot €0.05 | Rake €0 
Seat 1: ADRIAN0_MEIS (button) folded before Flop (didn't bet)
Seat 2: RRsanto (small blind) folded before Flop
Seat 3: caduceus369 (big blind) folded before Flop
Seat 4: pallone1969 folded before Flop (didn't bet)
Seat 5: panzapelata folded before Flop (didn't bet)
Seat 6: trisco66 collected (€0.05)



PokerStars Zoom Hand #257998271977:  Hold'em No Limit (€0.01/€0.02) [ADM ID: M62BD3044A1E13PD] - 2025/10/04 20:42:39 CET [2025/10/04 14:42:39 ET]
Table 'Sirio' 6-max Seat #1 is the button
Seat 1: ADRIAN0_MEIS (€2.34 in chips) 
Seat 2: IKARO_3 (€0.91 in chips) 
Seat 3: Warterror90 (€2 in chips) 
Seat 4: andregra11 (€1.23 in chips) 
Seat 5: caduceus369 (€2 in chips) 
Seat 6: GanchanS7 (€4.97 in chips) 
IKARO_3: posts small blind €0.01
Warterror90: posts big blind €0.02
*** HOLE CARDS ***
Dealt to caduceus369 [3s 4s]
andregra11: folds 
caduceus369: folds 
GanchanS7: folds 
ADRIAN0_MEIS: raises €0.03 to €0.05
IKARO_3: folds 
Warterror90: raises €0.11 to €0.16
ADRIAN0_MEIS: calls €0.11
*** FLOP *** [9c Qc 4d]
Warterror90: checks 
ADRIAN0_MEIS: checks 
*** TURN *** [9c Qc 4d] [9d]
Warterror90: checks 
ADRIAN0_MEIS: bets €0.18
Warterror90: calls €0.18
*** RIVER *** [9c Qc 4d 9d] [As]
Warterror90: bets €0.25
ADRIAN0_MEIS: folds 
Uncalled bet (€0.25) returned to Warterror90
Warterror90 collected €0.66 from pot
Warterror90: doesn't show hand 
*** SUMMARY ***
Total pot €0.69 | Rake €0.03 
Board [9c Qc 4d 9d As]
Seat 1: ADRIAN0_MEIS (button) folded on the River
Seat 2: IKARO_3 (small blind) folded before Flop
Seat 3: Warterror90 (big blind) collected (€0.66)
Seat 4: andregra11 folded before Flop (didn't bet)
Seat 5: caduceus369 folded before Flop (didn't bet)
Seat 6: GanchanS7 folded before Flop (didn't bet)



PokerStars Zoom Hand #257998283275:  Hold'em No Limit (€0.01/€0.02) [ADM ID: M62BD3044A1E13PD] - 2025/10/04 20:43:30 CET [2025/10/04 14:43:30 ET]
Table 'Sirio' 6-max Seat #1 is the button
Seat 1: caduceus369 (€2.02 in chips) 
Seat 2: CIKO71131 (€0.61 in chips) 
Seat 3: N0thingforU (€2 in chips) 
Seat 4: Wind9force (€3.64 in chips) 
Seat 5: Warterror90 (€1.69 in chips) 
Seat 6: potodds1979 (€2.08 in chips) 
CIKO71131: posts small blind €0.01
N0thingforU: posts big blind €0.02
*** HOLE CARDS ***
Dealt to caduceus369 [5h 3c]
Wind9force: folds 
Warterror90: folds 
potodds1979: raises €0.04 to €0.06
caduceus369: folds 
CIKO71131: folds 
N0thingforU: calls €0.04
*** FLOP *** [4c 9h 5d]
N0thingforU: checks 
potodds1979: bets €0.07
N0thingforU: calls €0.07
*** TURN *** [4c 9h 5d] [Kd]
N0thingforU: checks 
potodds1979: bets €0.18
N0thingforU: folds 
Uncalled bet (€0.18) returned to potodds1979
potodds1979 collected €0.26 from pot
potodds1979: doesn't show hand 
*** SUMMARY ***
Total pot €0.27 | Rake €0.01 
Board [4c 9h 5d Kd]
Seat 1: caduceus369 (button) folded before Flop (didn't bet)
Seat 2: CIKO71131 (small blind) folded before Flop
Seat 3: N0thingforU (big blind) folded on the Turn
Seat 4: Wind9force folded before Flop (didn't bet)
Seat 5: Warterror90 folded before Flop (didn't bet)
Seat 6: potodds1979 collected (€0.26)



PokerStars Zoom Hand #257998295135:  Hold'em No Limit (€0.01/€0.02) [ADM ID: M62BD3044A1E13PD] - 2025/10/04 20:44:24 CET [2025/10/04 14:44:24 ET]
Table 'Sirio' 6-max Seat #1 is the button
Seat 1: Warterror90 (€2.31 in chips) 
Seat 2: RRsanto (€2.98 in chips) 
Seat 3: Wind9force (€3.61 in chips) 
Seat 4: VagALiss (€1.73 in chips) 
Seat 5: Chia9711 (€1.38 in chips) 
Seat 6: caduceus369 (€2 in chips) 
RRsanto: posts small blind €0.01
Wind9force: posts big blind €0.02
*** HOLE CARDS ***
Dealt to caduceus369 [3c 4d]
VagALiss: folds 
Chia9711: folds 
caduceus369: folds 
Warterror90: folds 
RRsanto: raises €0.04 to €0.06
Wind9force: folds 
Uncalled bet (€0.04) returned to RRsanto
RRsanto collected €0.04 from pot
RRsanto: doesn't show hand 
*** SUMMARY ***
Total pot €0.04 | Rake €0 
Seat 1: Warterror90 (button) folded before Flop (didn't bet)
Seat 2: RRsanto (small blind) collected (€0.04)
Seat 3: Wind9force (big blind) folded before Flop
Seat 4: VagALiss folded before Flop (didn't bet)
Seat 5: Chia9711 folded before Flop (didn't bet)
Seat 6: caduceus369 folded before Flop (didn't bet)



PokerStars Zoom Hand #257998293400:  Hold'em No Limit (€0.01/€0.02) [ADM ID: M62BD3044A1E13PD] - 2025/10/04 20:44:16 CET [2025/10/04 14:44:16 ET]
Table 'Sirio' 6-max Seat #1 is the button
Seat 1: vckjakcon97 (€1.27 in chips) 
Seat 2: caduceus369 (€2 in chips) 
Seat 3: CARAPIGNA (€2.34 in chips) 
Seat 4: GanchanS7 (€4.07 in chips) 
Seat 5: IKARO_3 (€1.71 in chips) 
Seat 6: flippone78 (€2.71 in chips) 
caduceus369: posts small blind €0.01
CARAPIGNA: posts big blind €0.02
*** HOLE CARDS ***
Dealt to caduceus369 [Qd 6s]
GanchanS7: folds 
IKARO_3: folds 
flippone78: raises €0.03 to €0.05
vckjakcon97: folds 
caduceus369: folds 
CARAPIGNA: folds 
Uncalled bet (€0.03) returned to flippone78
flippone78 collected €0.05 from pot
flippone78: doesn't show hand 
*** SUMMARY ***
Total pot €0.05 | Rake €0 
Seat 1: vckjakcon97 (button) folded before Flop (didn't bet)
Seat 2: caduceus369 (small blind) folded before Flop
Seat 3: CARAPIGNA (big blind) folded before Flop
Seat 4: GanchanS7 folded before Flop (didn't bet)
Seat 5: IKARO_3 folded before Flop (didn't bet)
Seat 6: flippone78 collected (€0.05)



PokerStars Zoom Hand #257998296063:  Hold'em No Limit (€0.01/€0.02) [ADM ID: M62BD3044A1E13PD] - 2025/10/04 20:44:28 CET [2025/10/04 14:44:28 ET]
Table 'Sirio' 6-max Seat #1 is the button
Seat 1: panzapelata (€1.09 in chips) 
Seat 2: VagALiss (€1.73 in chips) 
Seat 3: IKARO_3 (€0.97 in chips) 
Seat 4: GanchanS7 (€4.07 in chips) 
Seat 5: caduceus369 (€2 in chips) 
Seat 6: Warterror90 (€2.31 in chips) 
VagALiss: posts small blind €0.01
IKARO_3: posts big blind €0.02
*** HOLE CARDS ***
Dealt to caduceus369 [Qd 4c]
GanchanS7: folds 
caduceus369: folds 
Warterror90: folds 
panzapelata: folds 
VagALiss: folds 
Uncalled bet (€0.01) returned to IKARO_3
IKARO_3 collected €0.02 from pot
IKARO_3: doesn't show hand 
*** SUMMARY ***
Total pot €0.02 | Rake €0 
Seat 1: panzapelata (button) folded before Flop (didn't bet)
Seat 2: VagALiss (small blind) folded before Flop
Seat 3: IKARO_3 (big blind) collected (€0.02)
Seat 4: GanchanS7 folded before Flop (didn't bet)
Seat 5: caduceus369 folded before Flop (didn't bet)
Seat 6: Warterror90 folded before Flop (didn't bet)



PokerStars Zoom Hand #257998297812:  Hold'em No Limit (€0.01/€0.02) [ADM ID: M62BD3044A1E13PD] - 2025/10/04 20:44:36 CET [2025/10/04 14:44:36 ET]
Table 'Sirio' 6-max Seat #1 is the button
Seat 1: RRsanto (€3 in chips) 
Seat 2: Ullkaustru (€1.18 in chips) 
Seat 3: GanchanS7 (€4.07 in chips) 
Seat 4: caduceus369 (€2 in chips) 
Seat 5: CARAPIGNA (€2.32 in chips) 
Seat 6: panzapelata (€1.09 in chips) 
Ullkaustru: posts small blind €0.01
GanchanS7: posts big blind €0.02
*** HOLE CARDS ***
Dealt to caduceus369 [Jh Jd]
caduceus369: raises €0.04 to €0.06
CARAPIGNA: folds 
panzapelata: calls €0.06
RRsanto: folds 
Ullkaustru: folds 
GanchanS7: folds 
*** FLOP *** [6d 9h As]
caduceus369: checks 
panzapelata: bets €0.15
caduceus369: folds 
Uncalled bet (€0.15) returned to panzapelata
panzapelata collected €0.15 from pot
panzapelata: doesn't show hand 
*** SUMMARY ***
Total pot €0.15 | Rake €0 
Board [6d 9h As]
Seat 1: RRsanto (button) folded before Flop (didn't bet)
Seat 2: Ullkaustru (small blind) folded before Flop
Seat 3: GanchanS7 (big blind) folded before Flop
Seat 4: caduceus369 folded on the Flop
Seat 5: CARAPIGNA folded before Flop (didn't bet)
Seat 6: panzapelata collected (€0.15)



PokerStars Zoom Hand #257998291483:  Hold'em No Limit (€0.01/€0.02) [ADM ID: M62BD3044A1E13PD] - 2025/10/04 20:44:07 CET [2025/10/04 14:44:07 ET]
Table 'Sirio' 6-max Seat #1 is the button
Seat 1: N0thingforU (€2 in chips) 
Seat 2: Warterror90 (€2.32 in chips) 
Seat 3: bruciapelo (€1.08 in chips) 
Seat 4: caduceus369 (€2 in chips) 
Seat 5: lucpri (€1.18 in chips) 
Seat 6: Clint934 (€1.77 in chips) 
Warterror90: posts small blind €0.01
bruciapelo: posts big blind €0.02
*** HOLE CARDS ***
Dealt to caduceus369 [Jc 5d]
caduceus369: folds 
lucpri: folds 
Clint934 has timed out
Clint934: folds 
N0thingforU: raises €0.04 to €0.06
Warterror90: folds 
bruciapelo: raises €0.13 to €0.19
N0thingforU: calls €0.13
*** FLOP *** [Kh 3c 5h]
bruciapelo: bets €0.24
N0thingforU: folds 
Uncalled bet (€0.24) returned to bruciapelo
bruciapelo collected €0.37 from pot
bruciapelo: doesn't show hand 
*** SUMMARY ***
Total pot €0.39 | Rake €0.02 
Board [Kh 3c 5h]
Seat 1: N0thingforU (button) folded on the Flop
Seat 2: Warterror90 (small blind) folded before Flop
Seat 3: bruciapelo (big blind) collected (€0.37)
Seat 4: caduceus369 folded before Flop (didn't bet)
Seat 5: lucpri folded before Flop (didn't bet)
Seat 6: Clint934 folded before Flop (didn't bet)



PokerStars Zoom Hand #257998290045:  Hold'em No Limit (€0.01/€0.02) [ADM ID: M62BD3044A1E13PD] - 2025/10/04 20:44:01 CET [2025/10/04 14:44:01 ET]
Table 'Sirio' 6-max Seat #1 is the button
Seat 1: caduceus369 (€2 in chips) 
Seat 2: CARAPIGNA (€2.35 in chips) 
Seat 3: monsterc99 (€0.75 in chips) 
Seat 4: andregra11 (€1.27 in chips) 
Seat 5: ADRIAN0_MEIS (€3.78 in chips) 
Seat 6: pallone1969 (€2.24 in chips) 
CARAPIGNA: posts small blind €0.01
monsterc99: posts big blind €0.02
*** HOLE CARDS ***
Dealt to caduceus369 [3d Ah]
andregra11: folds 
ADRIAN0_MEIS: raises €0.05 to €0.07
pallone1969: calls €0.07
caduceus369: folds 
CARAPIGNA: folds 
monsterc99: calls €0.05
*** FLOP *** [Tc 6h Ac]
monsterc99: checks 
ADRIAN0_MEIS: bets €0.16
pallone1969: calls €0.16
monsterc99: calls €0.16
*** TURN *** [Tc 6h Ac] [Th]
monsterc99: checks 
ADRIAN0_MEIS: bets €0.37
pallone1969: calls €0.37
monsterc99: calls €0.37
*** RIVER *** [Tc 6h Ac Th] [6c]
monsterc99: bets €0.15 and is all-in
ADRIAN0_MEIS: calls €0.15
pallone1969: raises €1.09 to €1.24
ADRIAN0_MEIS: folds 
Uncalled bet (€1.09) returned to pallone1969
*** SHOW DOWN ***
pallone1969: shows [7c Jc] (a flush, Ace high)
monsterc99: shows [Qc 8c] (a flush, Ace high - Queen higher)
monsterc99 collected €2.14 from pot
*** SUMMARY ***
Total pot €2.26 | Rake €0.12 
Board [Tc 6h Ac Th 6c]
Seat 1: caduceus369 (button) folded before Flop (didn't bet)
Seat 2: CARAPIGNA (small blind) folded before Flop
Seat 3: monsterc99 (big blind) showed [Qc 8c] and won (€2.14) with a flush, Ace high
Seat 4: andregra11 folded before Flop (didn't bet)
Seat 5: ADRIAN0_MEIS folded on the River
Seat 6: pallone1969 showed [7c Jc] and lost with a flush, Ace high



PokerStars Zoom Hand #257998303439:  Hold'em No Limit (€0.01/€0.02) [ADM ID: M62BD3044A1E13PD] - 2025/10/04 20:45:02 CET [2025/10/04 14:45:02 ET]
Table 'Sirio' 6-max Seat #1 is the button
Seat 1: robertoH2O (€2 in chips) 
Seat 2: vckjakcon97 (€1.24 in chips) 
Seat 3: caduceus369 (€2 in chips) 
Seat 4: ADRIAN0_MEIS (€4.93 in chips) 
Seat 5: Warterror90 (€2.32 in chips) 
Seat 6: Gabrielefante (€4.20 in chips) 
vckjakcon97: posts small blind €0.01
caduceus369: posts big blind €0.02
*** HOLE CARDS ***
Dealt to caduceus369 [Qs Js]
ADRIAN0_MEIS: folds 
Warterror90: folds 
Gabrielefante: folds 
robertoH2O: folds 
vckjakcon97: folds 
Uncalled bet (€0.01) returned to caduceus369
caduceus369 collected €0.02 from pot
caduceus369: doesn't show hand 
*** SUMMARY ***
Total pot €0.02 | Rake €0 
Seat 1: robertoH2O (button) folded before Flop (didn't bet)
Seat 2: vckjakcon97 (small blind) folded before Flop
Seat 3: caduceus369 (big blind) collected (€0.02)
Seat 4: ADRIAN0_MEIS folded before Flop (didn't bet)
Seat 5: Warterror90 folded before Flop (didn't bet)
Seat 6: Gabrielefante folded before Flop (didn't bet)



PokerStars Zoom Hand #257998311346:  Hold'em No Limit (€0.01/€0.02) [ADM ID: M62BD3044A1E13PD] - 2025/10/04 20:45:38 CET [2025/10/04 14:45:38 ET]
Table 'Sirio' 6-max Seat #1 is the button
Seat 1: Ullkaustru (€1.11 in chips) 
Seat 2: caduceus369 (€2.01 in chips) 
Seat 3: ghosto69 (€3.86 in chips) 
Seat 4: Gabrielefante (€4.20 in chips) 
Seat 5: heitel (€1.75 in chips) 
Seat 6: shakthi (€2.07 in chips) 
caduceus369: posts small blind €0.01
ghosto69: posts big blind €0.02
*** HOLE CARDS ***
Dealt to caduceus369 [Qs Ts]
Gabrielefante: folds 
heitel: folds 
shakthi: folds 
Ullkaustru: raises €1.09 to €1.11 and is all-in
caduceus369: folds 
ghosto69: folds 
Uncalled bet (€1.09) returned to Ullkaustru
Ullkaustru collected €0.05 from pot
Ullkaustru: doesn't show hand 
*** SUMMARY ***
Total pot €0.05 | Rake €0 
Seat 1: Ullkaustru (button) collected (€0.05)
Seat 2: caduceus369 (small blind) folded before Flop
Seat 3: ghosto69 (big blind) folded before Flop
Seat 4: Gabrielefante folded before Flop (didn't bet)
Seat 5: heitel folded before Flop (didn't bet)
Seat 6: shakthi folded before Flop (didn't bet)



PokerStars Zoom Hand #257998313557:  Hold'em No Limit (€0.01/€0.02) [ADM ID: M62BD3044A1E13PD] - 2025/10/04 20:45:47 CET [2025/10/04 14:45:47 ET]
Table 'Sirio' 6-max Seat #1 is the button
Seat 1: caduceus369 (€2 in chips) 
Seat 2: heitel (€1.75 in chips) 
Seat 3: RRsanto (€3.18 in chips) 
Seat 4: Warterror90 (€2.17 in chips) 
Seat 5: vckjakcon97 (€1.34 in chips) 
Seat 6: GanchanS7 (€2.71 in chips) 
heitel: posts small blind €0.01
RRsanto: posts big blind €0.02
*** HOLE CARDS ***
Dealt to caduceus369 [7s Jd]
Warterror90: folds 
vckjakcon97: folds 
GanchanS7: raises €0.03 to €0.05
caduceus369: folds 
heitel: folds 
RRsanto: folds 
Uncalled bet (€0.03) returned to GanchanS7
GanchanS7 collected €0.05 from pot
GanchanS7: doesn't show hand 
*** SUMMARY ***
Total pot €0.05 | Rake €0 
Seat 1: caduceus369 (button) folded before Flop (didn't bet)
Seat 2: heitel (small blind) folded before Flop
Seat 3: RRsanto (big blind) folded before Flop
Seat 4: Warterror90 folded before Flop (didn't bet)
Seat 5: vckjakcon97 folded before Flop (didn't bet)
Seat 6: GanchanS7 collected (€0.05)



PokerStars Zoom Hand #257998314993:  Hold'em No Limit (€0.01/€0.02) [ADM ID: M62BD3044A1E13PD] - 2025/10/04 20:45:54 CET [2025/10/04 14:45:54 ET]
Table 'Sirio' 6-max Seat #1 is the button
Seat 1: ghosto69 (€3.84 in chips) 
Seat 2: shakthi (€2.08 in chips) 
Seat 3: heitel (€1.74 in chips) 
Seat 4: IKARO_3 (€1.54 in chips) 
Seat 5: caduceus369 (€2 in chips) 
Seat 6: N0thingforU (€2 in chips) 
shakthi: posts small blind €0.01
heitel: posts big blind €0.02
*** HOLE CARDS ***
Dealt to caduceus369 [Jh 5s]
IKARO_3 has timed out
IKARO_3: folds 
caduceus369: folds 
N0thingforU: folds 
ghosto69: raises €0.02 to €0.04
shakthi: folds 
heitel: folds 
Uncalled bet (€0.02) returned to ghosto69
ghosto69 collected €0.05 from pot
ghosto69: doesn't show hand 
*** SUMMARY ***
Total pot €0.05 | Rake €0 
Seat 1: ghosto69 (button) collected (€0.05)
Seat 2: shakthi (small blind) folded before Flop
Seat 3: heitel (big blind) folded before Flop
Seat 4: IKARO_3 folded before Flop (didn't bet)
Seat 5: caduceus369 folded before Flop (didn't bet)
Seat 6: N0thingforU folded before Flop (didn't bet)



PokerStars Zoom Hand #257998308801:  Hold'em No Limit (€0.01/€0.02) [ADM ID: M62BD3044A1E13PD] - 2025/10/04 20:45:27 CET [2025/10/04 14:45:27 ET]
Table 'Sirio' 6-max Seat #1 is the button
Seat 1: CIKO71131 (€0.49 in chips) 
Seat 2: panzapelata (€1.16 in chips) 
Seat 3: VagALiss (€1.31 in chips) 
Seat 4: monsterc99 (€2.13 in chips) 
Seat 5: GanchanS7 (€4.04 in chips) 
Seat 6: caduceus369 (€2.01 in chips) 
panzapelata: posts small blind €0.01
VagALiss: posts big blind €0.02
*** HOLE CARDS ***
Dealt to caduceus369 [As 7h]
monsterc99: folds 
GanchanS7: raises €0.03 to €0.05
caduceus369: folds 
CIKO71131: calls €0.05
panzapelata: folds 
VagALiss: folds 
*** FLOP *** [7d 6h 2d]
GanchanS7: bets €0.03
CIKO71131: calls €0.03
*** TURN *** [7d 6h 2d] [8s]
GanchanS7: bets €0.14
CIKO71131: raises €0.14 to €0.28
GanchanS7: raises €0.35 to €0.63
CIKO71131: calls €0.13 and is all-in
Uncalled bet (€0.22) returned to GanchanS7
*** RIVER *** [7d 6h 2d 8s] [Kh]
*** SHOW DOWN ***
GanchanS7: shows [Jc Js] (a pair of Jacks)
CIKO71131: shows [8d 8h] (three of a kind, Eights)
CIKO71131 collected €0.96 from pot
*** SUMMARY ***
Total pot €1.01 | Rake €0.05 
Board [7d 6h 2d 8s Kh]
Seat 1: CIKO71131 (button) showed [8d 8h] and won (€0.96) with three of a kind, Eights
Seat 2: panzapelata (small blind) folded before Flop
Seat 3: VagALiss (big blind) folded before Flop
Seat 4: monsterc99 folded before Flop (didn't bet)
Seat 5: GanchanS7 showed [Jc Js] and lost with a pair of Jacks
Seat 6: caduceus369 folded before Flop (didn't bet)



PokerStars Zoom Hand #257998316481:  Hold'em No Limit (€0.01/€0.02) [ADM ID: M62BD3044A1E13PD] - 2025/10/04 20:46:01 CET [2025/10/04 14:46:01 ET]
Table 'Sirio' 6-max Seat #1 is the button
Seat 1: kAllSeMPRE73 (€1.53 in chips) 
Seat 2: panzapelata (€1.32 in chips) 
Seat 3: caduceus369 (€2 in chips) 
Seat 4: CARAPIGNA (€2.26 in chips) 
Seat 5: pallone1969 (€1.65 in chips) 
Seat 6: Warterror90 (€3.27 in chips) 
panzapelata: posts small blind €0.01
caduceus369: posts big blind €0.02
*** HOLE CARDS ***
Dealt to caduceus369 [Qh Ac]
CARAPIGNA: folds 
pallone1969 has timed out
pallone1969: folds 
Warterror90: raises €0.04 to €0.06
kAllSeMPRE73: folds 
panzapelata: folds 
caduceus369: raises €0.12 to €0.18
Warterror90: calls €0.12
*** FLOP *** [Qs Ts 8s]
caduceus369: checks 
Warterror90: bets €0.14
caduceus369: calls €0.14
*** TURN *** [Qs Ts 8s] [9c]
caduceus369: checks 
Warterror90: checks 
*** RIVER *** [Qs Ts 8s 9c] [Ks]
caduceus369: bets €0.37
Warterror90: raises €2.58 to €2.95 and is all-in
caduceus369: folds 
Uncalled bet (€2.58) returned to Warterror90
Warterror90 collected €1.32 from pot
Warterror90: doesn't show hand 
*** SUMMARY ***
Total pot €1.39 | Rake €0.07 
Board [Qs Ts 8s 9c Ks]
Seat 1: kAllSeMPRE73 (button) folded before Flop (didn't bet)
Seat 2: panzapelata (small blind) folded before Flop
Seat 3: caduceus369 (big blind) folded on the River
Seat 4: CARAPIGNA folded before Flop (didn't bet)
Seat 5: pallone1969 folded before Flop (didn't bet)
Seat 6: Warterror90 collected (€1.32)



PokerStars Zoom Hand #257998338395:  Hold'em No Limit (€0.01/€0.02) [ADM ID: M62BD3044A1E13PD] - 2025/10/04 20:47:41 CET [2025/10/04 14:47:41 ET]
Table 'Sirio' 6-max Seat #1 is the button
Seat 1: IKARO_3 (€1.97 in chips) 
Seat 2: Catania838 (€1.28 in chips) 
Seat 3: ADRIAN0_MEIS (€5.02 in chips) 
Seat 4: Gabrielefante (€4.12 in chips) 
Seat 5: GanchanS7 (€3.23 in chips) 
Seat 6: caduceus369 (€2 in chips) 
Catania838: posts small blind €0.01
ADRIAN0_MEIS: posts big blind €0.02
*** HOLE CARDS ***
Dealt to caduceus369 [As Jh]
Gabrielefante: folds 
GanchanS7: folds 
caduceus369: raises €0.04 to €0.06
IKARO_3: raises €0.14 to €0.20
Catania838: folds 
ADRIAN0_MEIS: folds 
caduceus369: calls €0.14
*** FLOP *** [3c 3s 7h]
caduceus369: checks 
IKARO_3: bets €0.31
caduceus369: folds 
Uncalled bet (€0.31) returned to IKARO_3
IKARO_3 collected €0.41 from pot
IKARO_3: doesn't show hand 
*** SUMMARY ***
Total pot €0.43 | Rake €0.02 
Board [3c 3s 7h]
Seat 1: IKARO_3 (button) collected (€0.41)
Seat 2: Catania838 (small blind) folded before Flop
Seat 3: ADRIAN0_MEIS (big blind) folded before Flop
Seat 4: Gabrielefante folded before Flop (didn't bet)
Seat 5: GanchanS7 folded before Flop (didn't bet)
Seat 6: caduceus369 folded on the Flop



PokerStars Zoom Hand #257998346010:  Hold'em No Limit (€0.01/€0.02) [ADM ID: M62BD3044A1E13PD] - 2025/10/04 20:48:16 CET [2025/10/04 14:48:16 ET]
Table 'Sirio' 6-max Seat #1 is the button
Seat 1: caduceus369 (€2 in chips) 
Seat 2: RRsanto (€2 in chips) 
Seat 3: vckjakcon97 (€1.47 in chips) 
Seat 4: ADRIAN0_MEIS (€5.21 in chips) 
Seat 5: Catania838 (€1.28 in chips) 
Seat 6: panzapelata (€1.73 in chips) 
RRsanto: posts small blind €0.01
vckjakcon97: posts big blind €0.02
*** HOLE CARDS ***
Dealt to caduceus369 [Jd 8d]
ADRIAN0_MEIS: folds 
Catania838: folds 
panzapelata: folds 
caduceus369: folds 
RRsanto: raises €0.04 to €0.06
vckjakcon97: raises €1.41 to €1.47 and is all-in
RRsanto: folds 
Uncalled bet (€1.41) returned to vckjakcon97
vckjakcon97 collected €0.12 from pot
vckjakcon97: doesn't show hand 
*** SUMMARY ***
Total pot €0.12 | Rake €0 
Seat 1: caduceus369 (button) folded before Flop (didn't bet)
Seat 2: RRsanto (small blind) folded before Flop
Seat 3: vckjakcon97 (big blind) collected (€0.12)
Seat 4: ADRIAN0_MEIS folded before Flop (didn't bet)
Seat 5: Catania838 folded before Flop (didn't bet)
Seat 6: panzapelata folded before Flop (didn't bet)



PokerStars Zoom Hand #257998349775:  Hold'em No Limit (€0.01/€0.02) [ADM ID: M62BD3044A1E13PD] - 2025/10/04 20:48:33 CET [2025/10/04 14:48:33 ET]
Table 'Sirio' 6-max Seat #1 is the button
Seat 1: amigliaccio (€2.20 in chips) 
Seat 2: shakthi (€2.02 in chips) 
Seat 3: ghosto69 (€2.86 in chips) 
Seat 4: caduceus369 (€2 in chips) 
Seat 5: kAllSeMPRE73 (€1.62 in chips) 
Seat 6: GanchanS7 (€3.21 in chips) 
shakthi: posts small blind €0.01
ghosto69: posts big blind €0.02
*** HOLE CARDS ***
Dealt to caduceus369 [9c Jd]
caduceus369: folds 
kAllSeMPRE73: folds 
GanchanS7: folds 
amigliaccio: folds 
shakthi: folds 
Uncalled bet (€0.01) returned to ghosto69
ghosto69 collected €0.02 from pot
ghosto69: doesn't show hand 
*** SUMMARY ***
Total pot €0.02 | Rake €0 
Seat 1: amigliaccio (button) folded before Flop (didn't bet)
Seat 2: shakthi (small blind) folded before Flop
Seat 3: ghosto69 (big blind) collected (€0.02)
Seat 4: caduceus369 folded before Flop (didn't bet)
Seat 5: kAllSeMPRE73 folded before Flop (didn't bet)
Seat 6: GanchanS7 folded before Flop (didn't bet)



PokerStars Zoom Hand #257998351052:  Hold'em No Limit (€0.01/€0.02) [ADM ID: M62BD3044A1E13PD] - 2025/10/04 20:48:39 CET [2025/10/04 14:48:39 ET]
Table 'Sirio' 6-max Seat #1 is the button
Seat 1: mafg420 (€0.57 in chips) 
Seat 2: caduceus369 (€2 in chips) 
Seat 3: panzapelata (€1.89 in chips) 
Seat 4: RRsanto (€2 in chips) 
Seat 5: IKARO_3 (€1.58 in chips) 
Seat 6: vckjakcon97 (€1.53 in chips) 
caduceus369: posts small blind €0.01
panzapelata: posts big blind €0.02
*** HOLE CARDS ***
Dealt to caduceus369 [Qh 5d]
RRsanto: raises €0.04 to €0.06
IKARO_3: folds 
vckjakcon97: folds 
mafg420: folds 
caduceus369: folds 
panzapelata: calls €0.04
*** FLOP *** [Ad Ac Kc]
panzapelata: bets €0.04
RRsanto: folds 
Uncalled bet (€0.04) returned to panzapelata
panzapelata collected €0.13 from pot
panzapelata: doesn't show hand 
*** SUMMARY ***
Total pot €0.13 | Rake €0 
Board [Ad Ac Kc]
Seat 1: mafg420 (button) folded before Flop (didn't bet)
Seat 2: caduceus369 (small blind) folded before Flop
Seat 3: panzapelata (big blind) collected (€0.13)
Seat 4: RRsanto folded on the Flop
Seat 5: IKARO_3 folded before Flop (didn't bet)
Seat 6: vckjakcon97 folded before Flop (didn't bet)



PokerStars Zoom Hand #257998348440:  Hold'em No Limit (€0.01/€0.02) [ADM ID: M62BD3044A1E13PD] - 2025/10/04 20:48:27 CET [2025/10/04 14:48:27 ET]
Table 'Sirio' 6-max Seat #1 is the button
Seat 1: potodds1979 (€2.93 in chips) 
Seat 2: ADRIAN0_MEIS (€5.21 in chips) 
Seat 3: rounders121282 (€1.77 in chips) 
Seat 4: panzapelata (€2.57 in chips) 
Seat 5: caduceus369 (€2 in chips) 
Seat 6: IKARO_3 (€1.58 in chips) 
ADRIAN0_MEIS: posts small blind €0.01
rounders121282: posts big blind €0.02
*** HOLE CARDS ***
Dealt to caduceus369 [Ac 3d]
panzapelata: raises €0.02 to €0.04
caduceus369: folds 
IKARO_3: folds 
potodds1979: folds 
ADRIAN0_MEIS: folds 
rounders121282: calls €0.02
*** FLOP *** [Kh 9s 4c]
rounders121282: bets €0.02
panzapelata: raises €0.13 to €0.15
rounders121282: calls €0.13
*** TURN *** [Kh 9s 4c] [7h]
rounders121282: checks 
panzapelata: bets €0.19
rounders121282: calls €0.19
*** RIVER *** [Kh 9s 4c 7h] [Ah]
rounders121282: checks 
panzapelata: bets €0.73
rounders121282: calls €0.73
*** SHOW DOWN ***
panzapelata: shows [8h 9h] (a flush, Ace high)
rounders121282: mucks hand 
panzapelata collected €2.11 from pot
*** SUMMARY ***
Total pot €2.23 | Rake €0.12 
Board [Kh 9s 4c 7h Ah]
Seat 1: potodds1979 (button) folded before Flop (didn't bet)
Seat 2: ADRIAN0_MEIS (small blind) folded before Flop
Seat 3: rounders121282 (big blind) mucked [5c Kd]
Seat 4: panzapelata showed [8h 9h] and won (€2.11) with a flush, Ace high
Seat 5: caduceus369 folded before Flop (didn't bet)
Seat 6: IKARO_3 folded before Flop (didn't bet)



PokerStars Zoom Hand #257998359849:  Hold'em No Limit (€0.01/€0.02) [ADM ID: M62BD3044A1E13PD] - 2025/10/04 20:49:20 CET [2025/10/04 14:49:20 ET]
Table 'Sirio' 6-max Seat #1 is the button
Seat 1: Gabrielefante (€4.18 in chips) 
Seat 2: Catania838 (€1.40 in chips) 
Seat 3: ADRIAN0_MEIS (€2 in chips) 
Seat 4: IKARO_3 (€1.73 in chips) 
Seat 5: N0thingforU (€2.09 in chips) 
Seat 6: caduceus369 (€2 in chips) 
Catania838: posts small blind €0.01
ADRIAN0_MEIS: posts big blind €0.02
*** HOLE CARDS ***
Dealt to caduceus369 [Jh 4s]
IKARO_3: folds 
N0thingforU: folds 
caduceus369: folds 
Gabrielefante: raises €0.04 to €0.06
Catania838: folds 
ADRIAN0_MEIS: folds 
Uncalled bet (€0.04) returned to Gabrielefante
Gabrielefante collected €0.05 from pot
Gabrielefante: doesn't show hand 
*** SUMMARY ***
Total pot €0.05 | Rake €0 
Seat 1: Gabrielefante (button) collected (€0.05)
Seat 2: Catania838 (small blind) folded before Flop
Seat 3: ADRIAN0_MEIS (big blind) folded before Flop
Seat 4: IKARO_3 folded before Flop (didn't bet)
Seat 5: N0thingforU folded before Flop (didn't bet)
Seat 6: caduceus369 folded before Flop (didn't bet)



PokerStars Zoom Hand #257998356968:  Hold'em No Limit (€0.01/€0.02) [ADM ID: M62BD3044A1E13PD] - 2025/10/04 20:49:06 CET [2025/10/04 14:49:06 ET]
Table 'Sirio' 6-max Seat #1 is the button
Seat 1: RRsanto (€2 in chips) 
Seat 2: VagALiss (€0.61 in chips) 
Seat 3: caduceus369 (€2 in chips) 
Seat 4: panzapelata (€1.86 in chips) 
Seat 5: vckjakcon97 (€1.52 in chips) 
Seat 6: Black98Demon (€2.81 in chips) 
VagALiss: posts small blind €0.01
caduceus369: posts big blind €0.02
*** HOLE CARDS ***
Dealt to caduceus369 [Td 7c]
panzapelata: raises €0.02 to €0.04
vckjakcon97: folds 
Black98Demon: folds 
RRsanto: calls €0.04
VagALiss: folds 
caduceus369: folds 
*** FLOP *** [4s 6h 2d]
panzapelata: checks 
RRsanto: bets €0.04
panzapelata: calls €0.04
*** TURN *** [4s 6h 2d] [Jh]
panzapelata: bets €0.09
RRsanto: folds 
Uncalled bet (€0.09) returned to panzapelata
panzapelata collected €0.18 from pot
panzapelata: doesn't show hand 
*** SUMMARY ***
Total pot €0.19 | Rake €0.01 
Board [4s 6h 2d Jh]
Seat 1: RRsanto (button) folded on the Turn
Seat 2: VagALiss (small blind) folded before Flop
Seat 3: caduceus369 (big blind) folded before Flop
Seat 4: panzapelata collected (€0.18)
Seat 5: vckjakcon97 folded before Flop (didn't bet)
Seat 6: Black98Demon folded before Flop (didn't bet)



PokerStars Zoom Hand #257998354529:  Hold'em No Limit (€0.01/€0.02) [ADM ID: M62BD3044A1E13PD] - 2025/10/04 20:48:55 CET [2025/10/04 14:48:55 ET]
Table 'Sirio' 6-max Seat #1 is the button
Seat 1: caduceus369 (€2 in chips) 
Seat 2: GanchanS7 (€3.50 in chips) 
Seat 3: bruciapelo (€1.66 in chips) 
Seat 4: VagALiss (€0.61 in chips) 
Seat 5: robertoH2O (€2 in chips) 
Seat 6: IKARO_3 (€2.17 in chips) 
GanchanS7: posts small blind €0.01
bruciapelo: posts big blind €0.02
*** HOLE CARDS ***
Dealt to caduceus369 [4s Ac]
VagALiss: folds 
robertoH2O: raises €0.03 to €0.05
IKARO_3: folds 
caduceus369: folds 
GanchanS7: folds 
bruciapelo: calls €0.03
*** FLOP *** [9c Kc 8c]
bruciapelo: checks 
robertoH2O: bets €0.08
bruciapelo: folds 
Uncalled bet (€0.08) returned to robertoH2O
robertoH2O collected €0.11 from pot
robertoH2O: doesn't show hand 
*** SUMMARY ***
Total pot €0.11 | Rake €0 
Board [9c Kc 8c]
Seat 1: caduceus369 (button) folded before Flop (didn't bet)
Seat 2: GanchanS7 (small blind) folded before Flop
Seat 3: bruciapelo (big blind) folded on the Flop
Seat 4: VagALiss folded before Flop (didn't bet)
Seat 5: robertoH2O collected (€0.11)
Seat 6: IKARO_3 folded before Flop (didn't bet)



PokerStars Zoom Hand #257998361152:  Hold'em No Limit (€0.01/€0.02) [ADM ID: M62BD3044A1E13PD] - 2025/10/04 20:49:26 CET [2025/10/04 14:49:26 ET]
Table 'Sirio' 6-max Seat #1 is the button
Seat 1: ADRIAN0_MEIS (€5.18 in chips) 
Seat 2: Ullkaustru (€1.30 in chips) 
Seat 3: IKARO_3 (€1.63 in chips) 
Seat 4: kAllSeMPRE73 (€1 in chips) 
Seat 5: caduceus369 (€2 in chips) 
Seat 6: GanchanS7 (€3.49 in chips) 
Ullkaustru: posts small blind €0.01
IKARO_3: posts big blind €0.02
*** HOLE CARDS ***
Dealt to caduceus369 [Jd 6s]
kAllSeMPRE73: raises €0.05 to €0.07
caduceus369: folds 
GanchanS7: folds 
ADRIAN0_MEIS: folds 
Ullkaustru: folds 
IKARO_3: folds 
Uncalled bet (€0.05) returned to kAllSeMPRE73
kAllSeMPRE73 collected €0.05 from pot
kAllSeMPRE73: doesn't show hand 
*** SUMMARY ***
Total pot €0.05 | Rake €0 
Seat 1: ADRIAN0_MEIS (button) folded before Flop (didn't bet)
Seat 2: Ullkaustru (small blind) folded before Flop
Seat 3: IKARO_3 (big blind) folded before Flop
Seat 4: kAllSeMPRE73 collected (€0.05)
Seat 5: caduceus369 folded before Flop (didn't bet)
Seat 6: GanchanS7 folded before Flop (didn't bet)



PokerStars Zoom Hand #257998362467:  Hold'em No Limit (€0.01/€0.02) [ADM ID: M62BD3044A1E13PD] - 2025/10/04 20:49:32 CET [2025/10/04 14:49:32 ET]
Table 'Sirio' 6-max Seat #1 is the button
Seat 1: ADRIAN0_MEIS (€2 in chips) 
Seat 2: IKARO_3 (€1.73 in chips) 
Seat 3: Warterror90 (€2.27 in chips) 
Seat 4: caduceus369 (€2 in chips) 
Seat 5: Chia9711 (€1.68 in chips) 
Seat 6: shakthi (€1.99 in chips) 
IKARO_3: posts small blind €0.01
Warterror90: posts big blind €0.02
*** HOLE CARDS ***
Dealt to caduceus369 [Kd 9d]
caduceus369: folds 
Chia9711: folds 
shakthi: folds 
ADRIAN0_MEIS: folds 
IKARO_3: folds 
Uncalled bet (€0.01) returned to Warterror90
Warterror90 collected €0.02 from pot
Warterror90: doesn't show hand 
*** SUMMARY ***
Total pot €0.02 | Rake €0 
Seat 1: ADRIAN0_MEIS (button) folded before Flop (didn't bet)
Seat 2: IKARO_3 (small blind) folded before Flop
Seat 3: Warterror90 (big blind) collected (€0.02)
Seat 4: caduceus369 folded before Flop (didn't bet)
Seat 5: Chia9711 folded before Flop (didn't bet)
Seat 6: shakthi folded before Flop (didn't bet)



PokerStars Zoom Hand #257998365395:  Hold'em No Limit (€0.01/€0.02) [ADM ID: M62BD3044A1E13PD] - 2025/10/04 20:49:45 CET [2025/10/04 14:49:45 ET]
Table 'Sirio' 6-max Seat #1 is the button
Seat 1: IKARO_3 (€1.72 in chips) 
Seat 2: monsterc99 (€1.74 in chips) 
Seat 3: AleBibi25 (€1.32 in chips) 
Seat 4: caduceus369 (€2 in chips) 
Seat 5: N0thingforU (€2.06 in chips) 
Seat 6: GanchanS7 (€4.37 in chips) 
monsterc99: posts small blind €0.01
AleBibi25: posts big blind €0.02
*** HOLE CARDS ***
Dealt to caduceus369 [5c Kc]
caduceus369: folds 
N0thingforU: folds 
GanchanS7: folds 
IKARO_3: folds 
monsterc99: folds 
Uncalled bet (€0.01) returned to AleBibi25
AleBibi25 collected €0.02 from pot
AleBibi25: doesn't show hand 
*** SUMMARY ***
Total pot €0.02 | Rake €0 
Seat 1: IKARO_3 (button) folded before Flop (didn't bet)
Seat 2: monsterc99 (small blind) folded before Flop
Seat 3: AleBibi25 (big blind) collected (€0.02)
Seat 4: caduceus369 folded before Flop (didn't bet)
Seat 5: N0thingforU folded before Flop (didn't bet)
Seat 6: GanchanS7 folded before Flop (didn't bet)



PokerStars Zoom Hand #257998364003:  Hold'em No Limit (€0.01/€0.02) [ADM ID: M62BD3044A1E13PD] - 2025/10/04 20:49:39 CET [2025/10/04 14:49:39 ET]
Table 'Sirio' 6-max Seat #1 is the button
Seat 1: panzapelata (€3.67 in chips) 
Seat 2: caduceus369 (€2 in chips) 
Seat 3: RRsanto (€2 in chips) 
Seat 4: ADRIAN0_MEIS (€4.97 in chips) 
Seat 5: Warterror90 (€3.79 in chips) 
Seat 6: monsterc99 (€1.74 in chips) 
caduceus369: posts small blind €0.01
RRsanto: posts big blind €0.02
*** HOLE CARDS ***
Dealt to caduceus369 [Jd 4c]
ADRIAN0_MEIS: folds 
Warterror90: raises €0.04 to €0.06
monsterc99: folds 
panzapelata: calls €0.06
caduceus369: folds 
RRsanto: folds 
*** FLOP *** [3d 7d 2s]
Warterror90: checks 
panzapelata: checks 
*** TURN *** [3d 7d 2s] [7s]
Warterror90: bets €0.06
panzapelata: folds 
Uncalled bet (€0.06) returned to Warterror90
Warterror90 collected €0.15 from pot
Warterror90: doesn't show hand 
*** SUMMARY ***
Total pot €0.15 | Rake €0 
Board [3d 7d 2s 7s]
Seat 1: panzapelata (button) folded on the Turn
Seat 2: caduceus369 (small blind) folded before Flop
Seat 3: RRsanto (big blind) folded before Flop
Seat 4: ADRIAN0_MEIS folded before Flop (didn't bet)
Seat 5: Warterror90 collected (€0.15)
Seat 6: monsterc99 folded before Flop (didn't bet)



PokerStars Zoom Hand #257998367515:  Hold'em No Limit (€0.01/€0.02) [ADM ID: M62BD3044A1E13PD] - 2025/10/04 20:49:55 CET [2025/10/04 14:49:55 ET]
Table 'Sirio' 6-max Seat #1 is the button
Seat 1: caduceus369 (€2 in chips) 
Seat 2: robertoH2O (€2.09 in chips) 
Seat 3: monsterc99 (€1.73 in chips) 
Seat 4: GanchanS7 (€2.70 in chips) 
Seat 5: ADRIAN0_MEIS (€2 in chips) 
Seat 6: RRsanto (€2 in chips) 
robertoH2O: posts small blind €0.01
monsterc99: posts big blind €0.02
*** HOLE CARDS ***
Dealt to caduceus369 [Ad 8d]
GanchanS7: folds 
ADRIAN0_MEIS: folds 
RRsanto: folds 
caduceus369: raises €0.04 to €0.06
robertoH2O: folds 
monsterc99: folds 
Uncalled bet (€0.04) returned to caduceus369
caduceus369 collected €0.05 from pot
caduceus369: doesn't show hand 
*** SUMMARY ***
Total pot €0.05 | Rake €0 
Seat 1: caduceus369 (button) collected (€0.05)
Seat 2: robertoH2O (small blind) folded before Flop
Seat 3: monsterc99 (big blind) folded before Flop
Seat 4: GanchanS7 folded before Flop (didn't bet)
Seat 5: ADRIAN0_MEIS folded before Flop (didn't bet)
Seat 6: RRsanto folded before Flop (didn't bet)



PokerStars Zoom Hand #257998372380:  Hold'em No Limit (€0.01/€0.02) [ADM ID: M62BD3044A1E13PD] - 2025/10/04 20:50:17 CET [2025/10/04 14:50:17 ET]
Table 'Sirio' 6-max Seat #1 is the button
Seat 1: Wunschgast (€4.66 in chips) 
Seat 2: N0thingforU (€2.06 in chips) 
Seat 3: caduceus369 (€2.03 in chips) 
Seat 4: Chia9711 (€1.65 in chips) 
Seat 5: pietr056 (€1.18 in chips) 
Seat 6: DPik10 (€2 in chips) 
N0thingforU: posts small blind €0.01
caduceus369: posts big blind €0.02
*** HOLE CARDS ***
Dealt to caduceus369 [Ah Kh]
Chia9711: calls €0.02
pietr056: calls €0.02
DPik10: folds 
Wunschgast: folds 
N0thingforU: folds 
caduceus369: raises €0.12 to €0.14
Chia9711: folds 
pietr056: calls €0.12
*** FLOP *** [Qc 2d 9s]
caduceus369: checks 
pietr056: checks 
*** TURN *** [Qc 2d 9s] [3c]
caduceus369: bets €0.11
pietr056: folds 
Uncalled bet (€0.11) returned to caduceus369
caduceus369 collected €0.30 from pot
caduceus369: doesn't show hand 
*** SUMMARY ***
Total pot €0.31 | Rake €0.01 
Board [Qc 2d 9s 3c]
Seat 1: Wunschgast (button) folded before Flop (didn't bet)
Seat 2: N0thingforU (small blind) folded before Flop
Seat 3: caduceus369 (big blind) collected (€0.30)
Seat 4: Chia9711 folded before Flop
Seat 5: pietr056 folded on the Turn
Seat 6: DPik10 folded before Flop (didn't bet)



PokerStars Zoom Hand #257998371033:  Hold'em No Limit (€0.01/€0.02) [ADM ID: M62BD3044A1E13PD] - 2025/10/04 20:50:11 CET [2025/10/04 14:50:11 ET]
Table 'Sirio' 6-max Seat #1 is the button
Seat 1: DPik10 (€2 in chips) 
Seat 2: IKARO_3 (€1.61 in chips) 
Seat 3: robertoH2O (€2.08 in chips) 
Seat 4: GanchanS7 (€3.48 in chips) 
Seat 5: Chia9711 (€1.65 in chips) 
Seat 6: caduceus369 (€2.03 in chips) 
IKARO_3: posts small blind €0.01
robertoH2O: posts big blind €0.02
*** HOLE CARDS ***
Dealt to caduceus369 [3c 9c]
GanchanS7: folds 
Chia9711: folds 
caduceus369: folds 
DPik10: folds 
IKARO_3: raises €0.04 to €0.06
robertoH2O: calls €0.04
*** FLOP *** [Jc 9h Qc]
IKARO_3: checks 
robertoH2O: checks 
*** TURN *** [Jc 9h Qc] [4h]
IKARO_3: checks 
robertoH2O: checks 
*** RIVER *** [Jc 9h Qc 4h] [Qh]
IKARO_3: checks 
robertoH2O: bets €0.09
IKARO_3: calls €0.09
*** SHOW DOWN ***
robertoH2O: shows [5s 7s] (a pair of Queens)
IKARO_3: shows [3d Kh] (a pair of Queens - King kicker)
IKARO_3 collected €0.29 from pot
*** SUMMARY ***
Total pot €0.30 | Rake €0.01 
Board [Jc 9h Qc 4h Qh]
Seat 1: DPik10 (button) folded before Flop (didn't bet)
Seat 2: IKARO_3 (small blind) showed [3d Kh] and won (€0.29) with a pair of Queens
Seat 3: robertoH2O (big blind) showed [5s 7s] and lost with a pair of Queens
Seat 4: GanchanS7 folded before Flop (didn't bet)
Seat 5: Chia9711 folded before Flop (didn't bet)
Seat 6: caduceus369 folded before Flop (didn't bet)



PokerStars Zoom Hand #257998382868:  Hold'em No Limit (€0.01/€0.02) [ADM ID: M62BD3044A1E13PD] - 2025/10/04 20:51:05 CET [2025/10/04 14:51:05 ET]
Table 'Sirio' 6-max Seat #1 is the button
Seat 1: ADRIAN0_MEIS (€4.70 in chips) 
Seat 2: caduceus369 (€2.19 in chips) 
Seat 3: masticatp (€1.20 in chips) 
Seat 4: lucpri (€1.23 in chips) 
Seat 5: IKARO_3 (€1.69 in chips) 
Seat 6: monsterc99 (€0.80 in chips) 
caduceus369: posts small blind €0.01
masticatp: posts big blind €0.02
*** HOLE CARDS ***
Dealt to caduceus369 [9c Th]
lucpri: folds 
IKARO_3: folds 
monsterc99: raises €0.02 to €0.04
ADRIAN0_MEIS: calls €0.04
caduceus369: folds 
masticatp: folds 
*** FLOP *** [6s Kd Ah]
monsterc99: bets €0.06
ADRIAN0_MEIS: folds 
Uncalled bet (€0.06) returned to monsterc99
monsterc99 collected €0.11 from pot
monsterc99: doesn't show hand 
*** SUMMARY ***
Total pot €0.11 | Rake €0 
Board [6s Kd Ah]
Seat 1: ADRIAN0_MEIS (button) folded on the Flop
Seat 2: caduceus369 (small blind) folded before Flop
Seat 3: masticatp (big blind) folded before Flop
Seat 4: lucpri folded before Flop (didn't bet)
Seat 5: IKARO_3 folded before Flop (didn't bet)
Seat 6: monsterc99 collected (€0.11)



PokerStars Zoom Hand #257998381162:  Hold'em No Limit (€0.01/€0.02) [ADM ID: M62BD3044A1E13PD] - 2025/10/04 20:50:57 CET [2025/10/04 14:50:57 ET]
Table 'Sirio' 6-max Seat #1 is the button
Seat 1: panzapelata (€2.04 in chips) 
Seat 2: pietr056 (€1.04 in chips) 
Seat 3: SuperGandhee (€2 in chips) 
Seat 4: lucpri (€1.23 in chips) 
Seat 5: caduceus369 (€2.19 in chips) 
Seat 6: Wunschgast (€4.64 in chips) 
pietr056: posts small blind €0.01
SuperGandhee: posts big blind €0.02
*** HOLE CARDS ***
Dealt to caduceus369 [8s 9d]
lucpri: folds 
caduceus369: folds 
Wunschgast: raises €0.04 to €0.06
panzapelata: raises €0.10 to €0.16
pietr056: folds 
SuperGandhee: folds 
Wunschgast: calls €0.10
*** FLOP *** [Td 9c Js]
Wunschgast: checks 
panzapelata: checks 
*** TURN *** [Td 9c Js] [2s]
Wunschgast: checks 
panzapelata: bets €0.17
Wunschgast: calls €0.17
*** RIVER *** [Td 9c Js 2s] [4s]
Wunschgast: checks 
panzapelata: bets €0.33
Wunschgast: raises €1.32 to €1.65
panzapelata: folds 
Uncalled bet (€1.32) returned to Wunschgast
Wunschgast collected €1.28 from pot
Wunschgast: doesn't show hand 
*** SUMMARY ***
Total pot €1.35 | Rake €0.07 
Board [Td 9c Js 2s 4s]
Seat 1: panzapelata (button) folded on the River
Seat 2: pietr056 (small blind) folded before Flop
Seat 3: SuperGandhee (big blind) folded before Flop
Seat 4: lucpri folded before Flop (didn't bet)
Seat 5: caduceus369 folded before Flop (didn't bet)
Seat 6: Wunschgast collected (€1.28)



PokerStars Zoom Hand #257998390824:  Hold'em No Limit (€0.01/€0.02) [ADM ID: M62BD3044A1E13PD] - 2025/10/04 20:51:42 CET [2025/10/04 14:51:42 ET]
Table 'Sirio' 6-max Seat #1 is the button
Seat 1: RRsanto (€2.58 in chips) 
Seat 2: ADRIAN0_MEIS (€2.08 in chips) 
Seat 3: monsterc99 (€0.87 in chips) 
Seat 4: DPik10 (€2.18 in chips) 
Seat 5: caduceus369 (€2.18 in chips) 
Seat 6: VagALiss (€0.93 in chips) 
ADRIAN0_MEIS: posts small blind €0.01
monsterc99: posts big blind €0.02
*** HOLE CARDS ***
Dealt to caduceus369 [7d 5c]
DPik10: folds 
caduceus369: folds 
VagALiss: folds 
RRsanto: folds 
ADRIAN0_MEIS: folds 
Uncalled bet (€0.01) returned to monsterc99
monsterc99 collected €0.02 from pot
monsterc99: doesn't show hand 
*** SUMMARY ***
Total pot €0.02 | Rake €0 
Seat 1: RRsanto (button) folded before Flop (didn't bet)
Seat 2: ADRIAN0_MEIS (small blind) folded before Flop
Seat 3: monsterc99 (big blind) collected (€0.02)
Seat 4: DPik10 folded before Flop (didn't bet)
Seat 5: caduceus369 folded before Flop (didn't bet)
Seat 6: VagALiss folded before Flop (didn't bet)



PokerStars Zoom Hand #257998388540:  Hold'em No Limit (€0.01/€0.02) [ADM ID: M62BD3044A1E13PD] - 2025/10/04 20:51:31 CET [2025/10/04 14:51:31 ET]
Table 'Sirio' 6-max Seat #1 is the button
Seat 1: panzapelata (€4.82 in chips) 
Seat 2: ghosto69 (€2.65 in chips) 
Seat 3: mafg420 (€0.94 in chips) 
Seat 4: caduceus369 (€2.18 in chips) 
Seat 5: GanchanS7 (€2.10 in chips) 
Seat 6: ADRIAN0_MEIS (€2.08 in chips) 
ghosto69: posts small blind €0.01
mafg420: posts big blind €0.02
*** HOLE CARDS ***
Dealt to caduceus369 [7c Qh]
caduceus369: folds 
GanchanS7: folds 
ADRIAN0_MEIS: folds 
panzapelata: raises €0.02 to €0.04
ghosto69: raises €0.10 to €0.14
mafg420: folds 
panzapelata: calls €0.10
*** FLOP *** [8s Th 6d]
ghosto69: bets €0.22
panzapelata: calls €0.22
*** TURN *** [8s Th 6d] [Jd]
ghosto69: bets €0.54
panzapelata: calls €0.54
*** RIVER *** [8s Th 6d Jd] [Qc]
ghosto69: checks 
panzapelata: checks 
*** SHOW DOWN ***
ghosto69: shows [Ac Ah] (a pair of Aces)
panzapelata: shows [Qd Js] (two pair, Queens and Jacks)
panzapelata collected €1.72 from pot
*** SUMMARY ***
Total pot €1.82 | Rake €0.10 
Board [8s Th 6d Jd Qc]
Seat 1: panzapelata (button) showed [Qd Js] and won (€1.72) with two pair, Queens and Jacks
Seat 2: ghosto69 (small blind) showed [Ac Ah] and lost with a pair of Aces
Seat 3: mafg420 (big blind) folded before Flop
Seat 4: caduceus369 folded before Flop (didn't bet)
Seat 5: GanchanS7 folded before Flop (didn't bet)
Seat 6: ADRIAN0_MEIS folded before Flop (didn't bet)



PokerStars Zoom Hand #257998390013:  Hold'em No Limit (€0.01/€0.02) [ADM ID: M62BD3044A1E13PD] - 2025/10/04 20:51:38 CET [2025/10/04 14:51:38 ET]
Table 'Sirio' 6-max Seat #1 is the button
Seat 1: Brigantoni66 (€0.80 in chips) 
Seat 2: ghosto69 (€4.78 in chips) 
Seat 3: ADRIAN0_MEIS (€4.66 in chips) 
Seat 4: caduceus369 (€2.18 in chips) 
Seat 5: robertoH2O (€2.15 in chips) 
Seat 6: kAllSeMPRE73 (€1.12 in chips) 
ghosto69: posts small blind €0.01
ADRIAN0_MEIS: posts big blind €0.02
*** HOLE CARDS ***
Dealt to caduceus369 [8s 5d]
caduceus369: folds 
robertoH2O: folds 
kAllSeMPRE73: calls €0.02
Brigantoni66: folds 
ghosto69: folds 
ADRIAN0_MEIS: checks 
*** FLOP *** [6d Qs 8c]
ADRIAN0_MEIS: checks 
kAllSeMPRE73: checks 
*** TURN *** [6d Qs 8c] [Ad]
ADRIAN0_MEIS: checks 
kAllSeMPRE73: checks 
*** RIVER *** [6d Qs 8c Ad] [2c]
ADRIAN0_MEIS: checks 
kAllSeMPRE73: checks 
*** SHOW DOWN ***
ADRIAN0_MEIS: shows [5c 7c] (high card Ace)
kAllSeMPRE73: mucks hand 
ADRIAN0_MEIS collected €0.05 from pot
*** SUMMARY ***
Total pot €0.05 | Rake €0 
Board [6d Qs 8c Ad 2c]
Seat 1: Brigantoni66 (button) folded before Flop (didn't bet)
Seat 2: ghosto69 (small blind) folded before Flop
Seat 3: ADRIAN0_MEIS (big blind) showed [5c 7c] and won (€0.05) with high card Ace
Seat 4: caduceus369 folded before Flop (didn't bet)
Seat 5: robertoH2O folded before Flop (didn't bet)
Seat 6: kAllSeMPRE73 mucked [5h 3c]



PokerStars Zoom Hand #257998392203:  Hold'em No Limit (€0.01/€0.02) [ADM ID: M62BD3044A1E13PD] - 2025/10/04 20:51:48 CET [2025/10/04 14:51:48 ET]
Table 'Sirio' 6-max Seat #1 is the button
Seat 1: ADRIAN0_MEIS (€5.09 in chips) 
Seat 2: caduceus369 (€2.18 in chips) 
Seat 3: DPik10 (€2.18 in chips) 
Seat 4: IKARO_3 (€1.67 in chips) 
Seat 5: VagALiss (€0.93 in chips) 
Seat 6: panzapelata (€1.38 in chips) 
caduceus369: posts small blind €0.01
DPik10: posts big blind €0.02
*** HOLE CARDS ***
Dealt to caduceus369 [Qc Jh]
IKARO_3: folds 
VagALiss: folds 
panzapelata: calls €0.02
ADRIAN0_MEIS: folds 
caduceus369: raises €0.08 to €0.10
DPik10: folds 
panzapelata: folds 
Uncalled bet (€0.08) returned to caduceus369
caduceus369 collected €0.06 from pot
caduceus369: doesn't show hand 
*** SUMMARY ***
Total pot €0.06 | Rake €0 
Seat 1: ADRIAN0_MEIS (button) folded before Flop (didn't bet)
Seat 2: caduceus369 (small blind) collected (€0.06)
Seat 3: DPik10 (big blind) folded before Flop
Seat 4: IKARO_3 folded before Flop (didn't bet)
Seat 5: VagALiss folded before Flop (didn't bet)
Seat 6: panzapelata folded before Flop



PokerStars Zoom Hand #257998398723:  Hold'em No Limit (€0.01/€0.02) [ADM ID: M62BD3044A1E13PD] - 2025/10/04 20:52:18 CET [2025/10/04 14:52:18 ET]
Table 'Sirio' 6-max Seat #1 is the button
Seat 1: GanchanS7 (€3.41 in chips) 
Seat 2: Wind9force (€4.59 in chips) 
Seat 3: caduceus369 (€2.22 in chips) 
Seat 4: monsterc99 (€0.87 in chips) 
Seat 5: Gabrielefante (€4.44 in chips) 
Seat 6: shakthi (€3.17 in chips) 
Wind9force: posts small blind €0.01
caduceus369: posts big blind €0.02
*** HOLE CARDS ***
Dealt to caduceus369 [5d 9c]
monsterc99: folds 
Gabrielefante: folds 
shakthi: folds 
GanchanS7: raises €0.02 to €0.04
Wind9force: folds 
caduceus369: calls €0.02
*** FLOP *** [5c 6d Kc]
caduceus369: checks 
GanchanS7: checks 
*** TURN *** [5c 6d Kc] [8c]
caduceus369: checks 
GanchanS7: checks 
*** RIVER *** [5c 6d Kc 8c] [Qd]
caduceus369: checks 
GanchanS7: checks 
*** SHOW DOWN ***
caduceus369: shows [5d 9c] (a pair of Fives)
GanchanS7: mucks hand 
caduceus369 collected €0.09 from pot
*** SUMMARY ***
Total pot €0.09 | Rake €0 
Board [5c 6d Kc 8c Qd]
Seat 1: GanchanS7 (button) mucked [Jh Th]
Seat 2: Wind9force (small blind) folded before Flop
Seat 3: caduceus369 (big blind) showed [5d 9c] and won (€0.09) with a pair of Fives
Seat 4: monsterc99 folded before Flop (didn't bet)
Seat 5: Gabrielefante folded before Flop (didn't bet)
Seat 6: shakthi folded before Flop (didn't bet)



PokerStars Zoom Hand #257998408629:  Hold'em No Limit (€0.01/€0.02) [ADM ID: M62BD3044A1E13PD] - 2025/10/04 20:53:03 CET [2025/10/04 14:53:03 ET]
Table 'Sirio' 6-max Seat #1 is the button
Seat 1: caduceus369 (€2.27 in chips) 
Seat 2: bruciapelo (€1.35 in chips) 
Seat 3: GanchanS7 (€3.37 in chips) 
Seat 4: panzapelata (€2.28 in chips) 
Seat 5: diesel197474 (€1.24 in chips) 
Seat 6: lucpri (€1.17 in chips) 
bruciapelo: posts small blind €0.01
GanchanS7: posts big blind €0.02
*** HOLE CARDS ***
Dealt to caduceus369 [Tc Ts]
panzapelata: folds 
diesel197474: folds 
lucpri: folds 
caduceus369: raises €0.04 to €0.06
bruciapelo: folds 
GanchanS7: folds 
Uncalled bet (€0.04) returned to caduceus369
caduceus369 collected €0.05 from pot
caduceus369: doesn't show hand 
*** SUMMARY ***
Total pot €0.05 | Rake €0 
Seat 1: caduceus369 (button) collected (€0.05)
Seat 2: bruciapelo (small blind) folded before Flop
Seat 3: GanchanS7 (big blind) folded before Flop
Seat 4: panzapelata folded before Flop (didn't bet)
Seat 5: diesel197474 folded before Flop (didn't bet)
Seat 6: lucpri folded before Flop (didn't bet)



PokerStars Zoom Hand #257998414018:  Hold'em No Limit (€0.01/€0.02) [ADM ID: M62BD3044A1E13PD] - 2025/10/04 20:53:28 CET [2025/10/04 14:53:28 ET]
Table 'Sirio' 6-max Seat #1 is the button
Seat 1: DPik10 (€2.16 in chips) 
Seat 2: monsterc99 (€1.05 in chips) 
Seat 3: Chia9711 (€1.37 in chips) 
Seat 4: masticatp (€2.16 in chips) 
Seat 5: CARAPIGNA (€1.87 in chips) 
Seat 6: caduceus369 (€2.30 in chips) 
monsterc99: posts small blind €0.01
Chia9711: posts big blind €0.02
*** HOLE CARDS ***
Dealt to caduceus369 [Ah Tc]
masticatp: folds 
CARAPIGNA: folds 
caduceus369: raises €0.04 to €0.06
DPik10: folds 
monsterc99: folds 
Chia9711: calls €0.04
*** FLOP *** [5s Kh Th]
Chia9711: checks 
caduceus369: bets €0.07
Chia9711: folds 
Uncalled bet (€0.07) returned to caduceus369
caduceus369 collected €0.13 from pot
caduceus369: doesn't show hand 
*** SUMMARY ***
Total pot €0.13 | Rake €0 
Board [5s Kh Th]
Seat 1: DPik10 (button) folded before Flop (didn't bet)
Seat 2: monsterc99 (small blind) folded before Flop
Seat 3: Chia9711 (big blind) folded on the Flop
Seat 4: masticatp folded before Flop (didn't bet)
Seat 5: CARAPIGNA folded before Flop (didn't bet)
Seat 6: caduceus369 collected (€0.13)



PokerStars Zoom Hand #257998422907:  Hold'em No Limit (€0.01/€0.02) [ADM ID: M62BD3044A1E13PD] - 2025/10/04 20:54:09 CET [2025/10/04 14:54:09 ET]
Table 'Sirio' 6-max Seat #1 is the button
Seat 1: ghosto69 (€4.56 in chips) 
Seat 2: RRsanto (€2.52 in chips) 
Seat 3: monsterc99 (€0.80 in chips) 
Seat 4: TheKing.1969 (€1.88 in chips) 
Seat 5: pylonstrip (€3.02 in chips) 
Seat 6: caduceus369 (€2.37 in chips) 
RRsanto: posts small blind €0.01
monsterc99: posts big blind €0.02
*** HOLE CARDS ***
Dealt to caduceus369 [Ad 5c]
TheKing.1969: folds 
pylonstrip: folds 
caduceus369: folds 
ghosto69: folds 
RRsanto: folds 
Uncalled bet (€0.01) returned to monsterc99
monsterc99 collected €0.02 from pot
monsterc99: doesn't show hand 
*** SUMMARY ***
Total pot €0.02 | Rake €0 
Seat 1: ghosto69 (button) folded before Flop (didn't bet)
Seat 2: RRsanto (small blind) folded before Flop
Seat 3: monsterc99 (big blind) collected (€0.02)
Seat 4: TheKing.1969 folded before Flop (didn't bet)
Seat 5: pylonstrip folded before Flop (didn't bet)
Seat 6: caduceus369 folded before Flop (didn't bet)



PokerStars Zoom Hand #257998419581:  Hold'em No Limit (€0.01/€0.02) [ADM ID: M62BD3044A1E13PD] - 2025/10/04 20:53:53 CET [2025/10/04 14:53:53 ET]
Table 'Sirio' 6-max Seat #1 is the button
Seat 1: diesel197474 (€1.19 in chips) 
Seat 2: Catania838 (€1.75 in chips) 
Seat 3: trisco66 (€4.42 in chips) 
Seat 4: GanchanS7 (€3.34 in chips) 
Seat 5: caduceus369 (€2.37 in chips) 
Seat 6: robertoH2O (€2.33 in chips) 
Catania838: posts small blind €0.01
trisco66: posts big blind €0.02
*** HOLE CARDS ***
Dealt to caduceus369 [Kd 7d]
GanchanS7: folds 
caduceus369: folds 
robertoH2O: folds 
diesel197474: folds 
Catania838: calls €0.01
trisco66: raises €0.06 to €0.08
Catania838: calls €0.06
*** FLOP *** [Kh 2h Ac]
Catania838: checks 
trisco66: checks 
*** TURN *** [Kh 2h Ac] [Qc]
Catania838: checks 
trisco66: checks 
*** RIVER *** [Kh 2h Ac Qc] [Jh]
Catania838: bets €0.08
trisco66: folds 
Uncalled bet (€0.08) returned to Catania838
Catania838 collected €0.16 from pot
Catania838: doesn't show hand 
*** SUMMARY ***
Total pot €0.16 | Rake €0 
Board [Kh 2h Ac Qc Jh]
Seat 1: diesel197474 (button) folded before Flop (didn't bet)
Seat 2: Catania838 (small blind) collected (€0.16)
Seat 3: trisco66 (big blind) folded on the River
Seat 4: GanchanS7 folded before Flop (didn't bet)
Seat 5: caduceus369 folded before Flop (didn't bet)
Seat 6: robertoH2O folded before Flop (didn't bet)



PokerStars Zoom Hand #257998421778:  Hold'em No Limit (€0.01/€0.02) [ADM ID: M62BD3044A1E13PD] - 2025/10/04 20:54:04 CET [2025/10/04 14:54:04 ET]
Table 'Sirio' 6-max Seat #1 is the button
Seat 1: caduceus369 (€2.37 in chips) 
Seat 2: mafg420 (€1.10 in chips) 
Seat 3: VagALiss (€0.86 in chips) 
Seat 4: ADRIAN0_MEIS (€2.11 in chips) 
Seat 5: ghosto69 (€4.56 in chips) 
Seat 6: RRsanto (€2.52 in chips) 
mafg420: posts small blind €0.01
VagALiss: posts big blind €0.02
*** HOLE CARDS ***
Dealt to caduceus369 [5h 8c]
ADRIAN0_MEIS: folds 
ghosto69: folds 
RRsanto: folds 
caduceus369: folds 
mafg420 has timed out
mafg420: folds 
Uncalled bet (€0.01) returned to VagALiss
VagALiss collected €0.02 from pot
VagALiss: doesn't show hand 
*** SUMMARY ***
Total pot €0.02 | Rake €0 
Seat 1: caduceus369 (button) folded before Flop (didn't bet)
Seat 2: mafg420 (small blind) folded before Flop
Seat 3: VagALiss (big blind) collected (€0.02)
Seat 4: ADRIAN0_MEIS folded before Flop (didn't bet)
Seat 5: ghosto69 folded before Flop (didn't bet)
Seat 6: RRsanto folded before Flop (didn't bet)



PokerStars Zoom Hand #257998425668:  Hold'em No Limit (€0.01/€0.02) [ADM ID: M62BD3044A1E13PD] - 2025/10/04 20:54:21 CET [2025/10/04 14:54:21 ET]
Table 'Sirio' 6-max Seat #1 is the button
Seat 1: ADRIAN0_MEIS (€2.02 in chips) 
Seat 2: Biggerman970 (€2.77 in chips) 
Seat 3: caduceus369 (€2.37 in chips) 
Seat 4: DPik10 (€2.17 in chips) 
Seat 5: robertoH2O (€2.32 in chips) 
Seat 6: TheKing.1969 (€2.32 in chips) 
Biggerman970: posts small blind €0.01
caduceus369: posts big blind €0.02
*** HOLE CARDS ***
Dealt to caduceus369 [Qd Qs]
DPik10: raises €0.04 to €0.06
robertoH2O: folds 
TheKing.1969: folds 
ADRIAN0_MEIS: folds 
Biggerman970: raises €0.04 to €0.10
caduceus369: raises €0.26 to €0.36
DPik10: folds 
Biggerman970: calls €0.26
*** FLOP *** [Js Ad 5d]
Biggerman970: checks 
caduceus369: checks 
*** TURN *** [Js Ad 5d] [Ks]
Biggerman970: bets €0.74
caduceus369: folds 
Uncalled bet (€0.74) returned to Biggerman970
Biggerman970 collected €0.74 from pot
Biggerman970: doesn't show hand 
*** SUMMARY ***
Total pot €0.78 | Rake €0.04 
Board [Js Ad 5d Ks]
Seat 1: ADRIAN0_MEIS (button) folded before Flop (didn't bet)
Seat 2: Biggerman970 (small blind) collected (€0.74)
Seat 3: caduceus369 (big blind) folded on the Turn
Seat 4: DPik10 folded before Flop
Seat 5: robertoH2O folded before Flop (didn't bet)
Seat 6: TheKing.1969 folded before Flop (didn't bet)



PokerStars Zoom Hand #257998438046:  Hold'em No Limit (€0.01/€0.02) [ADM ID: M62BD3044A1E13PD] - 2025/10/04 20:55:28 CET [2025/10/04 14:55:28 ET]
Table 'Sirio' 6-max Seat #1 is the button
Seat 1: panzapelata (€1 in chips) 
Seat 2: Catania838 (€1.79 in chips) 
Seat 3: IKARO_3 (€1.02 in chips) 
Seat 4: caduceus369 (€2 in chips) 
Seat 5: RRsanto (€2.23 in chips) 
Seat 6: pylonstrip (€2 in chips) 
Catania838: posts small blind €0.01
IKARO_3: posts big blind €0.02
*** HOLE CARDS ***
Dealt to caduceus369 [9h 3d]
caduceus369: folds 
RRsanto: folds 
pylonstrip: folds 
panzapelata: folds 
Catania838: folds 
Uncalled bet (€0.01) returned to IKARO_3
IKARO_3 collected €0.02 from pot
IKARO_3: doesn't show hand 
*** SUMMARY ***
Total pot €0.02 | Rake €0 
Seat 1: panzapelata (button) folded before Flop (didn't bet)
Seat 2: Catania838 (small blind) folded before Flop
Seat 3: IKARO_3 (big blind) collected (€0.02)
Seat 4: caduceus369 folded before Flop (didn't bet)
Seat 5: RRsanto folded before Flop (didn't bet)
Seat 6: pylonstrip folded before Flop (didn't bet)



PokerStars Zoom Hand #257998438900:  Hold'em No Limit (€0.01/€0.02) [ADM ID: M62BD3044A1E13PD] - 2025/10/04 20:55:34 CET [2025/10/04 14:55:34 ET]
Table 'Sirio' 6-max Seat #1 is the button
Seat 1: caduceus369 (€2 in chips) 
Seat 2: GanchanS7 (€2.90 in chips) 
Seat 3: Brigantoni66 (€0.59 in chips) 
Seat 4: ADRIAN0_MEIS (€5.34 in chips) 
Seat 5: Fedegala08 (€1.24 in chips) 
Seat 6: Catania838 (€1.78 in chips) 
GanchanS7: posts small blind €0.01
Brigantoni66: posts big blind €0.02
*** HOLE CARDS ***
Dealt to caduceus369 [Th 6s]
ADRIAN0_MEIS: folds 
Fedegala08: folds 
Catania838: folds 
caduceus369: raises €0.04 to €0.06
GanchanS7: folds 
Brigantoni66: raises €0.53 to €0.59 and is all-in
caduceus369: folds 
Uncalled bet (€0.53) returned to Brigantoni66
Brigantoni66 collected €0.13 from pot
Brigantoni66: doesn't show hand 
*** SUMMARY ***
Total pot €0.13 | Rake €0 
Seat 1: caduceus369 (button) folded before Flop
Seat 2: GanchanS7 (small blind) folded before Flop
Seat 3: Brigantoni66 (big blind) collected (€0.13)
Seat 4: ADRIAN0_MEIS folded before Flop (didn't bet)
Seat 5: Fedegala08 folded before Flop (didn't bet)
Seat 6: Catania838 folded before Flop (didn't bet)



PokerStars Zoom Hand #257998437360:  Hold'em No Limit (€0.01/€0.02) [ADM ID: M62BD3044A1E13PD] - 2025/10/04 20:55:23 CET [2025/10/04 14:55:23 ET]
Table 'Sirio' 6-max Seat #1 is the button
Seat 1: RRsanto (€2.52 in chips) 
Seat 2: Wind9force (€4.88 in chips) 
Seat 3: TheKing.1969 (€1.85 in chips) 
Seat 4: panzapelata (€1 in chips) 
Seat 5: caduceus369 (€2 in chips) 
Seat 6: GanchanS7 (€2.90 in chips) 
Wind9force: posts small blind €0.01
TheKing.1969: posts big blind €0.02
*** HOLE CARDS ***
Dealt to caduceus369 [3d 2d]
panzapelata: folds 
caduceus369: folds 
GanchanS7: folds 
RRsanto: raises €0.04 to €0.06
Wind9force: calls €0.05
TheKing.1969: folds 
*** FLOP *** [6c 5c Ts]
Wind9force: checks 
RRsanto: checks 
*** TURN *** [6c 5c Ts] [7s]
Wind9force: checks 
RRsanto: bets €0.07
Wind9force: calls €0.07
*** RIVER *** [6c 5c Ts 7s] [Js]
Wind9force: checks 
RRsanto: checks 
*** SHOW DOWN ***
Wind9force: shows [9d Jd] (a pair of Jacks)
RRsanto: mucks hand 
Wind9force collected €0.27 from pot
*** SUMMARY ***
Total pot €0.28 | Rake €0.01 
Board [6c 5c Ts 7s Js]
Seat 1: RRsanto (button) mucked [Ac 4s]
Seat 2: Wind9force (small blind) showed [9d Jd] and won (€0.27) with a pair of Jacks
Seat 3: TheKing.1969 (big blind) folded before Flop
Seat 4: panzapelata folded before Flop (didn't bet)
Seat 5: caduceus369 folded before Flop (didn't bet)
Seat 6: GanchanS7 folded before Flop (didn't bet)



PokerStars Zoom Hand #257998442517:  Hold'em No Limit (€0.01/€0.02) [ADM ID: M62BD3044A1E13PD] - 2025/10/04 20:55:59 CET [2025/10/04 14:55:59 ET]
Table 'Sirio' 6-max Seat #1 is the button
Seat 1: Brigantoni66 (€0.66 in chips) 
Seat 2: pylonstrip (€2.01 in chips) 
Seat 3: Black98Demon (€4.36 in chips) 
Seat 4: caduceus369 (€2 in chips) 
Seat 5: N0thingforU (€3.12 in chips) 
Seat 6: Biggerman970 (€3.21 in chips) 
pylonstrip: posts small blind €0.01
Black98Demon: posts big blind €0.02
*** HOLE CARDS ***
Dealt to caduceus369 [5s 9h]
caduceus369: folds 
N0thingforU: raises €0.05 to €0.07
Biggerman970: folds 
Brigantoni66: folds 
pylonstrip: folds 
Black98Demon: folds 
Uncalled bet (€0.05) returned to N0thingforU
N0thingforU collected €0.05 from pot
N0thingforU: doesn't show hand 
*** SUMMARY ***
Total pot €0.05 | Rake €0 
Seat 1: Brigantoni66 (button) folded before Flop (didn't bet)
Seat 2: pylonstrip (small blind) folded before Flop
Seat 3: Black98Demon (big blind) folded before Flop
Seat 4: caduceus369 folded before Flop (didn't bet)
Seat 5: N0thingforU collected (€0.05)
Seat 6: Biggerman970 folded before Flop (didn't bet)



PokerStars Zoom Hand #257998435294:  Hold'em No Limit (€0.01/€0.02) [ADM ID: M62BD3044A1E13PD] - 2025/10/04 20:55:08 CET [2025/10/04 14:55:08 ET]
Table 'Sirio' 6-max Seat #1 is the button
Seat 1: GanchanS7 (€2.90 in chips) 
Seat 2: caduceus369 (€2.01 in chips) 
Seat 3: panzapelata (€5.55 in chips) 
Seat 4: Catania838 (€1.81 in chips) 
Seat 5: potodds1979 (€2.01 in chips) 
Seat 6: ADRIAN0_MEIS (€2.08 in chips) 
caduceus369: posts small blind €0.01
panzapelata: posts big blind €0.02
*** HOLE CARDS ***
Dealt to caduceus369 [8h Qc]
Catania838: calls €0.02
potodds1979: folds 
ADRIAN0_MEIS: raises €0.05 to €0.07
GanchanS7: folds 
caduceus369: folds 
panzapelata: raises €0.17 to €0.24
Catania838: folds 
ADRIAN0_MEIS: calls €0.17
*** FLOP *** [6d 4h Td]
panzapelata: bets €0.49
ADRIAN0_MEIS: folds 
Uncalled bet (€0.49) returned to panzapelata
panzapelata collected €0.49 from pot
panzapelata: doesn't show hand 
*** SUMMARY ***
Total pot €0.51 | Rake €0.02 
Board [6d 4h Td]
Seat 1: GanchanS7 (button) folded before Flop (didn't bet)
Seat 2: caduceus369 (small blind) folded before Flop
Seat 3: panzapelata (big blind) collected (€0.49)
Seat 4: Catania838 folded before Flop
Seat 5: potodds1979 folded before Flop (didn't bet)
Seat 6: ADRIAN0_MEIS folded on the Flop



PokerStars Zoom Hand #257998443872:  Hold'em No Limit (€0.01/€0.02) [ADM ID: M62BD3044A1E13PD] - 2025/10/04 20:56:09 CET [2025/10/04 14:56:09 ET]
Table 'Sirio' 6-max Seat #1 is the button
Seat 1: Black98Demon (€4.34 in chips) 
Seat 2: Catania838 (€1.76 in chips) 
Seat 3: caduceus369 (€2 in chips) 
Seat 4: RRsanto (€2.39 in chips) 
Seat 5: DPik10 (€2.37 in chips) 
Seat 6: Fedegala08 (€1.24 in chips) 
Catania838: posts small blind €0.01
caduceus369: posts big blind €0.02
*** HOLE CARDS ***
Dealt to caduceus369 [Qd 9s]
RRsanto: folds 
DPik10: folds 
Fedegala08: raises €0.04 to €0.06
Black98Demon: folds 
Catania838: calls €0.05
caduceus369: calls €0.04
*** FLOP *** [Ks 3d 7c]
Catania838: checks 
caduceus369: checks 
Fedegala08: checks 
*** TURN *** [Ks 3d 7c] [Jd]
Catania838: bets €0.07
caduceus369: calls €0.07
Fedegala08: folds 
*** RIVER *** [Ks 3d 7c Jd] [4d]
Catania838: bets €0.16
caduceus369: folds 
Uncalled bet (€0.16) returned to Catania838
Catania838 collected €0.31 from pot
Catania838: doesn't show hand 
*** SUMMARY ***
Total pot €0.32 | Rake €0.01 
Board [Ks 3d 7c Jd 4d]
Seat 1: Black98Demon (button) folded before Flop (didn't bet)
Seat 2: Catania838 (small blind) collected (€0.31)
Seat 3: caduceus369 (big blind) folded on the River
Seat 4: RRsanto folded before Flop (didn't bet)
Seat 5: DPik10 folded before Flop (didn't bet)
Seat 6: Fedegala08 folded on the Turn



PokerStars Zoom Hand #257998453350:  Hold'em No Limit (€0.01/€0.02) [ADM ID: M62BD3044A1E13PD] - 2025/10/04 20:57:15 CET [2025/10/04 14:57:15 ET]
Table 'Sirio' 6-max Seat #1 is the button
Seat 1: Gabrielefante (€4.91 in chips) 
Seat 2: caduceus369 (€2 in chips) 
Seat 3: Black98Demon (€4.31 in chips) 
Seat 4: N0thingforU (€3.31 in chips) 
Seat 5: RRsanto (€2.72 in chips) 
Seat 6: Giuggiola64 (€1.35 in chips) 
caduceus369: posts small blind €0.01
Black98Demon: posts big blind €0.02
*** HOLE CARDS ***
Dealt to caduceus369 [As 7c]
N0thingforU: folds 
RRsanto: folds 
Giuggiola64: calls €0.02
Gabrielefante: folds 
caduceus369: folds 
Black98Demon: checks 
*** FLOP *** [6s 4s Th]
Black98Demon: checks 
Giuggiola64: bets €0.02
Black98Demon: folds 
Uncalled bet (€0.02) returned to Giuggiola64
Giuggiola64 collected €0.05 from pot
Giuggiola64: doesn't show hand 
*** SUMMARY ***
Total pot €0.05 | Rake €0 
Board [6s 4s Th]
Seat 1: Gabrielefante (button) folded before Flop (didn't bet)
Seat 2: caduceus369 (small blind) folded before Flop
Seat 3: Black98Demon (big blind) folded on the Flop
Seat 4: N0thingforU folded before Flop (didn't bet)
Seat 5: RRsanto folded before Flop (didn't bet)
Seat 6: Giuggiola64 collected (€0.05)



PokerStars Zoom Hand #257998454435:  Hold'em No Limit (€0.01/€0.02) [ADM ID: M62BD3044A1E13PD] - 2025/10/04 20:57:22 CET [2025/10/04 14:57:22 ET]
Table 'Sirio' 6-max Seat #1 is the button
Seat 1: panzapelata (€5.73 in chips) 
Seat 2: Brigantoni66 (€0.74 in chips) 
Seat 3: GanchanS7 (€4.47 in chips) 
Seat 4: ADRIAN0_MEIS (€2 in chips) 
Seat 5: Pascalzone (€2 in chips) 
Seat 6: caduceus369 (€2 in chips) 
Brigantoni66: posts small blind €0.01
GanchanS7: posts big blind €0.02
*** HOLE CARDS ***
Dealt to caduceus369 [8s 3c]
ADRIAN0_MEIS: raises €0.05 to €0.07
Pascalzone: folds 
caduceus369: folds 
panzapelata: calls €0.07
Brigantoni66: folds 
GanchanS7: calls €0.05
*** FLOP *** [Ks Jh Kh]
GanchanS7: checks 
ADRIAN0_MEIS: bets €0.12
panzapelata: folds 
GanchanS7: folds 
Uncalled bet (€0.12) returned to ADRIAN0_MEIS
ADRIAN0_MEIS collected €0.21 from pot
ADRIAN0_MEIS: doesn't show hand 
*** SUMMARY ***
Total pot €0.22 | Rake €0.01 
Board [Ks Jh Kh]
Seat 1: panzapelata (button) folded on the Flop
Seat 2: Brigantoni66 (small blind) folded before Flop
Seat 3: GanchanS7 (big blind) folded on the Flop
Seat 4: ADRIAN0_MEIS collected (€0.21)
Seat 5: Pascalzone folded before Flop (didn't bet)
Seat 6: caduceus369 folded before Flop (didn't bet)



PokerStars Zoom Hand #257998456929:  Hold'em No Limit (€0.01/€0.02) [ADM ID: M62BD3044A1E13PD] - 2025/10/04 20:57:39 CET [2025/10/04 14:57:39 ET]
Table 'Sirio' 6-max Seat #1 is the button
Seat 1: pietr056 (€1.07 in chips) 
Seat 2: TheKing.1969 (€1.49 in chips) 
Seat 3: Pascalzone (€2 in chips) 
Seat 4: ghosto69 (€1.86 in chips) 
Seat 5: ADRIAN0_MEIS (€2.06 in chips) 
Seat 6: caduceus369 (€2 in chips) 
TheKing.1969: posts small blind €0.01
Pascalzone: posts big blind €0.02
*** HOLE CARDS ***
Dealt to caduceus369 [4c 4h]
ghosto69: folds 
ADRIAN0_MEIS: folds 
caduceus369: folds 
pietr056: folds 
TheKing.1969: folds 
Uncalled bet (€0.01) returned to Pascalzone
Pascalzone collected €0.02 from pot
Pascalzone: doesn't show hand 
*** SUMMARY ***
Total pot €0.02 | Rake €0 
Seat 1: pietr056 (button) folded before Flop (didn't bet)
Seat 2: TheKing.1969 (small blind) folded before Flop
Seat 3: Pascalzone (big blind) collected (€0.02)
Seat 4: ghosto69 folded before Flop (didn't bet)
Seat 5: ADRIAN0_MEIS folded before Flop (didn't bet)
Seat 6: caduceus369 folded before Flop (didn't bet)



PokerStars Zoom Hand #257998457578:  Hold'em No Limit (€0.01/€0.02) [ADM ID: M62BD3044A1E13PD] - 2025/10/04 20:57:43 CET [2025/10/04 14:57:43 ET]
Table 'Sirio' 6-max Seat #1 is the button
Seat 1: GanchanS7 (€2.08 in chips) 
Seat 2: IKARO_3 (€1.09 in chips) 
Seat 3: caduceus369 (€2 in chips) 
Seat 4: VagALiss (€0.69 in chips) 
Seat 5: pietr056 (€1.07 in chips) 
Seat 6: TheKing.1969 (€1.48 in chips) 
IKARO_3: posts small blind €0.01
caduceus369: posts big blind €0.02
*** HOLE CARDS ***
Dealt to caduceus369 [Jc 5s]
VagALiss: folds 
pietr056: raises €0.04 to €0.06
TheKing.1969: folds 
GanchanS7: folds 
IKARO_3: folds 
caduceus369: folds 
Uncalled bet (€0.04) returned to pietr056
pietr056 collected €0.05 from pot
pietr056: doesn't show hand 
*** SUMMARY ***
Total pot €0.05 | Rake €0 
Seat 1: GanchanS7 (button) folded before Flop (didn't bet)
Seat 2: IKARO_3 (small blind) folded before Flop
Seat 3: caduceus369 (big blind) folded before Flop
Seat 4: VagALiss folded before Flop (didn't bet)
Seat 5: pietr056 collected (€0.05)
Seat 6: TheKing.1969 folded before Flop (didn't bet)



PokerStars Zoom Hand #257998455453:  Hold'em No Limit (€0.01/€0.02) [ADM ID: M62BD3044A1E13PD] - 2025/10/04 20:57:29 CET [2025/10/04 14:57:29 ET]
Table 'Sirio' 6-max Seat #1 is the button
Seat 1: Chia9711 (€1.26 in chips) 
Seat 2: ghosto69 (€4.28 in chips) 
Seat 3: TheKing.1969 (€1.57 in chips) 
Seat 4: bruciapelo (€2.28 in chips) 
Seat 5: caduceus369 (€2 in chips) 
Seat 6: Pascalzone (€2 in chips) 
ghosto69: posts small blind €0.01
TheKing.1969: posts big blind €0.02
*** HOLE CARDS ***
Dealt to caduceus369 [Qc Td]
bruciapelo: folds 
caduceus369: folds 
Pascalzone: folds 
Chia9711: calls €0.02
ghosto69: folds 
TheKing.1969: checks 
*** FLOP *** [6h 2d 4d]
TheKing.1969: checks 
Chia9711: checks 
*** TURN *** [6h 2d 4d] [Ks]
TheKing.1969: bets €0.04
Chia9711: raises €0.04 to €0.08
TheKing.1969: raises €0.20 to €0.28
Chia9711: calls €0.20
*** RIVER *** [6h 2d 4d Ks] [5c]
TheKing.1969: bets €0.52
Chia9711: folds 
Uncalled bet (€0.52) returned to TheKing.1969
TheKing.1969 collected €0.58 from pot
TheKing.1969: doesn't show hand 
*** SUMMARY ***
Total pot €0.61 | Rake €0.03 
Board [6h 2d 4d Ks 5c]
Seat 1: Chia9711 (button) folded on the River
Seat 2: ghosto69 (small blind) folded before Flop
Seat 3: TheKing.1969 (big blind) collected (€0.58)
Seat 4: bruciapelo folded before Flop (didn't bet)
Seat 5: caduceus369 folded before Flop (didn't bet)
Seat 6: Pascalzone folded before Flop (didn't bet)



PokerStars Zoom Hand #257998461642:  Hold'em No Limit (€0.01/€0.02) [ADM ID: M62BD3044A1E13PD] - 2025/10/04 20:58:11 CET [2025/10/04 14:58:11 ET]
Table 'Sirio' 6-max Seat #1 is the button
Seat 1: lupocane (€2.05 in chips) 
Seat 2: ghosto69 (€1.84 in chips) 
Seat 3: Chia9711 (€0.96 in chips) 
Seat 4: Ullkaustru (€2.98 in chips) 
Seat 5: caduceus369 (€2 in chips) 
Seat 6: VagALiss (€0.67 in chips) 
ghosto69: posts small blind €0.01
Chia9711: posts big blind €0.02
*** HOLE CARDS ***
Dealt to caduceus369 [8c 9s]
Ullkaustru: raises €0.02 to €0.04
caduceus369: folds 
VagALiss: folds 
lupocane: folds 
ghosto69: folds 
Chia9711: calls €0.02
*** FLOP *** [9d As Jc]
Chia9711: checks 
Ullkaustru: checks 
*** TURN *** [9d As Jc] [Qd]
Chia9711: checks 
Ullkaustru: checks 
*** RIVER *** [9d As Jc Qd] [8h]
Chia9711: checks 
Ullkaustru: checks 
*** SHOW DOWN ***
Chia9711: shows [Jh 3c] (a pair of Jacks)
Ullkaustru: mucks hand 
Chia9711 collected €0.09 from pot
*** SUMMARY ***
Total pot €0.09 | Rake €0 
Board [9d As Jc Qd 8h]
Seat 1: lupocane (button) folded before Flop (didn't bet)
Seat 2: ghosto69 (small blind) folded before Flop
Seat 3: Chia9711 (big blind) showed [Jh 3c] and won (€0.09) with a pair of Jacks
Seat 4: Ullkaustru mucked [Kd 9c]
Seat 5: caduceus369 folded before Flop (didn't bet)
Seat 6: VagALiss folded before Flop (didn't bet)



PokerStars Zoom Hand #257998462617:  Hold'em No Limit (€0.01/€0.02) [ADM ID: M62BD3044A1E13PD] - 2025/10/04 20:58:18 CET [2025/10/04 14:58:18 ET]
Table 'Sirio' 6-max Seat #1 is the button
Seat 1: CARAPIGNA (€1.66 in chips) 
Seat 2: caduceus369 (€2 in chips) 
Seat 3: TheKing.1969 (€1.48 in chips) 
Seat 4: Brigantoni66 (€0.71 in chips) 
Seat 5: GanchanS7 (€2.07 in chips) 
Seat 6: lupocane (€2.05 in chips) 
caduceus369: posts small blind €0.01
TheKing.1969: posts big blind €0.02
*** HOLE CARDS ***
Dealt to caduceus369 [As 8d]
Brigantoni66: raises €0.04 to €0.06
GanchanS7: raises €0.15 to €0.21
lupocane: folds 
CARAPIGNA: folds 
caduceus369: folds 
TheKing.1969: folds 
Brigantoni66: calls €0.15
*** FLOP *** [Kh 3c 4c]
Brigantoni66: checks 
GanchanS7: bets €0.51
Brigantoni66: folds 
Uncalled bet (€0.51) returned to GanchanS7
GanchanS7 collected €0.43 from pot
GanchanS7: doesn't show hand 
*** SUMMARY ***
Total pot €0.45 | Rake €0.02 
Board [Kh 3c 4c]
Seat 1: CARAPIGNA (button) folded before Flop (didn't bet)
Seat 2: caduceus369 (small blind) folded before Flop
Seat 3: TheKing.1969 (big blind) folded before Flop
Seat 4: Brigantoni66 folded on the Flop
Seat 5: GanchanS7 collected (€0.43)
Seat 6: lupocane folded before Flop (didn't bet)



PokerStars Zoom Hand #257998460473:  Hold'em No Limit (€0.01/€0.02) [ADM ID: M62BD3044A1E13PD] - 2025/10/04 20:58:03 CET [2025/10/04 14:58:03 ET]
Table 'Sirio' 6-max Seat #1 is the button
Seat 1: caduceus369 (€2 in chips) 
Seat 2: Catania838 (€1.86 in chips) 
Seat 3: pietr056 (€1.10 in chips) 
Seat 4: GanchanS7 (€3.21 in chips) 
Seat 5: pylonstrip (€2.03 in chips) 
Seat 6: trisco66 (€4.61 in chips) 
Catania838: posts small blind €0.01
pietr056: posts big blind €0.02
*** HOLE CARDS ***
Dealt to caduceus369 [3s Qs]
GanchanS7: folds 
pylonstrip: raises €0.03 to €0.05
trisco66: calls €0.05
caduceus369: folds 
Catania838: folds 
pietr056: folds 
*** FLOP *** [4c Ac 8c]
pylonstrip: bets €0.07
trisco66: calls €0.07
*** TURN *** [4c Ac 8c] [8d]
pylonstrip: bets €0.17
trisco66: calls €0.17
*** RIVER *** [4c Ac 8c 8d] [2h]
pylonstrip: bets €0.33
trisco66: folds 
Uncalled bet (€0.33) returned to pylonstrip
pylonstrip collected €0.58 from pot
pylonstrip: doesn't show hand 
*** SUMMARY ***
Total pot €0.61 | Rake €0.03 
Board [4c Ac 8c 8d 2h]
Seat 1: caduceus369 (button) folded before Flop (didn't bet)
Seat 2: Catania838 (small blind) folded before Flop
Seat 3: pietr056 (big blind) folded before Flop
Seat 4: GanchanS7 folded before Flop (didn't bet)
Seat 5: pylonstrip collected (€0.58)
Seat 6: trisco66 folded on the River



PokerStars Zoom Hand #257998464685:  Hold'em No Limit (€0.01/€0.02) [ADM ID: M62BD3044A1E13PD] - 2025/10/04 20:58:32 CET [2025/10/04 14:58:32 ET]
Table 'Sirio' 6-max Seat #1 is the button
Seat 1: Catania838 (€1.86 in chips) 
Seat 2: ADRIAN0_MEIS (€2.15 in chips) 
Seat 3: ghosto69 (€4.30 in chips) 
Seat 4: TheKing.1969 (€1.69 in chips) 
Seat 5: GanchanS7 (€2.87 in chips) 
Seat 6: caduceus369 (€2 in chips) 
ADRIAN0_MEIS: posts small blind €0.01
ghosto69: posts big blind €0.02
*** HOLE CARDS ***
Dealt to caduceus369 [Td Ks]
TheKing.1969: folds 
GanchanS7 has timed out
GanchanS7: folds 
caduceus369: raises €0.04 to €0.06
Catania838: raises €0.04 to €0.10
ADRIAN0_MEIS: calls €0.09
ghosto69: calls €0.08
caduceus369: calls €0.04
*** FLOP *** [8d 7c 8s]
ADRIAN0_MEIS: checks 
ghosto69: checks 
caduceus369: checks 
Catania838: bets €0.19
ADRIAN0_MEIS: folds 
ghosto69: calls €0.19
caduceus369: folds 
*** TURN *** [8d 7c 8s] [8h]
ghosto69: checks 
Catania838: checks 
*** RIVER *** [8d 7c 8s 8h] [3c]
ghosto69: bets €0.24
Catania838: folds 
Uncalled bet (€0.24) returned to ghosto69
ghosto69 collected €0.74 from pot
ghosto69: doesn't show hand 
*** SUMMARY ***
Total pot €0.78 | Rake €0.04 
Board [8d 7c 8s 8h 3c]
Seat 1: Catania838 (button) folded on the River
Seat 2: ADRIAN0_MEIS (small blind) folded on the Flop
Seat 3: ghosto69 (big blind) collected (€0.74)
Seat 4: TheKing.1969 folded before Flop (didn't bet)
Seat 5: GanchanS7 folded before Flop (didn't bet)
Seat 6: caduceus369 folded on the Flop



PokerStars Zoom Hand #257998472341:  Hold'em No Limit (€0.01/€0.02) [ADM ID: M62BD3044A1E13PD] - 2025/10/04 20:59:25 CET [2025/10/04 14:59:25 ET]
Table 'Sirio' 6-max Seat #1 is the button
Seat 1: Pascalzone (€1.82 in chips) 
Seat 2: GanchanS7 (€4.40 in chips) 
Seat 3: trisco66 (€4.31 in chips) 
Seat 4: caduceus369 (€2 in chips) 
Seat 5: TheKing.1969 (€2.11 in chips) 
Seat 6: panzapelata (€2.01 in chips) 
GanchanS7: posts small blind €0.01
trisco66: posts big blind €0.02
*** HOLE CARDS ***
Dealt to caduceus369 [9c Ah]
caduceus369: folds 
TheKing.1969: folds 
panzapelata: raises €0.12 to €0.14
Pascalzone: folds 
GanchanS7: folds 
trisco66: folds 
Uncalled bet (€0.12) returned to panzapelata
panzapelata collected €0.05 from pot
panzapelata: doesn't show hand 
*** SUMMARY ***
Total pot €0.05 | Rake €0 
Seat 1: Pascalzone (button) folded before Flop (didn't bet)
Seat 2: GanchanS7 (small blind) folded before Flop
Seat 3: trisco66 (big blind) folded before Flop
Seat 4: caduceus369 folded before Flop (didn't bet)
Seat 5: TheKing.1969 folded before Flop (didn't bet)
Seat 6: panzapelata collected (€0.05)



PokerStars Zoom Hand #257998471210:  Hold'em No Limit (€0.01/€0.02) [ADM ID: M62BD3044A1E13PD] - 2025/10/04 20:59:17 CET [2025/10/04 14:59:17 ET]
Table 'Sirio' 6-max Seat #1 is the button
Seat 1: GanchanS7 (€3.21 in chips) 
Seat 2: IKARO_3 (€1.30 in chips) 
Seat 3: Wunschgast (€5.22 in chips) 
Seat 4: caduceus369 (€2 in chips) 
Seat 5: pietr056 (€1.16 in chips) 
Seat 6: TheKing.1969 (€2.11 in chips) 
IKARO_3: posts small blind €0.01
Wunschgast: posts big blind €0.02
*** HOLE CARDS ***
Dealt to caduceus369 [Qd 3h]
caduceus369: folds 
pietr056: folds 
TheKing.1969: folds 
GanchanS7: folds 
IKARO_3: calls €0.01
Wunschgast: checks 
*** FLOP *** [2s 4s 5c]
IKARO_3: bets €0.03
Wunschgast: calls €0.03
*** TURN *** [2s 4s 5c] [Kd]
IKARO_3: bets €0.12
Wunschgast: calls €0.12
*** RIVER *** [2s 4s 5c Kd] [Ks]
IKARO_3: checks 
Wunschgast: checks 
*** SHOW DOWN ***
IKARO_3: shows [2c 2d] (a full house, Deuces full of Kings)
Wunschgast: mucks hand 
IKARO_3 collected €0.33 from pot
*** SUMMARY ***
Total pot €0.34 | Rake €0.01 
Board [2s 4s 5c Kd Ks]
Seat 1: GanchanS7 (button) folded before Flop (didn't bet)
Seat 2: IKARO_3 (small blind) showed [2c 2d] and won (€0.33) with a full house, Deuces full of Kings
Seat 3: Wunschgast (big blind) mucked [4d As]
Seat 4: caduceus369 folded before Flop (didn't bet)
Seat 5: pietr056 folded before Flop (didn't bet)
Seat 6: TheKing.1969 folded before Flop (didn't bet)



PokerStars Zoom Hand #257998474799:  Hold'em No Limit (€0.01/€0.02) [ADM ID: M62BD3044A1E13PD] - 2025/10/04 20:59:42 CET [2025/10/04 14:59:42 ET]
Table 'Sirio' 6-max Seat #1 is the button
Seat 1: ghosto69 (€1.83 in chips) 
Seat 2: lucacada98 (€2.14 in chips) 
Seat 3: caduceus369 (€2 in chips) 
Seat 4: Pascalzone (€1.82 in chips) 
Seat 5: TheKing.1969 (€1.45 in chips) 
Seat 6: panzapelata (€2.47 in chips) 
lucacada98: posts small blind €0.01
caduceus369: posts big blind €0.02
*** HOLE CARDS ***
Dealt to caduceus369 [4h Qd]
Pascalzone: folds 
TheKing.1969: folds 
panzapelata: folds 
ghosto69: folds 
lucacada98: folds 
Uncalled bet (€0.01) returned to caduceus369
caduceus369 collected €0.02 from pot
caduceus369: doesn't show hand 
*** SUMMARY ***
Total pot €0.02 | Rake €0 
Seat 1: ghosto69 (button) folded before Flop (didn't bet)
Seat 2: lucacada98 (small blind) folded before Flop
Seat 3: caduceus369 (big blind) collected (€0.02)
Seat 4: Pascalzone folded before Flop (didn't bet)
Seat 5: TheKing.1969 folded before Flop (didn't bet)
Seat 6: panzapelata folded before Flop (didn't bet)



PokerStars Zoom Hand #257998473594:  Hold'em No Limit (€0.01/€0.02) [ADM ID: M62BD3044A1E13PD] - 2025/10/04 20:59:34 CET [2025/10/04 14:59:34 ET]
Table 'Sirio' 6-max Seat #1 is the button
Seat 1: caduceus369 (€2 in chips) 
Seat 2: Brigantoni66 (€0.42 in chips) 
Seat 3: pietr056 (€1.15 in chips) 
Seat 4: flippone78 (€0.94 in chips) 
Seat 5: Giuggiola64 (€1.39 in chips) 
Seat 6: CARAPIGNA (€1.61 in chips) 
Brigantoni66: posts small blind €0.01
pietr056: posts big blind €0.02
*** HOLE CARDS ***
Dealt to caduceus369 [Ts 8d]
flippone78: folds 
Giuggiola64: calls €0.02
CARAPIGNA: folds 
caduceus369: folds 
Brigantoni66: calls €0.01
pietr056: checks 
*** FLOP *** [8h 7c 3s]
Brigantoni66: checks 
pietr056: bets €0.02
Giuggiola64: calls €0.02
Brigantoni66: calls €0.02
*** TURN *** [8h 7c 3s] [Ah]
Brigantoni66: checks 
pietr056: checks 
Giuggiola64: checks 
*** RIVER *** [8h 7c 3s Ah] [6c]
Brigantoni66: checks 
pietr056: checks 
Giuggiola64: bets €0.06
Brigantoni66: folds 
pietr056: folds 
Uncalled bet (€0.06) returned to Giuggiola64
Giuggiola64 collected €0.12 from pot
Giuggiola64: doesn't show hand 
*** SUMMARY ***
Total pot €0.12 | Rake €0 
Board [8h 7c 3s Ah 6c]
Seat 1: caduceus369 (button) folded before Flop (didn't bet)
Seat 2: Brigantoni66 (small blind) folded on the River
Seat 3: pietr056 (big blind) folded on the River
Seat 4: flippone78 folded before Flop (didn't bet)
Seat 5: Giuggiola64 collected (€0.12)
Seat 6: CARAPIGNA folded before Flop (didn't bet)



PokerStars Zoom Hand #257998477301:  Hold'em No Limit (€0.01/€0.02) [ADM ID: M62BD3044A1E13PD] - 2025/10/04 20:59:59 CET [2025/10/04 14:59:59 ET]
Table 'Sirio' 6-max Seat #1 is the button
Seat 1: Pascalzone (€1.80 in chips) 
Seat 2: caduceus369 (€2.01 in chips) 
Seat 3: ghosto69 (€1.83 in chips) 
Seat 4: Chia9711 (€1.21 in chips) 
Seat 5: panzapelata (€2.46 in chips) 
Seat 6: RRsanto (€2.08 in chips) 
caduceus369: posts small blind €0.01
ghosto69: posts big blind €0.02
*** HOLE CARDS ***
Dealt to caduceus369 [5d Ac]
Chia9711: calls €0.02
panzapelata: folds 
RRsanto: folds 
Pascalzone: raises €0.06 to €0.08
caduceus369: folds 
ghosto69: folds 
Chia9711: calls €0.06
*** FLOP *** [3s Td 6s]
Chia9711: checks 
Pascalzone: bets €0.08
Chia9711: folds 
Uncalled bet (€0.08) returned to Pascalzone
Pascalzone collected €0.18 from pot
Pascalzone: doesn't show hand 
*** SUMMARY ***
Total pot €0.19 | Rake €0.01 
Board [3s Td 6s]
Seat 1: Pascalzone (button) collected (€0.18)
Seat 2: caduceus369 (small blind) folded before Flop
Seat 3: ghosto69 (big blind) folded before Flop
Seat 4: Chia9711 folded on the Flop
Seat 5: panzapelata folded before Flop (didn't bet)
Seat 6: RRsanto folded before Flop (didn't bet)



PokerStars Zoom Hand #257998478453:  Hold'em No Limit (€0.01/€0.02) [ADM ID: M62BD3044A1E13PD] - 2025/10/04 21:00:07 CET [2025/10/04 15:00:07 ET]
Table 'Sirio' 6-max Seat #1 is the button
Seat 1: pietr056 (€1.11 in chips) 
Seat 2: kAllSeMPRE73 (€1.54 in chips) 
Seat 3: panzapelata (€2.46 in chips) 
Seat 4: caduceus369 (€2 in chips) 
Seat 5: ADRIAN0_MEIS (€4.55 in chips) 
Seat 6: Wind9force (€7.61 in chips) 
kAllSeMPRE73: posts small blind €0.01
panzapelata: posts big blind €0.02
*** HOLE CARDS ***
Dealt to caduceus369 [9d Jc]
caduceus369: folds 
ADRIAN0_MEIS: folds 
Wind9force: folds 
pietr056: folds 
kAllSeMPRE73: raises €0.02 to €0.04
panzapelata: folds 
Uncalled bet (€0.02) returned to kAllSeMPRE73
kAllSeMPRE73 collected €0.04 from pot
kAllSeMPRE73: doesn't show hand 
*** SUMMARY ***
Total pot €0.04 | Rake €0 
Seat 1: pietr056 (button) folded before Flop (didn't bet)
Seat 2: kAllSeMPRE73 (small blind) collected (€0.04)
Seat 3: panzapelata (big blind) folded before Flop
Seat 4: caduceus369 folded before Flop (didn't bet)
Seat 5: ADRIAN0_MEIS folded before Flop (didn't bet)
Seat 6: Wind9force folded before Flop (didn't bet)



PokerStars Zoom Hand #257998479379:  Hold'em No Limit (€0.01/€0.02) [ADM ID: M62BD3044A1E13PD] - 2025/10/04 21:00:13 CET [2025/10/04 15:00:13 ET]
Table 'Sirio' 6-max Seat #1 is the button
Seat 1: caduceus369 (€2 in chips) 
Seat 2: Gabrielefante (€6.44 in chips) 
Seat 3: RRsanto (€2.08 in chips) 
Seat 4: TheKing.1969 (€2 in chips) 
Seat 5: GanchanS7 (€4.39 in chips) 
Seat 6: lupocane (€2.11 in chips) 
Gabrielefante: posts small blind €0.01
RRsanto: posts big blind €0.02
*** HOLE CARDS ***
Dealt to caduceus369 [6h 4s]
TheKing.1969: folds 
GanchanS7: raises €0.03 to €0.05
lupocane: folds 
caduceus369: folds 
Gabrielefante: calls €0.04
RRsanto: folds 
*** FLOP *** [3c 4h 4d]
Gabrielefante: checks 
GanchanS7: checks 
*** TURN *** [3c 4h 4d] [5h]
Gabrielefante: bets €0.04
GanchanS7: folds 
Uncalled bet (€0.04) returned to Gabrielefante
Gabrielefante collected €0.12 from pot
Gabrielefante: doesn't show hand 
*** SUMMARY ***
Total pot €0.12 | Rake €0 
Board [3c 4h 4d 5h]
Seat 1: caduceus369 (button) folded before Flop (didn't bet)
Seat 2: Gabrielefante (small blind) collected (€0.12)
Seat 3: RRsanto (big blind) folded before Flop
Seat 4: TheKing.1969 folded before Flop (didn't bet)
Seat 5: GanchanS7 folded on the Turn
Seat 6: lupocane folded before Flop (didn't bet)



PokerStars Zoom Hand #257998480466:  Hold'em No Limit (€0.01/€0.02) [ADM ID: M62BD3044A1E13PD] - 2025/10/04 21:00:20 CET [2025/10/04 15:00:20 ET]
Table 'Sirio' 6-max Seat #1 is the button
Seat 1: Chia9711 (€1.13 in chips) 
Seat 2: IKARO_3 (€2.41 in chips) 
Seat 3: caduceus369 (€2 in chips) 
Seat 4: pietr056 (€1.11 in chips) 
Seat 5: lupocane (€2.11 in chips) 
Seat 6: GanchanS7 (€3.02 in chips) 
IKARO_3: posts small blind €0.01
caduceus369: posts big blind €0.02
*** HOLE CARDS ***
Dealt to caduceus369 [9h 5h]
pietr056: raises €0.02 to €0.04
lupocane: folds 
GanchanS7: folds 
Chia9711: calls €0.04
IKARO_3: folds 
caduceus369: folds 
*** FLOP *** [Jh 7s 8s]
pietr056: bets €0.06
Chia9711: calls €0.06
*** TURN *** [Jh 7s 8s] [7d]
pietr056: bets €0.11
Chia9711: folds 
Uncalled bet (€0.11) returned to pietr056
pietr056 collected €0.22 from pot
pietr056: doesn't show hand 
*** SUMMARY ***
Total pot €0.23 | Rake €0.01 
Board [Jh 7s 8s 7d]
Seat 1: Chia9711 (button) folded on the Turn
Seat 2: IKARO_3 (small blind) folded before Flop
Seat 3: caduceus369 (big blind) folded before Flop
Seat 4: pietr056 collected (€0.22)
Seat 5: lupocane folded before Flop (didn't bet)
Seat 6: GanchanS7 folded before Flop (didn't bet)



PokerStars Zoom Hand #257998483513:  Hold'em No Limit (€0.01/€0.02) [ADM ID: M62BD3044A1E13PD] - 2025/10/04 21:00:40 CET [2025/10/04 15:00:40 ET]
Table 'Sirio' 6-max Seat #1 is the button
Seat 1: diesel197474 (€1.25 in chips) 
Seat 2: caduceus369 (€2 in chips) 
Seat 3: ADRIAN0_MEIS (€2.19 in chips) 
Seat 4: GanchanS7 (€4.34 in chips) 
Seat 5: N0thingforU (€3.26 in chips) 
Seat 6: Brigantoni66 (€0.78 in chips) 
caduceus369: posts small blind €0.01
ADRIAN0_MEIS: posts big blind €0.02
*** HOLE CARDS ***
Dealt to caduceus369 [6c Ts]
GanchanS7: folds 
N0thingforU: folds 
Brigantoni66: folds 
diesel197474: folds 
caduceus369: folds 
Uncalled bet (€0.01) returned to ADRIAN0_MEIS
ADRIAN0_MEIS collected €0.02 from pot
ADRIAN0_MEIS: doesn't show hand 
*** SUMMARY ***
Total pot €0.02 | Rake €0 
Seat 1: diesel197474 (button) folded before Flop (didn't bet)
Seat 2: caduceus369 (small blind) folded before Flop
Seat 3: ADRIAN0_MEIS (big blind) collected (€0.02)
Seat 4: GanchanS7 folded before Flop (didn't bet)
Seat 5: N0thingforU folded before Flop (didn't bet)
Seat 6: Brigantoni66 folded before Flop (didn't bet)



PokerStars Zoom Hand #257998482801:  Hold'em No Limit (€0.01/€0.02) [ADM ID: M62BD3044A1E13PD] - 2025/10/04 21:00:35 CET [2025/10/04 15:00:35 ET]
Table 'Sirio' 6-max Seat #1 is the button
Seat 1: Black98Demon (€4.42 in chips) 
Seat 2: Pascalzone (€1.90 in chips) 
Seat 3: ghosto69 (€4.96 in chips) 
Seat 4: diesel197474 (€1.25 in chips) 
Seat 5: caduceus369 (€2 in chips) 
Seat 6: RRsanto (€2 in chips) 
Pascalzone: posts small blind €0.01
ghosto69: posts big blind €0.02
*** HOLE CARDS ***
Dealt to caduceus369 [4c 9c]
diesel197474: folds 
caduceus369: folds 
RRsanto: raises €0.04 to €0.06
Black98Demon: raises €0.12 to €0.18
Pascalzone: folds 
ghosto69: folds 
RRsanto: folds 
Uncalled bet (€0.12) returned to Black98Demon
Black98Demon collected €0.15 from pot
Black98Demon: doesn't show hand 
*** SUMMARY ***
Total pot €0.15 | Rake €0 
Seat 1: Black98Demon (button) collected (€0.15)
Seat 2: Pascalzone (small blind) folded before Flop
Seat 3: ghosto69 (big blind) folded before Flop
Seat 4: diesel197474 folded before Flop (didn't bet)
Seat 5: caduceus369 folded before Flop (didn't bet)
Seat 6: RRsanto folded before Flop



PokerStars Zoom Hand #257998486558:  Hold'em No Limit (€0.01/€0.02) [ADM ID: M62BD3044A1E13PD] - 2025/10/04 21:00:57 CET [2025/10/04 15:00:57 ET]
Table 'Sirio' 6-max Seat #1 is the button
Seat 1: potodds1979 (€2 in chips) 
Seat 2: lucacada98 (€2.12 in chips) 
Seat 3: pietr056 (€1.22 in chips) 
Seat 4: Pascalzone (€1.89 in chips) 
Seat 5: ghosto69 (€4.94 in chips) 
Seat 6: caduceus369 (€2 in chips) 
lucacada98: posts small blind €0.01
pietr056: posts big blind €0.02
*** HOLE CARDS ***
Dealt to caduceus369 [Kc 7d]
Pascalzone: folds 
ghosto69: folds 
caduceus369: folds 
potodds1979: raises €0.04 to €0.06
lucacada98: folds 
pietr056: calls €0.04
*** FLOP *** [2d 6h 3h]
pietr056: checks 
potodds1979: bets €0.07
pietr056: folds 
Uncalled bet (€0.07) returned to potodds1979
potodds1979 collected €0.13 from pot
potodds1979: doesn't show hand 
*** SUMMARY ***
Total pot €0.13 | Rake €0 
Board [2d 6h 3h]
Seat 1: potodds1979 (button) collected (€0.13)
Seat 2: lucacada98 (small blind) folded before Flop
Seat 3: pietr056 (big blind) folded on the Flop
Seat 4: Pascalzone folded before Flop (didn't bet)
Seat 5: ghosto69 folded before Flop (didn't bet)
Seat 6: caduceus369 folded before Flop (didn't bet)



PokerStars Zoom Hand #257998489436:  Hold'em No Limit (€0.01/€0.02) [ADM ID: M62BD3044A1E13PD] - 2025/10/04 21:01:12 CET [2025/10/04 15:01:12 ET]
Table 'Sirio' 6-max Seat #1 is the button
Seat 1: Catania838 (€1.43 in chips) 
Seat 2: stefano997 (€1.32 in chips) 
Seat 3: ghosto69 (€1.69 in chips) 
Seat 4: Black98Demon (€4.51 in chips) 
Seat 5: kAllSeMPRE73 (€1.68 in chips) 
Seat 6: caduceus369 (€2 in chips) 
stefano997: posts small blind €0.01
ghosto69: posts big blind €0.02
*** HOLE CARDS ***
Dealt to caduceus369 [7s Qs]
Black98Demon: folds 
kAllSeMPRE73: folds 
caduceus369: folds 
Catania838: folds 
stefano997: calls €0.01
ghosto69: checks 
*** FLOP *** [7h 8d Qd]
stefano997: bets €0.02
ghosto69: calls €0.02
*** TURN *** [7h 8d Qd] [Kd]
stefano997: bets €0.02
ghosto69: calls €0.02
*** RIVER *** [7h 8d Qd Kd] [3h]
stefano997: bets €0.02
ghosto69: calls €0.02
*** SHOW DOWN ***
stefano997: shows [8h 7d] (two pair, Eights and Sevens)
ghosto69: mucks hand 
stefano997 collected €0.16 from pot
*** SUMMARY ***
Total pot €0.16 | Rake €0 
Board [7h 8d Qd Kd 3h]
Seat 1: Catania838 (button) folded before Flop (didn't bet)
Seat 2: stefano997 (small blind) showed [8h 7d] and won (€0.16) with two pair, Eights and Sevens
Seat 3: ghosto69 (big blind) mucked [6c Qh]
Seat 4: Black98Demon folded before Flop (didn't bet)
Seat 5: kAllSeMPRE73 folded before Flop (didn't bet)
Seat 6: caduceus369 folded before Flop (didn't bet)



PokerStars Zoom Hand #257998493905:  Hold'em No Limit (€0.01/€0.02) [ADM ID: M62BD3044A1E13PD] - 2025/10/04 21:01:35 CET [2025/10/04 15:01:35 ET]
Table 'Sirio' 6-max Seat #1 is the button
Seat 1: Gabrielefante (€6.55 in chips) 
Seat 2: Black98Demon (€4.49 in chips) 
Seat 3: diesel197474 (€1.28 in chips) 
Seat 4: caduceus369 (€2 in chips) 
Seat 5: CARAPIGNA (€1.61 in chips) 
Seat 6: RRsanto (€2.32 in chips) 
Black98Demon: posts small blind €0.01
diesel197474: posts big blind €0.02
*** HOLE CARDS ***
Dealt to caduceus369 [Jd 8h]
caduceus369: folds 
CARAPIGNA: calls €0.02
RRsanto: folds 
Gabrielefante: calls €0.02
Black98Demon: folds 
diesel197474: checks 
*** FLOP *** [6s Qc Ah]
diesel197474: bets €0.04
CARAPIGNA: calls €0.04
Gabrielefante: calls €0.04
*** TURN *** [6s Qc Ah] [8s]
diesel197474: checks 
CARAPIGNA: checks 
Gabrielefante: checks 
*** RIVER *** [6s Qc Ah 8s] [2s]
diesel197474: checks 
CARAPIGNA: checks 
Gabrielefante: checks 
*** SHOW DOWN ***
diesel197474: shows [9d 9s] (a pair of Nines)
CARAPIGNA: shows [4c Ad] (a pair of Aces)
Gabrielefante: mucks hand 
CARAPIGNA collected €0.18 from pot
*** SUMMARY ***
Total pot €0.19 | Rake €0.01 
Board [6s Qc Ah 8s 2s]
Seat 1: Gabrielefante (button) mucked [Qd Ts]
Seat 2: Black98Demon (small blind) folded before Flop
Seat 3: diesel197474 (big blind) showed [9d 9s] and lost with a pair of Nines
Seat 4: caduceus369 folded before Flop (didn't bet)
Seat 5: CARAPIGNA showed [4c Ad] and won (€0.18) with a pair of Aces
Seat 6: RRsanto folded before Flop (didn't bet)



PokerStars Zoom Hand #257998497189:  Hold'em No Limit (€0.01/€0.02) [ADM ID: M62BD3044A1E13PD] - 2025/10/04 21:01:51 CET [2025/10/04 15:01:51 ET]
Table 'Sirio' 6-max Seat #1 is the button
Seat 1: lucpri (€0.84 in chips) 
Seat 2: ghosto69 (€1.61 in chips) 
Seat 3: caduceus369 (€2 in chips) 
Seat 4: ADRIAN0_MEIS (€2.17 in chips) 
Seat 5: lucacada98 (€2.03 in chips) 
Seat 6: GanchanS7 (€3.02 in chips) 
ghosto69: posts small blind €0.01
caduceus369: posts big blind €0.02
*** HOLE CARDS ***
Dealt to caduceus369 [Js 5d]
ADRIAN0_MEIS: folds 
lucacada98: raises €0.04 to €0.06
GanchanS7: folds 
lucpri: calls €0.06
ghosto69: folds 
caduceus369: folds 
*** FLOP *** [8h 6h Qc]
lucacada98: checks 
lucpri: checks 
*** TURN *** [8h 6h Qc] [8c]
lucacada98: bets €0.08
lucpri: calls €0.08
*** RIVER *** [8h 6h Qc 8c] [Th]
lucacada98: checks 
lucpri: checks 
*** SHOW DOWN ***
lucacada98: shows [6c 4c] (two pair, Eights and Sixes)
lucpri: shows [9h 9d] (two pair, Nines and Eights)
lucpri collected €0.30 from pot
*** SUMMARY ***
Total pot €0.31 | Rake €0.01 
Board [8h 6h Qc 8c Th]
Seat 1: lucpri (button) showed [9h 9d] and won (€0.30) with two pair, Nines and Eights
Seat 2: ghosto69 (small blind) folded before Flop
Seat 3: caduceus369 (big blind) folded before Flop
Seat 4: ADRIAN0_MEIS folded before Flop (didn't bet)
Seat 5: lucacada98 showed [6c 4c] and lost with two pair, Eights and Sixes
Seat 6: GanchanS7 folded before Flop (didn't bet)



PokerStars Zoom Hand #257998495210:  Hold'em No Limit (€0.01/€0.02) [ADM ID: M62BD3044A1E13PD] - 2025/10/04 21:01:42 CET [2025/10/04 15:01:42 ET]
Table 'Sirio' 6-max Seat #1 is the button
Seat 1: caduceus369 (€2 in chips) 
Seat 2: Chia9711 (€0.89 in chips) 
Seat 3: CIKO71131 (€0.94 in chips) 
Seat 4: ADRIAN0_MEIS (€2.05 in chips) 
Seat 5: TheKing.1969 (€1.46 in chips) 
Seat 6: pylonstrip (€3.45 in chips) 
Chia9711: posts small blind €0.01
CIKO71131: posts big blind €0.02
*** HOLE CARDS ***
Dealt to caduceus369 [6s Td]
ADRIAN0_MEIS: folds 
TheKing.1969: raises €0.02 to €0.04
pylonstrip: calls €0.04
caduceus369: folds 
Chia9711: folds 
CIKO71131: calls €0.02
*** FLOP *** [3d 7h Kd]
CIKO71131: checks 
TheKing.1969: bets €0.08
pylonstrip: folds 
CIKO71131: calls €0.08
*** TURN *** [3d 7h Kd] [Th]
CIKO71131: checks 
TheKing.1969: checks 
*** RIVER *** [3d 7h Kd Th] [Qc]
CIKO71131: bets €0.06
TheKing.1969: calls €0.06
*** SHOW DOWN ***
CIKO71131: shows [Ks 8s] (a pair of Kings)
TheKing.1969: mucks hand 
CIKO71131 collected €0.39 from pot
*** SUMMARY ***
Total pot €0.41 | Rake €0.02 
Board [3d 7h Kd Th Qc]
Seat 1: caduceus369 (button) folded before Flop (didn't bet)
Seat 2: Chia9711 (small blind) folded before Flop
Seat 3: CIKO71131 (big blind) showed [Ks 8s] and won (€0.39) with a pair of Kings
Seat 4: ADRIAN0_MEIS folded before Flop (didn't bet)
Seat 5: TheKing.1969 mucked [4h 4s]
Seat 6: pylonstrip folded on the Flop



PokerStars Zoom Hand #257998507906:  Hold'em No Limit (€0.01/€0.02) [ADM ID: M62BD3044A1E13PD] - 2025/10/04 21:02:41 CET [2025/10/04 15:02:41 ET]
Table 'Sirio' 6-max Seat #1 is the button
Seat 1: TheKing.1969 (€2.36 in chips) 
Seat 2: pylonstrip (€3.38 in chips) 
Seat 3: panzapelata (€5.25 in chips) 
Seat 4: caduceus369 (€2 in chips) 
Seat 5: Gabrielefante (€6.41 in chips) 
Seat 6: N0thingforU (€3.35 in chips) 
pylonstrip: posts small blind €0.01
panzapelata: posts big blind €0.02
*** HOLE CARDS ***
Dealt to caduceus369 [4h Th]
caduceus369: folds 
Gabrielefante: folds 
N0thingforU: folds 
TheKing.1969: folds 
pylonstrip: folds 
Uncalled bet (€0.01) returned to panzapelata
panzapelata collected €0.02 from pot
panzapelata: doesn't show hand 
*** SUMMARY ***
Total pot €0.02 | Rake €0 
Seat 1: TheKing.1969 (button) folded before Flop (didn't bet)
Seat 2: pylonstrip (small blind) folded before Flop
Seat 3: panzapelata (big blind) collected (€0.02)
Seat 4: caduceus369 folded before Flop (didn't bet)
Seat 5: Gabrielefante folded before Flop (didn't bet)
Seat 6: N0thingforU folded before Flop (didn't bet)



PokerStars Zoom Hand #257998503153:  Hold'em No Limit (€0.01/€0.02) [ADM ID: M62BD3044A1E13PD] - 2025/10/04 21:02:19 CET [2025/10/04 15:02:19 ET]
Table 'Sirio' 6-max Seat #1 is the button
Seat 1: pylonstrip (€3.38 in chips) 
Seat 2: caduceus369 (€2 in chips) 
Seat 3: VagALiss (€0.42 in chips) 
Seat 4: TheKing.1969 (€1.85 in chips) 
Seat 5: diesel197474 (€1.22 in chips) 
Seat 6: Catania838 (€1.38 in chips) 
caduceus369: posts small blind €0.01
VagALiss: posts big blind €0.02
*** HOLE CARDS ***
Dealt to caduceus369 [Ac 6c]
TheKing.1969: folds 
diesel197474: folds 
Catania838: raises €0.08 to €0.10
pylonstrip: folds 
caduceus369: folds 
VagALiss: calls €0.08
*** FLOP *** [4s 4d 2d]
VagALiss: checks 
Catania838: bets €1.28 and is all-in
VagALiss: folds 
Uncalled bet (€1.28) returned to Catania838
Catania838 collected €0.20 from pot
Catania838: doesn't show hand 
*** SUMMARY ***
Total pot €0.21 | Rake €0.01 
Board [4s 4d 2d]
Seat 1: pylonstrip (button) folded before Flop (didn't bet)
Seat 2: caduceus369 (small blind) folded before Flop
Seat 3: VagALiss (big blind) folded on the Flop
Seat 4: TheKing.1969 folded before Flop (didn't bet)
Seat 5: diesel197474 folded before Flop (didn't bet)
Seat 6: Catania838 collected (€0.20)



PokerStars Zoom Hand #257998501807:  Hold'em No Limit (€0.01/€0.02) [ADM ID: M62BD3044A1E13PD] - 2025/10/04 21:02:12 CET [2025/10/04 15:02:12 ET]
Table 'Sirio' 6-max Seat #1 is the button
Seat 1: bruciapelo (€2.79 in chips) 
Seat 2: Gabrielefante (€6.49 in chips) 
Seat 3: panzapelata (€1.58 in chips) 
Seat 4: masticatp (€1.08 in chips) 
Seat 5: caduceus369 (€2 in chips) 
Seat 6: diesel197474 (€1.22 in chips) 
Gabrielefante: posts small blind €0.01
panzapelata: posts big blind €0.02
*** HOLE CARDS ***
Dealt to caduceus369 [4h Kc]
masticatp: calls €0.02
caduceus369: folds 
diesel197474: folds 
bruciapelo: folds 
Gabrielefante: raises €0.06 to €0.08
panzapelata: calls €0.06
masticatp: calls €0.06
*** FLOP *** [2c Jd Qc]
Gabrielefante: checks 
panzapelata: bets €0.23
masticatp: calls €0.23
Gabrielefante: folds 
*** TURN *** [2c Jd Qc] [6d]
panzapelata: bets €0.78
masticatp: calls €0.77 and is all-in
Uncalled bet (€0.01) returned to panzapelata
*** RIVER *** [2c Jd Qc 6d] [6c]
*** SHOW DOWN ***
panzapelata: shows [Ts Qs] (two pair, Queens and Sixes)
masticatp: shows [Jc Qd] (two pair, Queens and Jacks)
masticatp collected €2.12 from pot
*** SUMMARY ***
Total pot €2.24 | Rake €0.12 
Board [2c Jd Qc 6d 6c]
Seat 1: bruciapelo (button) folded before Flop (didn't bet)
Seat 2: Gabrielefante (small blind) folded on the Flop
Seat 3: panzapelata (big blind) showed [Ts Qs] and lost with two pair, Queens and Sixes
Seat 4: masticatp showed [Jc Qd] and won (€2.12) with two pair, Queens and Jacks
Seat 5: caduceus369 folded before Flop (didn't bet)
Seat 6: diesel197474 folded before Flop (didn't bet)



PokerStars Zoom Hand #257998509120:  Hold'em No Limit (€0.01/€0.02) [ADM ID: M62BD3044A1E13PD] - 2025/10/04 21:02:47 CET [2025/10/04 15:02:47 ET]
Table 'Sirio' 6-max Seat #1 is the button
Seat 1: pylonstrip (€3.37 in chips) 
Seat 2: ADRIAN0_MEIS (€2 in chips) 
Seat 3: ghosto69 (€1.63 in chips) 
Seat 4: lucpri (€1 in chips) 
Seat 5: caduceus369 (€2 in chips) 
Seat 6: CIKO71131 (€1.14 in chips) 
ADRIAN0_MEIS: posts small blind €0.01
ghosto69: posts big blind €0.02
*** HOLE CARDS ***
Dealt to caduceus369 [4d 5c]
lucpri: folds 
caduceus369: folds 
CIKO71131: folds 
pylonstrip: folds 
ADRIAN0_MEIS: folds 
Uncalled bet (€0.01) returned to ghosto69
ghosto69 collected €0.02 from pot
ghosto69: doesn't show hand 
*** SUMMARY ***
Total pot €0.02 | Rake €0 
Seat 1: pylonstrip (button) folded before Flop (didn't bet)
Seat 2: ADRIAN0_MEIS (small blind) folded before Flop
Seat 3: ghosto69 (big blind) collected (€0.02)
Seat 4: lucpri folded before Flop (didn't bet)
Seat 5: caduceus369 folded before Flop (didn't bet)
Seat 6: CIKO71131 folded before Flop (didn't bet)



PokerStars Zoom Hand #257998510183:  Hold'em No Limit (€0.01/€0.02) [ADM ID: M62BD3044A1E13PD] - 2025/10/04 21:02:51 CET [2025/10/04 15:02:51 ET]
Table 'Sirio' 6-max Seat #1 is the button
Seat 1: caduceus369 (€2 in chips) 
Seat 2: lupocane (€2.02 in chips) 
Seat 3: pylonstrip (€3.37 in chips) 
Seat 4: N0thingforU (€3.35 in chips) 
Seat 5: IKARO_3 (€2.28 in chips) 
Seat 6: VagALiss (€0.32 in chips) 
lupocane: posts small blind €0.01
pylonstrip: posts big blind €0.02
*** HOLE CARDS ***
Dealt to caduceus369 [Ts 6c]
N0thingforU: folds 
IKARO_3: folds 
VagALiss: folds 
caduceus369: folds 
lupocane: folds 
Uncalled bet (€0.01) returned to pylonstrip
pylonstrip collected €0.02 from pot
pylonstrip: doesn't show hand 
*** SUMMARY ***
Total pot €0.02 | Rake €0 
Seat 1: caduceus369 (button) folded before Flop (didn't bet)
Seat 2: lupocane (small blind) folded before Flop
Seat 3: pylonstrip (big blind) collected (€0.02)
Seat 4: N0thingforU folded before Flop (didn't bet)
Seat 5: IKARO_3 folded before Flop (didn't bet)
Seat 6: VagALiss folded before Flop (didn't bet)



PokerStars Zoom Hand #257998506719:  Hold'em No Limit (€0.01/€0.02) [ADM ID: M62BD3044A1E13PD] - 2025/10/04 21:02:36 CET [2025/10/04 15:02:36 ET]
Table 'Sirio' 6-max Seat #1 is the button
Seat 1: bruciapelo (€2.78 in chips) 
Seat 2: TheKing.1969 (€2.09 in chips) 
Seat 3: kAllSeMPRE73 (€2.85 in chips) 
Seat 4: flippone78 (€1.03 in chips) 
Seat 5: ghosto69 (€1.63 in chips) 
Seat 6: caduceus369 (€2 in chips) 
TheKing.1969: posts small blind €0.01
kAllSeMPRE73: posts big blind €0.02
*** HOLE CARDS ***
Dealt to caduceus369 [6h Jd]
flippone78: raises €0.03 to €0.05
ghosto69: folds 
caduceus369: folds 
bruciapelo: folds 
TheKing.1969: folds 
kAllSeMPRE73: calls €0.03
*** FLOP *** [Kd 7d Ah]
kAllSeMPRE73: bets €0.02
flippone78: raises €0.08 to €0.10
kAllSeMPRE73: calls €0.08
*** TURN *** [Kd 7d Ah] [7c]
kAllSeMPRE73: bets €2.70 and is all-in
flippone78: folds 
Uncalled bet (€2.70) returned to kAllSeMPRE73
kAllSeMPRE73 collected €0.30 from pot
kAllSeMPRE73: doesn't show hand 
*** SUMMARY ***
Total pot €0.31 | Rake €0.01 
Board [Kd 7d Ah 7c]
Seat 1: bruciapelo (button) folded before Flop (didn't bet)
Seat 2: TheKing.1969 (small blind) folded before Flop
Seat 3: kAllSeMPRE73 (big blind) collected (€0.30)
Seat 4: flippone78 folded on the Turn
Seat 5: ghosto69 folded before Flop (didn't bet)
Seat 6: caduceus369 folded before Flop (didn't bet)



PokerStars Zoom Hand #257998511027:  Hold'em No Limit (€0.01/€0.02) [ADM ID: M62BD3044A1E13PD] - 2025/10/04 21:02:55 CET [2025/10/04 15:02:55 ET]
Table 'Sirio' 6-max Seat #1 is the button
Seat 1: Catania838 (€1.48 in chips) 
Seat 2: Robycastel89 (€1.23 in chips) 
Seat 3: caduceus369 (€2 in chips) 
Seat 4: GanchanS7 (€2.23 in chips) 
Seat 5: Chia9711 (€0.83 in chips) 
Seat 6: Giuggiola64 (€1.55 in chips) 
Robycastel89: posts small blind €0.01
caduceus369: posts big blind €0.02
*** HOLE CARDS ***
Dealt to caduceus369 [8c 6c]
GanchanS7: raises €0.03 to €0.05
Chia9711: folds 
Giuggiola64: calls €0.05
Catania838: folds 
Robycastel89: folds 
caduceus369: calls €0.03
*** FLOP *** [9s Ts 9d]
caduceus369: checks 
GanchanS7: checks 
Giuggiola64: bets €0.02
caduceus369: calls €0.02
GanchanS7: calls €0.02
*** TURN *** [9s Ts 9d] [Td]
caduceus369: checks 
GanchanS7: checks 
Giuggiola64: bets €0.02
caduceus369: folds 
GanchanS7: folds 
Uncalled bet (€0.02) returned to Giuggiola64
Giuggiola64 collected €0.21 from pot
Giuggiola64: doesn't show hand 
*** SUMMARY ***
Total pot €0.22 | Rake €0.01 
Board [9s Ts 9d Td]
Seat 1: Catania838 (button) folded before Flop (didn't bet)
Seat 2: Robycastel89 (small blind) folded before Flop
Seat 3: caduceus369 (big blind) folded on the Turn
Seat 4: GanchanS7 folded on the Turn
Seat 5: Chia9711 folded before Flop (didn't bet)
Seat 6: Giuggiola64 collected (€0.21)



PokerStars Zoom Hand #257998520507:  Hold'em No Limit (€0.01/€0.02) [ADM ID: M62BD3044A1E13PD] - 2025/10/04 21:03:38 CET [2025/10/04 15:03:38 ET]
Table 'Sirio' 6-max Seat #1 is the button
Seat 1: lupocane (€2.06 in chips) 
Seat 2: caduceus369 (€2 in chips) 
Seat 3: GanchanS7 (€2.16 in chips) 
Seat 4: Gabrielefante (€6.41 in chips) 
Seat 5: ADRIAN0_MEIS (€4.84 in chips) 
Seat 6: panzapelata (€5.48 in chips) 
caduceus369: posts small blind €0.01
GanchanS7: posts big blind €0.02
*** HOLE CARDS ***
Dealt to caduceus369 [Qd Qh]
Gabrielefante: folds 
ADRIAN0_MEIS: folds 
panzapelata: folds 
lupocane: folds 
caduceus369: raises €0.04 to €0.06
GanchanS7: folds 
Uncalled bet (€0.04) returned to caduceus369
caduceus369 collected €0.04 from pot
caduceus369: doesn't show hand 
*** SUMMARY ***
Total pot €0.04 | Rake €0 
Seat 1: lupocane (button) folded before Flop (didn't bet)
Seat 2: caduceus369 (small blind) collected (€0.04)
Seat 3: GanchanS7 (big blind) folded before Flop
Seat 4: Gabrielefante folded before Flop (didn't bet)
Seat 5: ADRIAN0_MEIS folded before Flop (didn't bet)
Seat 6: panzapelata folded before Flop (didn't bet)



PokerStars Zoom Hand #257998525793:  Hold'em No Limit (€0.01/€0.02) [ADM ID: M62BD3044A1E13PD] - 2025/10/04 21:04:02 CET [2025/10/04 15:04:02 ET]
Table 'Sirio' 6-max Seat #1 is the button
Seat 1: Black98Demon (€4.41 in chips) 
Seat 2: TheKing.1969 (€2.44 in chips) 
Seat 3: flippone78 (€0.84 in chips) 
Seat 4: ghosto69 (€4.74 in chips) 
Seat 5: caduceus369 (€2.02 in chips) 
Seat 6: lupocane (€2.04 in chips) 
TheKing.1969: posts small blind €0.01
flippone78: posts big blind €0.02
*** HOLE CARDS ***
Dealt to caduceus369 [9h 5c]
ghosto69: folds 
caduceus369: folds 
lupocane: folds 
Black98Demon: raises €0.03 to €0.05
TheKing.1969: folds 
flippone78: folds 
Uncalled bet (€0.03) returned to Black98Demon
Black98Demon collected €0.05 from pot
Black98Demon: doesn't show hand 
*** SUMMARY ***
Total pot €0.05 | Rake €0 
Seat 1: Black98Demon (button) collected (€0.05)
Seat 2: TheKing.1969 (small blind) folded before Flop
Seat 3: flippone78 (big blind) folded before Flop
Seat 4: ghosto69 folded before Flop (didn't bet)
Seat 5: caduceus369 folded before Flop (didn't bet)
Seat 6: lupocane folded before Flop (didn't bet)



PokerStars Zoom Hand #257998527588:  Hold'em No Limit (€0.01/€0.02) [ADM ID: M62BD3044A1E13PD] - 2025/10/04 21:04:10 CET [2025/10/04 15:04:10 ET]
Table 'Sirio' 6-max Seat #1 is the button
Seat 1: TheKing.1969 (€1.06 in chips) 
Seat 2: RRsanto (€2.67 in chips) 
Seat 3: N0thingforU (€3.58 in chips) 
Seat 4: caduceus369 (€2.02 in chips) 
Seat 5: pylonstrip (€3.50 in chips) 
Seat 6: GanchanS7 (€4.14 in chips) 
RRsanto: posts small blind €0.01
N0thingforU: posts big blind €0.02
*** HOLE CARDS ***
Dealt to caduceus369 [4s 3h]
caduceus369: folds 
pylonstrip: folds 
GanchanS7: folds 
TheKing.1969: raises €0.03 to €0.05
RRsanto: folds 
N0thingforU: calls €0.03
*** FLOP *** [5h 2h 9s]
N0thingforU: checks 
TheKing.1969: bets €0.10
N0thingforU: folds 
Uncalled bet (€0.10) returned to TheKing.1969
TheKing.1969 collected €0.11 from pot
TheKing.1969: doesn't show hand 
*** SUMMARY ***
Total pot €0.11 | Rake €0 
Board [5h 2h 9s]
Seat 1: TheKing.1969 (button) collected (€0.11)
Seat 2: RRsanto (small blind) folded before Flop
Seat 3: N0thingforU (big blind) folded on the Flop
Seat 4: caduceus369 folded before Flop (didn't bet)
Seat 5: pylonstrip folded before Flop (didn't bet)
Seat 6: GanchanS7 folded before Flop (didn't bet)



PokerStars Zoom Hand #257998529074:  Hold'em No Limit (€0.01/€0.02) [ADM ID: M62BD3044A1E13PD] - 2025/10/04 21:04:16 CET [2025/10/04 15:04:16 ET]
Table 'Sirio' 6-max Seat #1 is the button
Seat 1: flippone78 (€0.82 in chips) 
Seat 2: caduceus369 (€2.02 in chips) 
Seat 3: ADRIAN0_MEIS (€2 in chips) 
Seat 4: lupocane (€2.03 in chips) 
Seat 5: kAllSeMPRE73 (€3.02 in chips) 
Seat 6: Chia9711 (€0.87 in chips) 
caduceus369: posts small blind €0.01
ADRIAN0_MEIS: posts big blind €0.02
*** HOLE CARDS ***
Dealt to caduceus369 [2h 8h]
lupocane: folds 
kAllSeMPRE73: raises €0.02 to €0.04
Chia9711: calls €0.04
flippone78: folds 
caduceus369: folds 
ADRIAN0_MEIS: folds 
*** FLOP *** [2s Qh 7h]
kAllSeMPRE73: bets €0.06
Chia9711: calls €0.06
*** TURN *** [2s Qh 7h] [Js]
kAllSeMPRE73: bets €0.02
Chia9711: calls €0.02
*** RIVER *** [2s Qh 7h Js] [6h]
kAllSeMPRE73: bets €0.02
Chia9711: raises €0.20 to €0.22
kAllSeMPRE73: calls €0.20
*** SHOW DOWN ***
Chia9711: shows [Kh Th] (a flush, King high)
kAllSeMPRE73: mucks hand 
Chia9711 collected €0.68 from pot
*** SUMMARY ***
Total pot €0.71 | Rake €0.03 
Board [2s Qh 7h Js 6h]
Seat 1: flippone78 (button) folded before Flop (didn't bet)
Seat 2: caduceus369 (small blind) folded before Flop
Seat 3: ADRIAN0_MEIS (big blind) folded before Flop
Seat 4: lupocane folded before Flop (didn't bet)
Seat 5: kAllSeMPRE73 mucked [Td Qd]
Seat 6: Chia9711 showed [Kh Th] and won (€0.68) with a flush, King high



PokerStars Zoom Hand #257998532529:  Hold'em No Limit (€0.01/€0.02) [ADM ID: M62BD3044A1E13PD] - 2025/10/04 21:04:32 CET [2025/10/04 15:04:32 ET]
Table 'Sirio' 6-max Seat #1 is the button
Seat 1: eleonora50 (€1.14 in chips) 
Seat 2: ADRIAN0_MEIS (€2 in chips) 
Seat 3: caduceus369 (€2.01 in chips) 
Seat 4: GanchanS7 (€2.13 in chips) 
Seat 5: diesel197474 (€1.12 in chips) 
Seat 6: IKARO_3 (€2.25 in chips) 
ADRIAN0_MEIS: posts small blind €0.01
caduceus369: posts big blind €0.02
*** HOLE CARDS ***
Dealt to caduceus369 [8s 2s]
GanchanS7: folds 
diesel197474: folds 
IKARO_3: raises €0.04 to €0.06
eleonora50: folds 
ADRIAN0_MEIS: folds 
caduceus369: folds 
Uncalled bet (€0.04) returned to IKARO_3
IKARO_3 collected €0.05 from pot
IKARO_3: doesn't show hand 
*** SUMMARY ***
Total pot €0.05 | Rake €0 
Seat 1: eleonora50 (button) folded before Flop (didn't bet)
Seat 2: ADRIAN0_MEIS (small blind) folded before Flop
Seat 3: caduceus369 (big blind) folded before Flop
Seat 4: GanchanS7 folded before Flop (didn't bet)
Seat 5: diesel197474 folded before Flop (didn't bet)
Seat 6: IKARO_3 collected (€0.05)



PokerStars Zoom Hand #257998530809:  Hold'em No Limit (€0.01/€0.02) [ADM ID: M62BD3044A1E13PD] - 2025/10/04 21:04:24 CET [2025/10/04 15:04:24 ET]
Table 'Sirio' 6-max Seat #1 is the button
Seat 1: caduceus369 (€2.01 in chips) 
Seat 2: gigiriver170 (€1.36 in chips) 
Seat 3: GanchanS7 (€4.14 in chips) 
Seat 4: ghosto69 (€1.62 in chips) 
Seat 5: Catania838 (€1.57 in chips) 
Seat 6: flippone78 (€0.82 in chips) 
gigiriver170: posts small blind €0.01
GanchanS7: posts big blind €0.02
*** HOLE CARDS ***
Dealt to caduceus369 [5c Jd]
ghosto69: folds 
Catania838: calls €0.02
flippone78: calls €0.02
caduceus369: folds 
gigiriver170: raises €0.04 to €0.06
GanchanS7: folds 
Catania838: calls €0.04
flippone78: calls €0.04
*** FLOP *** [Ts Ad 4c]
gigiriver170: bets €0.19
Catania838: calls €0.19
flippone78: folds 
*** TURN *** [Ts Ad 4c] [3c]
gigiriver170: bets €0.28
Catania838: folds 
Uncalled bet (€0.28) returned to gigiriver170
gigiriver170 collected €0.55 from pot
gigiriver170: doesn't show hand 
*** SUMMARY ***
Total pot €0.58 | Rake €0.03 
Board [Ts Ad 4c 3c]
Seat 1: caduceus369 (button) folded before Flop (didn't bet)
Seat 2: gigiriver170 (small blind) collected (€0.55)
Seat 3: GanchanS7 (big blind) folded before Flop
Seat 4: ghosto69 folded before Flop (didn't bet)
Seat 5: Catania838 folded on the Turn
Seat 6: flippone78 folded on the Flop



PokerStars Zoom Hand #257998535028:  Hold'em No Limit (€0.01/€0.02) [ADM ID: M62BD3044A1E13PD] - 2025/10/04 21:04:43 CET [2025/10/04 15:04:43 ET]
Table 'Sirio' 6-max Seat #1 is the button
Seat 1: pylonstrip (€3.32 in chips) 
Seat 2: eleonora50 (€1.14 in chips) 
Seat 3: Bigo2802 (€2.04 in chips) 
Seat 4: Pascalzone (€1.98 in chips) 
Seat 5: masticatp (€2 in chips) 
Seat 6: caduceus369 (€2 in chips) 
eleonora50: posts small blind €0.01
Bigo2802: posts big blind €0.02
*** HOLE CARDS ***
Dealt to caduceus369 [4c Jc]
Pascalzone: folds 
masticatp: calls €0.02
caduceus369: folds 
pylonstrip: folds 
eleonora50: folds 
Bigo2802: raises €0.05 to €0.07
masticatp: calls €0.05
*** FLOP *** [6c 2d Kh]
Bigo2802: bets €0.11
masticatp: calls €0.11
*** TURN *** [6c 2d Kh] [Th]
Bigo2802: bets €0.26
masticatp: calls €0.26
*** RIVER *** [6c 2d Kh Th] [Ad]
Bigo2802: bets €1.60 and is all-in
masticatp: folds 
Uncalled bet (€1.60) returned to Bigo2802
Bigo2802 collected €0.85 from pot
Bigo2802: doesn't show hand 
*** SUMMARY ***
Total pot €0.89 | Rake €0.04 
Board [6c 2d Kh Th Ad]
Seat 1: pylonstrip (button) folded before Flop (didn't bet)
Seat 2: eleonora50 (small blind) folded before Flop
Seat 3: Bigo2802 (big blind) collected (€0.85)
Seat 4: Pascalzone folded before Flop (didn't bet)
Seat 5: masticatp folded on the River
Seat 6: caduceus369 folded before Flop (didn't bet)



PokerStars Zoom Hand #257998539120:  Hold'em No Limit (€0.01/€0.02) [ADM ID: M62BD3044A1E13PD] - 2025/10/04 21:05:01 CET [2025/10/04 15:05:01 ET]
Table 'Sirio' 6-max Seat #1 is the button
Seat 1: Giuggiola64 (€1.66 in chips) 
Seat 2: GanchanS7 (€4.12 in chips) 
Seat 3: caduceus369 (€2 in chips) 
Seat 4: Catania838 (€1.32 in chips) 
Seat 5: TheKing.1969 (€2.41 in chips) 
Seat 6: ADRIAN0_MEIS (€4.42 in chips) 
GanchanS7: posts small blind €0.01
caduceus369: posts big blind €0.02
*** HOLE CARDS ***
Dealt to caduceus369 [3h 4s]
Catania838: raises €0.02 to €0.04
TheKing.1969: folds 
ADRIAN0_MEIS: folds 
Giuggiola64: folds 
GanchanS7: folds 
caduceus369: folds 
Uncalled bet (€0.02) returned to Catania838
Catania838 collected €0.05 from pot
Catania838: doesn't show hand 
*** SUMMARY ***
Total pot €0.05 | Rake €0 
Seat 1: Giuggiola64 (button) folded before Flop (didn't bet)
Seat 2: GanchanS7 (small blind) folded before Flop
Seat 3: caduceus369 (big blind) folded before Flop
Seat 4: Catania838 collected (€0.05)
Seat 5: TheKing.1969 folded before Flop (didn't bet)
Seat 6: ADRIAN0_MEIS folded before Flop (didn't bet)



PokerStars Zoom Hand #257998541794:  Hold'em No Limit (€0.01/€0.02) [ADM ID: M62BD3044A1E13PD] - 2025/10/04 21:05:13 CET [2025/10/04 15:05:13 ET]
Table 'Sirio' 6-max Seat #1 is the button
Seat 1: caduceus369 (€2 in chips) 
Seat 2: TheKing.1969 (€1.13 in chips) 
Seat 3: gigiriver170 (€1.64 in chips) 
Seat 4: Bigo2802 (€2.45 in chips) 
Seat 5: RRsanto (€2.72 in chips) 
Seat 6: ghosto69 (€1.51 in chips) 
TheKing.1969: posts small blind €0.01
gigiriver170: posts big blind €0.02
*** HOLE CARDS ***
Dealt to caduceus369 [9h 5c]
Bigo2802: folds 
RRsanto: folds 
ghosto69: raises €0.04 to €0.06
caduceus369: folds 
TheKing.1969: folds 
gigiriver170: folds 
Uncalled bet (€0.04) returned to ghosto69
ghosto69 collected €0.05 from pot
ghosto69: doesn't show hand 
*** SUMMARY ***
Total pot €0.05 | Rake €0 
Seat 1: caduceus369 (button) folded before Flop (didn't bet)
Seat 2: TheKing.1969 (small blind) folded before Flop
Seat 3: gigiriver170 (big blind) folded before Flop
Seat 4: Bigo2802 folded before Flop (didn't bet)
Seat 5: RRsanto folded before Flop (didn't bet)
Seat 6: ghosto69 collected (€0.05)



PokerStars Zoom Hand #257998536118:  Hold'em No Limit (€0.01/€0.02) [ADM ID: M62BD3044A1E13PD] - 2025/10/04 21:04:48 CET [2025/10/04 15:04:48 ET]
Table 'Sirio' 6-max Seat #1 is the button
Seat 1: bruciapelo (€3 in chips) 
Seat 2: CIKO71131 (€0.78 in chips) 
Seat 3: eleonora50 (€1.13 in chips) 
Seat 4: caduceus369 (€2 in chips) 
Seat 5: flippone78 (€0.76 in chips) 
Seat 6: GanchanS7 (€4.12 in chips) 
CIKO71131: posts small blind €0.01
eleonora50: posts big blind €0.02
*** HOLE CARDS ***
Dealt to caduceus369 [2d 2s]
caduceus369: folds 
flippone78: raises €0.03 to €0.05
GanchanS7: folds 
bruciapelo: folds 
CIKO71131: calls €0.04
eleonora50: calls €0.03
*** FLOP *** [3d 9d Js]
CIKO71131: checks 
eleonora50: checks 
flippone78: bets €0.10
CIKO71131: folds 
eleonora50: folds 
Uncalled bet (€0.10) returned to flippone78
flippone78 collected €0.15 from pot
flippone78: doesn't show hand 
*** SUMMARY ***
Total pot €0.15 | Rake €0 
Board [3d 9d Js]
Seat 1: bruciapelo (button) folded before Flop (didn't bet)
Seat 2: CIKO71131 (small blind) folded on the Flop
Seat 3: eleonora50 (big blind) folded on the Flop
Seat 4: caduceus369 folded before Flop (didn't bet)
Seat 5: flippone78 collected (€0.15)
Seat 6: GanchanS7 folded before Flop (didn't bet)



PokerStars Zoom Hand #257998537674:  Hold'em No Limit (€0.01/€0.02) [ADM ID: M62BD3044A1E13PD] - 2025/10/04 21:04:56 CET [2025/10/04 15:04:56 ET]
Table 'Sirio' 6-max Seat #1 is the button
Seat 1: Pascalzone (€1.97 in chips) 
Seat 2: CARAPIGNA (€1.74 in chips) 
Seat 3: Black98Demon (€4.38 in chips) 
Seat 4: Giuggiola64 (€1.66 in chips) 
Seat 5: caduceus369 (€2 in chips) 
Seat 6: pylonstrip (€3.30 in chips) 
CARAPIGNA: posts small blind €0.01
Black98Demon: posts big blind €0.02
*** HOLE CARDS ***
Dealt to caduceus369 [4h 9c]
Giuggiola64: folds 
caduceus369: folds 
pylonstrip: folds 
Pascalzone: raises €0.02 to €0.04
CARAPIGNA: folds 
Black98Demon: raises €0.14 to €0.18
Pascalzone: calls €0.14
*** FLOP *** [Kc 7c 2h]
Black98Demon: bets €0.20
Pascalzone: calls €0.20
*** TURN *** [Kc 7c 2h] [5c]
Black98Demon: checks 
Pascalzone: bets €0.45
Black98Demon: folds 
Uncalled bet (€0.45) returned to Pascalzone
Pascalzone collected €0.73 from pot
Pascalzone: doesn't show hand 
*** SUMMARY ***
Total pot €0.77 | Rake €0.04 
Board [Kc 7c 2h 5c]
Seat 1: Pascalzone (button) collected (€0.73)
Seat 2: CARAPIGNA (small blind) folded before Flop
Seat 3: Black98Demon (big blind) folded on the Turn
Seat 4: Giuggiola64 folded before Flop (didn't bet)
Seat 5: caduceus369 folded before Flop (didn't bet)
Seat 6: pylonstrip folded before Flop (didn't bet)



PokerStars Zoom Hand #257998543397:  Hold'em No Limit (€0.01/€0.02) [ADM ID: M62BD3044A1E13PD] - 2025/10/04 21:05:21 CET [2025/10/04 15:05:21 ET]
Table 'Sirio' 6-max Seat #1 is the button
Seat 1: TheKing.1969 (€1.86 in chips) 
Seat 2: caduceus369 (€2 in chips) 
Seat 3: VagALiss (€0.85 in chips) 
Seat 4: GanchanS7 (€3.80 in chips) 
Seat 5: Wind9force (€7.75 in chips) 
Seat 6: eleonora50 (€1.08 in chips) 
caduceus369: posts small blind €0.01
VagALiss: posts big blind €0.02
*** HOLE CARDS ***
Dealt to caduceus369 [4s 2s]
GanchanS7: folds 
Wind9force: calls €0.02
eleonora50: folds 
TheKing.1969: folds 
caduceus369: folds 
VagALiss: checks 
*** FLOP *** [7c 3s 2c]
VagALiss: checks 
Wind9force: checks 
*** TURN *** [7c 3s 2c] [2d]
VagALiss: checks 
Wind9force: checks 
*** RIVER *** [7c 3s 2c 2d] [Qs]
VagALiss: checks 
Wind9force: checks 
*** SHOW DOWN ***
VagALiss: shows [Jd 4d] (a pair of Deuces)
Wind9force: shows [9s Ah] (a pair of Deuces - Ace kicker)
Wind9force collected €0.05 from pot
*** SUMMARY ***
Total pot €0.05 | Rake €0 
Board [7c 3s 2c 2d Qs]
Seat 1: TheKing.1969 (button) folded before Flop (didn't bet)
Seat 2: caduceus369 (small blind) folded before Flop
Seat 3: VagALiss (big blind) showed [Jd 4d] and lost with a pair of Deuces
Seat 4: GanchanS7 folded before Flop (didn't bet)
Seat 5: Wind9force showed [9s Ah] and won (€0.05) with a pair of Deuces
Seat 6: eleonora50 folded before Flop (didn't bet)



PokerStars Zoom Hand #257998545675:  Hold'em No Limit (€0.01/€0.02) [ADM ID: M62BD3044A1E13PD] - 2025/10/04 21:05:31 CET [2025/10/04 15:05:31 ET]
Table 'Sirio' 6-max Seat #1 is the button
Seat 1: Gabrielefante (€6.35 in chips) 
Seat 2: RRsanto (€2 in chips) 
Seat 3: N0thingforU (€3.55 in chips) 
Seat 4: TheKing.1969 (€1.12 in chips) 
Seat 5: lucacada98 (€2 in chips) 
Seat 6: caduceus369 (€2 in chips) 
RRsanto: posts small blind €0.01
N0thingforU: posts big blind €0.02
*** HOLE CARDS ***
Dealt to caduceus369 [9d Tc]
TheKing.1969: folds 
lucacada98: raises €0.04 to €0.06
caduceus369: folds 
Gabrielefante: folds 
RRsanto: folds 
N0thingforU: folds 
Uncalled bet (€0.04) returned to lucacada98
lucacada98 collected €0.05 from pot
lucacada98: doesn't show hand 
*** SUMMARY ***
Total pot €0.05 | Rake €0 
Seat 1: Gabrielefante (button) folded before Flop (didn't bet)
Seat 2: RRsanto (small blind) folded before Flop
Seat 3: N0thingforU (big blind) folded before Flop
Seat 4: TheKing.1969 folded before Flop (didn't bet)
Seat 5: lucacada98 collected (€0.05)
Seat 6: caduceus369 folded before Flop (didn't bet)



PokerStars Zoom Hand #257998546751:  Hold'em No Limit (€0.01/€0.02) [ADM ID: M62BD3044A1E13PD] - 2025/10/04 21:05:36 CET [2025/10/04 15:05:36 ET]
Table 'Sirio' 6-max Seat #1 is the button
Seat 1: Black98Demon (€4 in chips) 
Seat 2: gigiriver170 (€1.62 in chips) 
Seat 3: flippone78 (€0.86 in chips) 
Seat 4: GanchanS7 (€4.11 in chips) 
Seat 5: lupocane (€2.13 in chips) 
Seat 6: caduceus369 (€2 in chips) 
gigiriver170: posts small blind €0.01
flippone78: posts big blind €0.02
*** HOLE CARDS ***
Dealt to caduceus369 [2d 6s]
GanchanS7: folds 
lupocane: folds 
caduceus369: folds 
Black98Demon: folds 
gigiriver170: raises €0.04 to €0.06
flippone78: folds 
Uncalled bet (€0.04) returned to gigiriver170
gigiriver170 collected €0.04 from pot
gigiriver170: doesn't show hand 
*** SUMMARY ***
Total pot €0.04 | Rake €0 
Seat 1: Black98Demon (button) folded before Flop (didn't bet)
Seat 2: gigiriver170 (small blind) collected (€0.04)
Seat 3: flippone78 (big blind) folded before Flop
Seat 4: GanchanS7 folded before Flop (didn't bet)
Seat 5: lupocane folded before Flop (didn't bet)
Seat 6: caduceus369 folded before Flop (didn't bet)



PokerStars Zoom Hand #257998547896:  Hold'em No Limit (€0.01/€0.02) [ADM ID: M62BD3044A1E13PD] - 2025/10/04 21:05:41 CET [2025/10/04 15:05:41 ET]
Table 'Sirio' 6-max Seat #1 is the button
Seat 1: lupocane (€2.13 in chips) 
Seat 2: pylonstrip (€4.42 in chips) 
Seat 3: RRsanto (€2.75 in chips) 
Seat 4: Gabrielefante (€6.35 in chips) 
Seat 5: caduceus369 (€2 in chips) 
Seat 6: ghosto69 (€4.65 in chips) 
pylonstrip: posts small blind €0.01
RRsanto: posts big blind €0.02
*** HOLE CARDS ***
Dealt to caduceus369 [Kd Qs]
Gabrielefante: folds 
caduceus369: raises €0.04 to €0.06
ghosto69: folds 
lupocane: folds 
pylonstrip: calls €0.05
RRsanto: folds 
*** FLOP *** [5d Td 5s]
pylonstrip: checks 
caduceus369: checks 
*** TURN *** [5d Td 5s] [3c]
pylonstrip: bets €0.07
caduceus369: calls €0.07
*** RIVER *** [5d Td 5s 3c] [Tc]
pylonstrip: checks 
caduceus369: checks 
*** SHOW DOWN ***
pylonstrip: shows [4s 4h] (two pair, Tens and Fives)
caduceus369: shows [Kd Qs] (two pair, Tens and Fives - King kicker)
caduceus369 collected €0.27 from pot
*** SUMMARY ***
Total pot €0.28 | Rake €0.01 
Board [5d Td 5s 3c Tc]
Seat 1: lupocane (button) folded before Flop (didn't bet)
Seat 2: pylonstrip (small blind) showed [4s 4h] and lost with two pair, Tens and Fives
Seat 3: RRsanto (big blind) folded before Flop
Seat 4: Gabrielefante folded before Flop (didn't bet)
Seat 5: caduceus369 showed [Kd Qs] and won (€0.27) with two pair, Tens and Fives
Seat 6: ghosto69 folded before Flop (didn't bet)



PokerStars Zoom Hand #257998555235:  Hold'em No Limit (€0.01/€0.02) [ADM ID: M62BD3044A1E13PD] - 2025/10/04 21:06:13 CET [2025/10/04 15:06:13 ET]
Table 'Sirio' 6-max Seat #1 is the button
Seat 1: caduceus369 (€2.14 in chips) 
Seat 2: GanchanS7 (€4.09 in chips) 
Seat 3: lucacada98 (€2.06 in chips) 
Seat 4: pylonstrip (€4.29 in chips) 
Seat 5: TheKing.1969 (€1.83 in chips) 
Seat 6: diesel197474 (€0.63 in chips) 
GanchanS7: posts small blind €0.01
lucacada98: posts big blind €0.02
*** HOLE CARDS ***
Dealt to caduceus369 [Kc Th]
pylonstrip: folds 
TheKing.1969: folds 
diesel197474: calls €0.02
caduceus369: raises €0.08 to €0.10
GanchanS7: folds 
lucacada98: calls €0.08
diesel197474: calls €0.08
*** FLOP *** [Qs Jc 4c]
lucacada98: checks 
diesel197474: checks 
caduceus369: bets €0.11
lucacada98: folds 
diesel197474: folds 
Uncalled bet (€0.11) returned to caduceus369
caduceus369 collected €0.30 from pot
caduceus369: doesn't show hand 
*** SUMMARY ***
Total pot €0.31 | Rake €0.01 
Board [Qs Jc 4c]
Seat 1: caduceus369 (button) collected (€0.30)
Seat 2: GanchanS7 (small blind) folded before Flop
Seat 3: lucacada98 (big blind) folded on the Flop
Seat 4: pylonstrip folded before Flop (didn't bet)
Seat 5: TheKing.1969 folded before Flop (didn't bet)
Seat 6: diesel197474 folded on the Flop



PokerStars Zoom Hand #257998561379:  Hold'em No Limit (€0.01/€0.02) [ADM ID: M62BD3044A1E13PD] - 2025/10/04 21:06:40 CET [2025/10/04 15:06:40 ET]
Table 'Sirio' 6-max Seat #1 is the button
Seat 1: N0thingforU (€3.70 in chips) 
Seat 2: caduceus369 (€2.34 in chips) 
Seat 3: ADRIAN0_MEIS (€2 in chips) 
Seat 4: Robycastel89 (€0.86 in chips) 
Seat 5: diesel197474 (€0.53 in chips) 
Seat 6: GanchanS7 (€4.08 in chips) 
caduceus369: posts small blind €0.01
ADRIAN0_MEIS: posts big blind €0.02
*** HOLE CARDS ***
Dealt to caduceus369 [9h 8c]
Robycastel89: raises €0.04 to €0.06
diesel197474: folds 
GanchanS7: folds 
N0thingforU: calls €0.06
caduceus369: folds 
ADRIAN0_MEIS: calls €0.04
*** FLOP *** [9d 3c Jd]
ADRIAN0_MEIS: checks 
Robycastel89: checks 
N0thingforU: checks 
*** TURN *** [9d 3c Jd] [Qs]
ADRIAN0_MEIS: bets €0.14
Robycastel89: folds 
N0thingforU: calls €0.14
*** RIVER *** [9d 3c Jd Qs] [5h]
ADRIAN0_MEIS: bets €0.25
N0thingforU: calls €0.25
*** SHOW DOWN ***
ADRIAN0_MEIS: shows [Ts 9s] (a pair of Nines)
N0thingforU: shows [6d Qd] (a pair of Queens)
N0thingforU collected €0.92 from pot
*** SUMMARY ***
Total pot €0.97 | Rake €0.05 
Board [9d 3c Jd Qs 5h]
Seat 1: N0thingforU (button) showed [6d Qd] and won (€0.92) with a pair of Queens
Seat 2: caduceus369 (small blind) folded before Flop
Seat 3: ADRIAN0_MEIS (big blind) showed [Ts 9s] and lost with a pair of Nines
Seat 4: Robycastel89 folded on the Turn
Seat 5: diesel197474 folded before Flop (didn't bet)
Seat 6: GanchanS7 folded before Flop (didn't bet)



PokerStars Zoom Hand #257998571251:  Hold'em No Limit (€0.01/€0.02) [ADM ID: M62BD3044A1E13PD] - 2025/10/04 21:07:24 CET [2025/10/04 15:07:24 ET]
Table 'Sirio' 6-max Seat #1 is the button
Seat 1: caduceus369 (€2.31 in chips) 
Seat 2: RRsanto (€2.26 in chips) 
Seat 3: Wind9force (€7.85 in chips) 
Seat 4: ghosto69 (€4.62 in chips) 
Seat 5: Pascalzone (€2.36 in chips) 
Seat 6: TheKing.1969 (€1.80 in chips) 
RRsanto: posts small blind €0.01
Wind9force: posts big blind €0.02
*** HOLE CARDS ***
Dealt to caduceus369 [8d Th]
ghosto69: folds 
Pascalzone: folds 
TheKing.1969: folds 
caduceus369: folds 
RRsanto: raises €0.04 to €0.06
Wind9force: folds 
Uncalled bet (€0.04) returned to RRsanto
RRsanto collected €0.04 from pot
RRsanto: doesn't show hand 
*** SUMMARY ***
Total pot €0.04 | Rake €0 
Seat 1: caduceus369 (button) folded before Flop (didn't bet)
Seat 2: RRsanto (small blind) collected (€0.04)
Seat 3: Wind9force (big blind) folded before Flop
Seat 4: ghosto69 folded before Flop (didn't bet)
Seat 5: Pascalzone folded before Flop (didn't bet)
Seat 6: TheKing.1969 folded before Flop (didn't bet)



PokerStars Zoom Hand #257998569974:  Hold'em No Limit (€0.01/€0.02) [ADM ID: M62BD3044A1E13PD] - 2025/10/04 21:07:18 CET [2025/10/04 15:07:18 ET]
Table 'Sirio' 6-max Seat #1 is the button
Seat 1: ADRIAN0_MEIS (€2.15 in chips) 
Seat 2: Black98Demon (€4.02 in chips) 
Seat 3: pylonstrip (€4.32 in chips) 
Seat 4: caduceus369 (€2.31 in chips) 
Seat 5: VagALiss (€1.14 in chips) 
Seat 6: Bigo2802 (€4.82 in chips) 
Black98Demon: posts small blind €0.01
pylonstrip: posts big blind €0.02
*** HOLE CARDS ***
Dealt to caduceus369 [6h Ad]
caduceus369: folds 
VagALiss: raises €0.03 to €0.05
Bigo2802: calls €0.05
ADRIAN0_MEIS: folds 
Black98Demon: folds 
pylonstrip: folds 
*** FLOP *** [Qh 9s 9c]
VagALiss: bets €0.07
Bigo2802: folds 
Uncalled bet (€0.07) returned to VagALiss
VagALiss collected €0.13 from pot
VagALiss: doesn't show hand 
*** SUMMARY ***
Total pot €0.13 | Rake €0 
Board [Qh 9s 9c]
Seat 1: ADRIAN0_MEIS (button) folded before Flop (didn't bet)
Seat 2: Black98Demon (small blind) folded before Flop
Seat 3: pylonstrip (big blind) folded before Flop
Seat 4: caduceus369 folded before Flop (didn't bet)
Seat 5: VagALiss collected (€0.13)
Seat 6: Bigo2802 folded on the Flop



PokerStars Zoom Hand #257998567547:  Hold'em No Limit (€0.01/€0.02) [ADM ID: M62BD3044A1E13PD] - 2025/10/04 21:07:07 CET [2025/10/04 15:07:07 ET]
Table 'Sirio' 6-max Seat #1 is the button
Seat 1: gigiriver170 (€1.63 in chips) 
Seat 2: VagALiss (€1.15 in chips) 
Seat 3: CARAPIGNA (€1.84 in chips) 
Seat 4: ADRIAN0_MEIS (€2.15 in chips) 
Seat 5: caduceus369 (€2.31 in chips) 
Seat 6: GanchanS7 (€2.97 in chips) 
VagALiss: posts small blind €0.01
CARAPIGNA: posts big blind €0.02
*** HOLE CARDS ***
Dealt to caduceus369 [Kd 2h]
ADRIAN0_MEIS: folds 
caduceus369: folds 
GanchanS7 has timed out
GanchanS7: folds 
gigiriver170: folds 
VagALiss: folds 
Uncalled bet (€0.01) returned to CARAPIGNA
CARAPIGNA collected €0.02 from pot
CARAPIGNA: doesn't show hand 
*** SUMMARY ***
Total pot €0.02 | Rake €0 
Seat 1: gigiriver170 (button) folded before Flop (didn't bet)
Seat 2: VagALiss (small blind) folded before Flop
Seat 3: CARAPIGNA (big blind) collected (€0.02)
Seat 4: ADRIAN0_MEIS folded before Flop (didn't bet)
Seat 5: caduceus369 folded before Flop (didn't bet)
Seat 6: GanchanS7 folded before Flop (didn't bet)



PokerStars Zoom Hand #257998573163:  Hold'em No Limit (€0.01/€0.02) [ADM ID: M62BD3044A1E13PD] - 2025/10/04 21:07:32 CET [2025/10/04 15:07:32 ET]
Table 'Sirio' 6-max Seat #1 is the button
Seat 1: pylonstrip (€4.30 in chips) 
Seat 2: diesel197474 (€0.51 in chips) 
Seat 3: IKARO_3 (€2.24 in chips) 
Seat 4: RRsanto (€2 in chips) 
Seat 5: GanchanS7 (€3.82 in chips) 
Seat 6: caduceus369 (€2.31 in chips) 
diesel197474: posts small blind €0.01
IKARO_3: posts big blind €0.02
*** HOLE CARDS ***
Dealt to caduceus369 [Kd 2s]
RRsanto: folds 
GanchanS7: folds 
caduceus369: folds 
pylonstrip: folds 
diesel197474: folds 
Uncalled bet (€0.01) returned to IKARO_3
IKARO_3 collected €0.02 from pot
IKARO_3: doesn't show hand 
*** SUMMARY ***
Total pot €0.02 | Rake €0 
Seat 1: pylonstrip (button) folded before Flop (didn't bet)
Seat 2: diesel197474 (small blind) folded before Flop
Seat 3: IKARO_3 (big blind) collected (€0.02)
Seat 4: RRsanto folded before Flop (didn't bet)
Seat 5: GanchanS7 folded before Flop (didn't bet)
Seat 6: caduceus369 folded before Flop (didn't bet)



PokerStars Zoom Hand #257998563785:  Hold'em No Limit (€0.01/€0.02) [ADM ID: M62BD3044A1E13PD] - 2025/10/04 21:06:51 CET [2025/10/04 15:06:51 ET]
Table 'Sirio' 6-max Seat #1 is the button
Seat 1: lucacada98 (€1.95 in chips) 
Seat 2: Asso77407 (€0.99 in chips) 
Seat 3: caduceus369 (€2.33 in chips) 
Seat 4: stefano997 (€2.33 in chips) 
Seat 5: TheKing.1969 (€2.24 in chips) 
Seat 6: flippone78 (€0.83 in chips) 
Asso77407: posts small blind €0.01
caduceus369: posts big blind €0.02
*** HOLE CARDS ***
Dealt to caduceus369 [Th Qc]
stefano997: calls €0.02
TheKing.1969: raises €0.06 to €0.08
flippone78: folds 
lucacada98: calls €0.08
Asso77407: calls €0.07
caduceus369: folds 
stefano997: calls €0.06
*** FLOP *** [2h Kh 3c]
Asso77407: checks 
stefano997: checks 
TheKing.1969: checks 
lucacada98: checks 
*** TURN *** [2h Kh 3c] [As]
Asso77407: checks 
stefano997: checks 
TheKing.1969: bets €0.19
lucacada98: folds 
Asso77407: folds 
stefano997: folds 
Uncalled bet (€0.19) returned to TheKing.1969
TheKing.1969 collected €0.33 from pot
TheKing.1969: doesn't show hand 
*** SUMMARY ***
Total pot €0.34 | Rake €0.01 
Board [2h Kh 3c As]
Seat 1: lucacada98 (button) folded on the Turn
Seat 2: Asso77407 (small blind) folded on the Turn
Seat 3: caduceus369 (big blind) folded before Flop
Seat 4: stefano997 folded on the Turn
Seat 5: TheKing.1969 collected (€0.33)
Seat 6: flippone78 folded before Flop (didn't bet)



PokerStars Zoom Hand #257998574771:  Hold'em No Limit (€0.01/€0.02) [ADM ID: M62BD3044A1E13PD] - 2025/10/04 21:07:39 CET [2025/10/04 15:07:39 ET]
Table 'Sirio' 6-max Seat #1 is the button
Seat 1: Bigo2802 (€4.77 in chips) 
Seat 2: GanchanS7 (€3.82 in chips) 
Seat 3: caduceus369 (€2.31 in chips) 
Seat 4: gigiriver170 (€1.63 in chips) 
Seat 5: diesel197474 (€0.50 in chips) 
Seat 6: TheKing.1969 (€1.98 in chips) 
GanchanS7: posts small blind €0.01
caduceus369: posts big blind €0.02
*** HOLE CARDS ***
Dealt to caduceus369 [Th 5d]
gigiriver170: calls €0.02
diesel197474: calls €0.02
TheKing.1969: folds 
Bigo2802: folds 
GanchanS7: calls €0.01
caduceus369: checks 
*** FLOP *** [Jh 2s Kh]
GanchanS7: checks 
caduceus369: checks 
gigiriver170: checks 
diesel197474: checks 
*** TURN *** [Jh 2s Kh] [5c]
GanchanS7: checks 
caduceus369: checks 
gigiriver170: checks 
diesel197474: checks 
*** RIVER *** [Jh 2s Kh 5c] [4c]
GanchanS7: checks 
caduceus369: bets €0.02
gigiriver170 has timed out
gigiriver170: folds 
diesel197474: folds 
GanchanS7: folds 
Uncalled bet (€0.02) returned to caduceus369
caduceus369 collected €0.08 from pot
caduceus369: doesn't show hand 
*** SUMMARY ***
Total pot €0.08 | Rake €0 
Board [Jh 2s Kh 5c 4c]
Seat 1: Bigo2802 (button) folded before Flop (didn't bet)
Seat 2: GanchanS7 (small blind) folded on the River
Seat 3: caduceus369 (big blind) collected (€0.08)
Seat 4: gigiriver170 folded on the River
Seat 5: diesel197474 folded on the River
Seat 6: TheKing.1969 folded before Flop (didn't bet)



PokerStars Zoom Hand #257998600419:  Hold'em No Limit (€0.01/€0.02) [ADM ID: M62BD3044A1E13PD] - 2025/10/04 21:09:32 CET [2025/10/04 15:09:32 ET]
Table 'Sirio' 6-max Seat #1 is the button
Seat 1: GanchanS7 (€4.03 in chips) 
Seat 2: FARUCKK (€0.96 in chips) 
Seat 3: TheKing.1969 (€2.01 in chips) 
Seat 4: caduceus369 (€2.37 in chips) 
Seat 5: masticatp (€1.62 in chips) 
Seat 6: ghosto69 (€4.50 in chips) 
FARUCKK: posts small blind €0.01
TheKing.1969: posts big blind €0.02
*** HOLE CARDS ***
Dealt to caduceus369 [6d 8s]
caduceus369: folds 
masticatp: folds 
ghosto69: folds 
GanchanS7: raises €0.02 to €0.04
FARUCKK: folds 
TheKing.1969: folds 
Uncalled bet (€0.02) returned to GanchanS7
GanchanS7 collected €0.05 from pot
GanchanS7: doesn't show hand 
*** SUMMARY ***
Total pot €0.05 | Rake €0 
Seat 1: GanchanS7 (button) collected (€0.05)
Seat 2: FARUCKK (small blind) folded before Flop
Seat 3: TheKing.1969 (big blind) folded before Flop
Seat 4: caduceus369 folded before Flop (didn't bet)
Seat 5: masticatp folded before Flop (didn't bet)
Seat 6: ghosto69 folded before Flop (didn't bet)



PokerStars Zoom Hand #257998602327:  Hold'em No Limit (€0.01/€0.02) [ADM ID: M62BD3044A1E13PD] - 2025/10/04 21:09:41 CET [2025/10/04 15:09:41 ET]
Table 'Sirio' 6-max Seat #1 is the button
Seat 1: ghosto69 (€4.50 in chips) 
Seat 2: masticatp (€1.62 in chips) 
Seat 3: RRsanto (€2.17 in chips) 
Seat 4: caduceus369 (€2.37 in chips) 
Seat 5: eleonora50 (€1.82 in chips) 
Seat 6: ADRIAN0_MEIS (€4.78 in chips) 
masticatp: posts small blind €0.01
RRsanto: posts big blind €0.02
*** HOLE CARDS ***
Dealt to caduceus369 [2s 3d]
caduceus369: folds 
eleonora50: folds 
ADRIAN0_MEIS: folds 
ghosto69: folds 
masticatp: folds 
Uncalled bet (€0.01) returned to RRsanto
RRsanto collected €0.02 from pot
RRsanto: doesn't show hand 
*** SUMMARY ***
Total pot €0.02 | Rake €0 
Seat 1: ghosto69 (button) folded before Flop (didn't bet)
Seat 2: masticatp (small blind) folded before Flop
Seat 3: RRsanto (big blind) collected (€0.02)
Seat 4: caduceus369 folded before Flop (didn't bet)
Seat 5: eleonora50 folded before Flop (didn't bet)
Seat 6: ADRIAN0_MEIS folded before Flop (didn't bet)



PokerStars Zoom Hand #257998603205:  Hold'em No Limit (€0.01/€0.02) [ADM ID: M62BD3044A1E13PD] - 2025/10/04 21:09:45 CET [2025/10/04 15:09:45 ET]
Table 'Sirio' 6-max Seat #1 is the button
Seat 1: flippone78 (€0.34 in chips) 
Seat 2: caduceus369 (€2.37 in chips) 
Seat 3: Wind9force (€7.68 in chips) 
Seat 4: ghosto69 (€1.12 in chips) 
Seat 5: RRsanto (€2 in chips) 
Seat 6: ADRIAN0_MEIS (€2.36 in chips) 
caduceus369: posts small blind €0.01
Wind9force: posts big blind €0.02
*** HOLE CARDS ***
Dealt to caduceus369 [Tc Td]
ghosto69: folds 
RRsanto: folds 
ADRIAN0_MEIS: folds 
flippone78: raises €0.03 to €0.05
caduceus369: raises €0.10 to €0.15
Wind9force: calls €0.13
flippone78: folds 
*** FLOP *** [5c 3h Ts]
caduceus369: checks 
Wind9force: checks 
*** TURN *** [5c 3h Ts] [5h]
caduceus369: checks 
Wind9force: checks 
*** RIVER *** [5c 3h Ts 5h] [3c]
caduceus369: bets €0.42
Wind9force: folds 
Uncalled bet (€0.42) returned to caduceus369
caduceus369 collected €0.34 from pot
caduceus369: doesn't show hand 
*** SUMMARY ***
Total pot €0.35 | Rake €0.01 
Board [5c 3h Ts 5h 3c]
Seat 1: flippone78 (button) folded before Flop
Seat 2: caduceus369 (small blind) collected (€0.34)
Seat 3: Wind9force (big blind) folded on the River
Seat 4: ghosto69 folded before Flop (didn't bet)
Seat 5: RRsanto folded before Flop (didn't bet)
Seat 6: ADRIAN0_MEIS folded before Flop (didn't bet)



PokerStars Zoom Hand #257998615587:  Hold'em No Limit (€0.01/€0.02) [ADM ID: M62BD3044A1E13PD] - 2025/10/04 21:10:39 CET [2025/10/04 15:10:39 ET]
Table 'Sirio' 6-max Seat #1 is the button
Seat 1: FARUCKK (€1.01 in chips) 
Seat 2: masticatp (€1.66 in chips) 
Seat 3: diesel197474 (€0.93 in chips) 
Seat 4: RRsanto (€2.17 in chips) 
Seat 5: CARAPIGNA (€1.94 in chips) 
Seat 6: caduceus369 (€2.56 in chips) 
masticatp: posts small blind €0.01
diesel197474: posts big blind €0.02
*** HOLE CARDS ***
Dealt to caduceus369 [Qs Kc]
RRsanto: raises €0.04 to €0.06
CARAPIGNA: folds 
caduceus369: raises €0.12 to €0.18
FARUCKK: folds 
masticatp: folds 
diesel197474: folds 
RRsanto: folds 
Uncalled bet (€0.12) returned to caduceus369
caduceus369 collected €0.15 from pot
caduceus369: doesn't show hand 
*** SUMMARY ***
Total pot €0.15 | Rake €0 
Seat 1: FARUCKK (button) folded before Flop (didn't bet)
Seat 2: masticatp (small blind) folded before Flop
Seat 3: diesel197474 (big blind) folded before Flop
Seat 4: RRsanto folded before Flop
Seat 5: CARAPIGNA folded before Flop (didn't bet)
Seat 6: caduceus369 collected (€0.15)



PokerStars Zoom Hand #257998620532:  Hold'em No Limit (€0.01/€0.02) [ADM ID: M62BD3044A1E13PD] - 2025/10/04 21:11:01 CET [2025/10/04 15:11:01 ET]
Table 'Sirio' 6-max Seat #1 is the button
Seat 1: RRsanto (€2.11 in chips) 
Seat 2: CARAPIGNA (€1.94 in chips) 
Seat 3: ghosto69 (€1.08 in chips) 
Seat 4: stefano997 (€1.90 in chips) 
Seat 5: caduceus369 (€2.65 in chips) 
Seat 6: TheKing.1969 (€1.81 in chips) 
CARAPIGNA: posts small blind €0.01
ghosto69: posts big blind €0.02
*** HOLE CARDS ***
Dealt to caduceus369 [8s 8d]
stefano997: folds 
caduceus369: raises €0.04 to €0.06
TheKing.1969: folds 
RRsanto: raises €0.12 to €0.18
CARAPIGNA: folds 
ghosto69: folds 
caduceus369: calls €0.12
*** FLOP *** [Qh 7s 6d]
caduceus369: checks 
RRsanto: checks 
*** TURN *** [Qh 7s 6d] [5s]
caduceus369: bets €0.15
RRsanto: raises €0.34 to €0.49
caduceus369: folds 
Uncalled bet (€0.34) returned to RRsanto
RRsanto collected €0.66 from pot
RRsanto: doesn't show hand 
*** SUMMARY ***
Total pot €0.69 | Rake €0.03 
Board [Qh 7s 6d 5s]
Seat 1: RRsanto (button) collected (€0.66)
Seat 2: CARAPIGNA (small blind) folded before Flop
Seat 3: ghosto69 (big blind) folded before Flop
Seat 4: stefano997 folded before Flop (didn't bet)
Seat 5: caduceus369 folded on the Turn
Seat 6: TheKing.1969 folded before Flop (didn't bet)



PokerStars Zoom Hand #257998633265:  Hold'em No Limit (€0.01/€0.02) [ADM ID: M62BD3044A1E13PD] - 2025/10/04 21:11:57 CET [2025/10/04 15:11:57 ET]
Table 'Sirio' 6-max Seat #1 is the button
Seat 1: pylonstrip (€3.81 in chips) 
Seat 2: ghosto69 (€4.68 in chips) 
Seat 3: caduceus369 (€2.32 in chips) 
Seat 4: CARAPIGNA (€1.93 in chips) 
Seat 5: IKARO_3 (€4.07 in chips) 
Seat 6: ADRIAN0_MEIS (€4.71 in chips) 
ghosto69: posts small blind €0.01
caduceus369: posts big blind €0.02
*** HOLE CARDS ***
Dealt to caduceus369 [4s 6c]
CARAPIGNA: folds 
IKARO_3: raises €0.04 to €0.06
ADRIAN0_MEIS: folds 
pylonstrip: folds 
ghosto69: folds 
caduceus369: folds 
Uncalled bet (€0.04) returned to IKARO_3
IKARO_3 collected €0.05 from pot
IKARO_3: doesn't show hand 
*** SUMMARY ***
Total pot €0.05 | Rake €0 
Seat 1: pylonstrip (button) folded before Flop (didn't bet)
Seat 2: ghosto69 (small blind) folded before Flop
Seat 3: caduceus369 (big blind) folded before Flop
Seat 4: CARAPIGNA folded before Flop (didn't bet)
Seat 5: IKARO_3 collected (€0.05)
Seat 6: ADRIAN0_MEIS folded before Flop (didn't bet)



PokerStars Zoom Hand #257998637012:  Hold'em No Limit (€0.01/€0.02) [ADM ID: M62BD3044A1E13PD] - 2025/10/04 21:12:13 CET [2025/10/04 15:12:13 ET]
Table 'Sirio' 6-max Seat #1 is the button
Seat 1: caduceus369 (€2.30 in chips) 
Seat 2: bruciapelo (€3.66 in chips) 
Seat 3: TheKing.1969 (€1.20 in chips) 
Seat 4: CIKO71131 (€0.73 in chips) 
Seat 5: GanchanS7 (€3.20 in chips) 
Seat 6: masticatp (€1.12 in chips) 
bruciapelo: posts small blind €0.01
TheKing.1969: posts big blind €0.02
*** HOLE CARDS ***
Dealt to caduceus369 [2c Tc]
CIKO71131: folds 
GanchanS7: folds 
masticatp: folds 
caduceus369: folds 
bruciapelo: folds 
Uncalled bet (€0.01) returned to TheKing.1969
TheKing.1969 collected €0.02 from pot
TheKing.1969: doesn't show hand 
*** SUMMARY ***
Total pot €0.02 | Rake €0 
Seat 1: caduceus369 (button) folded before Flop (didn't bet)
Seat 2: bruciapelo (small blind) folded before Flop
Seat 3: TheKing.1969 (big blind) collected (€0.02)
Seat 4: CIKO71131 folded before Flop (didn't bet)
Seat 5: GanchanS7 folded before Flop (didn't bet)
Seat 6: masticatp folded before Flop (didn't bet)



PokerStars Zoom Hand #257998631377:  Hold'em No Limit (€0.01/€0.02) [ADM ID: M62BD3044A1E13PD] - 2025/10/04 21:11:49 CET [2025/10/04 15:11:49 ET]
Table 'Sirio' 6-max Seat #1 is the button
Seat 1: CARAPIGNA (€1.93 in chips) 
Seat 2: GanchanS7 (€3.21 in chips) 
Seat 3: Robycastel89 (€0.91 in chips) 
Seat 4: ADRIAN0_MEIS (€2.54 in chips) 
Seat 5: caduceus369 (€2.32 in chips) 
Seat 6: pylonstrip (€3.81 in chips) 
GanchanS7: posts small blind €0.01
Robycastel89: posts big blind €0.02
*** HOLE CARDS ***
Dealt to caduceus369 [Qs 8h]
ADRIAN0_MEIS: raises €0.04 to €0.06
caduceus369: folds 
pylonstrip: folds 
CARAPIGNA: folds 
GanchanS7: folds 
Robycastel89: raises €0.04 to €0.10
ADRIAN0_MEIS: calls €0.04
*** FLOP *** [Kc 9c 8s]
Robycastel89: bets €0.20
ADRIAN0_MEIS: folds 
Uncalled bet (€0.20) returned to Robycastel89
Robycastel89 collected €0.20 from pot
Robycastel89: doesn't show hand 
*** SUMMARY ***
Total pot €0.21 | Rake €0.01 
Board [Kc 9c 8s]
Seat 1: CARAPIGNA (button) folded before Flop (didn't bet)
Seat 2: GanchanS7 (small blind) folded before Flop
Seat 3: Robycastel89 (big blind) collected (€0.20)
Seat 4: ADRIAN0_MEIS folded on the Flop
Seat 5: caduceus369 folded before Flop (didn't bet)
Seat 6: pylonstrip folded before Flop (didn't bet)



PokerStars Zoom Hand #257998642349:  Hold'em No Limit (€0.01/€0.02) [ADM ID: M62BD3044A1E13PD] - 2025/10/04 21:12:37 CET [2025/10/04 15:12:37 ET]
Table 'Sirio' 6-max Seat #1 is the button
Seat 1: VagALiss (€2.37 in chips) 
Seat 2: caduceus369 (€2.30 in chips) 
Seat 3: ADRIAN0_MEIS (€2.44 in chips) 
Seat 4: IKARO_3 (€2.44 in chips) 
Seat 5: bruciapelo (€3.65 in chips) 
Seat 6: GanchanS7 (€3.63 in chips) 
caduceus369: posts small blind €0.01
ADRIAN0_MEIS: posts big blind €0.02
*** HOLE CARDS ***
Dealt to caduceus369 [6c 9d]
IKARO_3: raises €0.04 to €0.06
bruciapelo: folds 
GanchanS7: folds 
VagALiss: folds 
caduceus369: folds 
ADRIAN0_MEIS: folds 
Uncalled bet (€0.04) returned to IKARO_3
IKARO_3 collected €0.05 from pot
IKARO_3: doesn't show hand 
*** SUMMARY ***
Total pot €0.05 | Rake €0 
Seat 1: VagALiss (button) folded before Flop (didn't bet)
Seat 2: caduceus369 (small blind) folded before Flop
Seat 3: ADRIAN0_MEIS (big blind) folded before Flop
Seat 4: IKARO_3 collected (€0.05)
Seat 5: bruciapelo folded before Flop (didn't bet)
Seat 6: GanchanS7 folded before Flop (didn't bet)



PokerStars Zoom Hand #257998645789:  Hold'em No Limit (€0.01/€0.02) [ADM ID: M62BD3044A1E13PD] - 2025/10/04 21:12:52 CET [2025/10/04 15:12:52 ET]
Table 'Sirio' 6-max Seat #1 is the button
Seat 1: ghosto69 (€1.03 in chips) 
Seat 2: criptlux (€1.98 in chips) 
Seat 3: ADRIAN0_MEIS (€4.03 in chips) 
Seat 4: caduceus369 (€2.29 in chips) 
Seat 5: VagALiss (€2.37 in chips) 
Seat 6: N0thingforU (€4.15 in chips) 
criptlux: posts small blind €0.01
ADRIAN0_MEIS: posts big blind €0.02
*** HOLE CARDS ***
Dealt to caduceus369 [7h Jh]
caduceus369: folds 
VagALiss: folds 
N0thingforU: folds 
ghosto69: folds 
criptlux: folds 
Uncalled bet (€0.01) returned to ADRIAN0_MEIS
ADRIAN0_MEIS collected €0.02 from pot
ADRIAN0_MEIS: doesn't show hand 
*** SUMMARY ***
Total pot €0.02 | Rake €0 
Seat 1: ghosto69 (button) folded before Flop (didn't bet)
Seat 2: criptlux (small blind) folded before Flop
Seat 3: ADRIAN0_MEIS (big blind) collected (€0.02)
Seat 4: caduceus369 folded before Flop (didn't bet)
Seat 5: VagALiss folded before Flop (didn't bet)
Seat 6: N0thingforU folded before Flop (didn't bet)



PokerStars Zoom Hand #257998646951:  Hold'em No Limit (€0.01/€0.02) [ADM ID: M62BD3044A1E13PD] - 2025/10/04 21:12:57 CET [2025/10/04 15:12:57 ET]
Table 'Sirio' 6-max Seat #1 is the button
Seat 1: ADRIAN0_MEIS (€2.35 in chips) 
Seat 2: buscofan (€1.99 in chips) 
Seat 3: TheKing.1969 (€2.49 in chips) 
Seat 4: caduceus369 (€2.29 in chips) 
Seat 5: pylonstrip (€3.81 in chips) 
Seat 6: ghosto69 (€4.60 in chips) 
buscofan: posts small blind €0.01
TheKing.1969: posts big blind €0.02
*** HOLE CARDS ***
Dealt to caduceus369 [As 8h]
caduceus369: folds 
pylonstrip: raises €0.02 to €0.04
ghosto69: folds 
ADRIAN0_MEIS: calls €0.04
buscofan: folds 
TheKing.1969: folds 
*** FLOP *** [Jc Kc 9c]
pylonstrip: bets €0.08
ADRIAN0_MEIS: folds 
Uncalled bet (€0.08) returned to pylonstrip
pylonstrip collected €0.11 from pot
pylonstrip: doesn't show hand 
*** SUMMARY ***
Total pot €0.11 | Rake €0 
Board [Jc Kc 9c]
Seat 1: ADRIAN0_MEIS (button) folded on the Flop
Seat 2: buscofan (small blind) folded before Flop
Seat 3: TheKing.1969 (big blind) folded before Flop
Seat 4: caduceus369 folded before Flop (didn't bet)
Seat 5: pylonstrip collected (€0.11)
Seat 6: ghosto69 folded before Flop (didn't bet)



PokerStars Zoom Hand #257998651307:  Hold'em No Limit (€0.01/€0.02) [ADM ID: M62BD3044A1E13PD] - 2025/10/04 21:13:17 CET [2025/10/04 15:13:17 ET]
Table 'Sirio' 6-max Seat #1 is the button
Seat 1: caduceus369 (€2.27 in chips) 
Seat 2: eleonora50 (€1.83 in chips) 
Seat 3: ADRIAN0_MEIS (€4.77 in chips) 
Seat 4: RRsanto (€2 in chips) 
Seat 5: GanchanS7 (€3.88 in chips) 
Seat 6: TheKing.1969 (€2.47 in chips) 
eleonora50: posts small blind €0.01
ADRIAN0_MEIS: posts big blind €0.02
*** HOLE CARDS ***
Dealt to caduceus369 [4c 8s]
RRsanto: folds 
GanchanS7: folds 
TheKing.1969: folds 
caduceus369: folds 
eleonora50: folds 
Uncalled bet (€0.01) returned to ADRIAN0_MEIS
ADRIAN0_MEIS collected €0.02 from pot
ADRIAN0_MEIS: doesn't show hand 
*** SUMMARY ***
Total pot €0.02 | Rake €0 
Seat 1: caduceus369 (button) folded before Flop (didn't bet)
Seat 2: eleonora50 (small blind) folded before Flop
Seat 3: ADRIAN0_MEIS (big blind) collected (€0.02)
Seat 4: RRsanto folded before Flop (didn't bet)
Seat 5: GanchanS7 folded before Flop (didn't bet)
Seat 6: TheKing.1969 folded before Flop (didn't bet)



PokerStars Zoom Hand #257998648367:  Hold'em No Limit (€0.01/€0.02) [ADM ID: M62BD3044A1E13PD] - 2025/10/04 21:13:03 CET [2025/10/04 15:13:03 ET]
Table 'Sirio' 6-max Seat #1 is the button
Seat 1: TheKing.1969 (€1.74 in chips) 
Seat 2: bruciapelo (€3.63 in chips) 
Seat 3: caduceus369 (€2.29 in chips) 
Seat 4: Bigo2802 (€5.89 in chips) 
Seat 5: Robycastel89 (€1 in chips) 
Seat 6: ADRIAN0_MEIS (€4.04 in chips) 
bruciapelo: posts small blind €0.01
caduceus369: posts big blind €0.02
*** HOLE CARDS ***
Dealt to caduceus369 [Qh 2s]
Bigo2802: raises €0.03 to €0.05
Robycastel89: folds 
ADRIAN0_MEIS: folds 
TheKing.1969: calls €0.05
bruciapelo: folds 
caduceus369: folds 
*** FLOP *** [5h 3c 6s]
Bigo2802: bets €0.10
TheKing.1969: calls €0.10
*** TURN *** [5h 3c 6s] [8c]
Bigo2802: bets €0.24
TheKing.1969: folds 
Uncalled bet (€0.24) returned to Bigo2802
Bigo2802 collected €0.32 from pot
Bigo2802: doesn't show hand 
*** SUMMARY ***
Total pot €0.33 | Rake €0.01 
Board [5h 3c 6s 8c]
Seat 1: TheKing.1969 (button) folded on the Turn
Seat 2: bruciapelo (small blind) folded before Flop
Seat 3: caduceus369 (big blind) folded before Flop
Seat 4: Bigo2802 collected (€0.32)
Seat 5: Robycastel89 folded before Flop (didn't bet)
Seat 6: ADRIAN0_MEIS folded before Flop (didn't bet)



PokerStars Zoom Hand #257998652451:  Hold'em No Limit (€0.01/€0.02) [ADM ID: M62BD3044A1E13PD] - 2025/10/04 21:13:22 CET [2025/10/04 15:13:22 ET]
Table 'Sirio' 6-max Seat #1 is the button
Seat 1: bruciapelo (€3.62 in chips) 
Seat 2: caduceus369 (€2.27 in chips) 
Seat 3: ghosto69 (€1.03 in chips) 
Seat 4: Robycastel89 (€0.98 in chips) 
Seat 5: CIKO71131 (€0.75 in chips) 
Seat 6: Wind9force (€7.42 in chips) 
caduceus369: posts small blind €0.01
ghosto69: posts big blind €0.02
*** HOLE CARDS ***
Dealt to caduceus369 [8c Kc]
Robycastel89: folds 
CIKO71131: folds 
Wind9force: calls €0.02
bruciapelo: folds 
caduceus369: calls €0.01
ghosto69: checks 
*** FLOP *** [4s 4d 8h]
caduceus369: checks 
ghosto69: checks 
Wind9force: checks 
*** TURN *** [4s 4d 8h] [Th]
caduceus369: checks 
ghosto69: checks 
Wind9force: checks 
*** RIVER *** [4s 4d 8h Th] [7h]
caduceus369: bets €0.02
ghosto69: folds 
Wind9force: calls €0.02
*** SHOW DOWN ***
caduceus369: shows [8c Kc] (two pair, Eights and Fours)
Wind9force: shows [8d Kd] (two pair, Eights and Fours)
caduceus369 collected €0.05 from pot
Wind9force collected €0.05 from pot
*** SUMMARY ***
Total pot €0.10 | Rake €0 
Board [4s 4d 8h Th 7h]
Seat 1: bruciapelo (button) folded before Flop (didn't bet)
Seat 2: caduceus369 (small blind) showed [8c Kc] and won (€0.05) with two pair, Eights and Fours
Seat 3: ghosto69 (big blind) folded on the River
Seat 4: Robycastel89 folded before Flop (didn't bet)
Seat 5: CIKO71131 folded before Flop (didn't bet)
Seat 6: Wind9force showed [8d Kd] and won (€0.05) with two pair, Eights and Fours



PokerStars Zoom Hand #257998663202:  Hold'em No Limit (€0.01/€0.02) [ADM ID: M62BD3044A1E13PD] - 2025/10/04 21:14:09 CET [2025/10/04 15:14:09 ET]
Table 'Sirio' 6-max Seat #1 is the button
Seat 1: Wind9force (€7.43 in chips) 
Seat 2: RRsanto (€2.39 in chips) 
Seat 3: lupocane (€2 in chips) 
Seat 4: ghosto69 (€4.52 in chips) 
Seat 5: FARUCKK (€0.65 in chips) 
Seat 6: caduceus369 (€2.28 in chips) 
RRsanto: posts small blind €0.01
lupocane: posts big blind €0.02
*** HOLE CARDS ***
Dealt to caduceus369 [Ah Ad]
ghosto69: folds 
FARUCKK: folds 
caduceus369: raises €0.04 to €0.06
Wind9force: folds 
RRsanto: folds 
lupocane: calls €0.04
*** FLOP *** [Ks 2d 6h]
lupocane: checks 
caduceus369: bets €0.07
lupocane: folds 
Uncalled bet (€0.07) returned to caduceus369
caduceus369 collected €0.13 from pot
caduceus369: doesn't show hand 
*** SUMMARY ***
Total pot €0.13 | Rake €0 
Board [Ks 2d 6h]
Seat 1: Wind9force (button) folded before Flop (didn't bet)
Seat 2: RRsanto (small blind) folded before Flop
Seat 3: lupocane (big blind) folded on the Flop
Seat 4: ghosto69 folded before Flop (didn't bet)
Seat 5: FARUCKK folded before Flop (didn't bet)
Seat 6: caduceus369 collected (€0.13)



PokerStars Zoom Hand #257998668708:  Hold'em No Limit (€0.01/€0.02) [ADM ID: M62BD3044A1E13PD] - 2025/10/04 21:14:33 CET [2025/10/04 15:14:33 ET]
Table 'Sirio' 6-max Seat #1 is the button
Seat 1: TheKing.1969 (€4.24 in chips) 
Seat 2: lucpri (€1.77 in chips) 
Seat 3: bubu1554 (€1.47 in chips) 
Seat 4: ghosto69 (€4.51 in chips) 
Seat 5: caduceus369 (€2.35 in chips) 
Seat 6: stefano997 (€1.74 in chips) 
lucpri: posts small blind €0.01
bubu1554: posts big blind €0.02
*** HOLE CARDS ***
Dealt to caduceus369 [5c 8c]
ghosto69: folds 
caduceus369: folds 
stefano997: folds 
TheKing.1969: folds 
lucpri: folds 
Uncalled bet (€0.01) returned to bubu1554
bubu1554 collected €0.02 from pot
bubu1554: doesn't show hand 
*** SUMMARY ***
Total pot €0.02 | Rake €0 
Seat 1: TheKing.1969 (button) folded before Flop (didn't bet)
Seat 2: lucpri (small blind) folded before Flop
Seat 3: bubu1554 (big blind) collected (€0.02)
Seat 4: ghosto69 folded before Flop (didn't bet)
Seat 5: caduceus369 folded before Flop (didn't bet)
Seat 6: stefano997 folded before Flop (didn't bet)



PokerStars Zoom Hand #257998669901:  Hold'em No Limit (€0.01/€0.02) [ADM ID: M62BD3044A1E13PD] - 2025/10/04 21:14:38 CET [2025/10/04 15:14:38 ET]
Table 'Sirio' 6-max Seat #1 is the button
Seat 1: ghosto69 (€4.51 in chips) 
Seat 2: eleonora50 (€1.80 in chips) 
Seat 3: Remindre (€2 in chips) 
Seat 4: caduceus369 (€2.35 in chips) 
Seat 5: RRsanto (€2.38 in chips) 
Seat 6: TheKing.1969 (€2.81 in chips) 
eleonora50: posts small blind €0.01
Remindre: posts big blind €0.02
*** HOLE CARDS ***
Dealt to caduceus369 [4d Ks]
caduceus369: folds 
RRsanto: folds 
TheKing.1969: folds 
ghosto69: raises €0.04 to €0.06
eleonora50: folds 
Remindre: raises €1.94 to €2 and is all-in
ghosto69: folds 
Uncalled bet (€1.94) returned to Remindre
Remindre collected €0.13 from pot
Remindre: doesn't show hand 
*** SUMMARY ***
Total pot €0.13 | Rake €0 
Seat 1: ghosto69 (button) folded before Flop
Seat 2: eleonora50 (small blind) folded before Flop
Seat 3: Remindre (big blind) collected (€0.13)
Seat 4: caduceus369 folded before Flop (didn't bet)
Seat 5: RRsanto folded before Flop (didn't bet)
Seat 6: TheKing.1969 folded before Flop (didn't bet)



PokerStars Zoom Hand #257998670952:  Hold'em No Limit (€0.01/€0.02) [ADM ID: M62BD3044A1E13PD] - 2025/10/04 21:14:43 CET [2025/10/04 15:14:43 ET]
Table 'Sirio' 6-max Seat #1 is the button
Seat 1: CARAPIGNA (€1.84 in chips) 
Seat 2: caduceus369 (€2.35 in chips) 
Seat 3: RRsanto (€2.38 in chips) 
Seat 4: GanchanS7 (€4.47 in chips) 
Seat 5: IKARO_3 (€4.09 in chips) 
Seat 6: Bigo2802 (€6.06 in chips) 
caduceus369: posts small blind €0.01
RRsanto: posts big blind €0.02
*** HOLE CARDS ***
Dealt to caduceus369 [Qc Kd]
GanchanS7: folds 
IKARO_3: folds 
Bigo2802: raises €0.03 to €0.05
CARAPIGNA: folds 
caduceus369: raises €0.11 to €0.16
RRsanto: folds 
Bigo2802: calls €0.11
*** FLOP *** [3d 4h 6s]
caduceus369: bets €0.11
Bigo2802: folds 
Uncalled bet (€0.11) returned to caduceus369
caduceus369 collected €0.33 from pot
caduceus369: doesn't show hand 
*** SUMMARY ***
Total pot €0.34 | Rake €0.01 
Board [3d 4h 6s]
Seat 1: CARAPIGNA (button) folded before Flop (didn't bet)
Seat 2: caduceus369 (small blind) collected (€0.33)
Seat 3: RRsanto (big blind) folded before Flop
Seat 4: GanchanS7 folded before Flop (didn't bet)
Seat 5: IKARO_3 folded before Flop (didn't bet)
Seat 6: Bigo2802 folded on the Flop



PokerStars Zoom Hand #257998681044:  Hold'em No Limit (€0.01/€0.02) [ADM ID: M62BD3044A1E13PD] - 2025/10/04 21:15:27 CET [2025/10/04 15:15:27 ET]
Table 'Sirio' 6-max Seat #1 is the button
Seat 1: stefano997 (€1.68 in chips) 
Seat 2: Wind9force (€7.38 in chips) 
Seat 3: caduceus369 (€2.52 in chips) 
Seat 4: bubu1554 (€1.50 in chips) 
Seat 5: ghosto69 (€0.97 in chips) 
Seat 6: ALUMIX (€1.05 in chips) 
Wind9force: posts small blind €0.01
caduceus369: posts big blind €0.02
*** HOLE CARDS ***
Dealt to caduceus369 [9c 5h]
bubu1554: folds 
ghosto69: folds 
ALUMIX: calls €0.02
stefano997: folds 
Wind9force: folds 
caduceus369: checks 
*** FLOP *** [Td Tc 2c]
caduceus369: checks 
ALUMIX: bets €0.02
caduceus369: folds 
Uncalled bet (€0.02) returned to ALUMIX
ALUMIX collected €0.05 from pot
ALUMIX: doesn't show hand 
*** SUMMARY ***
Total pot €0.05 | Rake €0 
Board [Td Tc 2c]
Seat 1: stefano997 (button) folded before Flop (didn't bet)
Seat 2: Wind9force (small blind) folded before Flop
Seat 3: caduceus369 (big blind) folded on the Flop
Seat 4: bubu1554 folded before Flop (didn't bet)
Seat 5: ghosto69 folded before Flop (didn't bet)
Seat 6: ALUMIX collected (€0.05)



PokerStars Zoom Hand #257998688118:  Hold'em No Limit (€0.01/€0.02) [ADM ID: M62BD3044A1E13PD] - 2025/10/04 21:15:58 CET [2025/10/04 15:15:58 ET]
Table 'Sirio' 6-max Seat #1 is the button
Seat 1: lupocane (€2.07 in chips) 
Seat 2: eleonora50 (€1.85 in chips) 
Seat 3: RRsanto (€2 in chips) 
Seat 4: GanchanS7 (€3.20 in chips) 
Seat 5: TheKing.1969 (€4.72 in chips) 
Seat 6: caduceus369 (€2.50 in chips) 
eleonora50: posts small blind €0.01
RRsanto: posts big blind €0.02
*** HOLE CARDS ***
Dealt to caduceus369 [Tc 8d]
GanchanS7: folds 
TheKing.1969: folds 
caduceus369: folds 
lupocane: raises €0.04 to €0.06
eleonora50: folds 
RRsanto: folds 
Uncalled bet (€0.04) returned to lupocane
lupocane collected €0.05 from pot
lupocane: doesn't show hand 
*** SUMMARY ***
Total pot €0.05 | Rake €0 
Seat 1: lupocane (button) collected (€0.05)
Seat 2: eleonora50 (small blind) folded before Flop
Seat 3: RRsanto (big blind) folded before Flop
Seat 4: GanchanS7 folded before Flop (didn't bet)
Seat 5: TheKing.1969 folded before Flop (didn't bet)
Seat 6: caduceus369 folded before Flop (didn't bet)



PokerStars Zoom Hand #257998692574:  Hold'em No Limit (€0.01/€0.02) [ADM ID: M62BD3044A1E13PD] - 2025/10/04 21:16:18 CET [2025/10/04 15:16:18 ET]
Table 'Sirio' 6-max Seat #1 is the button
Seat 1: GanchanS7 (€3.20 in chips) 
Seat 2: RRsanto (€2 in chips) 
Seat 3: Robycastel89 (€0.84 in chips) 
Seat 4: caduceus369 (€2.50 in chips) 
Seat 5: IKARO_3 (€3.67 in chips) 
Seat 6: ghosto69 (€4.42 in chips) 
RRsanto: posts small blind €0.01
Robycastel89: posts big blind €0.02
*** HOLE CARDS ***
Dealt to caduceus369 [Jh 9h]
caduceus369: raises €0.04 to €0.06
IKARO_3: folds 
ghosto69: folds 
GanchanS7: folds 
RRsanto: folds 
Robycastel89: folds 
Uncalled bet (€0.04) returned to caduceus369
caduceus369 collected €0.05 from pot
caduceus369: doesn't show hand 
*** SUMMARY ***
Total pot €0.05 | Rake €0 
Seat 1: GanchanS7 (button) folded before Flop (didn't bet)
Seat 2: RRsanto (small blind) folded before Flop
Seat 3: Robycastel89 (big blind) folded before Flop
Seat 4: caduceus369 collected (€0.05)
Seat 5: IKARO_3 folded before Flop (didn't bet)
Seat 6: ghosto69 folded before Flop (didn't bet)



PokerStars Zoom Hand #257998685120:  Hold'em No Limit (€0.01/€0.02) [ADM ID: M62BD3044A1E13PD] - 2025/10/04 21:15:45 CET [2025/10/04 15:15:45 ET]
Table 'Sirio' 6-max Seat #1 is the button
Seat 1: caduceus369 (€2.50 in chips) 
Seat 2: bruciapelo (€3.51 in chips) 
Seat 3: buscofan (€1.97 in chips) 
Seat 4: Wind9force (€7.37 in chips) 
Seat 5: Gabrielefante (€6.91 in chips) 
Seat 6: Kazzimmino (€1.97 in chips) 
bruciapelo: posts small blind €0.01
buscofan: posts big blind €0.02
*** HOLE CARDS ***
Dealt to caduceus369 [As 8c]
Wind9force: folds 
Gabrielefante: folds 
Kazzimmino: raises €0.06 to €0.08
caduceus369: folds 
bruciapelo: folds 
buscofan: raises €0.22 to €0.30
Kazzimmino: calls €0.22
*** FLOP *** [9s 7s 7h]
buscofan: bets €0.23
Kazzimmino: calls €0.23
*** TURN *** [9s 7s 7h] [Th]
buscofan: checks 
Kazzimmino: bets €0.51
buscofan: raises €0.93 to €1.44 and is all-in
Kazzimmino: folds 
Uncalled bet (€0.93) returned to buscofan
buscofan collected €1.98 from pot
buscofan: doesn't show hand 
*** SUMMARY ***
Total pot €2.09 | Rake €0.11 
Board [9s 7s 7h Th]
Seat 1: caduceus369 (button) folded before Flop (didn't bet)
Seat 2: bruciapelo (small blind) folded before Flop
Seat 3: buscofan (big blind) collected (€1.98)
Seat 4: Wind9force folded before Flop (didn't bet)
Seat 5: Gabrielefante folded before Flop (didn't bet)
Seat 6: Kazzimmino folded on the Turn



PokerStars Zoom Hand #257998690117:  Hold'em No Limit (€0.01/€0.02) [ADM ID: M62BD3044A1E13PD] - 2025/10/04 21:16:07 CET [2025/10/04 15:16:07 ET]
Table 'Sirio' 6-max Seat #1 is the button
Seat 1: kAllSeMPRE73 (€1.64 in chips) 
Seat 2: stefano997 (€1.78 in chips) 
Seat 3: lucpri (€1.74 in chips) 
Seat 4: Robycastel89 (€0.84 in chips) 
Seat 5: caduceus369 (€2.50 in chips) 
Seat 6: pylonstrip (€3.92 in chips) 
stefano997: posts small blind €0.01
lucpri: posts big blind €0.02
*** HOLE CARDS ***
Dealt to caduceus369 [3h 7c]
Robycastel89: folds 
caduceus369: folds 
pylonstrip: folds 
kAllSeMPRE73: calls €0.02
stefano997: folds 
lucpri: checks 
*** FLOP *** [6d 8d As]
lucpri: checks 
kAllSeMPRE73: checks 
*** TURN *** [6d 8d As] [Jh]
lucpri: bets €0.02
kAllSeMPRE73: folds 
Uncalled bet (€0.02) returned to lucpri
lucpri collected €0.05 from pot
lucpri: doesn't show hand 
*** SUMMARY ***
Total pot €0.05 | Rake €0 
Board [6d 8d As Jh]
Seat 1: kAllSeMPRE73 (button) folded on the Turn
Seat 2: stefano997 (small blind) folded before Flop
Seat 3: lucpri (big blind) collected (€0.05)
Seat 4: Robycastel89 folded before Flop (didn't bet)
Seat 5: caduceus369 folded before Flop (didn't bet)
Seat 6: pylonstrip folded before Flop (didn't bet)



PokerStars Zoom Hand #257998695952:  Hold'em No Limit (€0.01/€0.02) [ADM ID: M62BD3044A1E13PD] - 2025/10/04 21:16:33 CET [2025/10/04 15:16:33 ET]
Table 'Sirio' 6-max Seat #1 is the button
Seat 1: caduceus369 (€2.53 in chips) 
Seat 2: kAllSeMPRE73 (€1.62 in chips) 
Seat 3: ghosto69 (€4.42 in chips) 
Seat 4: Wind9force (€7.41 in chips) 
Seat 5: RRsanto (€2.15 in chips) 
Seat 6: GanchanS7 (€4.44 in chips) 
kAllSeMPRE73: posts small blind €0.01
ghosto69: posts big blind €0.02
*** HOLE CARDS ***
Dealt to caduceus369 [Jc Tc]
Wind9force: calls €0.02
RRsanto: folds 
GanchanS7: folds 
caduceus369: raises €0.08 to €0.10
kAllSeMPRE73: folds 
ghosto69: folds 
Wind9force: calls €0.08
*** FLOP *** [6d 7h Ks]
Wind9force: checks 
caduceus369: bets €0.06
Wind9force: folds 
Uncalled bet (€0.06) returned to caduceus369
caduceus369 collected €0.22 from pot
caduceus369: doesn't show hand 
*** SUMMARY ***
Total pot €0.23 | Rake €0.01 
Board [6d 7h Ks]
Seat 1: caduceus369 (button) collected (€0.22)
Seat 2: kAllSeMPRE73 (small blind) folded before Flop
Seat 3: ghosto69 (big blind) folded before Flop
Seat 4: Wind9force folded on the Flop
Seat 5: RRsanto folded before Flop (didn't bet)
Seat 6: GanchanS7 folded before Flop (didn't bet)



PokerStars Zoom Hand #257998703827:  Hold'em No Limit (€0.01/€0.02) [ADM ID: M62BD3044A1E13PD] - 2025/10/04 21:17:07 CET [2025/10/04 15:17:07 ET]
Table 'Sirio' 6-max Seat #1 is the button
Seat 1: ghosto69 (€0.95 in chips) 
Seat 2: Gabrielefante (€6.83 in chips) 
Seat 3: GanchanS7 (€3.20 in chips) 
Seat 4: bruciapelo (€3.70 in chips) 
Seat 5: flippone78 (€1.74 in chips) 
Seat 6: caduceus369 (€2.65 in chips) 
Gabrielefante: posts small blind €0.01
GanchanS7: posts big blind €0.02
*** HOLE CARDS ***
Dealt to caduceus369 [Ad Ac]
bruciapelo: raises €0.04 to €0.06
flippone78: folds 
caduceus369: raises €0.12 to €0.18
ghosto69: folds 
Gabrielefante: folds 
GanchanS7: folds 
bruciapelo: calls €0.12
*** FLOP *** [3d 8d 2c]
bruciapelo: checks 
caduceus369: bets €0.15
bruciapelo: calls €0.15
*** TURN *** [3d 8d 2c] [Kc]
bruciapelo: checks 
caduceus369: checks 
*** RIVER *** [3d 8d 2c Kc] [4d]
bruciapelo: bets €0.33
caduceus369: calls €0.33
*** SHOW DOWN ***
bruciapelo: shows [8c 8s] (three of a kind, Eights)
caduceus369: mucks hand 
bruciapelo collected €1.28 from pot
*** SUMMARY ***
Total pot €1.35 | Rake €0.07 
Board [3d 8d 2c Kc 4d]
Seat 1: ghosto69 (button) folded before Flop (didn't bet)
Seat 2: Gabrielefante (small blind) folded before Flop
Seat 3: GanchanS7 (big blind) folded before Flop
Seat 4: bruciapelo showed [8c 8s] and won (€1.28) with three of a kind, Eights
Seat 5: flippone78 folded before Flop (didn't bet)
Seat 6: caduceus369 mucked [Ad Ac]



PokerStars Zoom Hand #257998721387:  Hold'em No Limit (€0.01/€0.02) [ADM ID: M62BD3044A1E13PD] - 2025/10/04 21:18:23 CET [2025/10/04 15:18:23 ET]
Table 'Sirio' 6-max Seat #1 is the button
Seat 1: GanchanS7 (€2 in chips) 
Seat 2: Kazzimmino (€2.06 in chips) 
Seat 3: caduceus369 (€2 in chips) 
Seat 4: TheKing.1969 (€5 in chips) 
Seat 5: trillycata (€1.21 in chips) 
Seat 6: N0thingforU (€4.08 in chips) 
Kazzimmino: posts small blind €0.01
caduceus369: posts big blind €0.02
*** HOLE CARDS ***
Dealt to caduceus369 [6h 9c]
TheKing.1969: raises €0.02 to €0.04
trillycata: calls €0.04
N0thingforU: folds 
GanchanS7: folds 
Kazzimmino: folds 
caduceus369: folds 
*** FLOP *** [2h 9h 5s]
TheKing.1969: bets €0.06
trillycata: folds 
Uncalled bet (€0.06) returned to TheKing.1969
TheKing.1969 collected €0.11 from pot
TheKing.1969: doesn't show hand 
*** SUMMARY ***
Total pot €0.11 | Rake €0 
Board [2h 9h 5s]
Seat 1: GanchanS7 (button) folded before Flop (didn't bet)
Seat 2: Kazzimmino (small blind) folded before Flop
Seat 3: caduceus369 (big blind) folded before Flop
Seat 4: TheKing.1969 collected (€0.11)
Seat 5: trillycata folded on the Flop
Seat 6: N0thingforU folded before Flop (didn't bet)



PokerStars Zoom Hand #257998725623:  Hold'em No Limit (€0.01/€0.02) [ADM ID: M62BD3044A1E13PD] - 2025/10/04 21:18:41 CET [2025/10/04 15:18:41 ET]
Table 'Sirio' 6-max Seat #1 is the button
Seat 1: TheKing.1969 (€1.45 in chips) 
Seat 2: ADRIAN0_MEIS (€2.58 in chips) 
Seat 3: RRsanto (€2.11 in chips) 
Seat 4: buscofan (€3.27 in chips) 
Seat 5: caduceus369 (€2 in chips) 
Seat 6: Kazzimmino (€2.03 in chips) 
ADRIAN0_MEIS: posts small blind €0.01
RRsanto: posts big blind €0.02
*** HOLE CARDS ***
Dealt to caduceus369 [Th 4c]
buscofan: raises €0.04 to €0.06
caduceus369: folds 
Kazzimmino: folds 
TheKing.1969: folds 
ADRIAN0_MEIS: raises €0.14 to €0.20
RRsanto: folds 
buscofan: folds 
Uncalled bet (€0.14) returned to ADRIAN0_MEIS
ADRIAN0_MEIS collected €0.14 from pot
ADRIAN0_MEIS: doesn't show hand 
*** SUMMARY ***
Total pot €0.14 | Rake €0 
Seat 1: TheKing.1969 (button) folded before Flop (didn't bet)
Seat 2: ADRIAN0_MEIS (small blind) collected (€0.14)
Seat 3: RRsanto (big blind) folded before Flop
Seat 4: buscofan folded before Flop
Seat 5: caduceus369 folded before Flop (didn't bet)
Seat 6: Kazzimmino folded before Flop (didn't bet)



PokerStars Zoom Hand #257998723937:  Hold'em No Limit (€0.01/€0.02) [ADM ID: M62BD3044A1E13PD] - 2025/10/04 21:18:34 CET [2025/10/04 15:18:34 ET]
Table 'Sirio' 6-max Seat #1 is the button
Seat 1: RRsanto (€2.11 in chips) 
Seat 2: caduceus369 (€2 in chips) 
Seat 3: GanchanS7 (€3.62 in chips) 
Seat 4: TheKing.1969 (€2.62 in chips) 
Seat 5: N0thingforU (€4.08 in chips) 
Seat 6: ghosto69 (€0.90 in chips) 
caduceus369: posts small blind €0.01
GanchanS7: posts big blind €0.02
*** HOLE CARDS ***
Dealt to caduceus369 [7c Qd]
TheKing.1969: folds 
N0thingforU: folds 
ghosto69: raises €0.04 to €0.06
RRsanto: folds 
caduceus369: folds 
GanchanS7: calls €0.04
*** FLOP *** [3d 8c 2c]
GanchanS7: checks 
ghosto69: checks 
*** TURN *** [3d 8c 2c] [2d]
GanchanS7: checks 
ghosto69: checks 
*** RIVER *** [3d 8c 2c 2d] [6s]
GanchanS7: checks 
ghosto69: checks 
*** SHOW DOWN ***
GanchanS7: shows [As 9s] (a pair of Deuces)
ghosto69: shows [Ah Jh] (a pair of Deuces - Ace+Jack kicker)
ghosto69 collected €0.13 from pot
*** SUMMARY ***
Total pot €0.13 | Rake €0 
Board [3d 8c 2c 2d 6s]
Seat 1: RRsanto (button) folded before Flop (didn't bet)
Seat 2: caduceus369 (small blind) folded before Flop
Seat 3: GanchanS7 (big blind) showed [As 9s] and lost with a pair of Deuces
Seat 4: TheKing.1969 folded before Flop (didn't bet)
Seat 5: N0thingforU folded before Flop (didn't bet)
Seat 6: ghosto69 showed [Ah Jh] and won (€0.13) with a pair of Deuces



PokerStars Zoom Hand #257998728197:  Hold'em No Limit (€0.01/€0.02) [ADM ID: M62BD3044A1E13PD] - 2025/10/04 21:18:53 CET [2025/10/04 15:18:53 ET]
Table 'Sirio' 6-max Seat #1 is the button
Seat 1: Wind9force (€7.18 in chips) 
Seat 2: kAllSeMPRE73 (€1.28 in chips) 
Seat 3: ALUMIX (€0.83 in chips) 
Seat 4: caduceus369 (€2 in chips) 
Seat 5: criptlux (€0.59 in chips) 
Seat 6: TheKing.1969 (€2.92 in chips) 
kAllSeMPRE73: posts small blind €0.01
ALUMIX: posts big blind €0.02
*** HOLE CARDS ***
Dealt to caduceus369 [As Kh]
caduceus369: raises €0.04 to €0.06
criptlux: folds 
TheKing.1969: folds 
Wind9force: folds 
kAllSeMPRE73: calls €0.05
ALUMIX: calls €0.04
*** FLOP *** [3d 8c Qd]
kAllSeMPRE73: checks 
ALUMIX: bets €0.18
caduceus369: folds 
kAllSeMPRE73: folds 
Uncalled bet (€0.18) returned to ALUMIX
ALUMIX collected €0.18 from pot
ALUMIX: doesn't show hand 
*** SUMMARY ***
Total pot €0.18 | Rake €0 
Board [3d 8c Qd]
Seat 1: Wind9force (button) folded before Flop (didn't bet)
Seat 2: kAllSeMPRE73 (small blind) folded on the Flop
Seat 3: ALUMIX (big blind) collected (€0.18)
Seat 4: caduceus369 folded on the Flop
Seat 5: criptlux folded before Flop (didn't bet)
Seat 6: TheKing.1969 folded before Flop (didn't bet)



PokerStars Zoom Hand #257998734077:  Hold'em No Limit (€0.01/€0.02) [ADM ID: M62BD3044A1E13PD] - 2025/10/04 21:19:19 CET [2025/10/04 15:19:19 ET]
Table 'Sirio' 6-max Seat #1 is the button
Seat 1: lucpri (€1.70 in chips) 
Seat 2: pylonstrip (€4.35 in chips) 
Seat 3: GanchanS7 (€4.38 in chips) 
Seat 4: TheKing.1969 (€2.62 in chips) 
Seat 5: ADRIAN0_MEIS (€2.32 in chips) 
Seat 6: caduceus369 (€2 in chips) 
pylonstrip: posts small blind €0.01
GanchanS7: posts big blind €0.02
*** HOLE CARDS ***
Dealt to caduceus369 [7s 4d]
TheKing.1969: folds 
ADRIAN0_MEIS: folds 
caduceus369: folds 
lucpri: folds 
pylonstrip: raises €0.04 to €0.06
GanchanS7: folds 
Uncalled bet (€0.04) returned to pylonstrip
pylonstrip collected €0.04 from pot
pylonstrip: doesn't show hand 
*** SUMMARY ***
Total pot €0.04 | Rake €0 
Seat 1: lucpri (button) folded before Flop (didn't bet)
Seat 2: pylonstrip (small blind) collected (€0.04)
Seat 3: GanchanS7 (big blind) folded before Flop
Seat 4: TheKing.1969 folded before Flop (didn't bet)
Seat 5: ADRIAN0_MEIS folded before Flop (didn't bet)
Seat 6: caduceus369 folded before Flop (didn't bet)



PokerStars Zoom Hand #257998737301:  Hold'em No Limit (€0.01/€0.02) [ADM ID: M62BD3044A1E13PD] - 2025/10/04 21:19:33 CET [2025/10/04 15:19:33 ET]
Table 'Sirio' 6-max Seat #1 is the button
Seat 1: ghosto69 (€1.09 in chips) 
Seat 2: TheKing.1969 (€2.62 in chips) 
Seat 3: kAllSeMPRE73 (€1.22 in chips) 
Seat 4: caduceus369 (€2 in chips) 
Seat 5: eleonora50 (€1.80 in chips) 
Seat 6: GanchanS7 (€2 in chips) 
TheKing.1969: posts small blind €0.01
kAllSeMPRE73: posts big blind €0.02
*** HOLE CARDS ***
Dealt to caduceus369 [8h Jc]
caduceus369: folds 
eleonora50: folds 
GanchanS7: folds 
ghosto69: folds 
TheKing.1969: folds 
Uncalled bet (€0.01) returned to kAllSeMPRE73
kAllSeMPRE73 collected €0.02 from pot
kAllSeMPRE73: doesn't show hand 
*** SUMMARY ***
Total pot €0.02 | Rake €0 
Seat 1: ghosto69 (button) folded before Flop (didn't bet)
Seat 2: TheKing.1969 (small blind) folded before Flop
Seat 3: kAllSeMPRE73 (big blind) collected (€0.02)
Seat 4: caduceus369 folded before Flop (didn't bet)
Seat 5: eleonora50 folded before Flop (didn't bet)
Seat 6: GanchanS7 folded before Flop (didn't bet)



PokerStars Zoom Hand #257998739350:  Hold'em No Limit (€0.01/€0.02) [ADM ID: M62BD3044A1E13PD] - 2025/10/04 21:19:41 CET [2025/10/04 15:19:41 ET]
Table 'Sirio' 6-max Seat #1 is the button
Seat 1: ADRIAN0_MEIS (€2.30 in chips) 
Seat 2: Wunschgast (€4.35 in chips) 
Seat 3: caduceus369 (€2 in chips) 
Seat 4: ghosto69 (€1.09 in chips) 
Seat 5: pylonstrip (€4.37 in chips) 
Seat 6: GanchanS7 (€4.36 in chips) 
Wunschgast: posts small blind €0.01
caduceus369: posts big blind €0.02
*** HOLE CARDS ***
Dealt to caduceus369 [Qd 5s]
ghosto69: folds 
pylonstrip: folds 
GanchanS7: folds 
ADRIAN0_MEIS: folds 
Wunschgast: folds 
Uncalled bet (€0.01) returned to caduceus369
caduceus369 collected €0.02 from pot
caduceus369: doesn't show hand 
*** SUMMARY ***
Total pot €0.02 | Rake €0 
Seat 1: ADRIAN0_MEIS (button) folded before Flop (didn't bet)
Seat 2: Wunschgast (small blind) folded before Flop
Seat 3: caduceus369 (big blind) collected (€0.02)
Seat 4: ghosto69 folded before Flop (didn't bet)
Seat 5: pylonstrip folded before Flop (didn't bet)
Seat 6: GanchanS7 folded before Flop (didn't bet)



PokerStars Zoom Hand #257998741954:  Hold'em No Limit (€0.01/€0.02) [ADM ID: M62BD3044A1E13PD] - 2025/10/04 21:19:53 CET [2025/10/04 15:19:53 ET]
Table 'Sirio' 6-max Seat #1 is the button
Seat 1: ADRIAN0_MEIS (€2.28 in chips) 
Seat 2: caduceus369 (€2.01 in chips) 
Seat 3: trillycata (€1.13 in chips) 
Seat 4: GanchanS7 (€2.92 in chips) 
Seat 5: TheKing.1969 (€2.90 in chips) 
Seat 6: lucpri (€1.70 in chips) 
caduceus369: posts small blind €0.01
trillycata: posts big blind €0.02
*** HOLE CARDS ***
Dealt to caduceus369 [Qh 2d]
GanchanS7: folds 
TheKing.1969: folds 
lucpri: folds 
ADRIAN0_MEIS: folds 
caduceus369: folds 
Uncalled bet (€0.01) returned to trillycata
trillycata collected €0.02 from pot
trillycata: doesn't show hand 
*** SUMMARY ***
Total pot €0.02 | Rake €0 
Seat 1: ADRIAN0_MEIS (button) folded before Flop (didn't bet)
Seat 2: caduceus369 (small blind) folded before Flop
Seat 3: trillycata (big blind) collected (€0.02)
Seat 4: GanchanS7 folded before Flop (didn't bet)
Seat 5: TheKing.1969 folded before Flop (didn't bet)
Seat 6: lucpri folded before Flop (didn't bet)



PokerStars Zoom Hand #257998745171:  Hold'em No Limit (€0.01/€0.02) [ADM ID: M62BD3044A1E13PD] - 2025/10/04 21:20:07 CET [2025/10/04 15:20:07 ET]
Table 'Sirio' 6-max Seat #1 is the button
Seat 1: caduceus369 (€2 in chips) 
Seat 2: pylonstrip (€4.35 in chips) 
Seat 3: TheKing.1969 (€5.15 in chips) 
Seat 4: ADRIAN0_MEIS (€2.76 in chips) 
Seat 5: RRsanto (€2.38 in chips) 
Seat 6: VagALiss (€2.20 in chips) 
pylonstrip: posts small blind €0.01
TheKing.1969: posts big blind €0.02
*** HOLE CARDS ***
Dealt to caduceus369 [Jh Td]
ADRIAN0_MEIS: raises €0.05 to €0.07
RRsanto: folds 
VagALiss: folds 
caduceus369: folds 
pylonstrip: folds 
TheKing.1969: folds 
Uncalled bet (€0.05) returned to ADRIAN0_MEIS
ADRIAN0_MEIS collected €0.05 from pot
ADRIAN0_MEIS: doesn't show hand 
*** SUMMARY ***
Total pot €0.05 | Rake €0 
Seat 1: caduceus369 (button) folded before Flop (didn't bet)
Seat 2: pylonstrip (small blind) folded before Flop
Seat 3: TheKing.1969 (big blind) folded before Flop
Seat 4: ADRIAN0_MEIS collected (€0.05)
Seat 5: RRsanto folded before Flop (didn't bet)
Seat 6: VagALiss folded before Flop (didn't bet)



PokerStars Zoom Hand #257998744206:  Hold'em No Limit (€0.01/€0.02) [ADM ID: M62BD3044A1E13PD] - 2025/10/04 21:20:02 CET [2025/10/04 15:20:02 ET]
Table 'Sirio' 6-max Seat #1 is the button
Seat 1: caduceus369 (€2 in chips) 
Seat 2: GanchanS7 (€2.92 in chips) 
Seat 3: stefano997 (€1.74 in chips) 
Seat 4: pylonstrip (€4.35 in chips) 
Seat 5: VagALiss (€2.20 in chips) 
Seat 6: Wunschgast (€4.32 in chips) 
GanchanS7: posts small blind €0.01
stefano997: posts big blind €0.02
*** HOLE CARDS ***
Dealt to caduceus369 [Ah 2s]
pylonstrip: folds 
VagALiss: folds 
Wunschgast: raises €0.04 to €0.06
caduceus369: folds 
GanchanS7: folds 
stefano997: calls €0.04
*** FLOP *** [4c 8h 6h]
stefano997: checks 
Wunschgast: bets €0.10
stefano997: calls €0.10
*** TURN *** [4c 8h 6h] [Js]
stefano997: checks 
Wunschgast: bets €0.26
stefano997: folds 
Uncalled bet (€0.26) returned to Wunschgast
Wunschgast collected €0.32 from pot
Wunschgast: doesn't show hand 
*** SUMMARY ***
Total pot €0.33 | Rake €0.01 
Board [4c 8h 6h Js]
Seat 1: caduceus369 (button) folded before Flop (didn't bet)
Seat 2: GanchanS7 (small blind) folded before Flop
Seat 3: stefano997 (big blind) folded on the Turn
Seat 4: pylonstrip folded before Flop (didn't bet)
Seat 5: VagALiss folded before Flop (didn't bet)
Seat 6: Wunschgast collected (€0.32)



PokerStars Zoom Hand #257998747231:  Hold'em No Limit (€0.01/€0.02) [ADM ID: M62BD3044A1E13PD] - 2025/10/04 21:20:16 CET [2025/10/04 15:20:16 ET]
Table 'Sirio' 6-max Seat #1 is the button
Seat 1: trillycata (€1.13 in chips) 
Seat 2: ADRIAN0_MEIS (€2.33 in chips) 
Seat 3: VagALiss (€2.20 in chips) 
Seat 4: buscofan (€3.28 in chips) 
Seat 5: caduceus369 (€2 in chips) 
Seat 6: RRsanto (€2 in chips) 
ADRIAN0_MEIS: posts small blind €0.01
VagALiss: posts big blind €0.02
*** HOLE CARDS ***
Dealt to caduceus369 [4s 3d]
buscofan: raises €0.04 to €0.06
caduceus369: folds 
RRsanto: folds 
trillycata: folds 
ADRIAN0_MEIS: folds 
VagALiss: calls €0.04
*** FLOP *** [2h 5s 8c]
VagALiss: checks 
buscofan: checks 
*** TURN *** [2h 5s 8c] [Ah]
VagALiss: checks 
buscofan: bets €0.05
VagALiss: calls €0.05
*** RIVER *** [2h 5s 8c Ah] [Ac]
VagALiss: checks 
buscofan: checks 
*** SHOW DOWN ***
VagALiss: shows [Jh Th] (a pair of Aces)
buscofan: shows [Jd Td] (a pair of Aces)
VagALiss collected €0.11 from pot
buscofan collected €0.11 from pot
*** SUMMARY ***
Total pot €0.23 | Rake €0.01 
Board [2h 5s 8c Ah Ac]
Seat 1: trillycata (button) folded before Flop (didn't bet)
Seat 2: ADRIAN0_MEIS (small blind) folded before Flop
Seat 3: VagALiss (big blind) showed [Jh Th] and won (€0.11) with a pair of Aces
Seat 4: buscofan showed [Jd Td] and won (€0.11) with a pair of Aces
Seat 5: caduceus369 folded before Flop (didn't bet)
Seat 6: RRsanto folded before Flop (didn't bet)



PokerStars Zoom Hand #257998748433:  Hold'em No Limit (€0.01/€0.02) [ADM ID: M62BD3044A1E13PD] - 2025/10/04 21:20:21 CET [2025/10/04 15:20:21 ET]
Table 'Sirio' 6-max Seat #1 is the button
Seat 1: RRsanto (€2 in chips) 
Seat 2: lucpri (€1.68 in chips) 
Seat 3: pylonstrip (€4.34 in chips) 
Seat 4: Asso77407 (€1.10 in chips) 
Seat 5: trillycata (€1.13 in chips) 
Seat 6: caduceus369 (€2 in chips) 
lucpri: posts small blind €0.01
pylonstrip: posts big blind €0.02
*** HOLE CARDS ***
Dealt to caduceus369 [7d 5h]
Asso77407: calls €0.02
trillycata: folds 
caduceus369: folds 
RRsanto: folds 
lucpri: folds 
pylonstrip: checks 
*** FLOP *** [8d 9h 6s]
pylonstrip: checks 
Asso77407: bets €0.06
pylonstrip: calls €0.06
*** TURN *** [8d 9h 6s] [As]
pylonstrip: checks 
Asso77407: checks 
*** RIVER *** [8d 9h 6s As] [4h]
pylonstrip: checks 
Asso77407: bets €0.12
pylonstrip: folds 
Uncalled bet (€0.12) returned to Asso77407
Asso77407 collected €0.17 from pot
Asso77407: doesn't show hand 
*** SUMMARY ***
Total pot €0.17 | Rake €0 
Board [8d 9h 6s As 4h]
Seat 1: RRsanto (button) folded before Flop (didn't bet)
Seat 2: lucpri (small blind) folded before Flop
Seat 3: pylonstrip (big blind) folded on the River
Seat 4: Asso77407 collected (€0.17)
Seat 5: trillycata folded before Flop (didn't bet)
Seat 6: caduceus369 folded before Flop (didn't bet)



PokerStars Zoom Hand #257998749504:  Hold'em No Limit (€0.01/€0.02) [ADM ID: M62BD3044A1E13PD] - 2025/10/04 21:20:26 CET [2025/10/04 15:20:26 ET]
Table 'Sirio' 6-max Seat #1 is the button
Seat 1: ADRIAN0_MEIS (€2.29 in chips) 
Seat 2: eleonora50 (€1.76 in chips) 
Seat 3: Kingm727 (€1.43 in chips) 
Seat 4: Kazzimmino (€1.73 in chips) 
Seat 5: caduceus369 (€2 in chips) 
Seat 6: trillycata (€1.13 in chips) 
eleonora50: posts small blind €0.01
Kingm727: posts big blind €0.02
*** HOLE CARDS ***
Dealt to caduceus369 [8d Qs]
Kazzimmino: folds 
caduceus369: folds 
trillycata: folds 
ADRIAN0_MEIS: folds 
eleonora50: calls €0.01
Kingm727: checks 
*** FLOP *** [6d 9h 3d]
eleonora50: bets €0.04
Kingm727: calls €0.04
*** TURN *** [6d 9h 3d] [5s]
eleonora50: bets €0.02
Kingm727: calls €0.02
*** RIVER *** [6d 9h 3d 5s] [6h]
eleonora50: bets €0.02
Kingm727: calls €0.02
*** SHOW DOWN ***
eleonora50: shows [9c Tc] (two pair, Nines and Sixes)
Kingm727: mucks hand 
eleonora50 collected €0.19 from pot
*** SUMMARY ***
Total pot €0.20 | Rake €0.01 
Board [6d 9h 3d 5s 6h]
Seat 1: ADRIAN0_MEIS (button) folded before Flop (didn't bet)
Seat 2: eleonora50 (small blind) showed [9c Tc] and won (€0.19) with two pair, Nines and Sixes
Seat 3: Kingm727 (big blind) mucked [Ac Jh]
Seat 4: Kazzimmino folded before Flop (didn't bet)
Seat 5: caduceus369 folded before Flop (didn't bet)
Seat 6: trillycata folded before Flop (didn't bet)



PokerStars Zoom Hand #257998751298:  Hold'em No Limit (€0.01/€0.02) [ADM ID: M62BD3044A1E13PD] - 2025/10/04 21:20:34 CET [2025/10/04 15:20:34 ET]
Table 'Sirio' 6-max Seat #1 is the button
Seat 1: TheKing.1969 (€5.12 in chips) 
Seat 2: Wunschgast (€4.48 in chips) 
Seat 3: caduceus369 (€2 in chips) 
Seat 4: ADRIAN0_MEIS (€2.32 in chips) 
Seat 5: ghosto69 (€4.97 in chips) 
Seat 6: RRsanto (€2 in chips) 
Wunschgast: posts small blind €0.01
caduceus369: posts big blind €0.02
*** HOLE CARDS ***
Dealt to caduceus369 [8c Jc]
ADRIAN0_MEIS: raises €0.05 to €0.07
ghosto69: folds 
RRsanto: calls €0.07
TheKing.1969: folds 
Wunschgast: calls €0.06
caduceus369: folds 
*** FLOP *** [Jd 4s Kh]
Wunschgast: checks 
ADRIAN0_MEIS: checks 
RRsanto: checks 
*** TURN *** [Jd 4s Kh] [3s]
Wunschgast: checks 
ADRIAN0_MEIS: checks 
RRsanto: checks 
*** RIVER *** [Jd 4s Kh 3s] [Ks]
Wunschgast: checks 
ADRIAN0_MEIS: checks 
RRsanto: checks 
*** SHOW DOWN ***
Wunschgast: shows [Ad Qs] (a pair of Kings)
ADRIAN0_MEIS: shows [As Qh] (a pair of Kings)
RRsanto: mucks hand 
Wunschgast collected €0.11 from pot
ADRIAN0_MEIS collected €0.11 from pot
*** SUMMARY ***
Total pot €0.23 | Rake €0.01 
Board [Jd 4s Kh 3s Ks]
Seat 1: TheKing.1969 (button) folded before Flop (didn't bet)
Seat 2: Wunschgast (small blind) showed [Ad Qs] and won (€0.11) with a pair of Kings
Seat 3: caduceus369 (big blind) folded before Flop
Seat 4: ADRIAN0_MEIS showed [As Qh] and won (€0.11) with a pair of Kings
Seat 5: ghosto69 folded before Flop (didn't bet)
Seat 6: RRsanto mucked [9h Ah]



PokerStars Zoom Hand #257998753036:  Hold'em No Limit (€0.01/€0.02) [ADM ID: M62BD3044A1E13PD] - 2025/10/04 21:20:41 CET [2025/10/04 15:20:41 ET]
Table 'Sirio' 6-max Seat #1 is the button
Seat 1: stefano997 (€1.57 in chips) 
Seat 2: caduceus369 (€2 in chips) 
Seat 3: trisco66 (€4.04 in chips) 
Seat 4: N0thingforU (€5.86 in chips) 
Seat 5: ghosto69 (€0.97 in chips) 
Seat 6: TheKing.1969 (€5.12 in chips) 
caduceus369: posts small blind €0.01
trisco66: posts big blind €0.02
*** HOLE CARDS ***
Dealt to caduceus369 [Ks Th]
N0thingforU: folds 
ghosto69: folds 
TheKing.1969: folds 
stefano997: calls €0.02
caduceus369: raises €0.08 to €0.10
trisco66: folds 
stefano997: calls €0.08
*** FLOP *** [6h 8d As]
caduceus369: bets €0.07
stefano997: calls €0.07
*** TURN *** [6h 8d As] [3s]
caduceus369: checks 
stefano997: checks 
*** RIVER *** [6h 8d As 3s] [Td]
caduceus369: bets €0.20
stefano997: folds 
Uncalled bet (€0.20) returned to caduceus369
caduceus369 collected €0.35 from pot
caduceus369: doesn't show hand 
*** SUMMARY ***
Total pot €0.36 | Rake €0.01 
Board [6h 8d As 3s Td]
Seat 1: stefano997 (button) folded on the River
Seat 2: caduceus369 (small blind) collected (€0.35)
Seat 3: trisco66 (big blind) folded before Flop
Seat 4: N0thingforU folded before Flop (didn't bet)
Seat 5: ghosto69 folded before Flop (didn't bet)
Seat 6: TheKing.1969 folded before Flop (didn't bet)



PokerStars Zoom Hand #257998763102:  Hold'em No Limit (€0.01/€0.02) [ADM ID: M62BD3044A1E13PD] - 2025/10/04 21:21:25 CET [2025/10/04 15:21:25 ET]
Table 'Sirio' 6-max Seat #1 is the button
Seat 1: OSPREYSTORM (€1.97 in chips) 
Seat 2: TheKing.1969 (€1.27 in chips) 
Seat 3: RRsanto (€2.53 in chips) 
Seat 4: ADRIAN0_MEIS (€4.13 in chips) 
Seat 5: pylonstrip (€4.29 in chips) 
Seat 6: caduceus369 (€2.18 in chips) 
TheKing.1969: posts small blind €0.01
RRsanto: posts big blind €0.02
*** HOLE CARDS ***
Dealt to caduceus369 [3d 3h]
ADRIAN0_MEIS: folds 
pylonstrip: raises €0.03 to €0.05
caduceus369: folds 
OSPREYSTORM: folds 
TheKing.1969: folds 
RRsanto: folds 
Uncalled bet (€0.03) returned to pylonstrip
pylonstrip collected €0.05 from pot
pylonstrip: doesn't show hand 
*** SUMMARY ***
Total pot €0.05 | Rake €0 
Seat 1: OSPREYSTORM (button) folded before Flop (didn't bet)
Seat 2: TheKing.1969 (small blind) folded before Flop
Seat 3: RRsanto (big blind) folded before Flop
Seat 4: ADRIAN0_MEIS folded before Flop (didn't bet)
Seat 5: pylonstrip collected (€0.05)
Seat 6: caduceus369 folded before Flop (didn't bet)



PokerStars Zoom Hand #257998767355:  Hold'em No Limit (€0.01/€0.02) [ADM ID: M62BD3044A1E13PD] - 2025/10/04 21:21:44 CET [2025/10/04 15:21:44 ET]
Table 'Sirio' 6-max Seat #1 is the button
Seat 1: Wunschgast (€4.46 in chips) 
Seat 2: OSPREYSTORM (€2.02 in chips) 
Seat 3: ALUMIX (€0.90 in chips) 
Seat 4: caduceus369 (€2.18 in chips) 
Seat 5: GanchanS7 (€2.72 in chips) 
Seat 6: N0thingforU (€5.83 in chips) 
OSPREYSTORM: posts small blind €0.01
ALUMIX: posts big blind €0.02
*** HOLE CARDS ***
Dealt to caduceus369 [8d Ad]
caduceus369: raises €0.04 to €0.06
GanchanS7: folds 
N0thingforU: folds 
Wunschgast: folds 
OSPREYSTORM: folds 
ALUMIX: calls €0.04
*** FLOP *** [As 2h 9s]
ALUMIX: bets €0.07
caduceus369: calls €0.07
*** TURN *** [As 2h 9s] [2d]
ALUMIX: bets €0.13
caduceus369: calls €0.13
*** RIVER *** [As 2h 9s 2d] [Jd]
ALUMIX: bets €0.26
caduceus369: calls €0.26
*** SHOW DOWN ***
ALUMIX: shows [9d 5s] (two pair, Nines and Deuces)
caduceus369: shows [8d Ad] (two pair, Aces and Deuces)
caduceus369 collected €1 from pot
*** SUMMARY ***
Total pot €1.05 | Rake €0.05 
Board [As 2h 9s 2d Jd]
Seat 1: Wunschgast (button) folded before Flop (didn't bet)
Seat 2: OSPREYSTORM (small blind) folded before Flop
Seat 3: ALUMIX (big blind) showed [9d 5s] and lost with two pair, Nines and Deuces
Seat 4: caduceus369 showed [8d Ad] and won (€1) with two pair, Aces and Deuces
Seat 5: GanchanS7 folded before Flop (didn't bet)
Seat 6: N0thingforU folded before Flop (didn't bet)



PokerStars Zoom Hand #257998778887:  Hold'em No Limit (€0.01/€0.02) [ADM ID: M62BD3044A1E13PD] - 2025/10/04 21:22:34 CET [2025/10/04 15:22:34 ET]
Table 'Sirio' 6-max Seat #1 is the button
Seat 1: caduceus369 (€2.66 in chips) 
Seat 2: ALUMIX (€0.38 in chips) 
Seat 3: ghosto69 (€1.01 in chips) 
Seat 4: RRsanto (€2.57 in chips) 
Seat 5: eleonora50 (€1.77 in chips) 
Seat 6: bruciapelo (€4.71 in chips) 
ALUMIX: posts small blind €0.01
ghosto69: posts big blind €0.02
*** HOLE CARDS ***
Dealt to caduceus369 [2s Th]
RRsanto: folds 
eleonora50: folds 
bruciapelo: raises €0.04 to €0.06
caduceus369: folds 
ALUMIX: folds 
ghosto69: folds 
Uncalled bet (€0.04) returned to bruciapelo
bruciapelo collected €0.05 from pot
bruciapelo: doesn't show hand 
*** SUMMARY ***
Total pot €0.05 | Rake €0 
Seat 1: caduceus369 (button) folded before Flop (didn't bet)
Seat 2: ALUMIX (small blind) folded before Flop
Seat 3: ghosto69 (big blind) folded before Flop
Seat 4: RRsanto folded before Flop (didn't bet)
Seat 5: eleonora50 folded before Flop (didn't bet)
Seat 6: bruciapelo collected (€0.05)



PokerStars Zoom Hand #257998780377:  Hold'em No Limit (€0.01/€0.02) [ADM ID: M62BD3044A1E13PD] - 2025/10/04 21:22:40 CET [2025/10/04 15:22:40 ET]
Table 'Sirio' 6-max Seat #1 is the button
Seat 1: ALUMIX (€0.37 in chips) 
Seat 2: GanchanS7 (€2.06 in chips) 
Seat 3: caduceus369 (€2.66 in chips) 
Seat 4: N0thingforU (€5.75 in chips) 
Seat 5: trillycata (€0.98 in chips) 
Seat 6: eleonora50 (€1.77 in chips) 
GanchanS7: posts small blind €0.01
caduceus369: posts big blind €0.02
*** HOLE CARDS ***
Dealt to caduceus369 [8d Jd]
N0thingforU: raises €0.05 to €0.07
trillycata: folds 
eleonora50: folds 
ALUMIX: calls €0.07
GanchanS7: folds 
caduceus369: calls €0.05
*** FLOP *** [3d 5s 2s]
caduceus369: checks 
N0thingforU: checks 
ALUMIX: bets €0.02
caduceus369: calls €0.02
N0thingforU: calls €0.02
*** TURN *** [3d 5s 2s] [Qd]
caduceus369: checks 
N0thingforU: checks 
ALUMIX: bets €0.14
caduceus369: folds 
N0thingforU: folds 
Uncalled bet (€0.14) returned to ALUMIX
ALUMIX collected €0.27 from pot
ALUMIX: doesn't show hand 
*** SUMMARY ***
Total pot €0.28 | Rake €0.01 
Board [3d 5s 2s Qd]
Seat 1: ALUMIX (button) collected (€0.27)
Seat 2: GanchanS7 (small blind) folded before Flop
Seat 3: caduceus369 (big blind) folded on the Turn
Seat 4: N0thingforU folded on the Turn
Seat 5: trillycata folded before Flop (didn't bet)
Seat 6: eleonora50 folded before Flop (didn't bet)



PokerStars Zoom Hand #257998793793:  Hold'em No Limit (€0.01/€0.02) [ADM ID: M62BD3044A1E13PD] - 2025/10/04 21:23:39 CET [2025/10/04 15:23:39 ET]
Table 'Sirio' 6-max Seat #1 is the button
Seat 1: zicky78.r (€2 in chips) 
Seat 2: gigiriver170 (€1.63 in chips) 
Seat 3: OSPREYSTORM (€2.02 in chips) 
Seat 4: lucpri (€1.67 in chips) 
Seat 5: VagALiss (€2.24 in chips) 
Seat 6: caduceus369 (€2.56 in chips) 
gigiriver170: posts small blind €0.01
OSPREYSTORM: posts big blind €0.02
*** HOLE CARDS ***
Dealt to caduceus369 [6h 4s]
lucpri: folds 
VagALiss: folds 
caduceus369: folds 
zicky78.r: raises €0.05 to €0.07
gigiriver170: folds 
OSPREYSTORM: folds 
Uncalled bet (€0.05) returned to zicky78.r
zicky78.r collected €0.05 from pot
zicky78.r: doesn't show hand 
*** SUMMARY ***
Total pot €0.05 | Rake €0 
Seat 1: zicky78.r (button) collected (€0.05)
Seat 2: gigiriver170 (small blind) folded before Flop
Seat 3: OSPREYSTORM (big blind) folded before Flop
Seat 4: lucpri folded before Flop (didn't bet)
Seat 5: VagALiss folded before Flop (didn't bet)
Seat 6: caduceus369 folded before Flop (didn't bet)



PokerStars Zoom Hand #257998790985:  Hold'em No Limit (€0.01/€0.02) [ADM ID: M62BD3044A1E13PD] - 2025/10/04 21:23:27 CET [2025/10/04 15:23:27 ET]
Table 'Sirio' 6-max Seat #1 is the button
Seat 1: ADRIAN0_MEIS (€4.13 in chips) 
Seat 2: stefano997 (€1.36 in chips) 
Seat 3: buscofan (€3.45 in chips) 
Seat 4: caduceus369 (€2.57 in chips) 
Seat 5: ghosto69 (€0.87 in chips) 
Seat 6: lucpri (€1.67 in chips) 
stefano997: posts small blind €0.01
buscofan: posts big blind €0.02
*** HOLE CARDS ***
Dealt to caduceus369 [Jc 9h]
caduceus369: folds 
ghosto69: folds 
lucpri: folds 
ADRIAN0_MEIS: folds 
stefano997: calls €0.01
buscofan: checks 
*** FLOP *** [Qh 9s Kd]
stefano997: checks 
buscofan: checks 
*** TURN *** [Qh 9s Kd] [Js]
stefano997: checks 
buscofan: checks 
*** RIVER *** [Qh 9s Kd Js] [Td]
stefano997: bets €0.02
buscofan: raises €0.08 to €0.10
stefano997: calls €0.08
*** SHOW DOWN ***
buscofan: shows [4d 8d] (a straight, Nine to King)
stefano997: shows [6h Ah] (a straight, Ten to Ace)
stefano997 collected €0.23 from pot
*** SUMMARY ***
Total pot €0.24 | Rake €0.01 
Board [Qh 9s Kd Js Td]
Seat 1: ADRIAN0_MEIS (button) folded before Flop (didn't bet)
Seat 2: stefano997 (small blind) showed [6h Ah] and won (€0.23) with a straight, Ten to Ace
Seat 3: buscofan (big blind) showed [4d 8d] and lost with a straight, Nine to King
Seat 4: caduceus369 folded before Flop (didn't bet)
Seat 5: ghosto69 folded before Flop (didn't bet)
Seat 6: lucpri folded before Flop (didn't bet)



PokerStars Zoom Hand #257998796374:  Hold'em No Limit (€0.01/€0.02) [ADM ID: M62BD3044A1E13PD] - 2025/10/04 21:23:50 CET [2025/10/04 15:23:50 ET]
Table 'Sirio' 6-max Seat #1 is the button
Seat 1: gigiriver170 (€1.62 in chips) 
Seat 2: pietr056 (€0.96 in chips) 
Seat 3: bruciapelo (€4.74 in chips) 
Seat 4: Gabrielefante (€5.27 in chips) 
Seat 5: caduceus369 (€2.56 in chips) 
Seat 6: RRsanto (€2.42 in chips) 
pietr056: posts small blind €0.01
bruciapelo: posts big blind €0.02
*** HOLE CARDS ***
Dealt to caduceus369 [2s 8s]
Gabrielefante: folds 
caduceus369: folds 
RRsanto: folds 
gigiriver170: folds 
pietr056: folds 
Uncalled bet (€0.01) returned to bruciapelo
bruciapelo collected €0.02 from pot
bruciapelo: doesn't show hand 
*** SUMMARY ***
Total pot €0.02 | Rake €0 
Seat 1: gigiriver170 (button) folded before Flop (didn't bet)
Seat 2: pietr056 (small blind) folded before Flop
Seat 3: bruciapelo (big blind) collected (€0.02)
Seat 4: Gabrielefante folded before Flop (didn't bet)
Seat 5: caduceus369 folded before Flop (didn't bet)
Seat 6: RRsanto folded before Flop (didn't bet)



PokerStars Zoom Hand #257998792630:  Hold'em No Limit (€0.01/€0.02) [ADM ID: M62BD3044A1E13PD] - 2025/10/04 21:23:34 CET [2025/10/04 15:23:34 ET]
Table 'Sirio' 6-max Seat #1 is the button
Seat 1: ghosto69 (€0.87 in chips) 
Seat 2: caduceus369 (€2.57 in chips) 
Seat 3: RRsanto (€2.45 in chips) 
Seat 4: GanchanS7 (€4.65 in chips) 
Seat 5: kAllSeMPRE73 (€2.05 in chips) 
Seat 6: ADRIAN0_MEIS (€2.81 in chips) 
caduceus369: posts small blind €0.01
RRsanto: posts big blind €0.02
*** HOLE CARDS ***
Dealt to caduceus369 [5h 4d]
GanchanS7: raises €0.03 to €0.05
kAllSeMPRE73: calls €0.05
ADRIAN0_MEIS: calls €0.05
ghosto69: calls €0.05
caduceus369: folds 
RRsanto: folds 
*** FLOP *** [6s 5c 6d]
GanchanS7: checks 
kAllSeMPRE73: checks 
ADRIAN0_MEIS: checks 
ghosto69: checks 
*** TURN *** [6s 5c 6d] [4s]
GanchanS7: bets €0.06
kAllSeMPRE73: calls €0.06
ADRIAN0_MEIS: folds 
ghosto69: calls €0.06
*** RIVER *** [6s 5c 6d 4s] [3h]
GanchanS7: checks 
kAllSeMPRE73: checks 
ghosto69: checks 
*** SHOW DOWN ***
GanchanS7: shows [9h 9d] (two pair, Nines and Sixes)
kAllSeMPRE73: mucks hand 
ghosto69: mucks hand 
GanchanS7 collected €0.39 from pot
*** SUMMARY ***
Total pot €0.41 | Rake €0.02 
Board [6s 5c 6d 4s 3h]
Seat 1: ghosto69 (button) mucked [8h Ah]
Seat 2: caduceus369 (small blind) folded before Flop
Seat 3: RRsanto (big blind) folded before Flop
Seat 4: GanchanS7 showed [9h 9d] and won (€0.39) with two pair, Nines and Sixes
Seat 5: kAllSeMPRE73 mucked [Ad Th]
Seat 6: ADRIAN0_MEIS folded on the Turn



PokerStars Zoom Hand #257998798067:  Hold'em No Limit (€0.01/€0.02) [ADM ID: M62BD3044A1E13PD] - 2025/10/04 21:23:57 CET [2025/10/04 15:23:57 ET]
Table 'Sirio' 6-max Seat #1 is the button
Seat 1: caduceus369 (€2.56 in chips) 
Seat 2: GanchanS7 (€2.03 in chips) 
Seat 3: zicky78.r (€2 in chips) 
Seat 4: stefano997 (€1.47 in chips) 
Seat 5: lucpri (€1.67 in chips) 
Seat 6: buscofan (€3.33 in chips) 
GanchanS7: posts small blind €0.01
zicky78.r: posts big blind €0.02
*** HOLE CARDS ***
Dealt to caduceus369 [9h Kd]
stefano997: folds 
lucpri: folds 
buscofan: raises €0.04 to €0.06
caduceus369: raises €0.12 to €0.18
GanchanS7: folds 
zicky78.r: folds 
buscofan: folds 
Uncalled bet (€0.12) returned to caduceus369
caduceus369 collected €0.15 from pot
caduceus369: doesn't show hand 
*** SUMMARY ***
Total pot €0.15 | Rake €0 
Seat 1: caduceus369 (button) collected (€0.15)
Seat 2: GanchanS7 (small blind) folded before Flop
Seat 3: zicky78.r (big blind) folded before Flop
Seat 4: stefano997 folded before Flop (didn't bet)
Seat 5: lucpri folded before Flop (didn't bet)
Seat 6: buscofan folded before Flop



PokerStars Zoom Hand #257998806124:  Hold'em No Limit (€0.01/€0.02) [ADM ID: M62BD3044A1E13PD] - 2025/10/04 21:24:32 CET [2025/10/04 15:24:32 ET]
Table 'Sirio' 6-max Seat #1 is the button
Seat 1: eleonora50 (€1.82 in chips) 
Seat 2: CARAPIGNA (€1.26 in chips) 
Seat 3: RRsanto (€2 in chips) 
Seat 4: caduceus369 (€2.65 in chips) 
Seat 5: ADRIAN0_MEIS (€2.38 in chips) 
Seat 6: GanchanS7 (€3.28 in chips) 
CARAPIGNA: posts small blind €0.01
RRsanto: posts big blind €0.02
*** HOLE CARDS ***
Dealt to caduceus369 [Ac Qh]
caduceus369: raises €0.04 to €0.06
ADRIAN0_MEIS: folds 
GanchanS7: folds 
eleonora50: folds 
CARAPIGNA: folds 
RRsanto: folds 
Uncalled bet (€0.04) returned to caduceus369
caduceus369 collected €0.05 from pot
caduceus369: doesn't show hand 
*** SUMMARY ***
Total pot €0.05 | Rake €0 
Seat 1: eleonora50 (button) folded before Flop (didn't bet)
Seat 2: CARAPIGNA (small blind) folded before Flop
Seat 3: RRsanto (big blind) folded before Flop
Seat 4: caduceus369 collected (€0.05)
Seat 5: ADRIAN0_MEIS folded before Flop (didn't bet)
Seat 6: GanchanS7 folded before Flop (didn't bet)



PokerStars Zoom Hand #257998809367:  Hold'em No Limit (€0.01/€0.02) [ADM ID: M62BD3044A1E13PD] - 2025/10/04 21:24:46 CET [2025/10/04 15:24:46 ET]
Table 'Sirio' 6-max Seat #1 is the button
Seat 1: buscofan (€3.26 in chips) 
Seat 2: GanchanS7 (€3.28 in chips) 
Seat 3: caduceus369 (€2.68 in chips) 
Seat 4: RRsanto (€2.36 in chips) 
Seat 5: Kazzimmino (€2.08 in chips) 
Seat 6: gigiriver170 (€1.65 in chips) 
GanchanS7: posts small blind €0.01
caduceus369: posts big blind €0.02
*** HOLE CARDS ***
Dealt to caduceus369 [6h Kd]
RRsanto: folds 
Kazzimmino: raises €0.06 to €0.08
gigiriver170: folds 
buscofan: folds 
GanchanS7: folds 
caduceus369: folds 
Uncalled bet (€0.06) returned to Kazzimmino
Kazzimmino collected €0.05 from pot
Kazzimmino: doesn't show hand 
*** SUMMARY ***
Total pot €0.05 | Rake €0 
Seat 1: buscofan (button) folded before Flop (didn't bet)
Seat 2: GanchanS7 (small blind) folded before Flop
Seat 3: caduceus369 (big blind) folded before Flop
Seat 4: RRsanto folded before Flop (didn't bet)
Seat 5: Kazzimmino collected (€0.05)
Seat 6: gigiriver170 folded before Flop (didn't bet)



PokerStars Zoom Hand #257998811589:  Hold'em No Limit (€0.01/€0.02) [ADM ID: M62BD3044A1E13PD] - 2025/10/04 21:24:56 CET [2025/10/04 15:24:56 ET]
Table 'Sirio' 6-max Seat #1 is the button
Seat 1: bruciapelo (€4.74 in chips) 
Seat 2: ADRIAN0_MEIS (€2.39 in chips) 
Seat 3: buscofan (€3.26 in chips) 
Seat 4: GanchanS7 (€2.63 in chips) 
Seat 5: caduceus369 (€2.66 in chips) 
Seat 6: RRsanto (€2.35 in chips) 
ADRIAN0_MEIS: posts small blind €0.01
buscofan: posts big blind €0.02
*** HOLE CARDS ***
Dealt to caduceus369 [6s Jh]
GanchanS7: folds 
caduceus369: folds 
RRsanto: folds 
bruciapelo: folds 
ADRIAN0_MEIS: folds 
Uncalled bet (€0.01) returned to buscofan
buscofan collected €0.02 from pot
buscofan: doesn't show hand 
*** SUMMARY ***
Total pot €0.02 | Rake €0 
Seat 1: bruciapelo (button) folded before Flop (didn't bet)
Seat 2: ADRIAN0_MEIS (small blind) folded before Flop
Seat 3: buscofan (big blind) collected (€0.02)
Seat 4: GanchanS7 folded before Flop (didn't bet)
Seat 5: caduceus369 folded before Flop (didn't bet)
Seat 6: RRsanto folded before Flop (didn't bet)



PokerStars Zoom Hand #257998815720:  Hold'em No Limit (€0.01/€0.02) [ADM ID: M62BD3044A1E13PD] - 2025/10/04 21:25:14 CET [2025/10/04 15:25:14 ET]
Table 'Sirio' 6-max Seat #1 is the button
Seat 1: caduceus369 (€2.65 in chips) 
Seat 2: buscofan (€3.27 in chips) 
Seat 3: CIKO71131 (€0.71 in chips) 
Seat 4: zicky78.r (€2.12 in chips) 
Seat 5: Mila727 (€1.94 in chips) 
Seat 6: N0thingforU (€5.57 in chips) 
buscofan: posts small blind €0.01
CIKO71131: posts big blind €0.02
*** HOLE CARDS ***
Dealt to caduceus369 [2d 9s]
zicky78.r: folds 
Mila727: folds 
N0thingforU: folds 
caduceus369: folds 
buscofan: folds 
Uncalled bet (€0.01) returned to CIKO71131
CIKO71131 collected €0.02 from pot
CIKO71131: doesn't show hand 
*** SUMMARY ***
Total pot €0.02 | Rake €0 
Seat 1: caduceus369 (button) folded before Flop (didn't bet)
Seat 2: buscofan (small blind) folded before Flop
Seat 3: CIKO71131 (big blind) collected (€0.02)
Seat 4: zicky78.r folded before Flop (didn't bet)
Seat 5: Mila727 folded before Flop (didn't bet)
Seat 6: N0thingforU folded before Flop (didn't bet)



PokerStars Zoom Hand #257998812735:  Hold'em No Limit (€0.01/€0.02) [ADM ID: M62BD3044A1E13PD] - 2025/10/04 21:25:01 CET [2025/10/04 15:25:01 ET]
Table 'Sirio' 6-max Seat #1 is the button
Seat 1: ADRIAN0_MEIS (€2.73 in chips) 
Seat 2: caduceus369 (€2.66 in chips) 
Seat 3: pietr056 (€0.89 in chips) 
Seat 4: zicky78.r (€2.02 in chips) 
Seat 5: OSPREYSTORM (€2 in chips) 
Seat 6: GanchanS7 (€2 in chips) 
caduceus369: posts small blind €0.01
pietr056: posts big blind €0.02
*** HOLE CARDS ***
Dealt to caduceus369 [Qs 4c]
zicky78.r: calls €0.02
OSPREYSTORM: folds 
GanchanS7: folds 
ADRIAN0_MEIS: raises €0.05 to €0.07
caduceus369: folds 
pietr056: raises €0.17 to €0.24
zicky78.r: folds 
ADRIAN0_MEIS: raises €2.49 to €2.73 and is all-in
pietr056: calls €0.65 and is all-in
Uncalled bet (€1.84) returned to ADRIAN0_MEIS
*** FLOP *** [6h 2d 7c]
*** TURN *** [6h 2d 7c] [Jh]
*** RIVER *** [6h 2d 7c Jh] [2h]
*** SHOW DOWN ***
pietr056: shows [As Ks] (a pair of Deuces)
ADRIAN0_MEIS: shows [9d 9s] (two pair, Nines and Deuces)
ADRIAN0_MEIS collected €1.72 from pot
*** SUMMARY ***
Total pot €1.81 | Rake €0.09 
Board [6h 2d 7c Jh 2h]
Seat 1: ADRIAN0_MEIS (button) showed [9d 9s] and won (€1.72) with two pair, Nines and Deuces
Seat 2: caduceus369 (small blind) folded before Flop
Seat 3: pietr056 (big blind) showed [As Ks] and lost with a pair of Deuces
Seat 4: zicky78.r folded before Flop
Seat 5: OSPREYSTORM folded before Flop (didn't bet)
Seat 6: GanchanS7 folded before Flop (didn't bet)



PokerStars Zoom Hand #257998816841:  Hold'em No Limit (€0.01/€0.02) [ADM ID: M62BD3044A1E13PD] - 2025/10/04 21:25:19 CET [2025/10/04 15:25:19 ET]
Table 'Sirio' 6-max Seat #1 is the button
Seat 1: OSPREYSTORM (€1.92 in chips) 
Seat 2: GanchanS7 (€2 in chips) 
Seat 3: caduceus369 (€2.65 in chips) 
Seat 4: ADRIAN0_MEIS (€2.18 in chips) 
Seat 5: RRsanto (€2.33 in chips) 
Seat 6: Lori241 (€0.87 in chips) 
GanchanS7: posts small blind €0.01
caduceus369: posts big blind €0.02
*** HOLE CARDS ***
Dealt to caduceus369 [Ac Qh]
ADRIAN0_MEIS: folds 
RRsanto: folds 
Lori241: folds 
OSPREYSTORM: folds 
GanchanS7: folds 
Uncalled bet (€0.01) returned to caduceus369
caduceus369 collected €0.02 from pot
caduceus369: doesn't show hand 
*** SUMMARY ***
Total pot €0.02 | Rake €0 
Seat 1: OSPREYSTORM (button) folded before Flop (didn't bet)
Seat 2: GanchanS7 (small blind) folded before Flop
Seat 3: caduceus369 (big blind) collected (€0.02)
Seat 4: ADRIAN0_MEIS folded before Flop (didn't bet)
Seat 5: RRsanto folded before Flop (didn't bet)
Seat 6: Lori241 folded before Flop (didn't bet)



PokerStars Zoom Hand #257998814548:  Hold'em No Limit (€0.01/€0.02) [ADM ID: M62BD3044A1E13PD] - 2025/10/04 21:25:09 CET [2025/10/04 15:25:09 ET]
Table 'Sirio' 6-max Seat #1 is the button
Seat 1: CIKO71131 (€0.89 in chips) 
Seat 2: gigiriver170 (€1.66 in chips) 
Seat 3: RRsanto (€2.35 in chips) 
Seat 4: N0thingforU (€5.57 in chips) 
Seat 5: buscofan (€3.27 in chips) 
Seat 6: caduceus369 (€2.65 in chips) 
gigiriver170: posts small blind €0.01
RRsanto: posts big blind €0.02
*** HOLE CARDS ***
Dealt to caduceus369 [6c 7d]
N0thingforU: folds 
buscofan: folds 
caduceus369: folds 
CIKO71131: calls €0.02
gigiriver170: raises €0.04 to €0.06
RRsanto: folds 
CIKO71131: calls €0.04
*** FLOP *** [6s Ah 6d]
gigiriver170: checks 
CIKO71131: checks 
*** TURN *** [6s Ah 6d] [Th]
gigiriver170: checks 
CIKO71131: bets €0.04
gigiriver170: folds 
Uncalled bet (€0.04) returned to CIKO71131
CIKO71131 collected €0.14 from pot
CIKO71131: doesn't show hand 
*** SUMMARY ***
Total pot €0.14 | Rake €0 
Board [6s Ah 6d Th]
Seat 1: CIKO71131 (button) collected (€0.14)
Seat 2: gigiriver170 (small blind) folded on the Turn
Seat 3: RRsanto (big blind) folded before Flop
Seat 4: N0thingforU folded before Flop (didn't bet)
Seat 5: buscofan folded before Flop (didn't bet)
Seat 6: caduceus369 folded before Flop (didn't bet)



PokerStars Zoom Hand #257998822099:  Hold'em No Limit (€0.01/€0.02) [ADM ID: M62BD3044A1E13PD] - 2025/10/04 21:25:42 CET [2025/10/04 15:25:42 ET]
Table 'Sirio' 6-max Seat #1 is the button
Seat 1: bruciapelo (€4.76 in chips) 
Seat 2: GanchanS7 (€3.25 in chips) 
Seat 3: ghosto69 (€5.31 in chips) 
Seat 4: caduceus369 (€2.66 in chips) 
Seat 5: pylonstrip (€4.51 in chips) 
Seat 6: ADRIAN0_MEIS (€2.41 in chips) 
GanchanS7: posts small blind €0.01
ghosto69: posts big blind €0.02
*** HOLE CARDS ***
Dealt to caduceus369 [Ts 7d]
caduceus369: folds 
pylonstrip: raises €0.02 to €0.04
ADRIAN0_MEIS: raises €0.11 to €0.15
bruciapelo: folds 
GanchanS7: folds 
ghosto69: folds 
pylonstrip: calls €0.11
*** FLOP *** [7s Tc Qc]
pylonstrip: checks 
ADRIAN0_MEIS: bets €0.24
pylonstrip: folds 
Uncalled bet (€0.24) returned to ADRIAN0_MEIS
ADRIAN0_MEIS collected €0.32 from pot
ADRIAN0_MEIS: doesn't show hand 
*** SUMMARY ***
Total pot €0.33 | Rake €0.01 
Board [7s Tc Qc]
Seat 1: bruciapelo (button) folded before Flop (didn't bet)
Seat 2: GanchanS7 (small blind) folded before Flop
Seat 3: ghosto69 (big blind) folded before Flop
Seat 4: caduceus369 folded before Flop (didn't bet)
Seat 5: pylonstrip folded on the Flop
Seat 6: ADRIAN0_MEIS collected (€0.32)



PokerStars Zoom Hand #257998827295:  Hold'em No Limit (€0.01/€0.02) [ADM ID: M62BD3044A1E13PD] - 2025/10/04 21:26:04 CET [2025/10/04 15:26:04 ET]
Table 'Sirio' 6-max Seat #1 is the button
Seat 1: ghosto69 (€5.28 in chips) 
Seat 2: zicky78.r (€2.08 in chips) 
Seat 3: trillycata (€0.91 in chips) 
Seat 4: RRsanto (€2.44 in chips) 
Seat 5: caduceus369 (€2.66 in chips) 
Seat 6: OSPREYSTORM (€2 in chips) 
zicky78.r: posts small blind €0.01
trillycata: posts big blind €0.02
*** HOLE CARDS ***
Dealt to caduceus369 [4d As]
RRsanto: folds 
caduceus369: raises €0.04 to €0.06
OSPREYSTORM: folds 
ghosto69: folds 
zicky78.r: folds 
trillycata: folds 
Uncalled bet (€0.04) returned to caduceus369
caduceus369 collected €0.05 from pot
caduceus369: doesn't show hand 
*** SUMMARY ***
Total pot €0.05 | Rake €0 
Seat 1: ghosto69 (button) folded before Flop (didn't bet)
Seat 2: zicky78.r (small blind) folded before Flop
Seat 3: trillycata (big blind) folded before Flop
Seat 4: RRsanto folded before Flop (didn't bet)
Seat 5: caduceus369 collected (€0.05)
Seat 6: OSPREYSTORM folded before Flop (didn't bet)



PokerStars Zoom Hand #257998823319:  Hold'em No Limit (€0.01/€0.02) [ADM ID: M62BD3044A1E13PD] - 2025/10/04 21:25:47 CET [2025/10/04 15:25:47 ET]
Table 'Sirio' 6-max Seat #1 is the button
Seat 1: GanchanS7 (€2 in chips) 
Seat 2: OSPREYSTORM (€2.01 in chips) 
Seat 3: kAllSeMPRE73 (€2.01 in chips) 
Seat 4: ADRIAN0_MEIS (€4.04 in chips) 
Seat 5: CARAPIGNA (€1.21 in chips) 
Seat 6: caduceus369 (€2.66 in chips) 
OSPREYSTORM: posts small blind €0.01
kAllSeMPRE73: posts big blind €0.02
*** HOLE CARDS ***
Dealt to caduceus369 [8h 2d]
ADRIAN0_MEIS: folds 
CARAPIGNA: calls €0.02
caduceus369: folds 
GanchanS7: folds 
OSPREYSTORM: folds 
kAllSeMPRE73: checks 
*** FLOP *** [Ks 3s 4h]
kAllSeMPRE73: bets €0.02
CARAPIGNA: calls €0.02
*** TURN *** [Ks 3s 4h] [2h]
kAllSeMPRE73: bets €0.02
CARAPIGNA: calls €0.02
*** RIVER *** [Ks 3s 4h 2h] [9d]
kAllSeMPRE73: bets €0.02
CARAPIGNA: folds 
Uncalled bet (€0.02) returned to kAllSeMPRE73
kAllSeMPRE73 collected €0.13 from pot
kAllSeMPRE73: doesn't show hand 
*** SUMMARY ***
Total pot €0.13 | Rake €0 
Board [Ks 3s 4h 2h 9d]
Seat 1: GanchanS7 (button) folded before Flop (didn't bet)
Seat 2: OSPREYSTORM (small blind) folded before Flop
Seat 3: kAllSeMPRE73 (big blind) collected (€0.13)
Seat 4: ADRIAN0_MEIS folded before Flop (didn't bet)
Seat 5: CARAPIGNA folded on the River
Seat 6: caduceus369 folded before Flop (didn't bet)



PokerStars Zoom Hand #257998831928:  Hold'em No Limit (€0.01/€0.02) [ADM ID: M62BD3044A1E13PD] - 2025/10/04 21:26:24 CET [2025/10/04 15:26:24 ET]
Table 'Sirio' 6-max Seat #1 is the button
Seat 1: lupocane (€3.19 in chips) 
Seat 2: caduceus369 (€2.69 in chips) 
Seat 3: OSPREYSTORM (€1.99 in chips) 
Seat 4: zicky78.r (€2 in chips) 
Seat 5: ghosto69 (€5.28 in chips) 
Seat 6: Kingo690 (€0.80 in chips) 
caduceus369: posts small blind €0.01
OSPREYSTORM: posts big blind €0.02
*** HOLE CARDS ***
Dealt to caduceus369 [7c 6c]
zicky78.r: folds 
ghosto69: folds 
Kingo690: raises €0.04 to €0.06
lupocane: folds 
caduceus369: folds 
OSPREYSTORM: folds 
Uncalled bet (€0.04) returned to Kingo690
Kingo690 collected €0.05 from pot
Kingo690: doesn't show hand 
*** SUMMARY ***
Total pot €0.05 | Rake €0 
Seat 1: lupocane (button) folded before Flop (didn't bet)
Seat 2: caduceus369 (small blind) folded before Flop
Seat 3: OSPREYSTORM (big blind) folded before Flop
Seat 4: zicky78.r folded before Flop (didn't bet)
Seat 5: ghosto69 folded before Flop (didn't bet)
Seat 6: Kingo690 collected (€0.05)



PokerStars Zoom Hand #257998835305:  Hold'em No Limit (€0.01/€0.02) [ADM ID: M62BD3044A1E13PD] - 2025/10/04 21:26:39 CET [2025/10/04 15:26:39 ET]
Table 'Sirio' 6-max Seat #1 is the button
Seat 1: zicky78.r (€2.05 in chips) 
Seat 2: OSPREYSTORM (€1.97 in chips) 
Seat 3: Gabrielefante (€5.74 in chips) 
Seat 4: RRsanto (€2.42 in chips) 
Seat 5: caduceus369 (€2.68 in chips) 
Seat 6: ghosto69 (€0.64 in chips) 
OSPREYSTORM: posts small blind €0.01
Gabrielefante: posts big blind €0.02
*** HOLE CARDS ***
Dealt to caduceus369 [Jd Qc]
RRsanto: folds 
caduceus369: raises €0.04 to €0.06
ghosto69: folds 
zicky78.r: folds 
OSPREYSTORM: calls €0.05
Gabrielefante: calls €0.04
*** FLOP *** [4d Kc 9d]
OSPREYSTORM: checks 
Gabrielefante: checks 
caduceus369: bets €0.06
OSPREYSTORM: folds 
Gabrielefante: folds 
Uncalled bet (€0.06) returned to caduceus369
caduceus369 collected €0.18 from pot
caduceus369: doesn't show hand 
*** SUMMARY ***
Total pot €0.18 | Rake €0 
Board [4d Kc 9d]
Seat 1: zicky78.r (button) folded before Flop (didn't bet)
Seat 2: OSPREYSTORM (small blind) folded on the Flop
Seat 3: Gabrielefante (big blind) folded on the Flop
Seat 4: RRsanto folded before Flop (didn't bet)
Seat 5: caduceus369 collected (€0.18)
Seat 6: ghosto69 folded before Flop (didn't bet)



PokerStars Zoom Hand #257998850131:  Hold'em No Limit (€0.01/€0.02) [ADM ID: M62BD3044A1E13PD] - 2025/10/04 21:27:43 CET [2025/10/04 15:27:43 ET]
Table 'Sirio' 6-max Seat #1 is the button
Seat 1: lupocane (€3.28 in chips) 
Seat 2: zicky78.r (€2 in chips) 
Seat 3: caduceus369 (€2.80 in chips) 
Seat 4: Wunschgast (€6.15 in chips) 
Seat 5: ghosto69 (€0.64 in chips) 
Seat 6: trillycata (€0.90 in chips) 
zicky78.r: posts small blind €0.01
caduceus369: posts big blind €0.02
*** HOLE CARDS ***
Dealt to caduceus369 [4s Jd]
Wunschgast: folds 
ghosto69: folds 
trillycata: folds 
lupocane: raises €0.05 to €0.07
zicky78.r: folds 
caduceus369: folds 
Uncalled bet (€0.05) returned to lupocane
lupocane collected €0.05 from pot
lupocane: doesn't show hand 
*** SUMMARY ***
Total pot €0.05 | Rake €0 
Seat 1: lupocane (button) collected (€0.05)
Seat 2: zicky78.r (small blind) folded before Flop
Seat 3: caduceus369 (big blind) folded before Flop
Seat 4: Wunschgast folded before Flop (didn't bet)
Seat 5: ghosto69 folded before Flop (didn't bet)
Seat 6: trillycata folded before Flop (didn't bet)



PokerStars Zoom Hand #257998852977:  Hold'em No Limit (€0.01/€0.02) [ADM ID: M62BD3044A1E13PD] - 2025/10/04 21:27:55 CET [2025/10/04 15:27:55 ET]
Table 'Sirio' 6-max Seat #1 is the button
Seat 1: caduceus369 (€2.78 in chips) 
Seat 2: gigiriver170 (€1.54 in chips) 
Seat 3: OSPREYSTORM (€1.97 in chips) 
Seat 4: ADRIAN0_MEIS (€2.05 in chips) 
Seat 5: RRsanto (€2.11 in chips) 
Seat 6: zicky78.r (€2.10 in chips) 
gigiriver170: posts small blind €0.01
OSPREYSTORM: posts big blind €0.02
*** HOLE CARDS ***
Dealt to caduceus369 [7h 6h]
ADRIAN0_MEIS: folds 
RRsanto: folds 
zicky78.r: raises €0.02 to €0.04
caduceus369: calls €0.04
gigiriver170: calls €0.03
OSPREYSTORM: folds 
*** FLOP *** [Tc 3c 7d]
gigiriver170: bets €0.07
zicky78.r: folds 
caduceus369: folds 
Uncalled bet (€0.07) returned to gigiriver170
gigiriver170 collected €0.14 from pot
gigiriver170: doesn't show hand 
*** SUMMARY ***
Total pot €0.14 | Rake €0 
Board [Tc 3c 7d]
Seat 1: caduceus369 (button) folded on the Flop
Seat 2: gigiriver170 (small blind) collected (€0.14)
Seat 3: OSPREYSTORM (big blind) folded before Flop
Seat 4: ADRIAN0_MEIS folded before Flop (didn't bet)
Seat 5: RRsanto folded before Flop (didn't bet)
Seat 6: zicky78.r folded on the Flop



PokerStars Zoom Hand #257998861185:  Hold'em No Limit (€0.01/€0.02) [ADM ID: M62BD3044A1E13PD] - 2025/10/04 21:28:31 CET [2025/10/04 15:28:31 ET]
Table 'Sirio' 6-max Seat #1 is the button
Seat 1: GanchanS7 (€3.22 in chips) 
Seat 2: caduceus369 (€2.74 in chips) 
Seat 3: OSPREYSTORM (€2 in chips) 
Seat 4: RRsanto (€2.99 in chips) 
Seat 5: Kazzimmino (€1.97 in chips) 
Seat 6: Gabrielefante (€5.76 in chips) 
caduceus369: posts small blind €0.01
OSPREYSTORM: posts big blind €0.02
*** HOLE CARDS ***
Dealt to caduceus369 [9h Qd]
RRsanto: folds 
Kazzimmino: folds 
Gabrielefante: folds 
GanchanS7: folds 
caduceus369: folds 
Uncalled bet (€0.01) returned to OSPREYSTORM
OSPREYSTORM collected €0.02 from pot
OSPREYSTORM: doesn't show hand 
*** SUMMARY ***
Total pot €0.02 | Rake €0 
Seat 1: GanchanS7 (button) folded before Flop (didn't bet)
Seat 2: caduceus369 (small blind) folded before Flop
Seat 3: OSPREYSTORM (big blind) collected (€0.02)
Seat 4: RRsanto folded before Flop (didn't bet)
Seat 5: Kazzimmino folded before Flop (didn't bet)
Seat 6: Gabrielefante folded before Flop (didn't bet)



PokerStars Zoom Hand #257998862771:  Hold'em No Limit (€0.01/€0.02) [ADM ID: M62BD3044A1E13PD] - 2025/10/04 21:28:38 CET [2025/10/04 15:28:38 ET]
Table 'Sirio' 6-max Seat #1 is the button
Seat 1: zicky78.r (€2 in chips) 
Seat 2: RRsanto (€2.99 in chips) 
Seat 3: Asso77407 (€0.80 in chips) 
Seat 4: Robycastel89 (€0.29 in chips) 
Seat 5: ADRIAN0_MEIS (€3.86 in chips) 
Seat 6: caduceus369 (€2.73 in chips) 
RRsanto: posts small blind €0.01
Asso77407: posts big blind €0.02
*** HOLE CARDS ***
Dealt to caduceus369 [8h As]
Robycastel89: raises €0.27 to €0.29 and is all-in
ADRIAN0_MEIS: folds 
caduceus369: folds 
zicky78.r: calls €0.29
RRsanto: folds 
Asso77407: folds 
*** FLOP *** [9s 7h 6h]
*** TURN *** [9s 7h 6h] [9h]
*** RIVER *** [9s 7h 6h 9h] [Kh]
*** SHOW DOWN ***
Robycastel89: shows [5s Th] (a flush, King high)
zicky78.r: shows [9c 9d] (four of a kind, Nines)
zicky78.r collected €0.58 from pot
*** SUMMARY ***
Total pot €0.61 | Rake €0.03 
Board [9s 7h 6h 9h Kh]
Seat 1: zicky78.r (button) showed [9c 9d] and won (€0.58) with four of a kind, Nines
Seat 2: RRsanto (small blind) folded before Flop
Seat 3: Asso77407 (big blind) folded before Flop
Seat 4: Robycastel89 showed [5s Th] and lost with a flush, King high
Seat 5: ADRIAN0_MEIS folded before Flop (didn't bet)
Seat 6: caduceus369 folded before Flop (didn't bet)



PokerStars Zoom Hand #257998860018:  Hold'em No Limit (€0.01/€0.02) [ADM ID: M62BD3044A1E13PD] - 2025/10/04 21:28:26 CET [2025/10/04 15:28:26 ET]
Table 'Sirio' 6-max Seat #1 is the button
Seat 1: andree128 (€2.04 in chips) 
Seat 2: zicky78.r (€2 in chips) 
Seat 3: lupocane (€3.30 in chips) 
Seat 4: RRsanto (€2.99 in chips) 
Seat 5: caduceus369 (€2.74 in chips) 
Seat 6: OSPREYSTORM (€1.94 in chips) 
zicky78.r: posts small blind €0.01
lupocane: posts big blind €0.02
*** HOLE CARDS ***
Dealt to caduceus369 [8s 3s]
RRsanto: folds 
caduceus369: folds 
OSPREYSTORM: folds 
andree128: raises €0.02 to €0.04
zicky78.r: folds 
lupocane: calls €0.02
*** FLOP *** [7h Ac 2d]
lupocane: checks 
andree128: bets €0.04
lupocane: raises €0.08 to €0.12
andree128: folds 
Uncalled bet (€0.08) returned to lupocane
lupocane collected €0.17 from pot
lupocane: doesn't show hand 
*** SUMMARY ***
Total pot €0.17 | Rake €0 
Board [7h Ac 2d]
Seat 1: andree128 (button) folded on the Flop
Seat 2: zicky78.r (small blind) folded before Flop
Seat 3: lupocane (big blind) collected (€0.17)
Seat 4: RRsanto folded before Flop (didn't bet)
Seat 5: caduceus369 folded before Flop (didn't bet)
Seat 6: OSPREYSTORM folded before Flop (didn't bet)



PokerStars Zoom Hand #257998865093:  Hold'em No Limit (€0.01/€0.02) [ADM ID: M62BD3044A1E13PD] - 2025/10/04 21:28:48 CET [2025/10/04 15:28:48 ET]
Table 'Sirio' 6-max Seat #1 is the button
Seat 1: RRsanto (€2.98 in chips) 
Seat 2: Gabrielefante (€5.77 in chips) 
Seat 3: GanchanS7 (€5.22 in chips) 
Seat 4: caduceus369 (€2.73 in chips) 
Seat 5: ADRIAN0_MEIS (€3.98 in chips) 
Seat 6: OSPREYSTORM (€1.99 in chips) 
Gabrielefante: posts small blind €0.01
GanchanS7: posts big blind €0.02
*** HOLE CARDS ***
Dealt to caduceus369 [Qc Th]
caduceus369: folds 
ADRIAN0_MEIS: folds 
OSPREYSTORM: raises €0.04 to €0.06
RRsanto: raises €0.12 to €0.18
Gabrielefante: folds 
GanchanS7: folds 
OSPREYSTORM: folds 
Uncalled bet (€0.12) returned to RRsanto
RRsanto collected €0.15 from pot
RRsanto: doesn't show hand 
*** SUMMARY ***
Total pot €0.15 | Rake €0 
Seat 1: RRsanto (button) collected (€0.15)
Seat 2: Gabrielefante (small blind) folded before Flop
Seat 3: GanchanS7 (big blind) folded before Flop
Seat 4: caduceus369 folded before Flop (didn't bet)
Seat 5: ADRIAN0_MEIS folded before Flop (didn't bet)
Seat 6: OSPREYSTORM folded before Flop



PokerStars Zoom Hand #257998866594:  Hold'em No Limit (€0.01/€0.02) [ADM ID: M62BD3044A1E13PD] - 2025/10/04 21:28:55 CET [2025/10/04 15:28:55 ET]
Table 'Sirio' 6-max Seat #1 is the button
Seat 1: caduceus369 (€2.73 in chips) 
Seat 2: RRsanto (€2.06 in chips) 
Seat 3: cayman29 (€2 in chips) 
Seat 4: Kazzimmino (€1.95 in chips) 
Seat 5: ADRIAN0_MEIS (€3.86 in chips) 
Seat 6: Wunschgast (€6.10 in chips) 
RRsanto: posts small blind €0.01
cayman29: posts big blind €0.02
*** HOLE CARDS ***
Dealt to caduceus369 [Td Kc]
Kazzimmino: folds 
ADRIAN0_MEIS: folds 
Wunschgast: folds 
caduceus369: raises €0.04 to €0.06
RRsanto: raises €0.12 to €0.18
cayman29: folds 
caduceus369: calls €0.12
*** FLOP *** [9c Th 4s]
RRsanto: checks 
caduceus369: bets €0.18
RRsanto: folds 
Uncalled bet (€0.18) returned to caduceus369
caduceus369 collected €0.36 from pot
caduceus369: doesn't show hand 
*** SUMMARY ***
Total pot €0.38 | Rake €0.02 
Board [9c Th 4s]
Seat 1: caduceus369 (button) collected (€0.36)
Seat 2: RRsanto (small blind) folded on the Flop
Seat 3: cayman29 (big blind) folded before Flop
Seat 4: Kazzimmino folded before Flop (didn't bet)
Seat 5: ADRIAN0_MEIS folded before Flop (didn't bet)
Seat 6: Wunschgast folded before Flop (didn't bet)



PokerStars Zoom Hand #257998874800:  Hold'em No Limit (€0.01/€0.02) [ADM ID: M62BD3044A1E13PD] - 2025/10/04 21:29:30 CET [2025/10/04 15:29:30 ET]
Table 'Sirio' 6-max Seat #1 is the button
Seat 1: OSPREYSTORM (€1.91 in chips) 
Seat 2: CARAPIGNA (€1.01 in chips) 
Seat 3: GanchanS7 (€2.42 in chips) 
Seat 4: caduceus369 (€2.91 in chips) 
Seat 5: ADRIAN0_MEIS (€2.22 in chips) 
Seat 6: cayman29 (€2.02 in chips) 
CARAPIGNA: posts small blind €0.01
GanchanS7: posts big blind €0.02
*** HOLE CARDS ***
Dealt to caduceus369 [Ad 2s]
caduceus369: folds 
ADRIAN0_MEIS: folds 
cayman29: raises €0.03 to €0.05
OSPREYSTORM: folds 
CARAPIGNA: calls €0.04
GanchanS7: folds 
*** FLOP *** [7h 5s 9h]
CARAPIGNA: checks 
cayman29: bets €0.06
CARAPIGNA: folds 
Uncalled bet (€0.06) returned to cayman29
cayman29 collected €0.12 from pot
cayman29: doesn't show hand 
*** SUMMARY ***
Total pot €0.12 | Rake €0 
Board [7h 5s 9h]
Seat 1: OSPREYSTORM (button) folded before Flop (didn't bet)
Seat 2: CARAPIGNA (small blind) folded on the Flop
Seat 3: GanchanS7 (big blind) folded before Flop
Seat 4: caduceus369 folded before Flop (didn't bet)
Seat 5: ADRIAN0_MEIS folded before Flop (didn't bet)
Seat 6: cayman29 collected (€0.12)



PokerStars Zoom Hand #257998878801:  Hold'em No Limit (€0.01/€0.02) [ADM ID: M62BD3044A1E13PD] - 2025/10/04 21:29:48 CET [2025/10/04 15:29:48 ET]
Table 'Sirio' 6-max Seat #1 is the button
Seat 1: trillycata (€0.79 in chips) 
Seat 2: RRsanto (€3.10 in chips) 
Seat 3: caduceus369 (€2.91 in chips) 
Seat 4: benve15 (€0.74 in chips) 
Seat 5: GanchanS7 (€3.21 in chips) 
Seat 6: andree128 (€1.98 in chips) 
RRsanto: posts small blind €0.01
caduceus369: posts big blind €0.02
*** HOLE CARDS ***
Dealt to caduceus369 [Ks 4c]
benve15: folds 
GanchanS7: folds 
andree128: folds 
trillycata: folds 
RRsanto: raises €0.04 to €0.06
caduceus369: folds 
Uncalled bet (€0.04) returned to RRsanto
RRsanto collected €0.04 from pot
RRsanto: doesn't show hand 
*** SUMMARY ***
Total pot €0.04 | Rake €0 
Seat 1: trillycata (button) folded before Flop (didn't bet)
Seat 2: RRsanto (small blind) collected (€0.04)
Seat 3: caduceus369 (big blind) folded before Flop
Seat 4: benve15 folded before Flop (didn't bet)
Seat 5: GanchanS7 folded before Flop (didn't bet)
Seat 6: andree128 folded before Flop (didn't bet)



PokerStars Zoom Hand #257998876928:  Hold'em No Limit (€0.01/€0.02) [ADM ID: M62BD3044A1E13PD] - 2025/10/04 21:29:39 CET [2025/10/04 15:29:39 ET]
Table 'Sirio' 6-max Seat #1 is the button
Seat 1: zicky78.r (€2.10 in chips) 
Seat 2: GanchanS7 (€2.37 in chips) 
Seat 3: Giafatto 75 (€1.37 in chips) 
Seat 4: caduceus369 (€2.91 in chips) 
Seat 5: andree128 (€1.98 in chips) 
Seat 6: Kazzimmino (€2.01 in chips) 
GanchanS7: posts small blind €0.01
Giafatto 75: posts big blind €0.02
*** HOLE CARDS ***
Dealt to caduceus369 [8d Kh]
caduceus369: folds 
andree128: folds 
Kazzimmino: raises €0.06 to €0.08
zicky78.r: folds 
GanchanS7: folds 
Giafatto 75: calls €0.06
*** FLOP *** [Qd Qs 5c]
Giafatto 75: checks 
Kazzimmino: bets €0.10
Giafatto 75: folds 
Uncalled bet (€0.10) returned to Kazzimmino
Kazzimmino collected €0.17 from pot
Kazzimmino: doesn't show hand 
*** SUMMARY ***
Total pot €0.17 | Rake €0 
Board [Qd Qs 5c]
Seat 1: zicky78.r (button) folded before Flop (didn't bet)
Seat 2: GanchanS7 (small blind) folded before Flop
Seat 3: Giafatto 75 (big blind) folded on the Flop
Seat 4: caduceus369 folded before Flop (didn't bet)
Seat 5: andree128 folded before Flop (didn't bet)
Seat 6: Kazzimmino collected (€0.17)



PokerStars Zoom Hand #257998888169:  Hold'em No Limit (€0.01/€0.02) [ADM ID: M62BD3044A1E13PD] - 2025/10/04 21:30:27 CET [2025/10/04 15:30:27 ET]
Table 'Sirio' 6-max Seat #1 is the button
Seat 1: stefano997 (€0.58 in chips) 
Seat 2: Kazzimmino (€2.08 in chips) 
Seat 3: trillycata (€0.77 in chips) 
Seat 4: Gabrielefante (€5.93 in chips) 
Seat 5: pylonstrip (€4.13 in chips) 
Seat 6: caduceus369 (€2.88 in chips) 
Kazzimmino: posts small blind €0.01
trillycata: posts big blind €0.02
*** HOLE CARDS ***
Dealt to caduceus369 [Ks Jc]
Gabrielefante: folds 
pylonstrip: folds 
caduceus369: raises €0.04 to €0.06
stefano997: folds 
Kazzimmino: folds 
trillycata: folds 
Uncalled bet (€0.04) returned to caduceus369
caduceus369 collected €0.05 from pot
caduceus369: doesn't show hand 
*** SUMMARY ***
Total pot €0.05 | Rake €0 
Seat 1: stefano997 (button) folded before Flop (didn't bet)
Seat 2: Kazzimmino (small blind) folded before Flop
Seat 3: trillycata (big blind) folded before Flop
Seat 4: Gabrielefante folded before Flop (didn't bet)
Seat 5: pylonstrip folded before Flop (didn't bet)
Seat 6: caduceus369 collected (€0.05)



PokerStars Zoom Hand #257998882181:  Hold'em No Limit (€0.01/€0.02) [ADM ID: M62BD3044A1E13PD] - 2025/10/04 21:30:01 CET [2025/10/04 15:30:01 ET]
Table 'Sirio' 6-max Seat #1 is the button
Seat 1: GanchanS7 (€5.19 in chips) 
Seat 2: caduceus369 (€2.89 in chips) 
Seat 3: zicky78.r (€3.15 in chips) 
Seat 4: RRsanto (€2.01 in chips) 
Seat 5: Asso77407 (€0.55 in chips) 
Seat 6: ADRIAN0_MEIS (€3.10 in chips) 
caduceus369: posts small blind €0.01
zicky78.r: posts big blind €0.02
*** HOLE CARDS ***
Dealt to caduceus369 [7h 9d]
RRsanto: raises €0.04 to €0.06
Asso77407: folds 
ADRIAN0_MEIS: calls €0.06
GanchanS7: folds 
caduceus369: folds 
zicky78.r: folds 
*** FLOP *** [4c 8c 3d]
RRsanto: bets €0.08
ADRIAN0_MEIS: folds 
Uncalled bet (€0.08) returned to RRsanto
RRsanto collected €0.15 from pot
RRsanto: doesn't show hand 
*** SUMMARY ***
Total pot €0.15 | Rake €0 
Board [4c 8c 3d]
Seat 1: GanchanS7 (button) folded before Flop (didn't bet)
Seat 2: caduceus369 (small blind) folded before Flop
Seat 3: zicky78.r (big blind) folded before Flop
Seat 4: RRsanto collected (€0.15)
Seat 5: Asso77407 folded before Flop (didn't bet)
Seat 6: ADRIAN0_MEIS folded on the Flop



PokerStars Zoom Hand #257998891367:  Hold'em No Limit (€0.01/€0.02) [ADM ID: M62BD3044A1E13PD] - 2025/10/04 21:30:41 CET [2025/10/04 15:30:41 ET]
Table 'Sirio' 6-max Seat #1 is the button
Seat 1: therezin1989 (€1.93 in chips) 
Seat 2: trillycata (€0.75 in chips) 
Seat 3: caduceus369 (€2.91 in chips) 
Seat 4: stefano997 (€0.59 in chips) 
Seat 5: cayman29 (€2 in chips) 
Seat 6: GanchanS7 (€2.39 in chips) 
trillycata: posts small blind €0.01
caduceus369: posts big blind €0.02
*** HOLE CARDS ***
Dealt to caduceus369 [8d As]
stefano997: calls €0.02
cayman29: folds 
GanchanS7: folds 
therezin1989: folds 
trillycata: folds 
caduceus369: checks 
*** FLOP *** [Td 3s 3d]
caduceus369: checks 
stefano997: checks 
*** TURN *** [Td 3s 3d] [Ks]
caduceus369: bets €0.02
stefano997: calls €0.02
*** RIVER *** [Td 3s 3d Ks] [6h]
caduceus369: checks 
stefano997: bets €0.06
caduceus369: folds 
Uncalled bet (€0.06) returned to stefano997
stefano997 collected €0.09 from pot
stefano997: doesn't show hand 
*** SUMMARY ***
Total pot €0.09 | Rake €0 
Board [Td 3s 3d Ks 6h]
Seat 1: therezin1989 (button) folded before Flop (didn't bet)
Seat 2: trillycata (small blind) folded before Flop
Seat 3: caduceus369 (big blind) folded on the River
Seat 4: stefano997 collected (€0.09)
Seat 5: cayman29 folded before Flop (didn't bet)
Seat 6: GanchanS7 folded before Flop (didn't bet)



PokerStars Zoom Hand #257998898617:  Hold'em No Limit (€0.01/€0.02) [ADM ID: M62BD3044A1E13PD] - 2025/10/04 21:31:12 CET [2025/10/04 15:31:12 ET]
Table 'Sirio' 6-max Seat #1 is the button
Seat 1: caduceus369 (€2.87 in chips) 
Seat 2: ADRIAN0_MEIS (€3.02 in chips) 
Seat 3: RRsanto (€2.09 in chips) 
Seat 4: therezin1989 (€1.90 in chips) 
Seat 5: cucciolo4447 (€0.87 in chips) 
Seat 6: DAMPER_KK (€2 in chips) 
ADRIAN0_MEIS: posts small blind €0.01
RRsanto: posts big blind €0.02
*** HOLE CARDS ***
Dealt to caduceus369 [Js Jh]
therezin1989: folds 
cucciolo4447: folds 
DAMPER_KK: raises €0.05 to €0.07
caduceus369: raises €0.11 to €0.18
ADRIAN0_MEIS: folds 
RRsanto: folds 
DAMPER_KK: calls €0.11
*** FLOP *** [7d 8c Jd]
DAMPER_KK: checks 
caduceus369: bets €0.15
DAMPER_KK: calls €0.15
*** TURN *** [7d 8c Jd] [6h]
DAMPER_KK: checks 
caduceus369: bets €0.33
DAMPER_KK: calls €0.33
*** RIVER *** [7d 8c Jd 6h] [3s]
DAMPER_KK: checks 
caduceus369: bets €1.16
DAMPER_KK: folds 
Uncalled bet (€1.16) returned to caduceus369
caduceus369 collected €1.28 from pot
caduceus369: doesn't show hand 
*** SUMMARY ***
Total pot €1.35 | Rake €0.07 
Board [7d 8c Jd 6h 3s]
Seat 1: caduceus369 (button) collected (€1.28)
Seat 2: ADRIAN0_MEIS (small blind) folded before Flop
Seat 3: RRsanto (big blind) folded before Flop
Seat 4: therezin1989 folded before Flop (didn't bet)
Seat 5: cucciolo4447 folded before Flop (didn't bet)
Seat 6: DAMPER_KK folded on the River



PokerStars Zoom Hand #257998917827:  Hold'em No Limit (€0.01/€0.02) [ADM ID: M62BD3044A1E13PD] - 2025/10/04 21:32:35 CET [2025/10/04 15:32:35 ET]
Table 'Sirio' 6-max Seat #1 is the button
Seat 1: OSPREYSTORM (€1.98 in chips) 
Seat 2: benve15 (€0.67 in chips) 
Seat 3: stefano997 (€0.67 in chips) 
Seat 4: GanchanS7 (€5.19 in chips) 
Seat 5: zicky78.r (€2.02 in chips) 
Seat 6: caduceus369 (€3.49 in chips) 
benve15: posts small blind €0.01
stefano997: posts big blind €0.02
*** HOLE CARDS ***
Dealt to caduceus369 [Ac 5s]
GanchanS7: folds 
zicky78.r: folds 
caduceus369: raises €0.04 to €0.06
OSPREYSTORM: folds 
benve15: folds 
stefano997: calls €0.04
*** FLOP *** [Td Qd 2c]
stefano997: checks 
caduceus369: checks 
*** TURN *** [Td Qd 2c] [2h]
stefano997: bets €0.02
caduceus369: calls €0.02
*** RIVER *** [Td Qd 2c 2h] [6s]
stefano997: bets €0.02
caduceus369: calls €0.02
*** SHOW DOWN ***
stefano997: shows [Ts Jd] (two pair, Tens and Deuces)
caduceus369: mucks hand 
stefano997 collected €0.20 from pot
*** SUMMARY ***
Total pot €0.21 | Rake €0.01 
Board [Td Qd 2c 2h 6s]
Seat 1: OSPREYSTORM (button) folded before Flop (didn't bet)
Seat 2: benve15 (small blind) folded before Flop
Seat 3: stefano997 (big blind) showed [Ts Jd] and won (€0.20) with two pair, Tens and Deuces
Seat 4: GanchanS7 folded before Flop (didn't bet)
Seat 5: zicky78.r folded before Flop (didn't bet)
Seat 6: caduceus369 mucked [Ac 5s]



PokerStars Zoom Hand #257998927429:  Hold'em No Limit (€0.01/€0.02) [ADM ID: M62BD3044A1E13PD] - 2025/10/04 21:33:16 CET [2025/10/04 15:33:16 ET]
Table 'Sirio' 6-max Seat #1 is the button
Seat 1: cucciolo4447 (€0.82 in chips) 
Seat 2: monsterc99 (€1.41 in chips) 
Seat 3: zicky78.r (€2.60 in chips) 
Seat 4: RRsanto (€2 in chips) 
Seat 5: caduceus369 (€3.39 in chips) 
Seat 6: GanchanS7 (€3.08 in chips) 
monsterc99: posts small blind €0.01
zicky78.r: posts big blind €0.02
*** HOLE CARDS ***
Dealt to caduceus369 [Qd 3c]
RRsanto: folds 
caduceus369: folds 
GanchanS7: folds 
cucciolo4447: folds 
monsterc99: folds 
Uncalled bet (€0.01) returned to zicky78.r
zicky78.r collected €0.02 from pot
zicky78.r: doesn't show hand 
*** SUMMARY ***
Total pot €0.02 | Rake €0 
Seat 1: cucciolo4447 (button) folded before Flop (didn't bet)
Seat 2: monsterc99 (small blind) folded before Flop
Seat 3: zicky78.r (big blind) collected (€0.02)
Seat 4: RRsanto folded before Flop (didn't bet)
Seat 5: caduceus369 folded before Flop (didn't bet)
Seat 6: GanchanS7 folded before Flop (didn't bet)



PokerStars Zoom Hand #257998931478:  Hold'em No Limit (€0.01/€0.02) [ADM ID: M62BD3044A1E13PD] - 2025/10/04 21:33:34 CET [2025/10/04 15:33:34 ET]
Table 'Sirio' 6-max Seat #1 is the button
Seat 1: zicky78.r (€2 in chips) 
Seat 2: caduceus369 (€3.39 in chips) 
Seat 3: Asso77407 (€0.46 in chips) 
Seat 4: N0thingforU (€5.10 in chips) 
Seat 5: cucciolo4447 (€0.80 in chips) 
Seat 6: Gonfio161070 (€1.49 in chips) 
caduceus369: posts small blind €0.01
Asso77407: posts big blind €0.02
*** HOLE CARDS ***
Dealt to caduceus369 [6c 2s]
N0thingforU: folds 
cucciolo4447: calls €0.02
Gonfio161070: folds 
zicky78.r: raises €0.09 to €0.11
caduceus369: folds 
Asso77407: calls €0.09
cucciolo4447: calls €0.09
*** FLOP *** [7h 6s 5d]
Asso77407: bets €0.02
cucciolo4447: calls €0.02
zicky78.r: raises €0.20 to €0.22
Asso77407: raises €0.13 to €0.35 and is all-in
cucciolo4447: folds 
zicky78.r: calls €0.13
*** TURN *** [7h 6s 5d] [Jd]
*** RIVER *** [7h 6s 5d Jd] [3s]
*** SHOW DOWN ***
Asso77407: shows [5h 3d] (two pair, Fives and Threes)
zicky78.r: shows [Qd Qh] (a pair of Queens)
Asso77407 collected €1.01 from pot
*** SUMMARY ***
Total pot €1.06 | Rake €0.05 
Board [7h 6s 5d Jd 3s]
Seat 1: zicky78.r (button) showed [Qd Qh] and lost with a pair of Queens
Seat 2: caduceus369 (small blind) folded before Flop
Seat 3: Asso77407 (big blind) showed [5h 3d] and won (€1.01) with two pair, Fives and Threes
Seat 4: N0thingforU folded before Flop (didn't bet)
Seat 5: cucciolo4447 folded on the Flop
Seat 6: Gonfio161070 folded before Flop (didn't bet)



PokerStars Zoom Hand #257998935305:  Hold'em No Limit (€0.01/€0.02) [ADM ID: M62BD3044A1E13PD] - 2025/10/04 21:33:51 CET [2025/10/04 15:33:51 ET]
Table 'Sirio' 6-max Seat #1 is the button
Seat 1: caduceus369 (€3.38 in chips) 
Seat 2: CIKO71131 (€0.89 in chips) 
Seat 3: Gonfio161070 (€1.48 in chips) 
Seat 4: N0thingforU (€5.09 in chips) 
Seat 5: monsterc99 (€1.40 in chips) 
Seat 6: GanchanS7 (€2.31 in chips) 
CIKO71131: posts small blind €0.01
Gonfio161070: posts big blind €0.02
*** HOLE CARDS ***
Dealt to caduceus369 [6d 7d]
N0thingforU: folds 
monsterc99: folds 
GanchanS7: folds 
caduceus369: raises €0.04 to €0.06
CIKO71131: calls €0.05
Gonfio161070: calls €0.04
*** FLOP *** [3s Kc 2c]
CIKO71131: checks 
Gonfio161070: checks 
caduceus369: checks 
*** TURN *** [3s Kc 2c] [8s]
CIKO71131: checks 
Gonfio161070: checks 
caduceus369: bets €0.06
CIKO71131: calls €0.06
Gonfio161070: folds 
*** RIVER *** [3s Kc 2c 8s] [5d]
CIKO71131: checks 
caduceus369: bets €0.08
CIKO71131: calls €0.08
*** SHOW DOWN ***
caduceus369: shows [6d 7d] (high card King)
CIKO71131: shows [3c Ac] (a pair of Threes)
CIKO71131 collected €0.44 from pot
*** SUMMARY ***
Total pot €0.46 | Rake €0.02 
Board [3s Kc 2c 8s 5d]
Seat 1: caduceus369 (button) showed [6d 7d] and lost with high card King
Seat 2: CIKO71131 (small blind) showed [3c Ac] and won (€0.44) with a pair of Threes
Seat 3: Gonfio161070 (big blind) folded on the Turn
Seat 4: N0thingforU folded before Flop (didn't bet)
Seat 5: monsterc99 folded before Flop (didn't bet)
Seat 6: GanchanS7 folded before Flop (didn't bet)



PokerStars Zoom Hand #257998948526:  Hold'em No Limit (€0.01/€0.02) [ADM ID: M62BD3044A1E13PD] - 2025/10/04 21:34:48 CET [2025/10/04 15:34:48 ET]
Table 'Sirio' 6-max Seat #1 is the button
Seat 1: CIKO71131 (€1.13 in chips) 
Seat 2: GanchanS7 (€3.05 in chips) 
Seat 3: zicky78.r (€3.27 in chips) 
Seat 4: lupocane (€3.37 in chips) 
Seat 5: RRsanto (€2 in chips) 
Seat 6: caduceus369 (€3.18 in chips) 
GanchanS7: posts small blind €0.01
zicky78.r: posts big blind €0.02
*** HOLE CARDS ***
Dealt to caduceus369 [6d Jc]
lupocane: folds 
RRsanto: folds 
caduceus369: folds 
CIKO71131: folds 
GanchanS7: calls €0.01
zicky78.r: checks 
*** FLOP *** [9h Jd 4c]
GanchanS7: checks 
zicky78.r: checks 
*** TURN *** [9h Jd 4c] [Js]
GanchanS7: bets €0.03
zicky78.r: folds 
Uncalled bet (€0.03) returned to GanchanS7
GanchanS7 collected €0.04 from pot
GanchanS7: doesn't show hand 
*** SUMMARY ***
Total pot €0.04 | Rake €0 
Board [9h Jd 4c Js]
Seat 1: CIKO71131 (button) folded before Flop (didn't bet)
Seat 2: GanchanS7 (small blind) collected (€0.04)
Seat 3: zicky78.r (big blind) folded on the Turn
Seat 4: lupocane folded before Flop (didn't bet)
Seat 5: RRsanto folded before Flop (didn't bet)
Seat 6: caduceus369 folded before Flop (didn't bet)



PokerStars Zoom Hand #257998950193:  Hold'em No Limit (€0.01/€0.02) [ADM ID: M62BD3044A1E13PD] - 2025/10/04 21:34:55 CET [2025/10/04 15:34:55 ET]
Table 'Sirio' 6-max Seat #1 is the button
Seat 1: CIKO71131 (€0.65 in chips) 
Seat 2: lupocane (€3.37 in chips) 
Seat 3: caduceus369 (€3.18 in chips) 
Seat 4: RRsanto (€2 in chips) 
Seat 5: ADRIAN0_MEIS (€3.17 in chips) 
Seat 6: OSPREYSTORM (€2 in chips) 
lupocane: posts small blind €0.01
caduceus369: posts big blind €0.02
*** HOLE CARDS ***
Dealt to caduceus369 [7c Qh]
RRsanto: folds 
ADRIAN0_MEIS: folds 
OSPREYSTORM: folds 
CIKO71131: calls €0.02
lupocane: calls €0.01
caduceus369: checks 
*** FLOP *** [Td Kc Qs]
lupocane: checks 
caduceus369: checks 
CIKO71131: checks 
*** TURN *** [Td Kc Qs] [4d]
lupocane: bets €0.05
caduceus369: calls €0.05
CIKO71131: folds 
*** RIVER *** [Td Kc Qs 4d] [3d]
lupocane: checks 
caduceus369: bets €0.08
lupocane: folds 
Uncalled bet (€0.08) returned to caduceus369
caduceus369 collected €0.16 from pot
caduceus369: doesn't show hand 
*** SUMMARY ***
Total pot €0.16 | Rake €0 
Board [Td Kc Qs 4d 3d]
Seat 1: CIKO71131 (button) folded on the Turn
Seat 2: lupocane (small blind) folded on the River
Seat 3: caduceus369 (big blind) collected (€0.16)
Seat 4: RRsanto folded before Flop (didn't bet)
Seat 5: ADRIAN0_MEIS folded before Flop (didn't bet)
Seat 6: OSPREYSTORM folded before Flop (didn't bet)



PokerStars Zoom Hand #257998963635:  Hold'em No Limit (€0.01/€0.02) [ADM ID: M62BD3044A1E13PD] - 2025/10/04 21:35:53 CET [2025/10/04 15:35:53 ET]
Table 'Sirio' 6-max Seat #1 is the button
Seat 1: Wunschgast (€6.54 in chips) 
Seat 2: ADRIAN0_MEIS (€3.03 in chips) 
Seat 3: CIKO71131 (€1.09 in chips) 
Seat 4: caduceus369 (€3.27 in chips) 
Seat 5: GanchanS7 (€2.27 in chips) 
Seat 6: Giafatto 75 (€1.89 in chips) 
ADRIAN0_MEIS: posts small blind €0.01
CIKO71131: posts big blind €0.02
*** HOLE CARDS ***
Dealt to caduceus369 [2c Kd]
caduceus369: folds 
GanchanS7: folds 
Giafatto 75: raises €0.02 to €0.04
Wunschgast: folds 
ADRIAN0_MEIS: folds 
CIKO71131: calls €0.02
*** FLOP *** [Kh 9h 7d]
CIKO71131: checks 
Giafatto 75: checks 
*** TURN *** [Kh 9h 7d] [8d]
CIKO71131: bets €0.02
Giafatto 75: calls €0.02
*** RIVER *** [Kh 9h 7d 8d] [8s]
CIKO71131: checks 
Giafatto 75: checks 
*** SHOW DOWN ***
CIKO71131: shows [Qs 7h] (two pair, Eights and Sevens)
Giafatto 75: mucks hand 
CIKO71131 collected €0.13 from pot
*** SUMMARY ***
Total pot €0.13 | Rake €0 
Board [Kh 9h 7d 8d 8s]
Seat 1: Wunschgast (button) folded before Flop (didn't bet)
Seat 2: ADRIAN0_MEIS (small blind) folded before Flop
Seat 3: CIKO71131 (big blind) showed [Qs 7h] and won (€0.13) with two pair, Eights and Sevens
Seat 4: caduceus369 folded before Flop (didn't bet)
Seat 5: GanchanS7 folded before Flop (didn't bet)
Seat 6: Giafatto 75 mucked [Ad 2d]



PokerStars Zoom Hand #257998966914:  Hold'em No Limit (€0.01/€0.02) [ADM ID: M62BD3044A1E13PD] - 2025/10/04 21:36:07 CET [2025/10/04 15:36:07 ET]
Table 'Sirio' 6-max Seat #1 is the button
Seat 1: OSPREYSTORM (€2.20 in chips) 
Seat 2: LolloSpino (€0.79 in chips) 
Seat 3: GanchanS7 (€5.11 in chips) 
Seat 4: ADRIAN0_MEIS (€4.03 in chips) 
Seat 5: caduceus369 (€3.27 in chips) 
Seat 6: Kingo690 (€0.42 in chips) 
LolloSpino: posts small blind €0.01
GanchanS7: posts big blind €0.02
*** HOLE CARDS ***
Dealt to caduceus369 [6s Ah]
ADRIAN0_MEIS: folds 
caduceus369: raises €0.04 to €0.06
Kingo690: folds 
OSPREYSTORM: folds 
LolloSpino: folds 
GanchanS7: calls €0.04
*** FLOP *** [6h 9d 9h]
GanchanS7: checks 
caduceus369: checks 
*** TURN *** [6h 9d 9h] [3h]
GanchanS7: checks 
caduceus369: bets €0.02
GanchanS7: folds 
Uncalled bet (€0.02) returned to caduceus369
caduceus369 collected €0.13 from pot
caduceus369: doesn't show hand 
*** SUMMARY ***
Total pot €0.13 | Rake €0 
Board [6h 9d 9h 3h]
Seat 1: OSPREYSTORM (button) folded before Flop (didn't bet)
Seat 2: LolloSpino (small blind) folded before Flop
Seat 3: GanchanS7 (big blind) folded on the Turn
Seat 4: ADRIAN0_MEIS folded before Flop (didn't bet)
Seat 5: caduceus369 collected (€0.13)
Seat 6: Kingo690 folded before Flop (didn't bet)



PokerStars Zoom Hand #257998974941:  Hold'em No Limit (€0.01/€0.02) [ADM ID: M62BD3044A1E13PD] - 2025/10/04 21:36:42 CET [2025/10/04 15:36:42 ET]
Table 'Sirio' 6-max Seat #1 is the button
Seat 1: Mila727 (€3.68 in chips) 
Seat 2: caduceus369 (€3.34 in chips) 
Seat 3: LolloSpino (€0.77 in chips) 
Seat 4: CIKO71131 (€1.16 in chips) 
Seat 5: Giafatto 75 (€1.83 in chips) 
Seat 6: zicky78.r (€2 in chips) 
caduceus369: posts small blind €0.01
LolloSpino: posts big blind €0.02
*** HOLE CARDS ***
Dealt to caduceus369 [Qh 8h]
CIKO71131: folds 
Giafatto 75: folds 
zicky78.r: folds 
Mila727: folds 
caduceus369: raises €0.04 to €0.06
LolloSpino: folds 
Uncalled bet (€0.04) returned to caduceus369
caduceus369 collected €0.04 from pot
caduceus369: doesn't show hand 
*** SUMMARY ***
Total pot €0.04 | Rake €0 
Seat 1: Mila727 (button) folded before Flop (didn't bet)
Seat 2: caduceus369 (small blind) collected (€0.04)
Seat 3: LolloSpino (big blind) folded before Flop
Seat 4: CIKO71131 folded before Flop (didn't bet)
Seat 5: Giafatto 75 folded before Flop (didn't bet)
Seat 6: zicky78.r folded before Flop (didn't bet)



PokerStars Zoom Hand #257998979856:  Hold'em No Limit (€0.01/€0.02) [ADM ID: M62BD3044A1E13PD] - 2025/10/04 21:37:03 CET [2025/10/04 15:37:03 ET]
Table 'Sirio' 6-max Seat #1 is the button
Seat 1: caduceus369 (€3.36 in chips) 
Seat 2: GanchanS7 (€2 in chips) 
Seat 3: ADRIAN0_MEIS (€3.08 in chips) 
Seat 4: zicky78.r (€3.29 in chips) 
Seat 5: N0thingforU (€5.05 in chips) 
Seat 6: benve15 (€0.41 in chips) 
GanchanS7: posts small blind €0.01
ADRIAN0_MEIS: posts big blind €0.02
*** HOLE CARDS ***
Dealt to caduceus369 [Ts 9h]
zicky78.r: folds 
N0thingforU: folds 
benve15: raises €0.02 to €0.04
caduceus369: folds 
GanchanS7: folds 
ADRIAN0_MEIS: folds 
Uncalled bet (€0.02) returned to benve15
benve15 collected €0.05 from pot
benve15: doesn't show hand 
*** SUMMARY ***
Total pot €0.05 | Rake €0 
Seat 1: caduceus369 (button) folded before Flop (didn't bet)
Seat 2: GanchanS7 (small blind) folded before Flop
Seat 3: ADRIAN0_MEIS (big blind) folded before Flop
Seat 4: zicky78.r folded before Flop (didn't bet)
Seat 5: N0thingforU folded before Flop (didn't bet)
Seat 6: benve15 collected (€0.05)



PokerStars Zoom Hand #257998978751:  Hold'em No Limit (€0.01/€0.02) [ADM ID: M62BD3044A1E13PD] - 2025/10/04 21:36:58 CET [2025/10/04 15:36:58 ET]
Table 'Sirio' 6-max Seat #1 is the button
Seat 1: ADRIAN0_MEIS (€5.03 in chips) 
Seat 2: stefano997 (€0.70 in chips) 
Seat 3: lupocane (€3.40 in chips) 
Seat 4: caduceus369 (€3.36 in chips) 
Seat 5: the_deejay1 (€1.95 in chips) 
Seat 6: monsterc99 (€0.78 in chips) 
stefano997: posts small blind €0.01
lupocane: posts big blind €0.02
*** HOLE CARDS ***
Dealt to caduceus369 [Jd 5c]
caduceus369: folds 
the_deejay1: raises €0.04 to €0.06
monsterc99: folds 
ADRIAN0_MEIS: folds 
stefano997: calls €0.05
lupocane: calls €0.04
*** FLOP *** [3s 7h Ah]
stefano997: checks 
lupocane: checks 
the_deejay1: checks 
*** TURN *** [3s 7h Ah] [Th]
stefano997: bets €0.02
lupocane: folds 
the_deejay1: folds 
Uncalled bet (€0.02) returned to stefano997
stefano997 collected €0.18 from pot
stefano997: doesn't show hand 
*** SUMMARY ***
Total pot €0.18 | Rake €0 
Board [3s 7h Ah Th]
Seat 1: ADRIAN0_MEIS (button) folded before Flop (didn't bet)
Seat 2: stefano997 (small blind) collected (€0.18)
Seat 3: lupocane (big blind) folded on the Turn
Seat 4: caduceus369 folded before Flop (didn't bet)
Seat 5: the_deejay1 folded on the Turn
Seat 6: monsterc99 folded before Flop (didn't bet)



PokerStars Zoom Hand #257998981517:  Hold'em No Limit (€0.01/€0.02) [ADM ID: M62BD3044A1E13PD] - 2025/10/04 21:37:11 CET [2025/10/04 15:37:11 ET]
Table 'Sirio' 6-max Seat #1 is the button
Seat 1: Giafatto 75 (€1.85 in chips) 
Seat 2: monsterc99 (€0.78 in chips) 
Seat 3: caduceus369 (€3.36 in chips) 
Seat 4: N0thingforU (€5.05 in chips) 
Seat 5: GanchanS7 (€5.12 in chips) 
Seat 6: trillycata (€0.19 in chips) 
monsterc99: posts small blind €0.01
caduceus369: posts big blind €0.02
*** HOLE CARDS ***
Dealt to caduceus369 [Ad As]
N0thingforU: folds 
GanchanS7: folds 
trillycata: calls €0.02
Giafatto 75: folds 
monsterc99: calls €0.01
caduceus369: raises €0.08 to €0.10
trillycata: folds 
monsterc99: calls €0.08
*** FLOP *** [5s 4h 9d]
monsterc99: checks 
caduceus369: bets €0.11
monsterc99: raises €0.17 to €0.28
caduceus369: raises €2.98 to €3.26 and is all-in
monsterc99: folds 
Uncalled bet (€2.98) returned to caduceus369
caduceus369 collected €0.74 from pot
caduceus369: doesn't show hand 
*** SUMMARY ***
Total pot €0.78 | Rake €0.04 
Board [5s 4h 9d]
Seat 1: Giafatto 75 (button) folded before Flop (didn't bet)
Seat 2: monsterc99 (small blind) folded on the Flop
Seat 3: caduceus369 (big blind) collected (€0.74)
Seat 4: N0thingforU folded before Flop (didn't bet)
Seat 5: GanchanS7 folded before Flop (didn't bet)
Seat 6: trillycata folded before Flop



PokerStars Zoom Hand #257998994275:  Hold'em No Limit (€0.01/€0.02) [ADM ID: M62BD3044A1E13PD] - 2025/10/04 21:38:06 CET [2025/10/04 15:38:06 ET]
Table 'Sirio' 6-max Seat #1 is the button
Seat 1: ADRIAN0_MEIS (€3.05 in chips) 
Seat 2: OSPREYSTORM (€2.01 in chips) 
Seat 3: trillycata (€0.19 in chips) 
Seat 4: mora009 (€0.77 in chips) 
Seat 5: GanchanS7 (€3.20 in chips) 
Seat 6: caduceus369 (€3.72 in chips) 
OSPREYSTORM: posts small blind €0.01
trillycata: posts big blind €0.02
*** HOLE CARDS ***
Dealt to caduceus369 [Kd As]
mora009: folds 
GanchanS7: folds 
caduceus369: raises €0.04 to €0.06
ADRIAN0_MEIS: folds 
OSPREYSTORM: folds 
trillycata: folds 
Uncalled bet (€0.04) returned to caduceus369
caduceus369 collected €0.05 from pot
caduceus369: doesn't show hand 
*** SUMMARY ***
Total pot €0.05 | Rake €0 
Seat 1: ADRIAN0_MEIS (button) folded before Flop (didn't bet)
Seat 2: OSPREYSTORM (small blind) folded before Flop
Seat 3: trillycata (big blind) folded before Flop
Seat 4: mora009 folded before Flop (didn't bet)
Seat 5: GanchanS7 folded before Flop (didn't bet)
Seat 6: caduceus369 collected (€0.05)



PokerStars Zoom Hand #257999003231:  Hold'em No Limit (€0.01/€0.02) [ADM ID: M62BD3044A1E13PD] - 2025/10/04 21:38:45 CET [2025/10/04 15:38:45 ET]
Table 'Sirio' 6-max Seat #1 is the button
Seat 1: zicky78.r (€2 in chips) 
Seat 2: TheodoreTBag (€2 in chips) 
Seat 3: ADRIAN0_MEIS (€3.05 in chips) 
Seat 4: LolloSpino (€0.79 in chips) 
Seat 5: lupocane (€3.26 in chips) 
Seat 6: caduceus369 (€3.74 in chips) 
TheodoreTBag: posts small blind €0.01
ADRIAN0_MEIS: posts big blind €0.02
*** HOLE CARDS ***
Dealt to caduceus369 [4d Ks]
LolloSpino: folds 
lupocane: folds 
caduceus369: folds 
zicky78.r: folds 
TheodoreTBag: folds 
Uncalled bet (€0.01) returned to ADRIAN0_MEIS
ADRIAN0_MEIS collected €0.02 from pot
ADRIAN0_MEIS: doesn't show hand 
*** SUMMARY ***
Total pot €0.02 | Rake €0 
Seat 1: zicky78.r (button) folded before Flop (didn't bet)
Seat 2: TheodoreTBag (small blind) folded before Flop
Seat 3: ADRIAN0_MEIS (big blind) collected (€0.02)
Seat 4: LolloSpino folded before Flop (didn't bet)
Seat 5: lupocane folded before Flop (didn't bet)
Seat 6: caduceus369 folded before Flop (didn't bet)



PokerStars Zoom Hand #257999001949:  Hold'em No Limit (€0.01/€0.02) [ADM ID: M62BD3044A1E13PD] - 2025/10/04 21:38:40 CET [2025/10/04 15:38:40 ET]
Table 'Sirio' 6-max Seat #1 is the button
Seat 1: the_deejay1 (€1.85 in chips) 
Seat 2: caduceus369 (€3.75 in chips) 
Seat 3: OSPREYSTORM (€2 in chips) 
Seat 4: GanchanS7 (€2.28 in chips) 
Seat 5: monsterc99 (€0.43 in chips) 
Seat 6: lupocane (€3.26 in chips) 
caduceus369: posts small blind €0.01
OSPREYSTORM: posts big blind €0.02
*** HOLE CARDS ***
Dealt to caduceus369 [2c Ks]
GanchanS7: folds 
monsterc99: raises €0.02 to €0.04
lupocane: folds 
the_deejay1: folds 
caduceus369: folds 
OSPREYSTORM: folds 
Uncalled bet (€0.02) returned to monsterc99
monsterc99 collected €0.05 from pot
monsterc99: doesn't show hand 
*** SUMMARY ***
Total pot €0.05 | Rake €0 
Seat 1: the_deejay1 (button) folded before Flop (didn't bet)
Seat 2: caduceus369 (small blind) folded before Flop
Seat 3: OSPREYSTORM (big blind) folded before Flop
Seat 4: GanchanS7 folded before Flop (didn't bet)
Seat 5: monsterc99 collected (€0.05)
Seat 6: lupocane folded before Flop (didn't bet)



PokerStars Zoom Hand #257998999886:  Hold'em No Limit (€0.01/€0.02) [ADM ID: M62BD3044A1E13PD] - 2025/10/04 21:38:31 CET [2025/10/04 15:38:31 ET]
Table 'Sirio' 6-max Seat #1 is the button
Seat 1: Kazzimmino (€2.13 in chips) 
Seat 2: ADRIAN0_MEIS (€4.96 in chips) 
Seat 3: Mila727 (€3.74 in chips) 
Seat 4: GanchanS7 (€2.06 in chips) 
Seat 5: caduceus369 (€3.75 in chips) 
Seat 6: benve15 (€0.59 in chips) 
ADRIAN0_MEIS: posts small blind €0.01
Mila727: posts big blind €0.02
*** HOLE CARDS ***
Dealt to caduceus369 [5d 3h]
GanchanS7: folds 
caduceus369: folds 
benve15: raises €0.06 to €0.08
Kazzimmino: folds 
ADRIAN0_MEIS: folds 
Mila727: calls €0.06
*** FLOP *** [8s 3d Tc]
Mila727: checks 
benve15: bets €0.51 and is all-in
Mila727: calls €0.51
*** TURN *** [8s 3d Tc] [Kc]
*** RIVER *** [8s 3d Tc Kc] [3s]
*** SHOW DOWN ***
Mila727: shows [9h Th] (two pair, Tens and Threes)
benve15: shows [Ah Jd] (a pair of Threes)
Mila727 collected €1.13 from pot
*** SUMMARY ***
Total pot €1.19 | Rake €0.06 
Board [8s 3d Tc Kc 3s]
Seat 1: Kazzimmino (button) folded before Flop (didn't bet)
Seat 2: ADRIAN0_MEIS (small blind) folded before Flop
Seat 3: Mila727 (big blind) showed [9h Th] and won (€1.13) with two pair, Tens and Threes
Seat 4: GanchanS7 folded before Flop (didn't bet)
Seat 5: caduceus369 folded before Flop (didn't bet)
Seat 6: benve15 showed [Ah Jd] and lost with a pair of Threes



PokerStars Zoom Hand #257999004610:  Hold'em No Limit (€0.01/€0.02) [ADM ID: M62BD3044A1E13PD] - 2025/10/04 21:38:51 CET [2025/10/04 15:38:51 ET]
Table 'Sirio' 6-max Seat #1 is the button
Seat 1: GanchanS7 (€5.21 in chips) 
Seat 2: Gabrielefante (€6.44 in chips) 
Seat 3: TheodoreTBag (€2 in chips) 
Seat 4: caduceus369 (€3.74 in chips) 
Seat 5: zicky78.r (€2 in chips) 
Seat 6: Kazzimmino (€2.13 in chips) 
Gabrielefante: posts small blind €0.01
TheodoreTBag: posts big blind €0.02
*** HOLE CARDS ***
Dealt to caduceus369 [Jc 7c]
caduceus369: folds 
zicky78.r: folds 
Kazzimmino: folds 
GanchanS7: folds 
Gabrielefante: folds 
Uncalled bet (€0.01) returned to TheodoreTBag
TheodoreTBag collected €0.02 from pot
TheodoreTBag: doesn't show hand 
*** SUMMARY ***
Total pot €0.02 | Rake €0 
Seat 1: GanchanS7 (button) folded before Flop (didn't bet)
Seat 2: Gabrielefante (small blind) folded before Flop
Seat 3: TheodoreTBag (big blind) collected (€0.02)
Seat 4: caduceus369 folded before Flop (didn't bet)
Seat 5: zicky78.r folded before Flop (didn't bet)
Seat 6: Kazzimmino folded before Flop (didn't bet)



PokerStars Zoom Hand #257999006072:  Hold'em No Limit (€0.01/€0.02) [ADM ID: M62BD3044A1E13PD] - 2025/10/04 21:38:58 CET [2025/10/04 15:38:58 ET]
Table 'Sirio' 6-max Seat #1 is the button
Seat 1: caduceus369 (€3.74 in chips) 
Seat 2: GanchanS7 (€2.28 in chips) 
Seat 3: Kazzimmino (€2.13 in chips) 
Seat 4: monsterc99 (€0.46 in chips) 
Seat 5: OSPREYSTORM (€2.17 in chips) 
Seat 6: VagALiss (€2.84 in chips) 
GanchanS7: posts small blind €0.01
Kazzimmino: posts big blind €0.02
*** HOLE CARDS ***
Dealt to caduceus369 [Ad 5c]
monsterc99: calls €0.02
OSPREYSTORM: folds 
VagALiss: raises €0.06 to €0.08
caduceus369: folds 
GanchanS7: folds 
Kazzimmino: folds 
monsterc99: calls €0.06
*** FLOP *** [8d 8c 9d]
monsterc99: checks 
VagALiss: bets €0.09
monsterc99: raises €0.29 to €0.38 and is all-in
VagALiss: calls €0.29
*** TURN *** [8d 8c 9d] [6d]
*** RIVER *** [8d 8c 9d 6d] [Qc]
*** SHOW DOWN ***
monsterc99: shows [Kd 7d] (a flush, King high)
VagALiss: shows [Ac Kc] (a pair of Eights)
monsterc99 collected €0.90 from pot
*** SUMMARY ***
Total pot €0.95 | Rake €0.05 
Board [8d 8c 9d 6d Qc]
Seat 1: caduceus369 (button) folded before Flop (didn't bet)
Seat 2: GanchanS7 (small blind) folded before Flop
Seat 3: Kazzimmino (big blind) folded before Flop
Seat 4: monsterc99 showed [Kd 7d] and won (€0.90) with a flush, King high
Seat 5: OSPREYSTORM folded before Flop (didn't bet)
Seat 6: VagALiss showed [Ac Kc] and lost with a pair of Eights



PokerStars Zoom Hand #257999008958:  Hold'em No Limit (€0.01/€0.02) [ADM ID: M62BD3044A1E13PD] - 2025/10/04 21:39:10 CET [2025/10/04 15:39:10 ET]
Table 'Sirio' 6-max Seat #1 is the button
Seat 1: ADRIAN0_MEIS (€3.06 in chips) 
Seat 2: Kazzimmino (€2.11 in chips) 
Seat 3: caduceus369 (€3.74 in chips) 
Seat 4: RRsanto (€3.67 in chips) 
Seat 5: Wunschgast (€6.42 in chips) 
Seat 6: potodds1979 (€2.02 in chips) 
Kazzimmino: posts small blind €0.01
caduceus369: posts big blind €0.02
*** HOLE CARDS ***
Dealt to caduceus369 [As 6c]
RRsanto: folds 
Wunschgast: raises €0.04 to €0.06
potodds1979: folds 
ADRIAN0_MEIS: folds 
Kazzimmino: calls €0.05
caduceus369: calls €0.04
*** FLOP *** [Ad 2s 3c]
Kazzimmino: checks 
caduceus369: bets €0.06
Wunschgast: folds 
Kazzimmino: calls €0.06
*** TURN *** [Ad 2s 3c] [5c]
Kazzimmino: checks 
caduceus369: checks 
*** RIVER *** [Ad 2s 3c 5c] [9h]
Kazzimmino: checks 
caduceus369: bets €0.23
Kazzimmino: folds 
Uncalled bet (€0.23) returned to caduceus369
caduceus369 collected €0.29 from pot
caduceus369: doesn't show hand 
*** SUMMARY ***
Total pot €0.30 | Rake €0.01 
Board [Ad 2s 3c 5c 9h]
Seat 1: ADRIAN0_MEIS (button) folded before Flop (didn't bet)
Seat 2: Kazzimmino (small blind) folded on the River
Seat 3: caduceus369 (big blind) collected (€0.29)
Seat 4: RRsanto folded before Flop (didn't bet)
Seat 5: Wunschgast folded on the Flop
Seat 6: potodds1979 folded before Flop (didn't bet)



PokerStars Zoom Hand #257999018764:  Hold'em No Limit (€0.01/€0.02) [ADM ID: M62BD3044A1E13PD] - 2025/10/04 21:39:53 CET [2025/10/04 15:39:53 ET]
Table 'Sirio' 6-max Seat #1 is the button
Seat 1: Kazzimmino (€1.99 in chips) 
Seat 2: ADRIAN0_MEIS (€4.91 in chips) 
Seat 3: monsterc99 (€0.90 in chips) 
Seat 4: GanchanS7 (€3.17 in chips) 
Seat 5: caduceus369 (€3.91 in chips) 
Seat 6: Wunschgast (€6.36 in chips) 
ADRIAN0_MEIS: posts small blind €0.01
monsterc99: posts big blind €0.02
*** HOLE CARDS ***
Dealt to caduceus369 [Jc Js]
GanchanS7: folds 
caduceus369: raises €0.04 to €0.06
Wunschgast: folds 
Kazzimmino: folds 
ADRIAN0_MEIS: folds 
monsterc99: calls €0.04
*** FLOP *** [As 2s Qs]
monsterc99: bets €0.07
caduceus369: calls €0.07
*** TURN *** [As 2s Qs] [3c]
monsterc99: checks 
caduceus369: checks 
*** RIVER *** [As 2s Qs 3c] [6d]
monsterc99: bets €0.13
caduceus369: raises €0.25 to €0.38
monsterc99: calls €0.25
*** SHOW DOWN ***
caduceus369: shows [Jc Js] (a pair of Jacks)
monsterc99: shows [6s Ah] (two pair, Aces and Sixes)
monsterc99 collected €0.98 from pot
*** SUMMARY ***
Total pot €1.03 | Rake €0.05 
Board [As 2s Qs 3c 6d]
Seat 1: Kazzimmino (button) folded before Flop (didn't bet)
Seat 2: ADRIAN0_MEIS (small blind) folded before Flop
Seat 3: monsterc99 (big blind) showed [6s Ah] and won (€0.98) with two pair, Aces and Sixes
Seat 4: GanchanS7 folded before Flop (didn't bet)
Seat 5: caduceus369 showed [Jc Js] and lost with a pair of Jacks
Seat 6: Wunschgast folded before Flop (didn't bet)



PokerStars Zoom Hand #257999040358:  Hold'em No Limit (€0.01/€0.02) [ADM ID: M62BD3044A1E13PD] - 2025/10/04 21:41:27 CET [2025/10/04 15:41:27 ET]
Table 'Sirio' 6-max Seat #1 is the button
Seat 1: ADRIAN0_MEIS (€4.01 in chips) 
Seat 2: monsterc99 (€1.37 in chips) 
Seat 3: CIKO71131 (€0.80 in chips) 
Seat 4: OSPREYSTORM (€1.99 in chips) 
Seat 5: caduceus369 (€3.40 in chips) 
Seat 6: trillycata (€0.80 in chips) 
monsterc99: posts small blind €0.01
CIKO71131: posts big blind €0.02
*** HOLE CARDS ***
Dealt to caduceus369 [6d Jh]
OSPREYSTORM: folds 
caduceus369: folds 
trillycata: folds 
ADRIAN0_MEIS: folds 
monsterc99: calls €0.01
CIKO71131: checks 
*** FLOP *** [3c 5d 6c]
monsterc99: bets €0.02
CIKO71131: folds 
Uncalled bet (€0.02) returned to monsterc99
monsterc99 collected €0.04 from pot
monsterc99: doesn't show hand 
*** SUMMARY ***
Total pot €0.04 | Rake €0 
Board [3c 5d 6c]
Seat 1: ADRIAN0_MEIS (button) folded before Flop (didn't bet)
Seat 2: monsterc99 (small blind) collected (€0.04)
Seat 3: CIKO71131 (big blind) folded on the Flop
Seat 4: OSPREYSTORM folded before Flop (didn't bet)
Seat 5: caduceus369 folded before Flop (didn't bet)
Seat 6: trillycata folded before Flop (didn't bet)



PokerStars Zoom Hand #257999044245:  Hold'em No Limit (€0.01/€0.02) [ADM ID: M62BD3044A1E13PD] - 2025/10/04 21:41:43 CET [2025/10/04 15:41:43 ET]
Table 'Sirio' 6-max Seat #1 is the button
Seat 1: caduceus369 (€3.39 in chips) 
Seat 2: willydag94 (€0.73 in chips) 
Seat 3: OSPREYSTORM (€1.99 in chips) 
Seat 4: DAMPER_KK (€2.30 in chips) 
Seat 5: ADRIAN0_MEIS (€4.02 in chips) 
Seat 6: VagALiss (€2.35 in chips) 
willydag94: posts small blind €0.01
OSPREYSTORM: posts big blind €0.02
*** HOLE CARDS ***
Dealt to caduceus369 [2s 4c]
DAMPER_KK: folds 
ADRIAN0_MEIS: folds 
VagALiss: folds 
caduceus369: folds 
willydag94: raises €0.02 to €0.04
OSPREYSTORM: calls €0.02
*** FLOP *** [6d 9c 8s]
willydag94: bets €0.04
OSPREYSTORM: calls €0.04
*** TURN *** [6d 9c 8s] [Jc]
willydag94: checks 
OSPREYSTORM: bets €0.09
willydag94: folds 
Uncalled bet (€0.09) returned to OSPREYSTORM
OSPREYSTORM collected €0.16 from pot
OSPREYSTORM: doesn't show hand 
*** SUMMARY ***
Total pot €0.16 | Rake €0 
Board [6d 9c 8s Jc]
Seat 1: caduceus369 (button) folded before Flop (didn't bet)
Seat 2: willydag94 (small blind) folded on the Turn
Seat 3: OSPREYSTORM (big blind) collected (€0.16)
Seat 4: DAMPER_KK folded before Flop (didn't bet)
Seat 5: ADRIAN0_MEIS folded before Flop (didn't bet)
Seat 6: VagALiss folded before Flop (didn't bet)



PokerStars Zoom Hand #257999045422:  Hold'em No Limit (€0.01/€0.02) [ADM ID: M62BD3044A1E13PD] - 2025/10/04 21:41:48 CET [2025/10/04 15:41:48 ET]
Table 'Sirio' 6-max Seat #1 is the button
Seat 1: Catania838 (€2 in chips) 
Seat 2: Gabrielefante (€6.86 in chips) 
Seat 3: GanchanS7 (€5.11 in chips) 
Seat 4: caduceus369 (€3.39 in chips) 
Seat 5: heitel (€1.29 in chips) 
Seat 6: ADRIAN0_MEIS (€4.02 in chips) 
Gabrielefante: posts small blind €0.01
GanchanS7: posts big blind €0.02
*** HOLE CARDS ***
Dealt to caduceus369 [9s Kd]
caduceus369: folds 
heitel: folds 
ADRIAN0_MEIS: folds 
Catania838: folds 
Gabrielefante: folds 
Uncalled bet (€0.01) returned to GanchanS7
GanchanS7 collected €0.02 from pot
GanchanS7: doesn't show hand 
*** SUMMARY ***
Total pot €0.02 | Rake €0 
Seat 1: Catania838 (button) folded before Flop (didn't bet)
Seat 2: Gabrielefante (small blind) folded before Flop
Seat 3: GanchanS7 (big blind) collected (€0.02)
Seat 4: caduceus369 folded before Flop (didn't bet)
Seat 5: heitel folded before Flop (didn't bet)
Seat 6: ADRIAN0_MEIS folded before Flop (didn't bet)



PokerStars Zoom Hand #257999041394:  Hold'em No Limit (€0.01/€0.02) [ADM ID: M62BD3044A1E13PD] - 2025/10/04 21:41:31 CET [2025/10/04 15:41:31 ET]
Table 'Sirio' 6-max Seat #1 is the button
Seat 1: OSPREYSTORM (€1.99 in chips) 
Seat 2: caduceus369 (€3.40 in chips) 
Seat 3: trillycata (€0.80 in chips) 
Seat 4: zicky78.r (€2.74 in chips) 
Seat 5: GanchanS7 (€3.13 in chips) 
Seat 6: andree128 (€1.64 in chips) 
caduceus369: posts small blind €0.01
trillycata: posts big blind €0.02
*** HOLE CARDS ***
Dealt to caduceus369 [Kh 2s]
zicky78.r: folds 
GanchanS7: folds 
andree128: raises €0.02 to €0.04
OSPREYSTORM: folds 
caduceus369: folds 
trillycata: calls €0.02
*** FLOP *** [3h 5d Kc]
trillycata: checks 
andree128: bets €0.04
trillycata: calls €0.04
*** TURN *** [3h 5d Kc] [8h]
trillycata: checks 
andree128: bets €0.02
trillycata: calls €0.02
*** RIVER *** [3h 5d Kc 8h] [7s]
trillycata: checks 
andree128: checks 
*** SHOW DOWN ***
trillycata: shows [4c Ks] (a pair of Kings)
andree128: mucks hand 
trillycata collected €0.20 from pot
*** SUMMARY ***
Total pot €0.21 | Rake €0.01 
Board [3h 5d Kc 8h 7s]
Seat 1: OSPREYSTORM (button) folded before Flop (didn't bet)
Seat 2: caduceus369 (small blind) folded before Flop
Seat 3: trillycata (big blind) showed [4c Ks] and won (€0.20) with a pair of Kings
Seat 4: zicky78.r folded before Flop (didn't bet)
Seat 5: GanchanS7 folded before Flop (didn't bet)
Seat 6: andree128 mucked [As 5s]



PokerStars Zoom Hand #257999049296:  Hold'em No Limit (€0.01/€0.02) [ADM ID: M62BD3044A1E13PD] - 2025/10/04 21:42:05 CET [2025/10/04 15:42:05 ET]
Table 'Sirio' 6-max Seat #1 is the button
Seat 1: Gabrielefante (€6.83 in chips) 
Seat 2: zicky78.r (€2.04 in chips) 
Seat 3: Alfio4865 (€1.20 in chips) 
Seat 4: ADRIAN0_MEIS (€4.02 in chips) 
Seat 5: stefano997 (€0.52 in chips) 
Seat 6: caduceus369 (€3.37 in chips) 
zicky78.r: posts small blind €0.01
Alfio4865: posts big blind €0.02
*** HOLE CARDS ***
Dealt to caduceus369 [Ks 6s]
ADRIAN0_MEIS: folds 
stefano997: raises €0.02 to €0.04
caduceus369: folds 
Gabrielefante: folds 
zicky78.r: folds 
Alfio4865: folds 
Uncalled bet (€0.02) returned to stefano997
stefano997 collected €0.05 from pot
stefano997: doesn't show hand 
*** SUMMARY ***
Total pot €0.05 | Rake €0 
Seat 1: Gabrielefante (button) folded before Flop (didn't bet)
Seat 2: zicky78.r (small blind) folded before Flop
Seat 3: Alfio4865 (big blind) folded before Flop
Seat 4: ADRIAN0_MEIS folded before Flop (didn't bet)
Seat 5: stefano997 collected (€0.05)
Seat 6: caduceus369 folded before Flop (didn't bet)



PokerStars Zoom Hand #257999047656:  Hold'em No Limit (€0.01/€0.02) [ADM ID: M62BD3044A1E13PD] - 2025/10/04 21:41:58 CET [2025/10/04 15:41:58 ET]
Table 'Sirio' 6-max Seat #1 is the button
Seat 1: Mila727 (€5.18 in chips) 
Seat 2: TheodoreTBag (€2 in chips) 
Seat 3: caduceus369 (€3.39 in chips) 
Seat 4: LolloSpino (€0.52 in chips) 
Seat 5: OSPREYSTORM (€1.99 in chips) 
Seat 6: GanchanS7 (€2.28 in chips) 
TheodoreTBag: posts small blind €0.01
caduceus369: posts big blind €0.02
*** HOLE CARDS ***
Dealt to caduceus369 [5c 8h]
LolloSpino: raises €0.02 to €0.04
OSPREYSTORM: folds 
GanchanS7 has timed out
GanchanS7: folds 
Mila727: folds 
TheodoreTBag: calls €0.03
caduceus369: folds 
*** FLOP *** [7s 4c 4h]
TheodoreTBag: checks 
LolloSpino: checks 
*** TURN *** [7s 4c 4h] [2d]
TheodoreTBag: checks 
LolloSpino: checks 
*** RIVER *** [7s 4c 4h 2d] [9s]
TheodoreTBag: checks 
LolloSpino: checks 
*** SHOW DOWN ***
TheodoreTBag: shows [Js 9h] (two pair, Nines and Fours)
LolloSpino: mucks hand 
TheodoreTBag collected €0.10 from pot
*** SUMMARY ***
Total pot €0.10 | Rake €0 
Board [7s 4c 4h 2d 9s]
Seat 1: Mila727 (button) folded before Flop (didn't bet)
Seat 2: TheodoreTBag (small blind) showed [Js 9h] and won (€0.10) with two pair, Nines and Fours
Seat 3: caduceus369 (big blind) folded before Flop
Seat 4: LolloSpino mucked [Ad 3d]
Seat 5: OSPREYSTORM folded before Flop (didn't bet)
Seat 6: GanchanS7 folded before Flop (didn't bet)



PokerStars Zoom Hand #257999051603:  Hold'em No Limit (€0.01/€0.02) [ADM ID: M62BD3044A1E13PD] - 2025/10/04 21:42:15 CET [2025/10/04 15:42:15 ET]
Table 'Sirio' 6-max Seat #1 is the button
Seat 1: Goal779 (€0.96 in chips) 
Seat 2: caduceus369 (€3.37 in chips) 
Seat 3: Mila727 (€5.18 in chips) 
Seat 4: Kingo690 (€0.77 in chips) 
Seat 5: zicky78.r (€4.33 in chips) 
Seat 6: RRsanto (€3.97 in chips) 
caduceus369: posts small blind €0.01
Mila727: posts big blind €0.02
*** HOLE CARDS ***
Dealt to caduceus369 [Jc 5s]
Kingo690: folds 
zicky78.r: raises €0.03 to €0.05
RRsanto: folds 
Goal779: calls €0.05
caduceus369: folds 
Mila727: folds 
*** FLOP *** [5h Kd 3d]
zicky78.r: checks 
Goal779: bets €0.06
zicky78.r: folds 
Uncalled bet (€0.06) returned to Goal779
Goal779 collected €0.13 from pot
Goal779: doesn't show hand 
*** SUMMARY ***
Total pot €0.13 | Rake €0 
Board [5h Kd 3d]
Seat 1: Goal779 (button) collected (€0.13)
Seat 2: caduceus369 (small blind) folded before Flop
Seat 3: Mila727 (big blind) folded before Flop
Seat 4: Kingo690 folded before Flop (didn't bet)
Seat 5: zicky78.r folded on the Flop
Seat 6: RRsanto folded before Flop (didn't bet)



PokerStars Zoom Hand #257999053714:  Hold'em No Limit (€0.01/€0.02) [ADM ID: M62BD3044A1E13PD] - 2025/10/04 21:42:24 CET [2025/10/04 15:42:24 ET]
Table 'Sirio' 6-max Seat #1 is the button
Seat 1: Catania838 (€1.47 in chips) 
Seat 2: uziu47 (€1.08 in chips) 
Seat 3: N0thingforU (€4.92 in chips) 
Seat 4: Gabrielefante (€6.83 in chips) 
Seat 5: caduceus369 (€3.36 in chips) 
Seat 6: stefano997 (€0.55 in chips) 
uziu47: posts small blind €0.01
N0thingforU: posts big blind €0.02
*** HOLE CARDS ***
Dealt to caduceus369 [Ac Td]
Gabrielefante: folds 
caduceus369: raises €0.04 to €0.06
stefano997: folds 
Catania838: folds 
uziu47: folds 
N0thingforU: folds 
Uncalled bet (€0.04) returned to caduceus369
caduceus369 collected €0.05 from pot
caduceus369: doesn't show hand 
*** SUMMARY ***
Total pot €0.05 | Rake €0 
Seat 1: Catania838 (button) folded before Flop (didn't bet)
Seat 2: uziu47 (small blind) folded before Flop
Seat 3: N0thingforU (big blind) folded before Flop
Seat 4: Gabrielefante folded before Flop (didn't bet)
Seat 5: caduceus369 collected (€0.05)
Seat 6: stefano997 folded before Flop (didn't bet)



PokerStars Zoom Hand #257999059229:  Hold'em No Limit (€0.01/€0.02) [ADM ID: M62BD3044A1E13PD] - 2025/10/04 21:42:48 CET [2025/10/04 15:42:48 ET]
Table 'Sirio' 6-max Seat #1 is the button
Seat 1: N0thingforU (€4.89 in chips) 
Seat 2: LolloSpino (€0.59 in chips) 
Seat 3: caduceus369 (€3.39 in chips) 
Seat 4: mora009 (€0.77 in chips) 
Seat 5: willydag94 (€1.22 in chips) 
Seat 6: uziu47 (€1.07 in chips) 
LolloSpino: posts small blind €0.01
caduceus369: posts big blind €0.02
*** HOLE CARDS ***
Dealt to caduceus369 [As 4h]
mora009: folds 
willydag94: folds 
uziu47: folds 
N0thingforU: raises €0.04 to €0.06
LolloSpino: raises €0.53 to €0.59 and is all-in
caduceus369: folds 
N0thingforU: folds 
Uncalled bet (€0.53) returned to LolloSpino
LolloSpino collected €0.14 from pot
LolloSpino: doesn't show hand 
*** SUMMARY ***
Total pot €0.14 | Rake €0 
Seat 1: N0thingforU (button) folded before Flop
Seat 2: LolloSpino (small blind) collected (€0.14)
Seat 3: caduceus369 (big blind) folded before Flop
Seat 4: mora009 folded before Flop (didn't bet)
Seat 5: willydag94 folded before Flop (didn't bet)
Seat 6: uziu47 folded before Flop (didn't bet)



PokerStars Zoom Hand #257999063116:  Hold'em No Limit (€0.01/€0.02) [ADM ID: M62BD3044A1E13PD] - 2025/10/04 21:43:06 CET [2025/10/04 15:43:06 ET]
Table 'Sirio' 6-max Seat #1 is the button
Seat 1: caduceus369 (€3.37 in chips) 
Seat 2: Gabrielefante (€6.83 in chips) 
Seat 3: ADRIAN0_MEIS (€2.99 in chips) 
Seat 4: potodds1979 (€2.09 in chips) 
Seat 5: GanchanS7 (€2.01 in chips) 
Seat 6: zicky78.r (€2 in chips) 
Gabrielefante: posts small blind €0.01
ADRIAN0_MEIS: posts big blind €0.02
*** HOLE CARDS ***
Dealt to caduceus369 [7c Qs]
potodds1979: folds 
GanchanS7: folds 
zicky78.r: folds 
caduceus369: folds 
Gabrielefante: folds 
Uncalled bet (€0.01) returned to ADRIAN0_MEIS
ADRIAN0_MEIS collected €0.02 from pot
ADRIAN0_MEIS: doesn't show hand 
*** SUMMARY ***
Total pot €0.02 | Rake €0 
Seat 1: caduceus369 (button) folded before Flop (didn't bet)
Seat 2: Gabrielefante (small blind) folded before Flop
Seat 3: ADRIAN0_MEIS (big blind) collected (€0.02)
Seat 4: potodds1979 folded before Flop (didn't bet)
Seat 5: GanchanS7 folded before Flop (didn't bet)
Seat 6: zicky78.r folded before Flop (didn't bet)



PokerStars Zoom Hand #257999064473:  Hold'em No Limit (€0.01/€0.02) [ADM ID: M62BD3044A1E13PD] - 2025/10/04 21:43:11 CET [2025/10/04 15:43:11 ET]
Table 'Sirio' 6-max Seat #1 is the button
Seat 1: father2008 (€2.04 in chips) 
Seat 2: Mila727 (€5 in chips) 
Seat 3: Gabrielefante (€6.82 in chips) 
Seat 4: caduceus369 (€3.37 in chips) 
Seat 5: Kingo690 (€0.74 in chips) 
Seat 6: Catania838 (€1.95 in chips) 
Mila727: posts small blind €0.01
Gabrielefante: posts big blind €0.02
*** HOLE CARDS ***
Dealt to caduceus369 [5c Qs]
caduceus369: folds 
Kingo690: folds 
Catania838: folds 
father2008: raises €0.04 to €0.06
Mila727: folds 
Gabrielefante: calls €0.04
*** FLOP *** [5d 3c 2h]
Gabrielefante: checks 
father2008: bets €0.08
Gabrielefante: folds 
Uncalled bet (€0.08) returned to father2008
father2008 collected €0.13 from pot
father2008: doesn't show hand 
*** SUMMARY ***
Total pot €0.13 | Rake €0 
Board [5d 3c 2h]
Seat 1: father2008 (button) collected (€0.13)
Seat 2: Mila727 (small blind) folded before Flop
Seat 3: Gabrielefante (big blind) folded on the Flop
Seat 4: caduceus369 folded before Flop (didn't bet)
Seat 5: Kingo690 folded before Flop (didn't bet)
Seat 6: Catania838 folded before Flop (didn't bet)



PokerStars Zoom Hand #257999066594:  Hold'em No Limit (€0.01/€0.02) [ADM ID: M62BD3044A1E13PD] - 2025/10/04 21:43:20 CET [2025/10/04 15:43:20 ET]
Table 'Sirio' 6-max Seat #1 is the button
Seat 1: monsterc99 (€1.43 in chips) 
Seat 2: Catania838 (€1.95 in chips) 
Seat 3: cucciolo4447 (€0.98 in chips) 
Seat 4: caduceus369 (€3.37 in chips) 
Seat 5: ADRIAN0_MEIS (€3.25 in chips) 
Seat 6: LolloSpino (€0.43 in chips) 
Catania838: posts small blind €0.01
cucciolo4447: posts big blind €0.02
*** HOLE CARDS ***
Dealt to caduceus369 [Kh Ts]
caduceus369: raises €0.04 to €0.06
ADRIAN0_MEIS: folds 
LolloSpino: calls €0.06
monsterc99: folds 
Catania838: folds 
cucciolo4447: folds 
*** FLOP *** [Js 2c Jc]
caduceus369: checks 
LolloSpino: checks 
*** TURN *** [Js 2c Jc] [Kd]
caduceus369: checks 
LolloSpino: checks 
*** RIVER *** [Js 2c Jc Kd] [8c]
caduceus369: bets €0.08
LolloSpino: folds 
Uncalled bet (€0.08) returned to caduceus369
caduceus369 collected €0.15 from pot
caduceus369: doesn't show hand 
*** SUMMARY ***
Total pot €0.15 | Rake €0 
Board [Js 2c Jc Kd 8c]
Seat 1: monsterc99 (button) folded before Flop (didn't bet)
Seat 2: Catania838 (small blind) folded before Flop
Seat 3: cucciolo4447 (big blind) folded before Flop
Seat 4: caduceus369 collected (€0.15)
Seat 5: ADRIAN0_MEIS folded before Flop (didn't bet)
Seat 6: LolloSpino folded on the River



PokerStars Zoom Hand #257999079381:  Hold'em No Limit (€0.01/€0.02) [ADM ID: M62BD3044A1E13PD] - 2025/10/04 21:44:16 CET [2025/10/04 15:44:16 ET]
Table 'Sirio' 6-max Seat #1 is the button
Seat 1: LolloSpino (€0.37 in chips) 
Seat 2: stefano997 (€0.86 in chips) 
Seat 3: OSPREYSTORM (€1.54 in chips) 
Seat 4: zicky78.r (€2.02 in chips) 
Seat 5: ADRIAN0_MEIS (€3.99 in chips) 
Seat 6: caduceus369 (€3.46 in chips) 
stefano997: posts small blind €0.01
OSPREYSTORM: posts big blind €0.02
*** HOLE CARDS ***
Dealt to caduceus369 [Jh 4d]
zicky78.r: folds 
ADRIAN0_MEIS: folds 
caduceus369: folds 
LolloSpino: folds 
stefano997: raises €0.04 to €0.06
OSPREYSTORM: folds 
Uncalled bet (€0.04) returned to stefano997
stefano997 collected €0.04 from pot
stefano997: doesn't show hand 
*** SUMMARY ***
Total pot €0.04 | Rake €0 
Seat 1: LolloSpino (button) folded before Flop (didn't bet)
Seat 2: stefano997 (small blind) collected (€0.04)
Seat 3: OSPREYSTORM (big blind) folded before Flop
Seat 4: zicky78.r folded before Flop (didn't bet)
Seat 5: ADRIAN0_MEIS folded before Flop (didn't bet)
Seat 6: caduceus369 folded before Flop (didn't bet)



PokerStars Zoom Hand #257999081052:  Hold'em No Limit (€0.01/€0.02) [ADM ID: M62BD3044A1E13PD] - 2025/10/04 21:44:24 CET [2025/10/04 15:44:24 ET]
Table 'Sirio' 6-max Seat #1 is the button
Seat 1: OSPREYSTORM (€2.03 in chips) 
Seat 2: caduceus369 (€3.46 in chips) 
Seat 3: LolloSpino (€0.37 in chips) 
Seat 4: cucciolo4447 (€1.11 in chips) 
Seat 5: zicky78.r (€2.02 in chips) 
Seat 6: ADRIAN0_MEIS (€3.99 in chips) 
caduceus369: posts small blind €0.01
LolloSpino: posts big blind €0.02
*** HOLE CARDS ***
Dealt to caduceus369 [4h 9s]
cucciolo4447: folds 
zicky78.r: folds 
ADRIAN0_MEIS: folds 
OSPREYSTORM: folds 
caduceus369: folds 
Uncalled bet (€0.01) returned to LolloSpino
LolloSpino collected €0.02 from pot
LolloSpino: doesn't show hand 
*** SUMMARY ***
Total pot €0.02 | Rake €0 
Seat 1: OSPREYSTORM (button) folded before Flop (didn't bet)
Seat 2: caduceus369 (small blind) folded before Flop
Seat 3: LolloSpino (big blind) collected (€0.02)
Seat 4: cucciolo4447 folded before Flop (didn't bet)
Seat 5: zicky78.r folded before Flop (didn't bet)
Seat 6: ADRIAN0_MEIS folded before Flop (didn't bet)



PokerStars Zoom Hand #257999082167:  Hold'em No Limit (€0.01/€0.02) [ADM ID: M62BD3044A1E13PD] - 2025/10/04 21:44:29 CET [2025/10/04 15:44:29 ET]
Table 'Sirio' 6-max Seat #1 is the button
Seat 1: pylonstrip (€2.89 in chips) 
Seat 2: zicky78.r (€2.02 in chips) 
Seat 3: GanchanS7 (€2.93 in chips) 
Seat 4: father2008 (€2.04 in chips) 
Seat 5: caduceus369 (€3.45 in chips) 
Seat 6: OSPREYSTORM (€2.03 in chips) 
zicky78.r: posts small blind €0.01
GanchanS7: posts big blind €0.02
*** HOLE CARDS ***
Dealt to caduceus369 [3h Ad]
father2008: folds 
caduceus369: folds 
OSPREYSTORM: folds 
pylonstrip: folds 
zicky78.r: folds 
Uncalled bet (€0.01) returned to GanchanS7
GanchanS7 collected €0.02 from pot
GanchanS7: doesn't show hand 
*** SUMMARY ***
Total pot €0.02 | Rake €0 
Seat 1: pylonstrip (button) folded before Flop (didn't bet)
Seat 2: zicky78.r (small blind) folded before Flop
Seat 3: GanchanS7 (big blind) collected (€0.02)
Seat 4: father2008 folded before Flop (didn't bet)
Seat 5: caduceus369 folded before Flop (didn't bet)
Seat 6: OSPREYSTORM folded before Flop (didn't bet)



PokerStars Zoom Hand #257999083336:  Hold'em No Limit (€0.01/€0.02) [ADM ID: M62BD3044A1E13PD] - 2025/10/04 21:44:34 CET [2025/10/04 15:44:34 ET]
Table 'Sirio' 6-max Seat #1 is the button
Seat 1: caduceus369 (€3.45 in chips) 
Seat 2: OSPREYSTORM (€2.03 in chips) 
Seat 3: pylonstrip (€2.89 in chips) 
Seat 4: father2008 (€2.04 in chips) 
Seat 5: zicky78.r (€4.47 in chips) 
Seat 6: Mila727 (€5.14 in chips) 
OSPREYSTORM: posts small blind €0.01
pylonstrip: posts big blind €0.02
*** HOLE CARDS ***
Dealt to caduceus369 [Kd 5h]
father2008: folds 
zicky78.r: folds 
Mila727: folds 
caduceus369: folds 
OSPREYSTORM: folds 
Uncalled bet (€0.01) returned to pylonstrip
pylonstrip collected €0.02 from pot
pylonstrip: doesn't show hand 
*** SUMMARY ***
Total pot €0.02 | Rake €0 
Seat 1: caduceus369 (button) folded before Flop (didn't bet)
Seat 2: OSPREYSTORM (small blind) folded before Flop
Seat 3: pylonstrip (big blind) collected (€0.02)
Seat 4: father2008 folded before Flop (didn't bet)
Seat 5: zicky78.r folded before Flop (didn't bet)
Seat 6: Mila727 folded before Flop (didn't bet)



PokerStars Zoom Hand #257999084732:  Hold'em No Limit (€0.01/€0.02) [ADM ID: M62BD3044A1E13PD] - 2025/10/04 21:44:40 CET [2025/10/04 15:44:40 ET]
Table 'Sirio' 6-max Seat #1 is the button
Seat 1: OSPREYSTORM (€1.97 in chips) 
Seat 2: GanchanS7 (€5.45 in chips) 
Seat 3: Mila727 (€5.14 in chips) 
Seat 4: ADRIAN0_MEIS (€5.24 in chips) 
Seat 5: Catania838 (€1.98 in chips) 
Seat 6: caduceus369 (€3.45 in chips) 
GanchanS7: posts small blind €0.01
Mila727: posts big blind €0.02
*** HOLE CARDS ***
Dealt to caduceus369 [4d As]
ADRIAN0_MEIS: folds 
Catania838: folds 
caduceus369: folds 
OSPREYSTORM: raises €0.04 to €0.06
GanchanS7: folds 
Mila727: folds 
Uncalled bet (€0.04) returned to OSPREYSTORM
OSPREYSTORM collected €0.05 from pot
OSPREYSTORM: doesn't show hand 
*** SUMMARY ***
Total pot €0.05 | Rake €0 
Seat 1: OSPREYSTORM (button) collected (€0.05)
Seat 2: GanchanS7 (small blind) folded before Flop
Seat 3: Mila727 (big blind) folded before Flop
Seat 4: ADRIAN0_MEIS folded before Flop (didn't bet)
Seat 5: Catania838 folded before Flop (didn't bet)
Seat 6: caduceus369 folded before Flop (didn't bet)



PokerStars Zoom Hand #257999088649:  Hold'em No Limit (€0.01/€0.02) [ADM ID: M62BD3044A1E13PD] - 2025/10/04 21:44:57 CET [2025/10/04 15:44:57 ET]
Table 'Sirio' 6-max Seat #1 is the button
Seat 1: ADRIAN0_MEIS (€2.99 in chips) 
Seat 2: DAMPER_KK (€2.01 in chips) 
Seat 3: caduceus369 (€3.45 in chips) 
Seat 4: zicky78.r (€4.47 in chips) 
Seat 5: stefano997 (€0.78 in chips) 
Seat 6: Catania838 (€1.44 in chips) 
DAMPER_KK: posts small blind €0.01
caduceus369: posts big blind €0.02
*** HOLE CARDS ***
Dealt to caduceus369 [8d 8s]
zicky78.r: raises €0.03 to €0.05
stefano997: calls €0.05
Catania838: folds 
ADRIAN0_MEIS: folds 
DAMPER_KK: calls €0.04
caduceus369: calls €0.03
*** FLOP *** [Qs Ad 8h]
DAMPER_KK: checks 
caduceus369: bets €0.02
zicky78.r: calls €0.02
stefano997: calls €0.02
DAMPER_KK: calls €0.02
*** TURN *** [Qs Ad 8h] [2h]
DAMPER_KK: checks 
caduceus369: bets €0.06
zicky78.r: calls €0.06
stefano997: folds 
DAMPER_KK: calls €0.06
*** RIVER *** [Qs Ad 8h 2h] [7d]
DAMPER_KK: checks 
caduceus369: bets €0.52
zicky78.r: folds 
DAMPER_KK: calls €0.52
*** SHOW DOWN ***
caduceus369: shows [8d 8s] (three of a kind, Eights)
DAMPER_KK: mucks hand 
caduceus369 collected €1.42 from pot
*** SUMMARY ***
Total pot €1.50 | Rake €0.08 
Board [Qs Ad 8h 2h 7d]
Seat 1: ADRIAN0_MEIS (button) folded before Flop (didn't bet)
Seat 2: DAMPER_KK (small blind) mucked [4d As]
Seat 3: caduceus369 (big blind) showed [8d 8s] and won (€1.42) with three of a kind, Eights
Seat 4: zicky78.r folded on the River
Seat 5: stefano997 folded on the Turn
Seat 6: Catania838 folded before Flop (didn't bet)



PokerStars Zoom Hand #257999111463:  Hold'em No Limit (€0.01/€0.02) [ADM ID: M62BD3044A1E13PD] - 2025/10/04 21:46:35 CET [2025/10/04 15:46:35 ET]
Table 'Sirio' 6-max Seat #1 is the button
Seat 1: OSPREYSTORM (€1.94 in chips) 
Seat 2: GanchanS7 (€5.48 in chips) 
Seat 3: ADRIAN0_MEIS (€3.19 in chips) 
Seat 4: caduceus369 (€4.22 in chips) 
Seat 5: zicky78.r (€2.36 in chips) 
Seat 6: Catania838 (€2.03 in chips) 
GanchanS7: posts small blind €0.01
ADRIAN0_MEIS: posts big blind €0.02
*** HOLE CARDS ***
Dealt to caduceus369 [2s Ac]
caduceus369: folds 
zicky78.r: folds 
Catania838: folds 
OSPREYSTORM: folds 
GanchanS7: folds 
Uncalled bet (€0.01) returned to ADRIAN0_MEIS
ADRIAN0_MEIS collected €0.02 from pot
ADRIAN0_MEIS: doesn't show hand 
*** SUMMARY ***
Total pot €0.02 | Rake €0 
Seat 1: OSPREYSTORM (button) folded before Flop (didn't bet)
Seat 2: GanchanS7 (small blind) folded before Flop
Seat 3: ADRIAN0_MEIS (big blind) collected (€0.02)
Seat 4: caduceus369 folded before Flop (didn't bet)
Seat 5: zicky78.r folded before Flop (didn't bet)
Seat 6: Catania838 folded before Flop (didn't bet)



PokerStars Zoom Hand #257999112604:  Hold'em No Limit (€0.01/€0.02) [ADM ID: M62BD3044A1E13PD] - 2025/10/04 21:46:40 CET [2025/10/04 15:46:40 ET]
Table 'Sirio' 6-max Seat #1 is the button
Seat 1: ADRIAN0_MEIS (€5.22 in chips) 
Seat 2: monsterc99 (€0.75 in chips) 
Seat 3: OSPREYSTORM (€2 in chips) 
Seat 4: caduceus369 (€4.22 in chips) 
Seat 5: Kazzimmino (€1.44 in chips) 
Seat 6: zicky78.r (€2 in chips) 
monsterc99: posts small blind €0.01
OSPREYSTORM: posts big blind €0.02
*** HOLE CARDS ***
Dealt to caduceus369 [Ad 9d]
caduceus369: raises €0.04 to €0.06
Kazzimmino: raises €0.08 to €0.14
zicky78.r: folds 
ADRIAN0_MEIS: folds 
monsterc99: folds 
OSPREYSTORM: folds 
caduceus369: calls €0.08
*** FLOP *** [Qd 4d 9s]
caduceus369: checks 
Kazzimmino: bets €0.17
caduceus369: calls €0.17
*** TURN *** [Qd 4d 9s] [5h]
caduceus369: checks 
Kazzimmino: checks 
*** RIVER *** [Qd 4d 9s 5h] [6d]
caduceus369: bets €0.14
Kazzimmino: calls €0.14
*** SHOW DOWN ***
caduceus369: shows [Ad 9d] (a flush, Ace high)
Kazzimmino: mucks hand 
caduceus369 collected €0.88 from pot
*** SUMMARY ***
Total pot €0.93 | Rake €0.05 
Board [Qd 4d 9s 5h 6d]
Seat 1: ADRIAN0_MEIS (button) folded before Flop (didn't bet)
Seat 2: monsterc99 (small blind) folded before Flop
Seat 3: OSPREYSTORM (big blind) folded before Flop
Seat 4: caduceus369 showed [Ad 9d] and won (€0.88) with a flush, Ace high
Seat 5: Kazzimmino mucked [Jd Js]
Seat 6: zicky78.r folded before Flop (didn't bet)



PokerStars Zoom Hand #257999125373:  Hold'em No Limit (€0.01/€0.02) [ADM ID: M62BD3044A1E13PD] - 2025/10/04 21:47:36 CET [2025/10/04 15:47:36 ET]
Table 'Sirio' 6-max Seat #1 is the button
Seat 1: father2008 (€2.06 in chips) 
Seat 2: caduceus369 (€4.65 in chips) 
Seat 3: CIKO71131 (€0.58 in chips) 
Seat 4: stefano997 (€0.57 in chips) 
Seat 5: GanchanS7 (€2.83 in chips) 
Seat 6: OSPREYSTORM (€1.97 in chips) 
caduceus369: posts small blind €0.01
CIKO71131: posts big blind €0.02
*** HOLE CARDS ***
Dealt to caduceus369 [Td 7h]
stefano997: calls €0.02
GanchanS7: folds 
OSPREYSTORM: raises €0.06 to €0.08
father2008: folds 
caduceus369: folds 
CIKO71131: calls €0.06
stefano997: calls €0.06
*** FLOP *** [9h 3h 2s]
CIKO71131: checks 
stefano997: checks 
OSPREYSTORM: bets €0.08
CIKO71131: calls €0.08
stefano997: folds 
*** TURN *** [9h 3h 2s] [Ks]
CIKO71131: checks 
OSPREYSTORM: bets €0.21
CIKO71131: folds 
Uncalled bet (€0.21) returned to OSPREYSTORM
OSPREYSTORM collected €0.39 from pot
OSPREYSTORM: doesn't show hand 
*** SUMMARY ***
Total pot €0.41 | Rake €0.02 
Board [9h 3h 2s Ks]
Seat 1: father2008 (button) folded before Flop (didn't bet)
Seat 2: caduceus369 (small blind) folded before Flop
Seat 3: CIKO71131 (big blind) folded on the Turn
Seat 4: stefano997 folded on the Flop
Seat 5: GanchanS7 folded before Flop (didn't bet)
Seat 6: OSPREYSTORM collected (€0.39)



PokerStars Zoom Hand #257999130154:  Hold'em No Limit (€0.01/€0.02) [ADM ID: M62BD3044A1E13PD] - 2025/10/04 21:47:57 CET [2025/10/04 15:47:57 ET]
Table 'Sirio' 6-max Seat #1 is the button
Seat 1: CIKO71131 (€1.05 in chips) 
Seat 2: Kazzimmino (€1.98 in chips) 
Seat 3: zicky78.r (€4.30 in chips) 
Seat 4: VagALiss (€2.10 in chips) 
Seat 5: caduceus369 (€4.64 in chips) 
Seat 6: willydag94 (€0.42 in chips) 
Kazzimmino: posts small blind €0.01
zicky78.r: posts big blind €0.02
*** HOLE CARDS ***
Dealt to caduceus369 [Kc 6h]
VagALiss: raises €0.03 to €0.05
caduceus369: folds 
willydag94: folds 
CIKO71131: calls €0.05
Kazzimmino: folds 
zicky78.r: calls €0.03
*** FLOP *** [4d 9d Qs]
zicky78.r: checks 
VagALiss: bets €0.08
CIKO71131: folds 
zicky78.r: folds 
Uncalled bet (€0.08) returned to VagALiss
VagALiss collected €0.16 from pot
VagALiss: doesn't show hand 
*** SUMMARY ***
Total pot €0.16 | Rake €0 
Board [4d 9d Qs]
Seat 1: CIKO71131 (button) folded on the Flop
Seat 2: Kazzimmino (small blind) folded before Flop
Seat 3: zicky78.r (big blind) folded on the Flop
Seat 4: VagALiss collected (€0.16)
Seat 5: caduceus369 folded before Flop (didn't bet)
Seat 6: willydag94 folded before Flop (didn't bet)



PokerStars Zoom Hand #257999131527:  Hold'em No Limit (€0.01/€0.02) [ADM ID: M62BD3044A1E13PD] - 2025/10/04 21:48:03 CET [2025/10/04 15:48:03 ET]
Table 'Sirio' 6-max Seat #1 is the button
Seat 1: LolloSpino (€0.49 in chips) 
Seat 2: cucciolo4447 (€1.40 in chips) 
Seat 3: caduceus369 (€4.64 in chips) 
Seat 4: willydag94 (€0.42 in chips) 
Seat 5: GanchanS7 (€2.40 in chips) 
Seat 6: ADRIAN0_MEIS (€5.22 in chips) 
cucciolo4447: posts small blind €0.01
caduceus369: posts big blind €0.02
*** HOLE CARDS ***
Dealt to caduceus369 [8c Ks]
willydag94: folds 
GanchanS7: folds 
ADRIAN0_MEIS: raises €0.05 to €0.07
LolloSpino: raises €0.42 to €0.49 and is all-in
cucciolo4447: folds 
caduceus369: folds 
ADRIAN0_MEIS: calls €0.42
*** FLOP *** [3h 3d Th]
*** TURN *** [3h 3d Th] [4d]
*** RIVER *** [3h 3d Th 4d] [7d]
*** SHOW DOWN ***
ADRIAN0_MEIS: shows [Qh Qd] (two pair, Queens and Threes)
LolloSpino: shows [Ad 5d] (a flush, Ace high)
LolloSpino collected €0.96 from pot
*** SUMMARY ***
Total pot €1.01 | Rake €0.05 
Board [3h 3d Th 4d 7d]
Seat 1: LolloSpino (button) showed [Ad 5d] and won (€0.96) with a flush, Ace high
Seat 2: cucciolo4447 (small blind) folded before Flop
Seat 3: caduceus369 (big blind) folded before Flop
Seat 4: willydag94 folded before Flop (didn't bet)
Seat 5: GanchanS7 folded before Flop (didn't bet)
Seat 6: ADRIAN0_MEIS showed [Qh Qd] and lost with two pair, Queens and Threes



PokerStars Zoom Hand #257999134648:  Hold'em No Limit (€0.01/€0.02) [ADM ID: M62BD3044A1E13PD] - 2025/10/04 21:48:17 CET [2025/10/04 15:48:17 ET]
Table 'Sirio' 6-max Seat #1 is the button
Seat 1: caduceus369 (€4.62 in chips) 
Seat 2: N0thingforU (€3.54 in chips) 
Seat 3: Gabrielefante (€7.15 in chips) 
Seat 4: Max071958 (€2.15 in chips) 
Seat 5: cucciolo4447 (€1.39 in chips) 
Seat 6: diesel197474 (€0.68 in chips) 
N0thingforU: posts small blind €0.01
Gabrielefante: posts big blind €0.02
*** HOLE CARDS ***
Dealt to caduceus369 [Qh Qc]
Max071958: calls €0.02
cucciolo4447: calls €0.02
diesel197474: folds 
caduceus369: raises €0.10 to €0.12
N0thingforU: calls €0.11
Gabrielefante: folds 
Max071958: calls €0.10
cucciolo4447: calls €0.10
*** FLOP *** [2s Kc 2d]
N0thingforU: checks 
Max071958: checks 
cucciolo4447: checks 
caduceus369: checks 
*** TURN *** [2s Kc 2d] [7h]
N0thingforU: checks 
Max071958: checks 
cucciolo4447: checks 
caduceus369: checks 
*** RIVER *** [2s Kc 2d 7h] [9s]
N0thingforU: bets €0.02
Max071958: calls €0.02
cucciolo4447: folds 
caduceus369: calls €0.02
*** SHOW DOWN ***
N0thingforU: shows [3s 3d] (two pair, Threes and Deuces)
Max071958: shows [9c Ad] (two pair, Nines and Deuces)
caduceus369: shows [Qh Qc] (two pair, Queens and Deuces)
caduceus369 collected €0.53 from pot
*** SUMMARY ***
Total pot €0.56 | Rake €0.03 
Board [2s Kc 2d 7h 9s]
Seat 1: caduceus369 (button) showed [Qh Qc] and won (€0.53) with two pair, Queens and Deuces
Seat 2: N0thingforU (small blind) showed [3s 3d] and lost with two pair, Threes and Deuces
Seat 3: Gabrielefante (big blind) folded before Flop
Seat 4: Max071958 showed [9c Ad] and lost with two pair, Nines and Deuces
Seat 5: cucciolo4447 folded on the River
Seat 6: diesel197474 folded before Flop (didn't bet)



PokerStars Zoom Hand #257999148659:  Hold'em No Limit (€0.01/€0.02) [ADM ID: M62BD3044A1E13PD] - 2025/10/04 21:49:19 CET [2025/10/04 15:49:19 ET]
Table 'Sirio' 6-max Seat #1 is the button
Seat 1: caduceus369 (€5.01 in chips) 
Seat 2: monsterc99 (€1.08 in chips) 
Seat 3: diesel197474 (€0.65 in chips) 
Seat 4: pylonstrip (€3.86 in chips) 
Seat 5: zicky78.r (€3.95 in chips) 
Seat 6: OSPREYSTORM (€2.29 in chips) 
monsterc99: posts small blind €0.01
diesel197474: posts big blind €0.02
*** HOLE CARDS ***
Dealt to caduceus369 [9d Tc]
pylonstrip: folds 
zicky78.r: folds 
OSPREYSTORM: folds 
caduceus369: folds 
monsterc99: folds 
Uncalled bet (€0.01) returned to diesel197474
diesel197474 collected €0.02 from pot
diesel197474: doesn't show hand 
*** SUMMARY ***
Total pot €0.02 | Rake €0 
Seat 1: caduceus369 (button) folded before Flop (didn't bet)
Seat 2: monsterc99 (small blind) folded before Flop
Seat 3: diesel197474 (big blind) collected (€0.02)
Seat 4: pylonstrip folded before Flop (didn't bet)
Seat 5: zicky78.r folded before Flop (didn't bet)
Seat 6: OSPREYSTORM folded before Flop (didn't bet)



PokerStars Zoom Hand #257999149989:  Hold'em No Limit (€0.01/€0.02) [ADM ID: M62BD3044A1E13PD] - 2025/10/04 21:49:25 CET [2025/10/04 15:49:25 ET]
Table 'Sirio' 6-max Seat #1 is the button
Seat 1: ADRIAN0_MEIS (€3.23 in chips) 
Seat 2: caduceus369 (€5.01 in chips) 
Seat 3: N0thingforU (€3.40 in chips) 
Seat 4: father2008 (€2 in chips) 
Seat 5: darkodiablo (€1.13 in chips) 
Seat 6: willydag94 (€2 in chips) 
caduceus369: posts small blind €0.01
N0thingforU: posts big blind €0.02
*** HOLE CARDS ***
Dealt to caduceus369 [5c 4c]
father2008: folds 
darkodiablo: folds 
willydag94: raises €0.03 to €0.05
ADRIAN0_MEIS: folds 
caduceus369: folds 
N0thingforU: folds 
Uncalled bet (€0.03) returned to willydag94
willydag94 collected €0.05 from pot
willydag94: doesn't show hand 
*** SUMMARY ***
Total pot €0.05 | Rake €0 
Seat 1: ADRIAN0_MEIS (button) folded before Flop (didn't bet)
Seat 2: caduceus369 (small blind) folded before Flop
Seat 3: N0thingforU (big blind) folded before Flop
Seat 4: father2008 folded before Flop (didn't bet)
Seat 5: darkodiablo folded before Flop (didn't bet)
Seat 6: willydag94 collected (€0.05)



PokerStars Zoom Hand #257999151773:  Hold'em No Limit (€0.01/€0.02) [ADM ID: M62BD3044A1E13PD] - 2025/10/04 21:49:33 CET [2025/10/04 15:49:33 ET]
Table 'Sirio' 6-max Seat #1 is the button
Seat 1: zicky78.r (€2.06 in chips) 
Seat 2: darkodiablo (€1.13 in chips) 
Seat 3: caduceus369 (€5 in chips) 
Seat 4: LolloSpino (€0.93 in chips) 
Seat 5: N0thingforU (€3.38 in chips) 
Seat 6: andree128 (€1.33 in chips) 
darkodiablo: posts small blind €0.01
caduceus369: posts big blind €0.02
*** HOLE CARDS ***
Dealt to caduceus369 [Qd 6s]
LolloSpino: folds 
N0thingforU: folds 
andree128: folds 
zicky78.r: folds 
darkodiablo: raises €0.06 to €0.08
caduceus369: folds 
Uncalled bet (€0.06) returned to darkodiablo
darkodiablo collected €0.04 from pot
darkodiablo: doesn't show hand 
*** SUMMARY ***
Total pot €0.04 | Rake €0 
Seat 1: zicky78.r (button) folded before Flop (didn't bet)
Seat 2: darkodiablo (small blind) collected (€0.04)
Seat 3: caduceus369 (big blind) folded before Flop
Seat 4: LolloSpino folded before Flop (didn't bet)
Seat 5: N0thingforU folded before Flop (didn't bet)
Seat 6: andree128 folded before Flop (didn't bet)



PokerStars Zoom Hand #257999147293:  Hold'em No Limit (€0.01/€0.02) [ADM ID: M62BD3044A1E13PD] - 2025/10/04 21:49:13 CET [2025/10/04 15:49:13 ET]
Table 'Sirio' 6-max Seat #1 is the button
Seat 1: Kazzimmino (€1.98 in chips) 
Seat 2: zicky78.r (€2.42 in chips) 
Seat 3: Max071958 (€2.01 in chips) 
Seat 4: N0thingforU (€3.40 in chips) 
Seat 5: darkodiablo (€1.15 in chips) 
Seat 6: caduceus369 (€5.01 in chips) 
zicky78.r: posts small blind €0.01
Max071958: posts big blind €0.02
*** HOLE CARDS ***
Dealt to caduceus369 [8d 7s]
N0thingforU: folds 
darkodiablo: folds 
caduceus369: folds 
Kazzimmino: folds 
zicky78.r: raises €0.03 to €0.05
Max071958: calls €0.03
*** FLOP *** [3h Jh Jd]
zicky78.r: checks 
Max071958: checks 
*** TURN *** [3h Jh Jd] [3c]
zicky78.r: checks 
Max071958: checks 
*** RIVER *** [3h Jh Jd 3c] [Ts]
zicky78.r: checks 
Max071958: checks 
*** SHOW DOWN ***
zicky78.r: shows [7c Ah] (two pair, Jacks and Threes)
Max071958: mucks hand 
zicky78.r collected €0.10 from pot
*** SUMMARY ***
Total pot €0.10 | Rake €0 
Board [3h Jh Jd 3c Ts]
Seat 1: Kazzimmino (button) folded before Flop (didn't bet)
Seat 2: zicky78.r (small blind) showed [7c Ah] and won (€0.10) with two pair, Jacks and Threes
Seat 3: Max071958 (big blind) mucked [Kc 9d]
Seat 4: N0thingforU folded before Flop (didn't bet)
Seat 5: darkodiablo folded before Flop (didn't bet)
Seat 6: caduceus369 folded before Flop (didn't bet)



PokerStars Zoom Hand #257999158098:  Hold'em No Limit (€0.01/€0.02) [ADM ID: M62BD3044A1E13PD] - 2025/10/04 21:50:01 CET [2025/10/04 15:50:01 ET]
Table 'Sirio' 6-max Seat #1 is the button
Seat 1: OSPREYSTORM (€2.30 in chips) 
Seat 2: caduceus369 (€4.98 in chips) 
Seat 3: Catania838 (€1.14 in chips) 
Seat 4: Kazzimmino (€1.97 in chips) 
Seat 5: GanchanS7 (€2.03 in chips) 
Seat 6: zicky78.r (€2.06 in chips) 
caduceus369: posts small blind €0.01
Catania838: posts big blind €0.02
*** HOLE CARDS ***
Dealt to caduceus369 [7s 3c]
Kazzimmino: folds 
GanchanS7: folds 
zicky78.r: folds 
OSPREYSTORM: folds 
caduceus369: folds 
Uncalled bet (€0.01) returned to Catania838
Catania838 collected €0.02 from pot
Catania838: doesn't show hand 
*** SUMMARY ***
Total pot €0.02 | Rake €0 
Seat 1: OSPREYSTORM (button) folded before Flop (didn't bet)
Seat 2: caduceus369 (small blind) folded before Flop
Seat 3: Catania838 (big blind) collected (€0.02)
Seat 4: Kazzimmino folded before Flop (didn't bet)
Seat 5: GanchanS7 folded before Flop (didn't bet)
Seat 6: zicky78.r folded before Flop (didn't bet)



PokerStars Zoom Hand #257999160403:  Hold'em No Limit (€0.01/€0.02) [ADM ID: M62BD3044A1E13PD] - 2025/10/04 21:50:11 CET [2025/10/04 15:50:11 ET]
Table 'Sirio' 6-max Seat #1 is the button
Seat 1: andree128 (€1.33 in chips) 
Seat 2: pylonstrip (€3.89 in chips) 
Seat 3: VE SCAVES (€1.23 in chips) 
Seat 4: caduceus369 (€4.97 in chips) 
Seat 5: zicky78.r (€2.06 in chips) 
Seat 6: VagALiss (€2.19 in chips) 
pylonstrip: posts small blind €0.01
VE SCAVES: posts big blind €0.02
*** HOLE CARDS ***
Dealt to caduceus369 [2h 9c]
caduceus369: folds 
zicky78.r: folds 
VagALiss: folds 
andree128: folds 
pylonstrip: folds 
Uncalled bet (€0.01) returned to VE SCAVES
VE SCAVES collected €0.02 from pot
VE SCAVES: doesn't show hand 
*** SUMMARY ***
Total pot €0.02 | Rake €0 
Seat 1: andree128 (button) folded before Flop (didn't bet)
Seat 2: pylonstrip (small blind) folded before Flop
Seat 3: VE SCAVES (big blind) collected (€0.02)
Seat 4: caduceus369 folded before Flop (didn't bet)
Seat 5: zicky78.r folded before Flop (didn't bet)
Seat 6: VagALiss folded before Flop (didn't bet)



PokerStars Zoom Hand #257999155169:  Hold'em No Limit (€0.01/€0.02) [ADM ID: M62BD3044A1E13PD] - 2025/10/04 21:49:48 CET [2025/10/04 15:49:48 ET]
Table 'Sirio' 6-max Seat #1 is the button
Seat 1: diesel197474 (€0.65 in chips) 
Seat 2: Catania838 (€1.15 in chips) 
Seat 3: monsterc99 (€1.07 in chips) 
Seat 4: darkodiablo (€1.15 in chips) 
Seat 5: caduceus369 (€4.98 in chips) 
Seat 6: LolloSpino (€0.34 in chips) 
Catania838: posts small blind €0.01
monsterc99: posts big blind €0.02
*** HOLE CARDS ***
Dealt to caduceus369 [Td 7s]
darkodiablo: calls €0.02
caduceus369: folds 
LolloSpino: folds 
diesel197474: folds 
Catania838: folds 
monsterc99: checks 
*** FLOP *** [Qc 5c 3c]
monsterc99: checks 
darkodiablo: bets €0.02
monsterc99: calls €0.02
*** TURN *** [Qc 5c 3c] [9c]
monsterc99: checks 
darkodiablo: checks 
*** RIVER *** [Qc 5c 3c 9c] [2h]
monsterc99: checks 
darkodiablo: checks 
*** SHOW DOWN ***
monsterc99: shows [9h Th] (a pair of Nines)
darkodiablo: mucks hand 
monsterc99 collected €0.09 from pot
*** SUMMARY ***
Total pot €0.09 | Rake €0 
Board [Qc 5c 3c 9c 2h]
Seat 1: diesel197474 (button) folded before Flop (didn't bet)
Seat 2: Catania838 (small blind) folded before Flop
Seat 3: monsterc99 (big blind) showed [9h Th] and won (€0.09) with a pair of Nines
Seat 4: darkodiablo mucked [7h 5h]
Seat 5: caduceus369 folded before Flop (didn't bet)
Seat 6: LolloSpino folded before Flop (didn't bet)



PokerStars Zoom Hand #257999156283:  Hold'em No Limit (€0.01/€0.02) [ADM ID: M62BD3044A1E13PD] - 2025/10/04 21:49:53 CET [2025/10/04 15:49:53 ET]
Table 'Sirio' 6-max Seat #1 is the button
Seat 1: Gabrielefante (€7.23 in chips) 
Seat 2: ADRIAN0_MEIS (€3.23 in chips) 
Seat 3: LolloSpino (€0.92 in chips) 
Seat 4: mora009 (€1.95 in chips) 
Seat 5: uziu47 (€1 in chips) 
Seat 6: caduceus369 (€4.98 in chips) 
ADRIAN0_MEIS: posts small blind €0.01
LolloSpino: posts big blind €0.02
*** HOLE CARDS ***
Dealt to caduceus369 [8c Ks]
mora009: calls €0.02
uziu47: folds 
caduceus369: folds 
Gabrielefante: calls €0.02
ADRIAN0_MEIS: folds 
LolloSpino: checks 
*** FLOP *** [Tc Jh Td]
LolloSpino: checks 
mora009: bets €0.02
Gabrielefante: folds 
LolloSpino: calls €0.02
*** TURN *** [Tc Jh Td] [7s]
LolloSpino: checks 
mora009: bets €0.02
LolloSpino: calls €0.02
*** RIVER *** [Tc Jh Td 7s] [6c]
LolloSpino: checks 
mora009: checks 
*** SHOW DOWN ***
LolloSpino: shows [7d Js] (two pair, Jacks and Tens)
mora009: mucks hand 
LolloSpino collected €0.15 from pot
*** SUMMARY ***
Total pot €0.15 | Rake €0 
Board [Tc Jh Td 7s 6c]
Seat 1: Gabrielefante (button) folded on the Flop
Seat 2: ADRIAN0_MEIS (small blind) folded before Flop
Seat 3: LolloSpino (big blind) showed [7d Js] and won (€0.15) with two pair, Jacks and Tens
Seat 4: mora009 mucked [7c Kd]
Seat 5: uziu47 folded before Flop (didn't bet)
Seat 6: caduceus369 folded before Flop (didn't bet)



PokerStars Zoom Hand #257999161939:  Hold'em No Limit (€0.01/€0.02) [ADM ID: M62BD3044A1E13PD] - 2025/10/04 21:50:18 CET [2025/10/04 15:50:18 ET]
Table 'Sirio' 6-max Seat #1 is the button
Seat 1: stefano997 (€0.30 in chips) 
Seat 2: GanchanS7 (€2.77 in chips) 
Seat 3: pylonstrip (€3.88 in chips) 
Seat 4: caduceus369 (€4.97 in chips) 
Seat 5: VagALiss (€2.19 in chips) 
Seat 6: andree128 (€1.33 in chips) 
GanchanS7: posts small blind €0.01
pylonstrip: posts big blind €0.02
*** HOLE CARDS ***
Dealt to caduceus369 [Qh 9c]
caduceus369: folds 
VagALiss: raises €0.03 to €0.05
andree128: folds 
stefano997: folds 
GanchanS7: raises €0.20 to €0.25
pylonstrip: folds 
VagALiss: folds 
Uncalled bet (€0.20) returned to GanchanS7
GanchanS7 collected €0.12 from pot
GanchanS7: doesn't show hand 
*** SUMMARY ***
Total pot €0.12 | Rake €0 
Seat 1: stefano997 (button) folded before Flop (didn't bet)
Seat 2: GanchanS7 (small blind) collected (€0.12)
Seat 3: pylonstrip (big blind) folded before Flop
Seat 4: caduceus369 folded before Flop (didn't bet)
Seat 5: VagALiss folded before Flop
Seat 6: andree128 folded before Flop (didn't bet)



PokerStars Zoom Hand #257999165168:  Hold'em No Limit (€0.01/€0.02) [ADM ID: M62BD3044A1E13PD] - 2025/10/04 21:50:32 CET [2025/10/04 15:50:32 ET]
Table 'Sirio' 6-max Seat #1 is the button
Seat 1: caduceus369 (€4.97 in chips) 
Seat 2: monsterc99 (€1.12 in chips) 
Seat 3: OSPREYSTORM (€2.29 in chips) 
Seat 4: father2008 (€2 in chips) 
Seat 5: zicky78.r (€4.17 in chips) 
Seat 6: GanchanS7 (€2.01 in chips) 
monsterc99: posts small blind €0.01
OSPREYSTORM: posts big blind €0.02
*** HOLE CARDS ***
Dealt to caduceus369 [3c 9d]
father2008: raises €0.05 to €0.07
zicky78.r: folds 
GanchanS7: folds 
caduceus369: folds 
monsterc99: folds 
OSPREYSTORM: folds 
Uncalled bet (€0.05) returned to father2008
father2008 collected €0.05 from pot
father2008: doesn't show hand 
*** SUMMARY ***
Total pot €0.05 | Rake €0 
Seat 1: caduceus369 (button) folded before Flop (didn't bet)
Seat 2: monsterc99 (small blind) folded before Flop
Seat 3: OSPREYSTORM (big blind) folded before Flop
Seat 4: father2008 collected (€0.05)
Seat 5: zicky78.r folded before Flop (didn't bet)
Seat 6: GanchanS7 folded before Flop (didn't bet)



PokerStars Zoom Hand #257999166353:  Hold'em No Limit (€0.01/€0.02) [ADM ID: M62BD3044A1E13PD] - 2025/10/04 21:50:37 CET [2025/10/04 15:50:37 ET]
Table 'Sirio' 6-max Seat #1 is the button
Seat 1: ADRIAN0_MEIS (€2.10 in chips) 
Seat 2: DAMPER_KK (€1.26 in chips) 
Seat 3: Kingo690 (€0.65 in chips) 
Seat 4: stefano997 (€0.30 in chips) 
Seat 5: caduceus369 (€4.97 in chips) 
Seat 6: zicky78.r (€4.17 in chips) 
DAMPER_KK: posts small blind €0.01
Kingo690: posts big blind €0.02
*** HOLE CARDS ***
Dealt to caduceus369 [Th Qd]
stefano997: calls €0.02
caduceus369: folds 
zicky78.r: folds 
ADRIAN0_MEIS: folds 
DAMPER_KK: folds 
Kingo690: checks 
*** FLOP *** [6s 5d Ah]
Kingo690: checks 
stefano997: bets €0.02
Kingo690: folds 
Uncalled bet (€0.02) returned to stefano997
stefano997 collected €0.05 from pot
stefano997: doesn't show hand 
*** SUMMARY ***
Total pot €0.05 | Rake €0 
Board [6s 5d Ah]
Seat 1: ADRIAN0_MEIS (button) folded before Flop (didn't bet)
Seat 2: DAMPER_KK (small blind) folded before Flop
Seat 3: Kingo690 (big blind) folded on the Flop
Seat 4: stefano997 collected (€0.05)
Seat 5: caduceus369 folded before Flop (didn't bet)
Seat 6: zicky78.r folded before Flop (didn't bet)



PokerStars Zoom Hand #257999178193:  Hold'em No Limit (€0.01/€0.02) [ADM ID: M62BD3044A1E13PD] - 2025/10/04 21:51:29 CET [2025/10/04 15:51:29 ET]
Table 'Sirio' 6-max Seat #1 is the button
Seat 1: VagALiss (€2.15 in chips) 
Seat 2: zicky78.r (€4.17 in chips) 
Seat 3: emidio92 (€2 in chips) 
Seat 4: trillycata (€1.09 in chips) 
Seat 5: GanchanS7 (€2.06 in chips) 
Seat 6: caduceus369 (€4.97 in chips) 
zicky78.r: posts small blind €0.01
emidio92: posts big blind €0.02
*** HOLE CARDS ***
Dealt to caduceus369 [Ah 9h]
trillycata: folds 
GanchanS7: folds 
caduceus369: raises €0.04 to €0.06
VagALiss: folds 
zicky78.r: folds 
emidio92: folds 
Uncalled bet (€0.04) returned to caduceus369
caduceus369 collected €0.05 from pot
caduceus369: doesn't show hand 
*** SUMMARY ***
Total pot €0.05 | Rake €0 
Seat 1: VagALiss (button) folded before Flop (didn't bet)
Seat 2: zicky78.r (small blind) folded before Flop
Seat 3: emidio92 (big blind) folded before Flop
Seat 4: trillycata folded before Flop (didn't bet)
Seat 5: GanchanS7 folded before Flop (didn't bet)
Seat 6: caduceus369 collected (€0.05)



PokerStars Zoom Hand #257999182284:  Hold'em No Limit (€0.01/€0.02) [ADM ID: M62BD3044A1E13PD] - 2025/10/04 21:51:47 CET [2025/10/04 15:51:47 ET]
Table 'Sirio' 6-max Seat #1 is the button
Seat 1: father2008 (€2.34 in chips) 
Seat 2: emidio92 (€2 in chips) 
Seat 3: caduceus369 (€5 in chips) 
Seat 4: Catania838 (€2.41 in chips) 
Seat 5: LolloSpino (€0.80 in chips) 
Seat 6: zicky78.r (€2.37 in chips) 
emidio92: posts small blind €0.01
caduceus369: posts big blind €0.02
*** HOLE CARDS ***
Dealt to caduceus369 [Qs 4s]
Catania838: folds 
LolloSpino: folds 
zicky78.r: folds 
father2008: raises €0.04 to €0.06
emidio92: raises €0.18 to €0.24
caduceus369: folds 
father2008: folds 
Uncalled bet (€0.18) returned to emidio92
emidio92 collected €0.14 from pot
emidio92: doesn't show hand 
*** SUMMARY ***
Total pot €0.14 | Rake €0 
Seat 1: father2008 (button) folded before Flop
Seat 2: emidio92 (small blind) collected (€0.14)
Seat 3: caduceus369 (big blind) folded before Flop
Seat 4: Catania838 folded before Flop (didn't bet)
Seat 5: LolloSpino folded before Flop (didn't bet)
Seat 6: zicky78.r folded before Flop (didn't bet)



PokerStars Zoom Hand #257999185253:  Hold'em No Limit (€0.01/€0.02) [ADM ID: M62BD3044A1E13PD] - 2025/10/04 21:52:00 CET [2025/10/04 15:52:00 ET]
Table 'Sirio' 6-max Seat #1 is the button
Seat 1: stefano997 (€0.61 in chips) 
Seat 2: caduceus369 (€4.98 in chips) 
Seat 3: ADRIAN0_MEIS (€2.94 in chips) 
Seat 4: Gabrielefante (€7.06 in chips) 
Seat 5: LolloSpino (€0.97 in chips) 
Seat 6: Kingo690 (€0.38 in chips) 
caduceus369: posts small blind €0.01
ADRIAN0_MEIS: posts big blind €0.02
*** HOLE CARDS ***
Dealt to caduceus369 [Th 8s]
Gabrielefante: raises €0.02 to €0.04
LolloSpino: folds 
Kingo690: folds 
stefano997: folds 
caduceus369: folds 
ADRIAN0_MEIS: folds 
Uncalled bet (€0.02) returned to Gabrielefante
Gabrielefante collected €0.05 from pot
Gabrielefante: doesn't show hand 
*** SUMMARY ***
Total pot €0.05 | Rake €0 
Seat 1: stefano997 (button) folded before Flop (didn't bet)
Seat 2: caduceus369 (small blind) folded before Flop
Seat 3: ADRIAN0_MEIS (big blind) folded before Flop
Seat 4: Gabrielefante collected (€0.05)
Seat 5: LolloSpino folded before Flop (didn't bet)
Seat 6: Kingo690 folded before Flop (didn't bet)



PokerStars Zoom Hand #257999186913:  Hold'em No Limit (€0.01/€0.02) [ADM ID: M62BD3044A1E13PD] - 2025/10/04 21:52:08 CET [2025/10/04 15:52:08 ET]
Table 'Sirio' 6-max Seat #1 is the button
Seat 1: caduceus369 (€4.97 in chips) 
Seat 2: emidio92 (€2 in chips) 
Seat 3: Kingo690 (€0.38 in chips) 
Seat 4: Mila727 (€4.62 in chips) 
Seat 5: ADRIAN0_MEIS (€2.32 in chips) 
Seat 6: GanchanS7 (€2.76 in chips) 
emidio92: posts small blind €0.01
Kingo690: posts big blind €0.02
*** HOLE CARDS ***
Dealt to caduceus369 [2h 4s]
Mila727: folds 
ADRIAN0_MEIS: folds 
GanchanS7: raises €0.03 to €0.05
caduceus369: folds 
emidio92: folds 
Kingo690: calls €0.03
*** FLOP *** [Jd Qd 4c]
Kingo690: checks 
GanchanS7: checks 
*** TURN *** [Jd Qd 4c] [Ks]
Kingo690: bets €0.02
GanchanS7: calls €0.02
*** RIVER *** [Jd Qd 4c Ks] [5s]
Kingo690: bets €0.02
GanchanS7: folds 
Uncalled bet (€0.02) returned to Kingo690
Kingo690 collected €0.15 from pot
Kingo690: doesn't show hand 
*** SUMMARY ***
Total pot €0.15 | Rake €0 
Board [Jd Qd 4c Ks 5s]
Seat 1: caduceus369 (button) folded before Flop (didn't bet)
Seat 2: emidio92 (small blind) folded before Flop
Seat 3: Kingo690 (big blind) collected (€0.15)
Seat 4: Mila727 folded before Flop (didn't bet)
Seat 5: ADRIAN0_MEIS folded before Flop (didn't bet)
Seat 6: GanchanS7 folded on the River



PokerStars Zoom Hand #257999188054:  Hold'em No Limit (€0.01/€0.02) [ADM ID: M62BD3044A1E13PD] - 2025/10/04 21:52:12 CET [2025/10/04 15:52:12 ET]
Table 'Sirio' 6-max Seat #1 is the button
Seat 1: ADRIAN0_MEIS (€2.92 in chips) 
Seat 2: Catania838 (€2.42 in chips) 
Seat 3: caduceus369 (€4.97 in chips) 
Seat 4: father2008 (€2.01 in chips) 
Seat 5: TeoFeli13 (€1.03 in chips) 
Seat 6: trillycata (€1.03 in chips) 
Catania838: posts small blind €0.01
caduceus369: posts big blind €0.02
*** HOLE CARDS ***
Dealt to caduceus369 [8h 4s]
father2008: folds 
TeoFeli13: calls €0.02
trillycata: calls €0.02
ADRIAN0_MEIS: folds 
Catania838: calls €0.01
caduceus369: checks 
*** FLOP *** [3c Jc 6d]
Catania838: checks 
caduceus369: checks 
TeoFeli13: checks 
trillycata: checks 
*** TURN *** [3c Jc 6d] [Kd]
Catania838: checks 
caduceus369: checks 
TeoFeli13: bets €0.04
trillycata: folds 
Catania838: calls €0.04
caduceus369: folds 
*** RIVER *** [3c Jc 6d Kd] [Ks]
Catania838: checks 
TeoFeli13: checks 
*** SHOW DOWN ***
Catania838: shows [5d 9d] (a pair of Kings)
TeoFeli13: shows [Qd 5c] (a pair of Kings - Queen kicker)
TeoFeli13 collected €0.16 from pot
*** SUMMARY ***
Total pot €0.16 | Rake €0 
Board [3c Jc 6d Kd Ks]
Seat 1: ADRIAN0_MEIS (button) folded before Flop (didn't bet)
Seat 2: Catania838 (small blind) showed [5d 9d] and lost with a pair of Kings
Seat 3: caduceus369 (big blind) folded on the Turn
Seat 4: father2008 folded before Flop (didn't bet)
Seat 5: TeoFeli13 showed [Qd 5c] and won (€0.16) with a pair of Kings
Seat 6: trillycata folded on the Turn



PokerStars Zoom Hand #257999200675:  Hold'em No Limit (€0.01/€0.02) [ADM ID: M62BD3044A1E13PD] - 2025/10/04 21:53:08 CET [2025/10/04 15:53:08 ET]
Table 'Sirio' 6-max Seat #1 is the button
Seat 1: OSPREYSTORM (€1.97 in chips) 
Seat 2: GanchanS7 (€2.57 in chips) 
Seat 3: Wunschgast (€6.82 in chips) 
Seat 4: zicky78.r (€3.80 in chips) 
Seat 5: caduceus369 (€4.95 in chips) 
Seat 6: ADRIAN0_MEIS (€4.34 in chips) 
GanchanS7: posts small blind €0.01
Wunschgast: posts big blind €0.02
*** HOLE CARDS ***
Dealt to caduceus369 [9h 8s]
zicky78.r: folds 
caduceus369: folds 
ADRIAN0_MEIS: folds 
OSPREYSTORM: folds 
GanchanS7: folds 
Uncalled bet (€0.01) returned to Wunschgast
Wunschgast collected €0.02 from pot
Wunschgast: doesn't show hand 
*** SUMMARY ***
Total pot €0.02 | Rake €0 
Seat 1: OSPREYSTORM (button) folded before Flop (didn't bet)
Seat 2: GanchanS7 (small blind) folded before Flop
Seat 3: Wunschgast (big blind) collected (€0.02)
Seat 4: zicky78.r folded before Flop (didn't bet)
Seat 5: caduceus369 folded before Flop (didn't bet)
Seat 6: ADRIAN0_MEIS folded before Flop (didn't bet)



PokerStars Zoom Hand #257999202659:  Hold'em No Limit (€0.01/€0.02) [ADM ID: M62BD3044A1E13PD] - 2025/10/04 21:53:17 CET [2025/10/04 15:53:17 ET]
Table 'Sirio' 6-max Seat #1 is the button
Seat 1: ghosto69 (€1.91 in chips) 
Seat 2: caduceus369 (€4.95 in chips) 
Seat 3: zicky78.r (€3.80 in chips) 
Seat 4: LolloSpino (€1.05 in chips) 
Seat 5: emidio92 (€2 in chips) 
Seat 6: OSPREYSTORM (€1.97 in chips) 
caduceus369: posts small blind €0.01
zicky78.r: posts big blind €0.02
*** HOLE CARDS ***
Dealt to caduceus369 [6h 3s]
LolloSpino: folds 
zicky78.r is disconnected 
emidio92: folds 
OSPREYSTORM: folds 
ghosto69: folds 
caduceus369: folds 
Uncalled bet (€0.01) returned to zicky78.r
zicky78.r collected €0.02 from pot
zicky78.r: doesn't show hand 
*** SUMMARY ***
Total pot €0.02 | Rake €0 
Seat 1: ghosto69 (button) folded before Flop (didn't bet)
Seat 2: caduceus369 (small blind) folded before Flop
Seat 3: zicky78.r (big blind) collected (€0.02)
Seat 4: LolloSpino folded before Flop (didn't bet)
Seat 5: emidio92 folded before Flop (didn't bet)
Seat 6: OSPREYSTORM folded before Flop (didn't bet)



PokerStars Zoom Hand #257999205841:  Hold'em No Limit (€0.01/€0.02) [ADM ID: M62BD3044A1E13PD] - 2025/10/04 21:53:31 CET [2025/10/04 15:53:31 ET]
Table 'Sirio' 6-max Seat #1 is the button
Seat 1: caduceus369 (€4.94 in chips) 
Seat 2: GanchanS7 (€5.40 in chips) 
Seat 3: emidio92 (€2 in chips) 
Seat 4: father2008 (€2.03 in chips) 
Seat 5: OSPREYSTORM (€2.67 in chips) 
Seat 6: mora009 (€1.81 in chips) 
GanchanS7: posts small blind €0.01
emidio92: posts big blind €0.02
*** HOLE CARDS ***
Dealt to caduceus369 [Jd Ts]
father2008: folds 
OSPREYSTORM: folds 
mora009: raises €0.02 to €0.04
caduceus369: raises €0.10 to €0.14
GanchanS7: folds 
emidio92: folds 
mora009: folds 
Uncalled bet (€0.10) returned to caduceus369
caduceus369 collected €0.11 from pot
caduceus369: doesn't show hand 
*** SUMMARY ***
Total pot €0.11 | Rake €0 
Seat 1: caduceus369 (button) collected (€0.11)
Seat 2: GanchanS7 (small blind) folded before Flop
Seat 3: emidio92 (big blind) folded before Flop
Seat 4: father2008 folded before Flop (didn't bet)
Seat 5: OSPREYSTORM folded before Flop (didn't bet)
Seat 6: mora009 folded before Flop



PokerStars Zoom Hand #257999201541:  Hold'em No Limit (€0.01/€0.02) [ADM ID: M62BD3044A1E13PD] - 2025/10/04 21:53:12 CET [2025/10/04 15:53:12 ET]
Table 'Sirio' 6-max Seat #1 is the button
Seat 1: GanchanS7 (€2.03 in chips) 
Seat 2: emidio92 (€2.05 in chips) 
Seat 3: Max071958 (€1.20 in chips) 
Seat 4: caduceus369 (€4.95 in chips) 
Seat 5: ghosto69 (€1.89 in chips) 
Seat 6: zicky78.r (€4.40 in chips) 
emidio92: posts small blind €0.01
Max071958: posts big blind €0.02
*** HOLE CARDS ***
Dealt to caduceus369 [6d 3s]
caduceus369: folds 
zicky78.r is disconnected 
ghosto69: raises €0.04 to €0.06
zicky78.r has timed out while disconnected
zicky78.r: folds 
GanchanS7: folds 
emidio92: folds 
Max071958: calls €0.04
*** FLOP *** [Th 4d 8h]
Max071958: bets €0.02
ghosto69: folds 
Uncalled bet (€0.02) returned to Max071958
Max071958 collected €0.13 from pot
Max071958: doesn't show hand 
*** SUMMARY ***
Total pot €0.13 | Rake €0 
Board [Th 4d 8h]
Seat 1: GanchanS7 (button) folded before Flop (didn't bet)
Seat 2: emidio92 (small blind) folded before Flop
Seat 3: Max071958 (big blind) collected (€0.13)
Seat 4: caduceus369 folded before Flop (didn't bet)
Seat 5: ghosto69 folded on the Flop
Seat 6: zicky78.r folded before Flop (didn't bet)



PokerStars Zoom Hand #257999210724:  Hold'em No Limit (€0.01/€0.02) [ADM ID: M62BD3044A1E13PD] - 2025/10/04 21:53:52 CET [2025/10/04 15:53:52 ET]
Table 'Sirio' 6-max Seat #1 is the button
Seat 1: ADRIAN0_MEIS (€2.92 in chips) 
Seat 2: Mila727 (€4.75 in chips) 
Seat 3: emidio92 (€2.04 in chips) 
Seat 4: Gabrielefante (€7.03 in chips) 
Seat 5: GanchanS7 (€2.56 in chips) 
Seat 6: caduceus369 (€5.01 in chips) 
Mila727: posts small blind €0.01
emidio92: posts big blind €0.02
*** HOLE CARDS ***
Dealt to caduceus369 [2h Jh]
Gabrielefante: folds 
GanchanS7: folds 
caduceus369: folds 
ADRIAN0_MEIS: folds 
Mila727: folds 
Uncalled bet (€0.01) returned to emidio92
emidio92 collected €0.02 from pot
emidio92: doesn't show hand 
*** SUMMARY ***
Total pot €0.02 | Rake €0 
Seat 1: ADRIAN0_MEIS (button) folded before Flop (didn't bet)
Seat 2: Mila727 (small blind) folded before Flop
Seat 3: emidio92 (big blind) collected (€0.02)
Seat 4: Gabrielefante folded before Flop (didn't bet)
Seat 5: GanchanS7 folded before Flop (didn't bet)
Seat 6: caduceus369 folded before Flop (didn't bet)



PokerStars Zoom Hand #257999211884:  Hold'em No Limit (€0.01/€0.02) [ADM ID: M62BD3044A1E13PD] - 2025/10/04 21:53:58 CET [2025/10/04 15:53:58 ET]
Table 'Sirio' 6-max Seat #1 is the button
Seat 1: Max071958 (€1.27 in chips) 
Seat 2: Kingo690 (€0.52 in chips) 
Seat 3: caduceus369 (€5.01 in chips) 
Seat 4: GanchanS7 (€5.39 in chips) 
Seat 5: darkodiablo (€1.29 in chips) 
Seat 6: ADRIAN0_MEIS (€4.32 in chips) 
Kingo690: posts small blind €0.01
caduceus369: posts big blind €0.02
*** HOLE CARDS ***
Dealt to caduceus369 [6d 9h]
GanchanS7: folds 
darkodiablo: folds 
ADRIAN0_MEIS: raises €0.05 to €0.07
Max071958: folds 
Kingo690: folds 
caduceus369: folds 
Uncalled bet (€0.05) returned to ADRIAN0_MEIS
ADRIAN0_MEIS collected €0.05 from pot
ADRIAN0_MEIS: doesn't show hand 
*** SUMMARY ***
Total pot €0.05 | Rake €0 
Seat 1: Max071958 (button) folded before Flop (didn't bet)
Seat 2: Kingo690 (small blind) folded before Flop
Seat 3: caduceus369 (big blind) folded before Flop
Seat 4: GanchanS7 folded before Flop (didn't bet)
Seat 5: darkodiablo folded before Flop (didn't bet)
Seat 6: ADRIAN0_MEIS collected (€0.05)



PokerStars Zoom Hand #257999214841:  Hold'em No Limit (€0.01/€0.02) [ADM ID: M62BD3044A1E13PD] - 2025/10/04 21:54:11 CET [2025/10/04 15:54:11 ET]
Table 'Sirio' 6-max Seat #1 is the button
Seat 1: father2008 (€2.17 in chips) 
Seat 2: Alfio4865 (€1.14 in chips) 
Seat 3: OSPREYSTORM (€1.99 in chips) 
Seat 4: ADRIAN0_MEIS (€4.66 in chips) 
Seat 5: caduceus369 (€4.99 in chips) 
Seat 6: Wunschgast (€6.86 in chips) 
Alfio4865: posts small blind €0.01
OSPREYSTORM: posts big blind €0.02
*** HOLE CARDS ***
Dealt to caduceus369 [7c 7s]
ADRIAN0_MEIS: folds 
caduceus369: raises €0.04 to €0.06
Wunschgast: folds 
father2008: folds 
Alfio4865: folds 
OSPREYSTORM: folds 
Uncalled bet (€0.04) returned to caduceus369
caduceus369 collected €0.05 from pot
caduceus369: doesn't show hand 
*** SUMMARY ***
Total pot €0.05 | Rake €0 
Seat 1: father2008 (button) folded before Flop (didn't bet)
Seat 2: Alfio4865 (small blind) folded before Flop
Seat 3: OSPREYSTORM (big blind) folded before Flop
Seat 4: ADRIAN0_MEIS folded before Flop (didn't bet)
Seat 5: caduceus369 collected (€0.05)
Seat 6: Wunschgast folded before Flop (didn't bet)



PokerStars Zoom Hand #257999220014:  Hold'em No Limit (€0.01/€0.02) [ADM ID: M62BD3044A1E13PD] - 2025/10/04 21:54:34 CET [2025/10/04 15:54:34 ET]
Table 'Sirio' 6-max Seat #1 is the button
Seat 1: GanchanS7 (€5.37 in chips) 
Seat 2: Catania838 (€2.48 in chips) 
Seat 3: LolloSpino (€1.11 in chips) 
Seat 4: caduceus369 (€5.02 in chips) 
Seat 5: stefano997 (€0.61 in chips) 
Seat 6: Kazzimmino (€1.74 in chips) 
Catania838: posts small blind €0.01
LolloSpino: posts big blind €0.02
*** HOLE CARDS ***
Dealt to caduceus369 [8h As]
caduceus369: folds 
stefano997: folds 
Kazzimmino: folds 
GanchanS7: folds 
Catania838: folds 
Uncalled bet (€0.01) returned to LolloSpino
LolloSpino collected €0.02 from pot
LolloSpino: doesn't show hand 
*** SUMMARY ***
Total pot €0.02 | Rake €0 
Seat 1: GanchanS7 (button) folded before Flop (didn't bet)
Seat 2: Catania838 (small blind) folded before Flop
Seat 3: LolloSpino (big blind) collected (€0.02)
Seat 4: caduceus369 folded before Flop (didn't bet)
Seat 5: stefano997 folded before Flop (didn't bet)
Seat 6: Kazzimmino folded before Flop (didn't bet)



PokerStars Zoom Hand #257999221082:  Hold'em No Limit (€0.01/€0.02) [ADM ID: M62BD3044A1E13PD] - 2025/10/04 21:54:39 CET [2025/10/04 15:54:39 ET]
Table 'Sirio' 6-max Seat #1 is the button
Seat 1: padisha00 (€1.34 in chips) 
Seat 2: darkodiablo (€1.30 in chips) 
Seat 3: trillycata (€0.97 in chips) 
Seat 4: OSPREYSTORM (€2 in chips) 
Seat 5: Catania838 (€2.41 in chips) 
Seat 6: caduceus369 (€5.02 in chips) 
darkodiablo: posts small blind €0.01
trillycata: posts big blind €0.02
*** HOLE CARDS ***
Dealt to caduceus369 [3s Jd]
OSPREYSTORM: folds 
Catania838: folds 
caduceus369: folds 
padisha00: folds 
darkodiablo: raises €0.06 to €0.08
trillycata: folds 
Uncalled bet (€0.06) returned to darkodiablo
darkodiablo collected €0.04 from pot
darkodiablo: doesn't show hand 
*** SUMMARY ***
Total pot €0.04 | Rake €0 
Seat 1: padisha00 (button) folded before Flop (didn't bet)
Seat 2: darkodiablo (small blind) collected (€0.04)
Seat 3: trillycata (big blind) folded before Flop
Seat 4: OSPREYSTORM folded before Flop (didn't bet)
Seat 5: Catania838 folded before Flop (didn't bet)
Seat 6: caduceus369 folded before Flop (didn't bet)



PokerStars Zoom Hand #257999224715:  Hold'em No Limit (€0.01/€0.02) [ADM ID: M62BD3044A1E13PD] - 2025/10/04 21:54:55 CET [2025/10/04 15:54:55 ET]
Table 'Sirio' 6-max Seat #1 is the button
Seat 1: emidio92 (€2.05 in chips) 
Seat 2: GanchanS7 (€2.76 in chips) 
Seat 3: mora009 (€1.77 in chips) 
Seat 4: ADRIAN0_MEIS (€4.64 in chips) 
Seat 5: caduceus369 (€5.01 in chips) 
Seat 6: Catania838 (€2.41 in chips) 
GanchanS7: posts small blind €0.01
mora009: posts big blind €0.02
*** HOLE CARDS ***
Dealt to caduceus369 [7h 6d]
ADRIAN0_MEIS: folds 
caduceus369: folds 
Catania838: folds 
emidio92: folds 
GanchanS7: folds 
Uncalled bet (€0.01) returned to mora009
mora009 collected €0.02 from pot
mora009: doesn't show hand 
*** SUMMARY ***
Total pot €0.02 | Rake €0 
Seat 1: emidio92 (button) folded before Flop (didn't bet)
Seat 2: GanchanS7 (small blind) folded before Flop
Seat 3: mora009 (big blind) collected (€0.02)
Seat 4: ADRIAN0_MEIS folded before Flop (didn't bet)
Seat 5: caduceus369 folded before Flop (didn't bet)
Seat 6: Catania838 folded before Flop (didn't bet)



PokerStars Zoom Hand #257999222304:  Hold'em No Limit (€0.01/€0.02) [ADM ID: M62BD3044A1E13PD] - 2025/10/04 21:54:44 CET [2025/10/04 15:54:44 ET]
Table 'Sirio' 6-max Seat #1 is the button
Seat 1: Catania838 (€2.41 in chips) 
Seat 2: caduceus369 (€5.02 in chips) 
Seat 3: emidio92 (€2.12 in chips) 
Seat 4: mora009 (€1.77 in chips) 
Seat 5: father2008 (€2 in chips) 
Seat 6: OSPREYSTORM (€2 in chips) 
caduceus369: posts small blind €0.01
emidio92: posts big blind €0.02
*** HOLE CARDS ***
Dealt to caduceus369 [6h Js]
mora009: folds 
father2008: folds 
OSPREYSTORM: raises €0.04 to €0.06
Catania838: folds 
caduceus369: folds 
emidio92: calls €0.04
*** FLOP *** [Tc 7s Td]
emidio92: checks 
OSPREYSTORM: bets €0.03
emidio92: raises €0.13 to €0.16
OSPREYSTORM: folds 
Uncalled bet (€0.13) returned to emidio92
emidio92 collected €0.18 from pot
emidio92: doesn't show hand 
*** SUMMARY ***
Total pot €0.19 | Rake €0.01 
Board [Tc 7s Td]
Seat 1: Catania838 (button) folded before Flop (didn't bet)
Seat 2: caduceus369 (small blind) folded before Flop
Seat 3: emidio92 (big blind) collected (€0.18)
Seat 4: mora009 folded before Flop (didn't bet)
Seat 5: father2008 folded before Flop (didn't bet)
Seat 6: OSPREYSTORM folded on the Flop



PokerStars Zoom Hand #257999226293:  Hold'em No Limit (€0.01/€0.02) [ADM ID: M62BD3044A1E13PD] - 2025/10/04 21:55:02 CET [2025/10/04 15:55:02 ET]
Table 'Sirio' 6-max Seat #1 is the button
Seat 1: caduceus369 (€5.01 in chips) 
Seat 2: Kingo690 (€0.40 in chips) 
Seat 3: VE SCAVES (€1.40 in chips) 
Seat 4: OSPREYSTORM (€2.56 in chips) 
Seat 5: Asso77407 (€1.08 in chips) 
Seat 6: uziu47 (€1.40 in chips) 
Kingo690: posts small blind €0.01
VE SCAVES: posts big blind €0.02
*** HOLE CARDS ***
Dealt to caduceus369 [3d 2d]
OSPREYSTORM: raises €0.04 to €0.06
Asso77407: calls €0.06
uziu47: folds 
caduceus369: folds 
Kingo690: folds 
VE SCAVES: raises €0.19 to €0.25
OSPREYSTORM: calls €0.19
Asso77407: calls €0.19
*** FLOP *** [6c 9d 5s]
VE SCAVES: bets €0.72
OSPREYSTORM: folds 
Asso77407: folds 
Uncalled bet (€0.72) returned to VE SCAVES
VE SCAVES collected €0.72 from pot
VE SCAVES: doesn't show hand 
*** SUMMARY ***
Total pot €0.76 | Rake €0.04 
Board [6c 9d 5s]
Seat 1: caduceus369 (button) folded before Flop (didn't bet)
Seat 2: Kingo690 (small blind) folded before Flop
Seat 3: VE SCAVES (big blind) collected (€0.72)
Seat 4: OSPREYSTORM folded on the Flop
Seat 5: Asso77407 folded on the Flop
Seat 6: uziu47 folded before Flop (didn't bet)



PokerStars Zoom Hand #257999232117:  Hold'em No Limit (€0.01/€0.02) [ADM ID: M62BD3044A1E13PD] - 2025/10/04 21:55:43 CET [2025/10/04 15:55:43 ET]
Table 'Sirio' 6-max Seat #1 is the button
Seat 1: GanchanS7 (€2 in chips) 
Seat 2: father2008 (€2 in chips) 
Seat 3: OSPREYSTORM (€1.85 in chips) 
Seat 4: caduceus369 (€4.99 in chips) 
Seat 5: N0thingforU (€3.67 in chips) 
Seat 6: Gabrielefante (€7.13 in chips) 
father2008: posts small blind €0.01
OSPREYSTORM: posts big blind €0.02
*** HOLE CARDS ***
Dealt to caduceus369 [9s 7c]
caduceus369: folds 
N0thingforU: folds 
Gabrielefante: folds 
GanchanS7: folds 
father2008: folds 
Uncalled bet (€0.01) returned to OSPREYSTORM
OSPREYSTORM collected €0.02 from pot
OSPREYSTORM: doesn't show hand 
*** SUMMARY ***
Total pot €0.02 | Rake €0 
Seat 1: GanchanS7 (button) folded before Flop (didn't bet)
Seat 2: father2008 (small blind) folded before Flop
Seat 3: OSPREYSTORM (big blind) collected (€0.02)
Seat 4: caduceus369 folded before Flop (didn't bet)
Seat 5: N0thingforU folded before Flop (didn't bet)
Seat 6: Gabrielefante folded before Flop (didn't bet)



PokerStars Zoom Hand #257999231375:  Hold'em No Limit (€0.01/€0.02) [ADM ID: M62BD3044A1E13PD] - 2025/10/04 21:55:38 CET [2025/10/04 15:55:38 ET]
Table 'Sirio' 6-max Seat #1 is the button
Seat 1: MIRKO8888554 (€1.96 in chips) 
Seat 2: OSPREYSTORM (€2.31 in chips) 
Seat 3: ADRIAN0_MEIS (€2.34 in chips) 
Seat 4: Alfio4865 (€1.25 in chips) 
Seat 5: VE SCAVES (€1.87 in chips) 
Seat 6: caduceus369 (€4.99 in chips) 
OSPREYSTORM: posts small blind €0.01
ADRIAN0_MEIS: posts big blind €0.02
*** HOLE CARDS ***
Dealt to caduceus369 [8c 4s]
Alfio4865: folds 
VE SCAVES: folds 
caduceus369: folds 
MIRKO8888554: folds 
OSPREYSTORM: folds 
Uncalled bet (€0.01) returned to ADRIAN0_MEIS
ADRIAN0_MEIS collected €0.02 from pot
ADRIAN0_MEIS: doesn't show hand 
*** SUMMARY ***
Total pot €0.02 | Rake €0 
Seat 1: MIRKO8888554 (button) folded before Flop (didn't bet)
Seat 2: OSPREYSTORM (small blind) folded before Flop
Seat 3: ADRIAN0_MEIS (big blind) collected (€0.02)
Seat 4: Alfio4865 folded before Flop (didn't bet)
Seat 5: VE SCAVES folded before Flop (didn't bet)
Seat 6: caduceus369 folded before Flop (didn't bet)



PokerStars Zoom Hand #257999232685:  Hold'em No Limit (€0.01/€0.02) [ADM ID: M62BD3044A1E13PD] - 2025/10/04 21:55:47 CET [2025/10/04 15:55:47 ET]
Table 'Sirio' 6-max Seat #1 is the button
Seat 1: caduceus369 (€4.99 in chips) 
Seat 2: GanchanS7 (€2.55 in chips) 
Seat 3: VE SCAVES (€1.87 in chips) 
Seat 4: Mila727 (€5.30 in chips) 
Seat 5: LolloSpino (€1.35 in chips) 
Seat 6: MIRKO8888554 (€1.96 in chips) 
GanchanS7: posts small blind €0.01
VE SCAVES: posts big blind €0.02
*** HOLE CARDS ***
Dealt to caduceus369 [Td Kd]
Mila727: folds 
LolloSpino: folds 
MIRKO8888554: folds 
caduceus369: raises €0.04 to €0.06
GanchanS7: folds 
VE SCAVES: folds 
Uncalled bet (€0.04) returned to caduceus369
caduceus369 collected €0.05 from pot
caduceus369: doesn't show hand 
*** SUMMARY ***
Total pot €0.05 | Rake €0 
Seat 1: caduceus369 (button) collected (€0.05)
Seat 2: GanchanS7 (small blind) folded before Flop
Seat 3: VE SCAVES (big blind) folded before Flop
Seat 4: Mila727 folded before Flop (didn't bet)
Seat 5: LolloSpino folded before Flop (didn't bet)
Seat 6: MIRKO8888554 folded before Flop (didn't bet)



PokerStars Zoom Hand #257999230211:  Hold'em No Limit (€0.01/€0.02) [ADM ID: M62BD3044A1E13PD] - 2025/10/04 21:55:30 CET [2025/10/04 15:55:30 ET]
Table 'Sirio' 6-max Seat #1 is the button
Seat 1: GanchanS7 (€5.36 in chips) 
Seat 2: Asso77407 (€0.83 in chips) 
Seat 3: 71anto71 (€1.20 in chips) 
Seat 4: ADRIAN0_MEIS (€2.34 in chips) 
Seat 5: caduceus369 (€4.99 in chips) 
Seat 6: LolloSpino (€0.84 in chips) 
Asso77407: posts small blind €0.01
71anto71: posts big blind €0.02
*** HOLE CARDS ***
Dealt to caduceus369 [Jh 5h]
ADRIAN0_MEIS: folds 
caduceus369: folds 
LolloSpino: raises €0.02 to €0.04
GanchanS7: folds 
Asso77407: calls €0.03
71anto71: calls €0.02
*** FLOP *** [7h 4c 7d]
Asso77407: bets €0.02
71anto71: folds 
LolloSpino: calls €0.02
*** TURN *** [7h 4c 7d] [Kd]
Asso77407: bets €0.06
LolloSpino: calls €0.06
*** RIVER *** [7h 4c 7d Kd] [7s]
Asso77407: bets €0.08
LolloSpino: calls €0.08
*** SHOW DOWN ***
Asso77407: shows [6c Kc] (a full house, Sevens full of Kings)
LolloSpino: mucks hand 
Asso77407 collected €0.42 from pot
*** SUMMARY ***
Total pot €0.44 | Rake €0.02 
Board [7h 4c 7d Kd 7s]
Seat 1: GanchanS7 (button) folded before Flop (didn't bet)
Seat 2: Asso77407 (small blind) showed [6c Kc] and won (€0.42) with a full house, Sevens full of Kings
Seat 3: 71anto71 (big blind) folded on the Flop
Seat 4: ADRIAN0_MEIS folded before Flop (didn't bet)
Seat 5: caduceus369 folded before Flop (didn't bet)
Seat 6: LolloSpino mucked [8d 8s]



PokerStars Zoom Hand #257999236088:  Hold'em No Limit (€0.01/€0.02) [ADM ID: M62BD3044A1E13PD] - 2025/10/04 21:56:11 CET [2025/10/04 15:56:11 ET]
Table 'Sirio' 6-max Seat #1 is the button
Seat 1: Catania838 (€2.35 in chips) 
Seat 2: caduceus369 (€5.02 in chips) 
Seat 3: diesel197474 (€0.97 in chips) 
Seat 4: TeoFeli13 (€1.11 in chips) 
Seat 5: darkodiablo (€1.25 in chips) 
Seat 6: Mila727 (€5.29 in chips) 
caduceus369: posts small blind €0.01
diesel197474: posts big blind €0.02
*** HOLE CARDS ***
Dealt to caduceus369 [Ks 4c]
TeoFeli13: raises €0.06 to €0.08
darkodiablo: folds 
Mila727: folds 
Catania838: folds 
caduceus369: folds 
diesel197474: folds 
Uncalled bet (€0.06) returned to TeoFeli13
TeoFeli13 collected €0.05 from pot
TeoFeli13: doesn't show hand 
*** SUMMARY ***
Total pot €0.05 | Rake €0 
Seat 1: Catania838 (button) folded before Flop (didn't bet)
Seat 2: caduceus369 (small blind) folded before Flop
Seat 3: diesel197474 (big blind) folded before Flop
Seat 4: TeoFeli13 collected (€0.05)
Seat 5: darkodiablo folded before Flop (didn't bet)
Seat 6: Mila727 folded before Flop (didn't bet)



PokerStars Zoom Hand #257999227345:  Hold'em No Limit (€0.01/€0.02) [ADM ID: M62BD3044A1E13PD] - 2025/10/04 21:55:10 CET [2025/10/04 15:55:10 ET]
Table 'Sirio' 6-max Seat #1 is the button
Seat 1: mora009 (€1.78 in chips) 
Seat 2: ghosto69 (€1.08 in chips) 
Seat 3: caduceus369 (€5.01 in chips) 
Seat 4: cucciolo4447 (€1.43 in chips) 
Seat 5: Catania838 (€2.47 in chips) 
Seat 6: emidio92 (€2.07 in chips) 
ghosto69: posts small blind €0.01
caduceus369: posts big blind €0.02
*** HOLE CARDS ***
Dealt to caduceus369 [Qs 3d]
cucciolo4447: folds 
Catania838: calls €0.02
emidio92: raises €0.06 to €0.08
mora009: calls €0.08
ghosto69: folds 
caduceus369: folds 
Catania838: calls €0.06
*** FLOP *** [As 8s Jc]
Catania838: checks 
emidio92: bets €0.10
mora009: calls €0.10
Catania838: folds 
*** TURN *** [As 8s Jc] [2c]
emidio92: bets €0.34
mora009: calls €0.34
*** RIVER *** [As 8s Jc 2c] [Th]
emidio92: checks 
mora009: checks 
*** SHOW DOWN ***
emidio92: shows [Ts Qc] (a pair of Tens)
mora009: shows [Tc Ah] (two pair, Aces and Tens)
mora009 collected €1.09 from pot
*** SUMMARY ***
Total pot €1.15 | Rake €0.06 
Board [As 8s Jc 2c Th]
Seat 1: mora009 (button) showed [Tc Ah] and won (€1.09) with two pair, Aces and Tens
Seat 2: ghosto69 (small blind) folded before Flop
Seat 3: caduceus369 (big blind) folded before Flop
Seat 4: cucciolo4447 folded before Flop (didn't bet)
Seat 5: Catania838 folded on the Flop
Seat 6: emidio92 showed [Ts Qc] and lost with a pair of Tens



PokerStars Zoom Hand #257999237393:  Hold'em No Limit (€0.01/€0.02) [ADM ID: M62BD3044A1E13PD] - 2025/10/04 21:56:20 CET [2025/10/04 15:56:20 ET]
Table 'Sirio' 6-max Seat #1 is the button
Seat 1: cucciolo4447 (€1.39 in chips) 
Seat 2: darkodiablo (€1.25 in chips) 
Seat 3: Asso77407 (€1.05 in chips) 
Seat 4: Kazzimmino (€1.81 in chips) 
Seat 5: ADRIAN0_MEIS (€3.08 in chips) 
Seat 6: caduceus369 (€5.01 in chips) 
darkodiablo: posts small blind €0.01
Asso77407: posts big blind €0.02
*** HOLE CARDS ***
Dealt to caduceus369 [3c 2s]
Kazzimmino: raises €0.06 to €0.08
ADRIAN0_MEIS: folds 
caduceus369: folds 
cucciolo4447: folds 
darkodiablo: folds 
Asso77407: calls €0.06
*** FLOP *** [Jh 5c Ah]
Asso77407: checks 
Kazzimmino: bets €0.11
Asso77407: folds 
Uncalled bet (€0.11) returned to Kazzimmino
Kazzimmino collected €0.17 from pot
Kazzimmino: doesn't show hand 
*** SUMMARY ***
Total pot €0.17 | Rake €0 
Board [Jh 5c Ah]
Seat 1: cucciolo4447 (button) folded before Flop (didn't bet)
Seat 2: darkodiablo (small blind) folded before Flop
Seat 3: Asso77407 (big blind) folded on the Flop
Seat 4: Kazzimmino collected (€0.17)
Seat 5: ADRIAN0_MEIS folded before Flop (didn't bet)
Seat 6: caduceus369 folded before Flop (didn't bet)



PokerStars Zoom Hand #257999242993:  Hold'em No Limit (€0.01/€0.02) [ADM ID: M62BD3044A1E13PD] - 2025/10/04 21:56:57 CET [2025/10/04 15:56:57 ET]
Table 'Sirio' 6-max Seat #1 is the button
Seat 1: Alfio4865 (€1.22 in chips) 
Seat 2: MIRKO8888554 (€1.93 in chips) 
Seat 3: caduceus369 (€4.98 in chips) 
Seat 4: ghosto69 (€1.41 in chips) 
Seat 5: emidio92 (€2.42 in chips) 
Seat 6: trillycata (€1.08 in chips) 
MIRKO8888554: posts small blind €0.01
caduceus369: posts big blind €0.02
*** HOLE CARDS ***
Dealt to caduceus369 [9c Ah]
ghosto69: folds 
emidio92: folds 
trillycata: folds 
Alfio4865: folds 
MIRKO8888554: folds 
Uncalled bet (€0.01) returned to caduceus369
caduceus369 collected €0.02 from pot
caduceus369: doesn't show hand 
*** SUMMARY ***
Total pot €0.02 | Rake €0 
Seat 1: Alfio4865 (button) folded before Flop (didn't bet)
Seat 2: MIRKO8888554 (small blind) folded before Flop
Seat 3: caduceus369 (big blind) collected (€0.02)
Seat 4: ghosto69 folded before Flop (didn't bet)
Seat 5: emidio92 folded before Flop (didn't bet)
Seat 6: trillycata folded before Flop (didn't bet)



PokerStars Zoom Hand #257999241938:  Hold'em No Limit (€0.01/€0.02) [ADM ID: M62BD3044A1E13PD] - 2025/10/04 21:56:50 CET [2025/10/04 15:56:50 ET]
Table 'Sirio' 6-max Seat #1 is the button
Seat 1: Wunschgast (€6.62 in chips) 
Seat 2: Alfio4865 (€1.23 in chips) 
Seat 3: bubu1554 (€1.20 in chips) 
Seat 4: caduceus369 (€4.99 in chips) 
Seat 5: mora009 (€2.37 in chips) 
Seat 6: Catania838 (€2.32 in chips) 
Alfio4865: posts small blind €0.01
bubu1554: posts big blind €0.02
*** HOLE CARDS ***
Dealt to caduceus369 [Tc 3s]
caduceus369: folds 
mora009: raises €0.02 to €0.04
Catania838: folds 
Wunschgast: calls €0.04
Alfio4865: folds 
bubu1554: calls €0.02
*** FLOP *** [7s 2d 5c]
bubu1554: checks 
mora009: bets €0.02
Wunschgast: folds 
bubu1554: folds 
Uncalled bet (€0.02) returned to mora009
mora009 collected €0.13 from pot
mora009: doesn't show hand 
*** SUMMARY ***
Total pot €0.13 | Rake €0 
Board [7s 2d 5c]
Seat 1: Wunschgast (button) folded on the Flop
Seat 2: Alfio4865 (small blind) folded before Flop
Seat 3: bubu1554 (big blind) folded on the Flop
Seat 4: caduceus369 folded before Flop (didn't bet)
Seat 5: mora009 collected (€0.13)
Seat 6: Catania838 folded before Flop (didn't bet)



PokerStars Zoom Hand #257999241021:  Hold'em No Limit (€0.01/€0.02) [ADM ID: M62BD3044A1E13PD] - 2025/10/04 21:56:44 CET [2025/10/04 15:56:44 ET]
Table 'Sirio' 6-max Seat #1 is the button
Seat 1: Asso77407 (€0.97 in chips) 
Seat 2: N0thingforU (€3.68 in chips) 
Seat 3: ghosto69 (€1.07 in chips) 
Seat 4: GanchanS7 (€5.34 in chips) 
Seat 5: caduceus369 (€4.99 in chips) 
Seat 6: Alfio4865 (€1.23 in chips) 
N0thingforU: posts small blind €0.01
ghosto69: posts big blind €0.02
*** HOLE CARDS ***
Dealt to caduceus369 [6d 2c]
GanchanS7: folds 
caduceus369: folds 
Alfio4865: folds 
Asso77407: calls €0.02
N0thingforU: calls €0.01
ghosto69: checks 
*** FLOP *** [Th 7s 4h]
N0thingforU: checks 
ghosto69: bets €0.02
Asso77407: calls €0.02
N0thingforU: calls €0.02
*** TURN *** [Th 7s 4h] [8d]
N0thingforU: checks 
ghosto69: checks 
Asso77407: checks 
*** RIVER *** [Th 7s 4h 8d] [Kd]
N0thingforU: checks 
ghosto69: checks 
Asso77407: checks 
*** SHOW DOWN ***
N0thingforU: shows [8c Ah] (a pair of Eights)
ghosto69: mucks hand 
Asso77407: mucks hand 
N0thingforU collected €0.12 from pot
*** SUMMARY ***
Total pot €0.12 | Rake €0 
Board [Th 7s 4h 8d Kd]
Seat 1: Asso77407 (button) mucked [2d 5h]
Seat 2: N0thingforU (small blind) showed [8c Ah] and won (€0.12) with a pair of Eights
Seat 3: ghosto69 (big blind) mucked [4c Qh]
Seat 4: GanchanS7 folded before Flop (didn't bet)
Seat 5: caduceus369 folded before Flop (didn't bet)
Seat 6: Alfio4865 folded before Flop (didn't bet)



PokerStars Zoom Hand #257999242529:  Hold'em No Limit (€0.01/€0.02) [ADM ID: M62BD3044A1E13PD] - 2025/10/04 21:56:54 CET [2025/10/04 15:56:54 ET]
Table 'Sirio' 6-max Seat #1 is the button
Seat 1: Catania838 (€2.11 in chips) 
Seat 2: caduceus369 (€4.99 in chips) 
Seat 3: GanchanS7 (€2.72 in chips) 
Seat 4: Mila727 (€5.26 in chips) 
Seat 5: darkodiablo (€1.20 in chips) 
Seat 6: ADRIAN0_MEIS (€4.70 in chips) 
caduceus369: posts small blind €0.01
GanchanS7: posts big blind €0.02
*** HOLE CARDS ***
Dealt to caduceus369 [2h Qc]
Mila727: folds 
darkodiablo: folds 
ADRIAN0_MEIS: folds 
Catania838: folds 
caduceus369: folds 
Uncalled bet (€0.01) returned to GanchanS7
GanchanS7 collected €0.02 from pot
GanchanS7: doesn't show hand 
*** SUMMARY ***
Total pot €0.02 | Rake €0 
Seat 1: Catania838 (button) folded before Flop (didn't bet)
Seat 2: caduceus369 (small blind) folded before Flop
Seat 3: GanchanS7 (big blind) collected (€0.02)
Seat 4: Mila727 folded before Flop (didn't bet)
Seat 5: darkodiablo folded before Flop (didn't bet)
Seat 6: ADRIAN0_MEIS folded before Flop (didn't bet)



PokerStars Zoom Hand #257999237951:  Hold'em No Limit (€0.01/€0.02) [ADM ID: M62BD3044A1E13PD] - 2025/10/04 21:56:24 CET [2025/10/04 15:56:24 ET]
Table 'Sirio' 6-max Seat #1 is the button
Seat 1: MIRKO8888554 (€1.93 in chips) 
Seat 2: emidio92 (€2 in chips) 
Seat 3: monsterc99 (€0.97 in chips) 
Seat 4: caduceus369 (€5.01 in chips) 
Seat 5: VagALiss (€2.14 in chips) 
Seat 6: TeoFeli13 (€1.14 in chips) 
emidio92: posts small blind €0.01
monsterc99: posts big blind €0.02
*** HOLE CARDS ***
Dealt to caduceus369 [Jh 6d]
caduceus369: folds 
VagALiss: raises €0.03 to €0.05
TeoFeli13: raises €0.07 to €0.12
MIRKO8888554: folds 
emidio92: raises €0.26 to €0.38
monsterc99: folds 
VagALiss: folds 
TeoFeli13: raises €0.26 to €0.64
emidio92: raises €1.36 to €2 and is all-in
TeoFeli13: calls €0.50 and is all-in
Uncalled bet (€0.86) returned to emidio92
*** FLOP *** [5h 2h 8d]
*** TURN *** [5h 2h 8d] [7d]
*** RIVER *** [5h 2h 8d 7d] [Jc]
*** SHOW DOWN ***
emidio92: shows [Td Th] (a pair of Tens)
TeoFeli13: shows [Qc Qd] (a pair of Queens)
TeoFeli13 collected €2.23 from pot
*** SUMMARY ***
Total pot €2.35 | Rake €0.12 
Board [5h 2h 8d 7d Jc]
Seat 1: MIRKO8888554 (button) folded before Flop (didn't bet)
Seat 2: emidio92 (small blind) showed [Td Th] and lost with a pair of Tens
Seat 3: monsterc99 (big blind) folded before Flop
Seat 4: caduceus369 folded before Flop (didn't bet)
Seat 5: VagALiss folded before Flop
Seat 6: TeoFeli13 showed [Qc Qd] and won (€2.23) with a pair of Queens



PokerStars Zoom Hand #257999238603:  Hold'em No Limit (€0.01/€0.02) [ADM ID: M62BD3044A1E13PD] - 2025/10/04 21:56:28 CET [2025/10/04 15:56:28 ET]
Table 'Sirio' 6-max Seat #1 is the button
Seat 1: diesel197474 (€0.94 in chips) 
Seat 2: Catania838 (€2.33 in chips) 
Seat 3: caduceus369 (€5.01 in chips) 
Seat 4: ghosto69 (€1.07 in chips) 
Seat 5: cucciolo4447 (€1.39 in chips) 
Seat 6: maxedrum68 (€1.96 in chips) 
Catania838: posts small blind €0.01
caduceus369: posts big blind €0.02
*** HOLE CARDS ***
Dealt to caduceus369 [6d Kd]
ghosto69: folds 
cucciolo4447: calls €0.02
maxedrum68: calls €0.02
diesel197474: raises €0.06 to €0.08
Catania838: folds 
caduceus369: folds 
cucciolo4447: calls €0.06
maxedrum68: calls €0.06
*** FLOP *** [Ad 3c As]
cucciolo4447: checks 
maxedrum68: checks 
diesel197474: bets €0.12
cucciolo4447: calls €0.12
maxedrum68: folds 
*** TURN *** [Ad 3c As] [7d]
cucciolo4447: checks 
diesel197474: checks 
*** RIVER *** [Ad 3c As 7d] [2s]
cucciolo4447: bets €0.49
diesel197474: folds 
Uncalled bet (€0.49) returned to cucciolo4447
cucciolo4447 collected €0.49 from pot
cucciolo4447: doesn't show hand 
*** SUMMARY ***
Total pot €0.51 | Rake €0.02 
Board [Ad 3c As 7d 2s]
Seat 1: diesel197474 (button) folded on the River
Seat 2: Catania838 (small blind) folded before Flop
Seat 3: caduceus369 (big blind) folded before Flop
Seat 4: ghosto69 folded before Flop (didn't bet)
Seat 5: cucciolo4447 collected (€0.49)
Seat 6: maxedrum68 folded on the Flop



PokerStars Zoom Hand #257999249426:  Hold'em No Limit (€0.01/€0.02) [ADM ID: M62BD3044A1E13PD] - 2025/10/04 21:57:40 CET [2025/10/04 15:57:40 ET]
Table 'Sirio' 6-max Seat #1 is the button
Seat 1: ADRIAN0_MEIS (€3.91 in chips) 
Seat 2: Gabrielefante (€7.20 in chips) 
Seat 3: GanchanS7 (€5.33 in chips) 
Seat 4: Mila727 (€5.28 in chips) 
Seat 5: caduceus369 (€4.98 in chips) 
Seat 6: ThetaFlora (€1.17 in chips) 
Gabrielefante: posts small blind €0.01
GanchanS7: posts big blind €0.02
*** HOLE CARDS ***
Dealt to caduceus369 [9c Kd]
Mila727: folds 
caduceus369: raises €0.04 to €0.06
ThetaFlora: folds 
ADRIAN0_MEIS: folds 
Gabrielefante: folds 
GanchanS7: raises €0.19 to €0.25
caduceus369: folds 
Uncalled bet (€0.19) returned to GanchanS7
GanchanS7 collected €0.13 from pot
GanchanS7: doesn't show hand 
*** SUMMARY ***
Total pot €0.13 | Rake €0 
Seat 1: ADRIAN0_MEIS (button) folded before Flop (didn't bet)
Seat 2: Gabrielefante (small blind) folded before Flop
Seat 3: GanchanS7 (big blind) collected (€0.13)
Seat 4: Mila727 folded before Flop (didn't bet)
Seat 5: caduceus369 folded before Flop
Seat 6: ThetaFlora folded before Flop (didn't bet)



PokerStars Zoom Hand #257999245418:  Hold'em No Limit (€0.01/€0.02) [ADM ID: M62BD3044A1E13PD] - 2025/10/04 21:57:13 CET [2025/10/04 15:57:13 ET]
Table 'Sirio' 6-max Seat #1 is the button
Seat 1: caduceus369 (€4.99 in chips) 
Seat 2: ADRIAN0_MEIS (€4.70 in chips) 
Seat 3: VagALiss (€2.09 in chips) 
Seat 4: Gabrielefante (€7.23 in chips) 
Seat 5: VE SCAVES (€1.66 in chips) 
Seat 6: LolloSpino (€1.22 in chips) 
ADRIAN0_MEIS: posts small blind €0.01
VagALiss: posts big blind €0.02
*** HOLE CARDS ***
Dealt to caduceus369 [4h 5s]
Gabrielefante: folds 
VE SCAVES: raises €0.04 to €0.06
LolloSpino: calls €0.06
caduceus369: folds 
ADRIAN0_MEIS: folds 
VagALiss: calls €0.04
*** FLOP *** [6d 7d 2c]
VagALiss: checks 
VE SCAVES: bets €0.09
LolloSpino: folds 
VagALiss: folds 
Uncalled bet (€0.09) returned to VE SCAVES
VE SCAVES collected €0.18 from pot
VE SCAVES: doesn't show hand 
*** SUMMARY ***
Total pot €0.19 | Rake €0.01 
Board [6d 7d 2c]
Seat 1: caduceus369 (button) folded before Flop (didn't bet)
Seat 2: ADRIAN0_MEIS (small blind) folded before Flop
Seat 3: VagALiss (big blind) folded on the Flop
Seat 4: Gabrielefante folded before Flop (didn't bet)
Seat 5: VE SCAVES collected (€0.18)
Seat 6: LolloSpino folded on the Flop



PokerStars Zoom Hand #257999247784:  Hold'em No Limit (€0.01/€0.02) [ADM ID: M62BD3044A1E13PD] - 2025/10/04 21:57:29 CET [2025/10/04 15:57:29 ET]
Table 'Sirio' 6-max Seat #1 is the button
Seat 1: padisha00 (€1.25 in chips) 
Seat 2: caduceus369 (€4.99 in chips) 
Seat 3: Mila727 (€5.31 in chips) 
Seat 4: uziu47 (€1.47 in chips) 
Seat 5: MIRKO8888554 (€1.95 in chips) 
Seat 6: N0thingforU (€3.76 in chips) 
caduceus369: posts small blind €0.01
Mila727: posts big blind €0.02
*** HOLE CARDS ***
Dealt to caduceus369 [6c 9d]
uziu47: folds 
MIRKO8888554: raises €0.04 to €0.06
N0thingforU: calls €0.06
padisha00: calls €0.06
caduceus369: folds 
Mila727: folds 
*** FLOP *** [3c 8d Td]
MIRKO8888554: checks 
N0thingforU: bets €0.10
padisha00: folds 
MIRKO8888554: calls €0.10
*** TURN *** [3c 8d Td] [Ts]
MIRKO8888554: checks 
N0thingforU: checks 
*** RIVER *** [3c 8d Td Ts] [2s]
MIRKO8888554: checks 
N0thingforU: checks 
*** SHOW DOWN ***
MIRKO8888554: shows [8c Ah] (two pair, Tens and Eights)
N0thingforU: mucks hand 
MIRKO8888554 collected €0.39 from pot
*** SUMMARY ***
Total pot €0.41 | Rake €0.02 
Board [3c 8d Td Ts 2s]
Seat 1: padisha00 (button) folded on the Flop
Seat 2: caduceus369 (small blind) folded before Flop
Seat 3: Mila727 (big blind) folded before Flop
Seat 4: uziu47 folded before Flop (didn't bet)
Seat 5: MIRKO8888554 showed [8c Ah] and won (€0.39) with two pair, Tens and Eights
Seat 6: N0thingforU mucked [Jd Qd]



PokerStars Zoom Hand #257999253603:  Hold'em No Limit (€0.01/€0.02) [ADM ID: M62BD3044A1E13PD] - 2025/10/04 21:58:07 CET [2025/10/04 15:58:07 ET]
Table 'Sirio' 6-max Seat #1 is the button
Seat 1: father2008 (€2.01 in chips) 
Seat 2: GanchanS7 (€5.40 in chips) 
Seat 3: caduceus369 (€4.92 in chips) 
Seat 4: emidio92 (€2.06 in chips) 
Seat 5: Alfio4865 (€1.20 in chips) 
Seat 6: Mila727 (€5.33 in chips) 
GanchanS7: posts small blind €0.01
caduceus369: posts big blind €0.02
*** HOLE CARDS ***
Dealt to caduceus369 [2d Qd]
emidio92: folds 
Alfio4865: folds 
Mila727: folds 
father2008: folds 
GanchanS7: folds 
Uncalled bet (€0.01) returned to caduceus369
caduceus369 collected €0.02 from pot
caduceus369: doesn't show hand 
*** SUMMARY ***
Total pot €0.02 | Rake €0 
Seat 1: father2008 (button) folded before Flop (didn't bet)
Seat 2: GanchanS7 (small blind) folded before Flop
Seat 3: caduceus369 (big blind) collected (€0.02)
Seat 4: emidio92 folded before Flop (didn't bet)
Seat 5: Alfio4865 folded before Flop (didn't bet)
Seat 6: Mila727 folded before Flop (didn't bet)



PokerStars Zoom Hand #257999255435:  Hold'em No Limit (€0.01/€0.02) [ADM ID: M62BD3044A1E13PD] - 2025/10/04 21:58:19 CET [2025/10/04 15:58:19 ET]
Table 'Sirio' 6-max Seat #1 is the button
Seat 1: GanchanS7 (€2.59 in chips) 
Seat 2: ADRIAN0_MEIS (€3.91 in chips) 
Seat 3: Mila727 (€5.33 in chips) 
Seat 4: caduceus369 (€4.93 in chips) 
Seat 5: emidio92 (€2.06 in chips) 
Seat 6: uziu47 (€1.38 in chips) 
ADRIAN0_MEIS: posts small blind €0.01
Mila727: posts big blind €0.02
*** HOLE CARDS ***
Dealt to caduceus369 [3c 9c]
caduceus369: folds 
emidio92: folds 
uziu47: folds 
GanchanS7: folds 
ADRIAN0_MEIS: raises €0.04 to €0.06
Mila727: folds 
Uncalled bet (€0.04) returned to ADRIAN0_MEIS
ADRIAN0_MEIS collected €0.04 from pot
ADRIAN0_MEIS: doesn't show hand 
*** SUMMARY ***
Total pot €0.04 | Rake €0 
Seat 1: GanchanS7 (button) folded before Flop (didn't bet)
Seat 2: ADRIAN0_MEIS (small blind) collected (€0.04)
Seat 3: Mila727 (big blind) folded before Flop
Seat 4: caduceus369 folded before Flop (didn't bet)
Seat 5: emidio92 folded before Flop (didn't bet)
Seat 6: uziu47 folded before Flop (didn't bet)



PokerStars Zoom Hand #257999246253:  Hold'em No Limit (€0.01/€0.02) [ADM ID: M62BD3044A1E13PD] - 2025/10/04 21:57:18 CET [2025/10/04 15:57:18 ET]
Table 'Sirio' 6-max Seat #1 is the button
Seat 1: trillycata (€1.07 in chips) 
Seat 2: TeoFeli13 (€2.23 in chips) 
Seat 3: ThetaFlora (€1.20 in chips) 
Seat 4: 71anto71 (€1.33 in chips) 
Seat 5: GanchanS7 (€5.33 in chips) 
Seat 6: caduceus369 (€4.99 in chips) 
TeoFeli13: posts small blind €0.01
ThetaFlora: posts big blind €0.02
*** HOLE CARDS ***
Dealt to caduceus369 [2d 6c]
71anto71: raises €0.04 to €0.06
GanchanS7: folds 
caduceus369: folds 
trillycata: calls €0.06
TeoFeli13: folds 
ThetaFlora: folds 
*** FLOP *** [Jd Jc Tc]
71anto71: checks 
trillycata: checks 
*** TURN *** [Jd Jc Tc] [8h]
71anto71: bets €0.08
trillycata: calls €0.08
*** RIVER *** [Jd Jc Tc 8h] [Ts]
71anto71: bets €0.30
trillycata: calls €0.30
*** SHOW DOWN ***
71anto71: shows [Th Jh] (a full house, Jacks full of Tens)
trillycata: mucks hand 
71anto71 collected €0.86 from pot
*** SUMMARY ***
Total pot €0.91 | Rake €0.05 
Board [Jd Jc Tc 8h Ts]
Seat 1: trillycata (button) mucked [Ah Qd]
Seat 2: TeoFeli13 (small blind) folded before Flop
Seat 3: ThetaFlora (big blind) folded before Flop
Seat 4: 71anto71 showed [Th Jh] and won (€0.86) with a full house, Jacks full of Tens
Seat 5: GanchanS7 folded before Flop (didn't bet)
Seat 6: caduceus369 folded before Flop (didn't bet)



PokerStars Zoom Hand #257999252222:  Hold'em No Limit (€0.01/€0.02) [ADM ID: M62BD3044A1E13PD] - 2025/10/04 21:57:58 CET [2025/10/04 15:57:58 ET]
Table 'Sirio' 6-max Seat #1 is the button
Seat 1: caduceus369 (€4.92 in chips) 
Seat 2: emidio92 (€2.07 in chips) 
Seat 3: ADRIAN0_MEIS (€2.07 in chips) 
Seat 4: Kingo690 (€0.71 in chips) 
Seat 5: GanchanS7 (€2.73 in chips) 
Seat 6: VagALiss (€2.02 in chips) 
emidio92: posts small blind €0.01
ADRIAN0_MEIS: posts big blind €0.02
*** HOLE CARDS ***
Dealt to caduceus369 [6h Qd]
Kingo690: folds 
GanchanS7: folds 
VagALiss: raises €0.03 to €0.05
caduceus369: folds 
emidio92: folds 
ADRIAN0_MEIS: raises €0.11 to €0.16
VagALiss: calls €0.11
*** FLOP *** [9d 7h Td]
ADRIAN0_MEIS: checks 
VagALiss: bets €0.10
ADRIAN0_MEIS: folds 
Uncalled bet (€0.10) returned to VagALiss
VagALiss collected €0.32 from pot
VagALiss: doesn't show hand 
*** SUMMARY ***
Total pot €0.33 | Rake €0.01 
Board [9d 7h Td]
Seat 1: caduceus369 (button) folded before Flop (didn't bet)
Seat 2: emidio92 (small blind) folded before Flop
Seat 3: ADRIAN0_MEIS (big blind) folded on the Flop
Seat 4: Kingo690 folded before Flop (didn't bet)
Seat 5: GanchanS7 folded before Flop (didn't bet)
Seat 6: VagALiss collected (€0.32)



PokerStars Zoom Hand #257999257428:  Hold'em No Limit (€0.01/€0.02) [ADM ID: M62BD3044A1E13PD] - 2025/10/04 21:58:32 CET [2025/10/04 15:58:32 ET]
Table 'Sirio' 6-max Seat #1 is the button
Seat 1: maxedrum68 (€2.23 in chips) 
Seat 2: diesel197474 (€1.47 in chips) 
Seat 3: padisha00 (€1.13 in chips) 
Seat 4: emidio92 (€2.06 in chips) 
Seat 5: caduceus369 (€4.93 in chips) 
Seat 6: Gabrielefante (€6.42 in chips) 
diesel197474: posts small blind €0.01
padisha00: posts big blind €0.02
*** HOLE CARDS ***
Dealt to caduceus369 [9s Js]
emidio92: folds 
caduceus369: raises €0.04 to €0.06
Gabrielefante: folds 
maxedrum68: calls €0.06
diesel197474: folds 
padisha00: folds 
*** FLOP *** [7s 7d 2c]
caduceus369: checks 
maxedrum68: bets €0.08
caduceus369: calls €0.08
*** TURN *** [7s 7d 2c] [Qc]
caduceus369: bets €0.19
maxedrum68: folds 
Uncalled bet (€0.19) returned to caduceus369
caduceus369 collected €0.30 from pot
caduceus369: doesn't show hand 
*** SUMMARY ***
Total pot €0.31 | Rake €0.01 
Board [7s 7d 2c Qc]
Seat 1: maxedrum68 (button) folded on the Turn
Seat 2: diesel197474 (small blind) folded before Flop
Seat 3: padisha00 (big blind) folded before Flop
Seat 4: emidio92 folded before Flop (didn't bet)
Seat 5: caduceus369 collected (€0.30)
Seat 6: Gabrielefante folded before Flop (didn't bet)



PokerStars Zoom Hand #257999256184:  Hold'em No Limit (€0.01/€0.02) [ADM ID: M62BD3044A1E13PD] - 2025/10/04 21:58:24 CET [2025/10/04 15:58:24 ET]
Table 'Sirio' 6-max Seat #1 is the button
Seat 1: mora009 (€3.50 in chips) 
Seat 2: father2008 (€2.01 in chips) 
Seat 3: GanchanS7 (€2 in chips) 
Seat 4: ADRIAN0_MEIS (€3.05 in chips) 
Seat 5: maxedrum68 (€2.23 in chips) 
Seat 6: caduceus369 (€4.93 in chips) 
father2008: posts small blind €0.01
GanchanS7: posts big blind €0.02
*** HOLE CARDS ***
Dealt to caduceus369 [9s 5c]
ADRIAN0_MEIS: folds 
maxedrum68: folds 
caduceus369: folds 
mora009: calls €0.02
father2008: folds 
GanchanS7: checks 
*** FLOP *** [8s 7h 8d]
GanchanS7: checks 
mora009: checks 
*** TURN *** [8s 7h 8d] [As]
GanchanS7: bets €0.03
mora009: calls €0.03
*** RIVER *** [8s 7h 8d As] [Qd]
GanchanS7: bets €0.08
mora009: raises €0.08 to €0.16
GanchanS7: calls €0.08
*** SHOW DOWN ***
mora009: shows [8h Ks] (three of a kind, Eights)
GanchanS7: mucks hand 
GanchanS7 is disconnected 
mora009 collected €0.41 from pot
*** SUMMARY ***
Total pot €0.43 | Rake €0.02 
Board [8s 7h 8d As Qd]
Seat 1: mora009 (button) showed [8h Ks] and won (€0.41) with three of a kind, Eights
Seat 2: father2008 (small blind) folded before Flop
Seat 3: GanchanS7 (big blind) mucked [4s Ac]
Seat 4: ADRIAN0_MEIS folded before Flop (didn't bet)
Seat 5: maxedrum68 folded before Flop (didn't bet)
Seat 6: caduceus369 folded before Flop (didn't bet)



PokerStars Zoom Hand #257999264272:  Hold'em No Limit (€0.01/€0.02) [ADM ID: M62BD3044A1E13PD] - 2025/10/04 21:59:18 CET [2025/10/04 15:59:18 ET]
Table 'Sirio' 6-max Seat #1 is the button
Seat 1: trillycata (€0.60 in chips) 
Seat 2: caduceus369 (€5.09 in chips) 
Seat 3: Catania838 (€2.35 in chips) 
Seat 4: 71anto71 (€1.72 in chips) 
Seat 5: Kingo690 (€0.81 in chips) 
Seat 6: ADRIAN0_MEIS (€3.94 in chips) 
caduceus369: posts small blind €0.01
Catania838: posts big blind €0.02
*** HOLE CARDS ***
Dealt to caduceus369 [6s Ts]
71anto71: folds 
Kingo690: folds 
ADRIAN0_MEIS: folds 
trillycata: folds 
caduceus369: calls €0.01
Catania838: checks 
*** FLOP *** [Ks 6h 7d]
caduceus369: bets €0.02
Catania838: folds 
Uncalled bet (€0.02) returned to caduceus369
caduceus369 collected €0.04 from pot
caduceus369: doesn't show hand 
*** SUMMARY ***
Total pot €0.04 | Rake €0 
Board [Ks 6h 7d]
Seat 1: trillycata (button) folded before Flop (didn't bet)
Seat 2: caduceus369 (small blind) collected (€0.04)
Seat 3: Catania838 (big blind) folded on the Flop
Seat 4: 71anto71 folded before Flop (didn't bet)
Seat 5: Kingo690 folded before Flop (didn't bet)
Seat 6: ADRIAN0_MEIS folded before Flop (didn't bet)



PokerStars Zoom Hand #257999269309:  Hold'em No Limit (€0.01/€0.02) [ADM ID: M62BD3044A1E13PD] - 2025/10/04 21:59:51 CET [2025/10/04 15:59:51 ET]
Table 'Sirio' 6-max Seat #1 is the button
Seat 1: caduceus369 (€5.11 in chips) 
Seat 2: emidio92 (€2 in chips) 
Seat 3: Wunschgast (€6.46 in chips) 
Seat 4: ADRIAN0_MEIS (€3.02 in chips) 
Seat 5: Mila727 (€5.25 in chips) 
Seat 6: VagALiss (€2.24 in chips) 
emidio92: posts small blind €0.01
Wunschgast: posts big blind €0.02
*** HOLE CARDS ***
Dealt to caduceus369 [7s 2s]
ADRIAN0_MEIS: folds 
Mila727: folds 
VagALiss: raises €0.03 to €0.05
caduceus369: folds 
emidio92: folds 
Wunschgast: folds 
Uncalled bet (€0.03) returned to VagALiss
VagALiss collected €0.05 from pot
VagALiss: doesn't show hand 
*** SUMMARY ***
Total pot €0.05 | Rake €0 
Seat 1: caduceus369 (button) folded before Flop (didn't bet)
Seat 2: emidio92 (small blind) folded before Flop
Seat 3: Wunschgast (big blind) folded before Flop
Seat 4: ADRIAN0_MEIS folded before Flop (didn't bet)
Seat 5: Mila727 folded before Flop (didn't bet)
Seat 6: VagALiss collected (€0.05)



PokerStars Zoom Hand #257999270053:  Hold'em No Limit (€0.01/€0.02) [ADM ID: M62BD3044A1E13PD] - 2025/10/04 21:59:56 CET [2025/10/04 15:59:56 ET]
Table 'Sirio' 6-max Seat #1 is the button
Seat 1: senzazucca (€0.80 in chips) 
Seat 2: Mila727 (€5.25 in chips) 
Seat 3: Cedro9191 (€0.80 in chips) 
Seat 4: N0thingforU (€3.62 in chips) 
Seat 5: caduceus369 (€5.11 in chips) 
Seat 6: trillycata (€0.58 in chips) 
Mila727: posts small blind €0.01
Cedro9191: posts big blind €0.02
*** HOLE CARDS ***
Dealt to caduceus369 [5h 7s]
N0thingforU: folds 
caduceus369: folds 
trillycata: folds 
senzazucca: folds 
Mila727: raises €0.04 to €0.06
Cedro9191: calls €0.04
*** FLOP *** [Ks 8h Ts]
Mila727: bets €0.06
Cedro9191: folds 
Uncalled bet (€0.06) returned to Mila727
Mila727 collected €0.12 from pot
Mila727: doesn't show hand 
*** SUMMARY ***
Total pot €0.12 | Rake €0 
Board [Ks 8h Ts]
Seat 1: senzazucca (button) folded before Flop (didn't bet)
Seat 2: Mila727 (small blind) collected (€0.12)
Seat 3: Cedro9191 (big blind) folded on the Flop
Seat 4: N0thingforU folded before Flop (didn't bet)
Seat 5: caduceus369 folded before Flop (didn't bet)
Seat 6: trillycata folded before Flop (didn't bet)



PokerStars Zoom Hand #257999273322:  Hold'em No Limit (€0.01/€0.02) [ADM ID: M62BD3044A1E13PD] - 2025/10/04 22:00:16 CET [2025/10/04 16:00:16 ET]
Table 'Sirio' 6-max Seat #1 is the button
Seat 1: yanez61 (€1.11 in chips) 
Seat 2: N0thingforU (€3.55 in chips) 
Seat 3: andresette (€2 in chips) 
Seat 4: mora009 (€3.62 in chips) 
Seat 5: emidio92 (€2 in chips) 
Seat 6: caduceus369 (€5.11 in chips) 
N0thingforU: posts small blind €0.01
andresette: posts big blind €0.02
*** HOLE CARDS ***
Dealt to caduceus369 [Tc 7c]
mora009: raises €0.02 to €0.04
emidio92: folds 
caduceus369: folds 
yanez61: folds 
N0thingforU: calls €0.03
andresette: folds 
*** FLOP *** [2c Ad 2d]
N0thingforU: checks 
mora009: bets €0.02
N0thingforU: calls €0.02
*** TURN *** [2c Ad 2d] [Jd]
N0thingforU: checks 
mora009: checks 
*** RIVER *** [2c Ad 2d Jd] [Ks]
N0thingforU: checks 
mora009: bets €0.02
N0thingforU: calls €0.02
*** SHOW DOWN ***
mora009: shows [Qh Kc] (two pair, Kings and Deuces)
N0thingforU: mucks hand 
mora009 collected €0.18 from pot
*** SUMMARY ***
Total pot €0.18 | Rake €0 
Board [2c Ad 2d Jd Ks]
Seat 1: yanez61 (button) folded before Flop (didn't bet)
Seat 2: N0thingforU (small blind) mucked [5d 5c]
Seat 3: andresette (big blind) folded before Flop
Seat 4: mora009 showed [Qh Kc] and won (€0.18) with two pair, Kings and Deuces
Seat 5: emidio92 folded before Flop (didn't bet)
Seat 6: caduceus369 folded before Flop (didn't bet)



PokerStars Zoom Hand #257999272061:  Hold'em No Limit (€0.01/€0.02) [ADM ID: M62BD3044A1E13PD] - 2025/10/04 22:00:08 CET [2025/10/04 16:00:08 ET]
Table 'Sirio' 6-max Seat #1 is the button
Seat 1: emidio92 (€2.26 in chips) 
Seat 2: maxedrum68 (€1.81 in chips) 
Seat 3: ADRIAN0_MEIS (€4.95 in chips) 
Seat 4: caduceus369 (€5.11 in chips) 
Seat 5: TeoFeli13 (€2.59 in chips) 
Seat 6: stefano997 (€0.64 in chips) 
maxedrum68: posts small blind €0.01
ADRIAN0_MEIS: posts big blind €0.02
*** HOLE CARDS ***
Dealt to caduceus369 [4c Qh]
caduceus369: folds 
TeoFeli13: calls €0.02
stefano997: folds 
emidio92: folds 
maxedrum68: folds 
ADRIAN0_MEIS: checks 
*** FLOP *** [6c Ah 9d]
ADRIAN0_MEIS: checks 
TeoFeli13: checks 
*** TURN *** [6c Ah 9d] [9h]
ADRIAN0_MEIS: checks 
TeoFeli13: bets €0.03
ADRIAN0_MEIS: folds 
Uncalled bet (€0.03) returned to TeoFeli13
TeoFeli13 collected €0.05 from pot
TeoFeli13: doesn't show hand 
*** SUMMARY ***
Total pot €0.05 | Rake €0 
Board [6c Ah 9d 9h]
Seat 1: emidio92 (button) folded before Flop (didn't bet)
Seat 2: maxedrum68 (small blind) folded before Flop
Seat 3: ADRIAN0_MEIS (big blind) folded on the Turn
Seat 4: caduceus369 folded before Flop (didn't bet)
Seat 5: TeoFeli13 collected (€0.05)
Seat 6: stefano997 folded before Flop (didn't bet)



PokerStars Zoom Hand #257999275136:  Hold'em No Limit (€0.01/€0.02) [ADM ID: M62BD3044A1E13PD] - 2025/10/04 22:00:27 CET [2025/10/04 16:00:27 ET]
Table 'Sirio' 6-max Seat #1 is the button
Seat 1: emidio92 (€2.54 in chips) 
Seat 2: uziu47 (€1.30 in chips) 
Seat 3: andresette (€2 in chips) 
Seat 4: caduceus369 (€5.11 in chips) 
Seat 5: yanez61 (€1.11 in chips) 
Seat 6: Mila727 (€5.31 in chips) 
uziu47: posts small blind €0.01
andresette: posts big blind €0.02
*** HOLE CARDS ***
Dealt to caduceus369 [3d Tc]
caduceus369: folds 
yanez61: calls €0.02
Mila727: folds 
emidio92: raises €0.06 to €0.08
uziu47: folds 
andresette: folds 
yanez61: calls €0.06
*** FLOP *** [4d Jh Kd]
yanez61: checks 
emidio92: bets €0.05
yanez61: calls €0.05
*** TURN *** [4d Jh Kd] [9s]
yanez61: checks 
emidio92: checks 
*** RIVER *** [4d Jh Kd 9s] [8s]
yanez61: bets €0.28
emidio92: folds 
Uncalled bet (€0.28) returned to yanez61
yanez61 collected €0.28 from pot
yanez61: doesn't show hand 
*** SUMMARY ***
Total pot €0.29 | Rake €0.01 
Board [4d Jh Kd 9s 8s]
Seat 1: emidio92 (button) folded on the River
Seat 2: uziu47 (small blind) folded before Flop
Seat 3: andresette (big blind) folded before Flop
Seat 4: caduceus369 folded before Flop (didn't bet)
Seat 5: yanez61 collected (€0.28)
Seat 6: Mila727 folded before Flop (didn't bet)



