PokerStars Zoom Hand #257974326628:  Hold'em No Limit (€0.01/€0.02) [ADM ID: M62BA304494E32ST] - 2025/10/02 22:01:59 CET [2025/10/02 16:01:59 ET]
Table 'Sirio' 6-max Seat #1 is the button
Seat 1: axel75.s (€1.35 in chips) 
Seat 2: riki00000119 (€3.23 in chips) 
Seat 3: caduceus369 (€2 in chips) 
Seat 4: EntitaOscura (€5.37 in chips) 
Seat 5: GIacius (€3.79 in chips) 
Seat 6: gigiruk91 (€5.95 in chips) 
riki00000119: posts small blind €0.01
caduceus369: posts big blind €0.02
*** HOLE CARDS ***
Dealt to caduceus369 [5d 6s]
EntitaOscura: raises €0.03 to €0.05
GIacius: raises €0.15 to €0.20
gigiruk91: folds 
axel75.s: folds 
riki00000119: folds 
caduceus369: folds 
EntitaOscura: folds 
Uncalled bet (€0.15) returned to GIacius
GIacius collected €0.13 from pot
GIacius: doesn't show hand 
*** SUMMARY ***
Total pot €0.13 | Rake €0 
Seat 1: axel75.s (button) folded before Flop (didn't bet)
Seat 2: riki00000119 (small blind) folded before Flop
Seat 3: caduceus369 (big blind) folded before Flop
Seat 4: EntitaOscura folded before Flop
Seat 5: GIacius collected (€0.13)
Seat 6: gigiruk91 folded before Flop (didn't bet)



PokerStars Zoom Hand #257974331189:  Hold'em No Limit (€0.01/€0.02) [ADM ID: M62BA304494E32ST] - 2025/10/02 22:02:19 CET [2025/10/02 16:02:19 ET]
Table 'Sirio' 6-max Seat #1 is the button
Seat 1: father2008 (€2.01 in chips) 
Seat 2: caduceus369 (€1.98 in chips) 
Seat 3: EntitaOscura (€2.69 in chips) 
Seat 4: peones95 (€0.94 in chips) 
Seat 5: canario90 (€3.35 in chips) 
Seat 6: Kamiros01 (€4.19 in chips) 
caduceus369: posts small blind €0.01
EntitaOscura: posts big blind €0.02
*** HOLE CARDS ***
Dealt to caduceus369 [2d 3h]
peones95: folds 
canario90: folds 
Kamiros01: raises €0.06 to €0.08
father2008: folds 
canario90 is disconnected 
caduceus369: folds 
EntitaOscura: folds 
Uncalled bet (€0.06) returned to Kamiros01
Kamiros01 collected €0.05 from pot
Kamiros01: doesn't show hand 
*** SUMMARY ***
Total pot €0.05 | Rake €0 
Seat 1: father2008 (button) folded before Flop (didn't bet)
Seat 2: caduceus369 (small blind) folded before Flop
Seat 3: EntitaOscura (big blind) folded before Flop
Seat 4: peones95 folded before Flop (didn't bet)
Seat 5: canario90 folded before Flop (didn't bet)
Seat 6: Kamiros01 collected (€0.05)



PokerStars Zoom Hand #257974334921:  Hold'em No Limit (€0.01/€0.02) [ADM ID: M62BA304494E32ST] - 2025/10/02 22:02:33 CET [2025/10/02 16:02:33 ET]
Table 'Sirio' 6-max Seat #1 is the button
Seat 1: caduceus369 (€1.97 in chips) 
Seat 2: EntitaOscura (€2.67 in chips) 
Seat 3: zicky78.r (€2 in chips) 
Seat 4: gigiruk91 (€4.11 in chips) 
Seat 5: Alfio6565 (€0.69 in chips) 
Seat 6: MOLDAVO1069 (€2.57 in chips) 
EntitaOscura: posts small blind €0.01
zicky78.r: posts big blind €0.02
*** HOLE CARDS ***
Dealt to caduceus369 [5d As]
gigiruk91: folds 
Alfio6565: calls €0.02
MOLDAVO1069: folds 
caduceus369: raises €0.06 to €0.08
EntitaOscura: folds 
zicky78.r: calls €0.06
Alfio6565: folds 
*** FLOP *** [4h 6s 5s]
zicky78.r: checks 
caduceus369: bets €0.04
zicky78.r: calls €0.04
*** TURN *** [4h 6s 5s] [9c]
zicky78.r: checks 
caduceus369: checks 
*** RIVER *** [4h 6s 5s 9c] [Ah]
zicky78.r: bets €0.26
caduceus369: calls €0.26
*** SHOW DOWN ***
zicky78.r: shows [Tc Ac] (a pair of Aces)
caduceus369: shows [5d As] (two pair, Aces and Fives)
caduceus369 collected €0.75 from pot
*** SUMMARY ***
Total pot €0.79 | Rake €0.04 
Board [4h 6s 5s 9c Ah]
Seat 1: caduceus369 (button) showed [5d As] and won (€0.75) with two pair, Aces and Fives
Seat 2: EntitaOscura (small blind) folded before Flop
Seat 3: zicky78.r (big blind) showed [Tc Ac] and lost with a pair of Aces
Seat 4: gigiruk91 folded before Flop (didn't bet)
Seat 5: Alfio6565 folded before Flop
Seat 6: MOLDAVO1069 folded before Flop (didn't bet)



PokerStars Zoom Hand #257974351801:  Hold'em No Limit (€0.01/€0.02) [ADM ID: M62BA304494E32ST] - 2025/10/02 22:03:46 CET [2025/10/02 16:03:46 ET]
Table 'Sirio' 6-max Seat #1 is the button
Seat 1: QUATTRODAME (€1 in chips) 
Seat 2: zicky78.r (€2 in chips) 
Seat 3: ghosto69 (€1.29 in chips) 
Seat 4: ADRIAN0_MEIS (€2.20 in chips) 
Seat 5: EntitaOscura (€5.35 in chips) 
Seat 6: caduceus369 (€2.34 in chips) 
zicky78.r: posts small blind €0.01
ghosto69: posts big blind €0.02
*** HOLE CARDS ***
Dealt to caduceus369 [Jh 2h]
ADRIAN0_MEIS: raises €0.05 to €0.07
EntitaOscura: folds 
caduceus369: folds 
QUATTRODAME: calls €0.07
zicky78.r: folds 
ghosto69: folds 
*** FLOP *** [Qs Kc 4h]
ADRIAN0_MEIS: bets €0.13
QUATTRODAME: calls €0.13
*** TURN *** [Qs Kc 4h] [Ac]
ADRIAN0_MEIS: bets €0.41
QUATTRODAME: folds 
Uncalled bet (€0.41) returned to ADRIAN0_MEIS
ADRIAN0_MEIS collected €0.41 from pot
ADRIAN0_MEIS: doesn't show hand 
*** SUMMARY ***
Total pot €0.43 | Rake €0.02 
Board [Qs Kc 4h Ac]
Seat 1: QUATTRODAME (button) folded on the Turn
Seat 2: zicky78.r (small blind) folded before Flop
Seat 3: ghosto69 (big blind) folded before Flop
Seat 4: ADRIAN0_MEIS collected (€0.41)
Seat 5: EntitaOscura folded before Flop (didn't bet)
Seat 6: caduceus369 folded before Flop (didn't bet)



PokerStars Zoom Hand #257974354173:  Hold'em No Limit (€0.01/€0.02) [ADM ID: M62BA304494E32ST] - 2025/10/02 22:03:56 CET [2025/10/02 16:03:56 ET]
Table 'Sirio' 6-max Seat #1 is the button
Seat 1: Catania838 (€1.31 in chips) 
Seat 2: zicky78.r (€2.11 in chips) 
Seat 3: Cooper8mic (€1.89 in chips) 
Seat 4: TheGreatSimba (€0.51 in chips) 
Seat 5: caduceus369 (€2.34 in chips) 
Seat 6: EntitaOscura (€5.35 in chips) 
zicky78.r: posts small blind €0.01
Cooper8mic: posts big blind €0.02
*** HOLE CARDS ***
Dealt to caduceus369 [5s 8d]
TheGreatSimba: folds 
caduceus369: folds 
EntitaOscura: raises €0.03 to €0.05
Catania838: raises €1.26 to €1.31 and is all-in
zicky78.r: folds 
Cooper8mic: folds 
EntitaOscura: folds 
Uncalled bet (€1.26) returned to Catania838
Catania838 collected €0.13 from pot
Catania838: doesn't show hand 
*** SUMMARY ***
Total pot €0.13 | Rake €0 
Seat 1: Catania838 (button) collected (€0.13)
Seat 2: zicky78.r (small blind) folded before Flop
Seat 3: Cooper8mic (big blind) folded before Flop
Seat 4: TheGreatSimba folded before Flop (didn't bet)
Seat 5: caduceus369 folded before Flop (didn't bet)
Seat 6: EntitaOscura folded before Flop



PokerStars Zoom Hand #257974357980:  Hold'em No Limit (€0.01/€0.02) [ADM ID: M62BA304494E32ST] - 2025/10/02 22:04:12 CET [2025/10/02 16:04:12 ET]
Table 'Sirio' 6-max Seat #1 is the button
Seat 1: GIacius (€2 in chips) 
Seat 2: caduceus369 (€2.34 in chips) 
Seat 3: Spillo.RN (€1.96 in chips) 
Seat 4: c.ronaldo644 (€2 in chips) 
Seat 5: ADRIAN0_MEIS (€2.88 in chips) 
Seat 6: PLOttingerrr (€2 in chips) 
caduceus369: posts small blind €0.01
Spillo.RN: posts big blind €0.02
*** HOLE CARDS ***
Dealt to caduceus369 [5h 2h]
c.ronaldo644: folds 
ADRIAN0_MEIS: raises €0.05 to €0.07
PLOttingerrr: folds 
GIacius: raises €0.13 to €0.20
caduceus369: folds 
Spillo.RN: folds 
ADRIAN0_MEIS: calls €0.13
*** FLOP *** [8d 4h 5c]
ADRIAN0_MEIS: checks 
GIacius: checks 
*** TURN *** [8d 4h 5c] [3c]
ADRIAN0_MEIS: bets €0.41
GIacius: folds 
Uncalled bet (€0.41) returned to ADRIAN0_MEIS
ADRIAN0_MEIS collected €0.41 from pot
ADRIAN0_MEIS: doesn't show hand 
*** SUMMARY ***
Total pot €0.43 | Rake €0.02 
Board [8d 4h 5c 3c]
Seat 1: GIacius (button) folded on the Turn
Seat 2: caduceus369 (small blind) folded before Flop
Seat 3: Spillo.RN (big blind) folded before Flop
Seat 4: c.ronaldo644 folded before Flop (didn't bet)
Seat 5: ADRIAN0_MEIS collected (€0.41)
Seat 6: PLOttingerrr folded before Flop (didn't bet)



PokerStars Zoom Hand #257974361117:  Hold'em No Limit (€0.01/€0.02) [ADM ID: M62BA304494E32ST] - 2025/10/02 22:04:25 CET [2025/10/02 16:04:25 ET]
Table 'Sirio' 6-max Seat #1 is the button
Seat 1: gigiruk91 (€5.87 in chips) 
Seat 2: EntitaOscura (€5.30 in chips) 
Seat 3: caduceus369 (€2.33 in chips) 
Seat 4: Iacuba (€1.13 in chips) 
Seat 5: GIacius (€2.12 in chips) 
Seat 6: bruciapelo (€4 in chips) 
EntitaOscura: posts small blind €0.01
caduceus369: posts big blind €0.02
*** HOLE CARDS ***
Dealt to caduceus369 [Ts 8d]
Iacuba: raises €0.02 to €0.04
GIacius: folds 
bruciapelo: folds 
gigiruk91: calls €0.04
EntitaOscura: folds 
caduceus369: folds 
*** FLOP *** [Qd Qs 8c]
Iacuba: checks 
gigiruk91: bets €0.04
Iacuba: calls €0.04
*** TURN *** [Qd Qs 8c] [Ac]
Iacuba: checks 
gigiruk91: checks 
*** RIVER *** [Qd Qs 8c Ac] [5s]
Iacuba: bets €0.09
gigiruk91: folds 
Uncalled bet (€0.09) returned to Iacuba
Iacuba collected €0.18 from pot
Iacuba: doesn't show hand 
*** SUMMARY ***
Total pot €0.19 | Rake €0.01 
Board [Qd Qs 8c Ac 5s]
Seat 1: gigiruk91 (button) folded on the River
Seat 2: EntitaOscura (small blind) folded before Flop
Seat 3: caduceus369 (big blind) folded before Flop
Seat 4: Iacuba collected (€0.18)
Seat 5: GIacius folded before Flop (didn't bet)
Seat 6: bruciapelo folded before Flop (didn't bet)



PokerStars Zoom Hand #257974363505:  Hold'em No Limit (€0.01/€0.02) [ADM ID: M62BA304494E32ST] - 2025/10/02 22:04:35 CET [2025/10/02 16:04:35 ET]
Table 'Sirio' 6-max Seat #1 is the button
Seat 1: caduceus369 (€2.31 in chips) 
Seat 2: ADRIAN0_MEIS (€2.41 in chips) 
Seat 3: ghosto69 (€2.02 in chips) 
Seat 4: Allino29 (€5.11 in chips) 
Seat 5: Kamiros01 (€4.18 in chips) 
Seat 6: PLOttingerrr (€2.11 in chips) 
ADRIAN0_MEIS: posts small blind €0.01
ghosto69: posts big blind €0.02
*** HOLE CARDS ***
Dealt to caduceus369 [Ah Qh]
Allino29: folds 
Kamiros01: folds 
PLOttingerrr: folds 
caduceus369: raises €0.02 to €0.04
ADRIAN0_MEIS: folds 
ghosto69: folds 
Uncalled bet (€0.02) returned to caduceus369
caduceus369 collected €0.05 from pot
caduceus369: doesn't show hand 
*** SUMMARY ***
Total pot €0.05 | Rake €0 
Seat 1: caduceus369 (button) collected (€0.05)
Seat 2: ADRIAN0_MEIS (small blind) folded before Flop
Seat 3: ghosto69 (big blind) folded before Flop
Seat 4: Allino29 folded before Flop (didn't bet)
Seat 5: Kamiros01 folded before Flop (didn't bet)
Seat 6: PLOttingerrr folded before Flop (didn't bet)



PokerStars Zoom Hand #257974355622:  Hold'em No Limit (€0.01/€0.02) [ADM ID: M62BA304494E32ST] - 2025/10/02 22:04:02 CET [2025/10/02 16:04:02 ET]
Table 'Sirio' 6-max Seat #1 is the button
Seat 1: syux707 (€1.20 in chips) 
Seat 2: Pasdum57 (€1.98 in chips) 
Seat 3: giocrouch (€2.36 in chips) 
Seat 4: riki00000119 (€3.28 in chips) 
Seat 5: caduceus369 (€2.34 in chips) 
Seat 6: peones95 (€1.20 in chips) 
Pasdum57: posts small blind €0.01
giocrouch: posts big blind €0.02
*** HOLE CARDS ***
Dealt to caduceus369 [3h Jd]
riki00000119: folds 
caduceus369: folds 
peones95: raises €0.02 to €0.04
syux707: calls €0.04
Pasdum57: calls €0.03
giocrouch: folds 
*** FLOP *** [Qs Th 5c]
Pasdum57: checks 
peones95: checks 
syux707: bets €0.04
Pasdum57: folds 
peones95: calls €0.04
*** TURN *** [Qs Th 5c] [Ad]
peones95: checks 
syux707: bets €0.06
peones95: calls €0.06
*** RIVER *** [Qs Th 5c Ad] [7c]
peones95: checks 
syux707: checks 
*** SHOW DOWN ***
peones95: shows [Ks 5s] (a pair of Fives)
syux707: shows [Qh Kc] (a pair of Queens)
syux707 collected €0.33 from pot
*** SUMMARY ***
Total pot €0.34 | Rake €0.01 
Board [Qs Th 5c Ad 7c]
Seat 1: syux707 (button) showed [Qh Kc] and won (€0.33) with a pair of Queens
Seat 2: Pasdum57 (small blind) folded on the Flop
Seat 3: giocrouch (big blind) folded before Flop
Seat 4: riki00000119 folded before Flop (didn't bet)
Seat 5: caduceus369 folded before Flop (didn't bet)
Seat 6: peones95 showed [Ks 5s] and lost with a pair of Fives



PokerStars Zoom Hand #257974368434:  Hold'em No Limit (€0.01/€0.02) [ADM ID: M62BA304494E32ST] - 2025/10/02 22:04:55 CET [2025/10/02 16:04:55 ET]
Table 'Sirio' 6-max Seat #1 is the button
Seat 1: Iacuba (€1.23 in chips) 
Seat 2: PLOttingerrr (€2 in chips) 
Seat 3: EntitaOscura (€5.27 in chips) 
Seat 4: Ange57304 (€2.23 in chips) 
Seat 5: Warterror90 (€2.27 in chips) 
Seat 6: caduceus369 (€2.34 in chips) 
PLOttingerrr: posts small blind €0.01
EntitaOscura: posts big blind €0.02
*** HOLE CARDS ***
Dealt to caduceus369 [7s 4s]
Ange57304: folds 
Warterror90: folds 
caduceus369: folds 
Iacuba: raises €0.02 to €0.04
PLOttingerrr: folds 
EntitaOscura: calls €0.02
*** FLOP *** [Th Ah 4h]
EntitaOscura: checks 
Iacuba: checks 
*** TURN *** [Th Ah 4h] [Jd]
EntitaOscura: checks 
Iacuba: bets €0.03
EntitaOscura: calls €0.03
*** RIVER *** [Th Ah 4h Jd] [6h]
EntitaOscura: checks 
Iacuba: bets €0.08
EntitaOscura: calls €0.08
*** SHOW DOWN ***
Iacuba: shows [Kh Qc] (a flush, Ace high)
EntitaOscura: mucks hand 
Iacuba collected €0.30 from pot
*** SUMMARY ***
Total pot €0.31 | Rake €0.01 
Board [Th Ah 4h Jd 6h]
Seat 1: Iacuba (button) showed [Kh Qc] and won (€0.30) with a flush, Ace high
Seat 2: PLOttingerrr (small blind) folded before Flop
Seat 3: EntitaOscura (big blind) mucked [Jh Kc]
Seat 4: Ange57304 folded before Flop (didn't bet)
Seat 5: Warterror90 folded before Flop (didn't bet)
Seat 6: caduceus369 folded before Flop (didn't bet)



PokerStars Zoom Hand #257974371837:  Hold'em No Limit (€0.01/€0.02) [ADM ID: M62BA304494E32ST] - 2025/10/02 22:05:09 CET [2025/10/02 16:05:09 ET]
Table 'Sirio' 6-max Seat #1 is the button
Seat 1: MOLDAVO1069 (€2.50 in chips) 
Seat 2: zicky78.r (€2.06 in chips) 
Seat 3: Catania838 (€1.38 in chips) 
Seat 4: Alfio6565 (€0.53 in chips) 
Seat 5: PLOttingerrr (€2.13 in chips) 
Seat 6: caduceus369 (€2.34 in chips) 
zicky78.r: posts small blind €0.01
Catania838: posts big blind €0.02
*** HOLE CARDS ***
Dealt to caduceus369 [Js Jd]
Alfio6565: calls €0.02
PLOttingerrr: folds 
caduceus369: raises €0.06 to €0.08
MOLDAVO1069: folds 
zicky78.r: folds 
Catania838: folds 
Alfio6565: calls €0.06
*** FLOP *** [9h 9c Ac]
Alfio6565: bets €0.02
caduceus369: calls €0.02
*** TURN *** [9h 9c Ac] [4d]
Alfio6565: checks 
caduceus369: bets €0.10
Alfio6565: folds 
Uncalled bet (€0.10) returned to caduceus369
caduceus369 collected €0.22 from pot
caduceus369: doesn't show hand 
*** SUMMARY ***
Total pot €0.23 | Rake €0.01 
Board [9h 9c Ac 4d]
Seat 1: MOLDAVO1069 (button) folded before Flop (didn't bet)
Seat 2: zicky78.r (small blind) folded before Flop
Seat 3: Catania838 (big blind) folded before Flop
Seat 4: Alfio6565 folded on the Turn
Seat 5: PLOttingerrr folded before Flop (didn't bet)
Seat 6: caduceus369 collected (€0.22)



PokerStars Zoom Hand #257974370098:  Hold'em No Limit (€0.01/€0.02) [ADM ID: M62BA304494E32ST] - 2025/10/02 22:05:02 CET [2025/10/02 16:05:02 ET]
Table 'Sirio' 6-max Seat #1 is the button
Seat 1: monsterc99 (€0.57 in chips) 
Seat 2: VagALiss (€1.93 in chips) 
Seat 3: Allino29 (€5.11 in chips) 
Seat 4: caduceus369 (€2.34 in chips) 
Seat 5: syux707 (€1.39 in chips) 
Seat 6: ghosto69 (€1.99 in chips) 
VagALiss: posts small blind €0.01
Allino29: posts big blind €0.02
*** HOLE CARDS ***
Dealt to caduceus369 [8d Ah]
caduceus369: folds 
syux707: raises €0.04 to €0.06
ghosto69: folds 
monsterc99: folds 
VagALiss: folds 
Allino29: raises €0.18 to €0.24
syux707: calls €0.18
*** FLOP *** [Td Jc 2c]
Allino29: checks 
syux707: checks 
*** TURN *** [Td Jc 2c] [7h]
Allino29: bets €0.35
syux707: calls €0.35
*** RIVER *** [Td Jc 2c 7h] [5s]
Allino29: bets €0.84
syux707: calls €0.80 and is all-in
Uncalled bet (€0.04) returned to Allino29
*** SHOW DOWN ***
Allino29: shows [Jh Jd] (three of a kind, Jacks)
syux707: shows [7c 9c] (a pair of Sevens)
Allino29 collected €2.64 from pot
*** SUMMARY ***
Total pot €2.79 | Rake €0.15 
Board [Td Jc 2c 7h 5s]
Seat 1: monsterc99 (button) folded before Flop (didn't bet)
Seat 2: VagALiss (small blind) folded before Flop
Seat 3: Allino29 (big blind) showed [Jh Jd] and won (€2.64) with three of a kind, Jacks
Seat 4: caduceus369 folded before Flop (didn't bet)
Seat 5: syux707 showed [7c 9c] and lost with a pair of Sevens
Seat 6: ghosto69 folded before Flop (didn't bet)



PokerStars Zoom Hand #257974382445:  Hold'em No Limit (€0.01/€0.02) [ADM ID: M62BA304494E32ST] - 2025/10/02 22:05:53 CET [2025/10/02 16:05:53 ET]
Table 'Sirio' 6-max Seat #1 is the button
Seat 1: Gabrielefante (€3.96 in chips) 
Seat 2: ghosto69 (€2 in chips) 
Seat 3: EntitaOscura (€2.03 in chips) 
Seat 4: GIacius (€2 in chips) 
Seat 5: caduceus369 (€2.46 in chips) 
Seat 6: zicky78.r (€2.06 in chips) 
ghosto69: posts small blind €0.01
EntitaOscura: posts big blind €0.02
*** HOLE CARDS ***
Dealt to caduceus369 [4s 7h]
GIacius: folds 
caduceus369: folds 
zicky78.r: folds 
Gabrielefante: raises €0.04 to €0.06
ghosto69: folds 
EntitaOscura: folds 
Uncalled bet (€0.04) returned to Gabrielefante
Gabrielefante collected €0.05 from pot
Gabrielefante: doesn't show hand 
*** SUMMARY ***
Total pot €0.05 | Rake €0 
Seat 1: Gabrielefante (button) collected (€0.05)
Seat 2: ghosto69 (small blind) folded before Flop
Seat 3: EntitaOscura (big blind) folded before Flop
Seat 4: GIacius folded before Flop (didn't bet)
Seat 5: caduceus369 folded before Flop (didn't bet)
Seat 6: zicky78.r folded before Flop (didn't bet)



PokerStars Zoom Hand #257974384811:  Hold'em No Limit (€0.01/€0.02) [ADM ID: M62BA304494E32ST] - 2025/10/02 22:06:02 CET [2025/10/02 16:06:02 ET]
Table 'Sirio' 6-max Seat #1 is the button
Seat 1: zicky78.r (€2.60 in chips) 
Seat 2: riki00000119 (€3.26 in chips) 
Seat 3: caduceus369 (€2.46 in chips) 
Seat 4: GIacius (€2 in chips) 
Seat 5: Allino29 (€2.48 in chips) 
Seat 6: de_toro_76 (€4.14 in chips) 
riki00000119: posts small blind €0.01
caduceus369: posts big blind €0.02
*** HOLE CARDS ***
Dealt to caduceus369 [9h 4c]
GIacius: folds 
Allino29: folds 
de_toro_76: folds 
zicky78.r: folds 
riki00000119: folds 
Uncalled bet (€0.01) returned to caduceus369
caduceus369 collected €0.02 from pot
caduceus369: doesn't show hand 
*** SUMMARY ***
Total pot €0.02 | Rake €0 
Seat 1: zicky78.r (button) folded before Flop (didn't bet)
Seat 2: riki00000119 (small blind) folded before Flop
Seat 3: caduceus369 (big blind) collected (€0.02)
Seat 4: GIacius folded before Flop (didn't bet)
Seat 5: Allino29 folded before Flop (didn't bet)
Seat 6: de_toro_76 folded before Flop (didn't bet)



PokerStars Zoom Hand #257974388324:  Hold'em No Limit (€0.01/€0.02) [ADM ID: M62BA304494E32ST] - 2025/10/02 22:06:17 CET [2025/10/02 16:06:17 ET]
Table 'Sirio' 6-max Seat #1 is the button
Seat 1: c.ronaldo644 (€1.84 in chips) 
Seat 2: caduceus369 (€2.47 in chips) 
Seat 3: father2008 (€2 in chips) 
Seat 4: Catania838 (€3.55 in chips) 
Seat 5: stfuplzudonk (€1.85 in chips) 
Seat 6: riki00000119 (€2.69 in chips) 
caduceus369: posts small blind €0.01
father2008: posts big blind €0.02
*** HOLE CARDS ***
Dealt to caduceus369 [7d 2h]
Catania838 has timed out while disconnected
Catania838: folds 
stfuplzudonk: folds 
riki00000119: folds 
c.ronaldo644: folds 
caduceus369: folds 
Uncalled bet (€0.01) returned to father2008
father2008 collected €0.02 from pot
father2008: doesn't show hand 
*** SUMMARY ***
Total pot €0.02 | Rake €0 
Seat 1: c.ronaldo644 (button) folded before Flop (didn't bet)
Seat 2: caduceus369 (small blind) folded before Flop
Seat 3: father2008 (big blind) collected (€0.02)
Seat 4: Catania838 folded before Flop (didn't bet)
Seat 5: stfuplzudonk folded before Flop (didn't bet)
Seat 6: riki00000119 folded before Flop (didn't bet)



PokerStars Zoom Hand #257974392234:  Hold'em No Limit (€0.01/€0.02) [ADM ID: M62BA304494E32ST] - 2025/10/02 22:06:33 CET [2025/10/02 16:06:33 ET]
Table 'Sirio' 6-max Seat #1 is the button
Seat 1: caduceus369 (€2.46 in chips) 
Seat 2: monsterc99 (€0.49 in chips) 
Seat 3: RRgalp (€5.15 in chips) 
Seat 4: Giuggiola64 (€2.97 in chips) 
Seat 5: GIacius (€2 in chips) 
Seat 6: Warterror90 (€2.24 in chips) 
monsterc99: posts small blind €0.01
RRgalp: posts big blind €0.02
*** HOLE CARDS ***
Dealt to caduceus369 [Qh Qs]
Giuggiola64: calls €0.02
GIacius: folds 
Warterror90: folds 
caduceus369: raises €0.06 to €0.08
monsterc99: calls €0.07
RRgalp: folds 
Giuggiola64: folds 
*** FLOP *** [3s 4c Ad]
monsterc99: checks 
caduceus369: checks 
*** TURN *** [3s 4c Ad] [5h]
monsterc99: bets €0.06
caduceus369: calls €0.06
*** RIVER *** [3s 4c Ad 5h] [As]
monsterc99: bets €0.08
caduceus369: raises €0.16 to €0.24
monsterc99: calls €0.16
*** SHOW DOWN ***
caduceus369: shows [Qh Qs] (two pair, Aces and Queens)
monsterc99: shows [Jh Ah] (three of a kind, Aces)
monsterc99 collected €0.76 from pot
*** SUMMARY ***
Total pot €0.80 | Rake €0.04 
Board [3s 4c Ad 5h As]
Seat 1: caduceus369 (button) showed [Qh Qs] and lost with two pair, Aces and Queens
Seat 2: monsterc99 (small blind) showed [Jh Ah] and won (€0.76) with three of a kind, Aces
Seat 3: RRgalp (big blind) folded before Flop
Seat 4: Giuggiola64 folded before Flop
Seat 5: GIacius folded before Flop (didn't bet)
Seat 6: Warterror90 folded before Flop (didn't bet)



PokerStars Zoom Hand #257974405588:  Hold'em No Limit (€0.01/€0.02) [ADM ID: M62BA304494E32ST] - 2025/10/02 22:07:30 CET [2025/10/02 16:07:30 ET]
Table 'Sirio' 6-max Seat #1 is the button
Seat 1: ADRIAN0_MEIS (€2.31 in chips) 
Seat 2: caduceus369 (€2.08 in chips) 
Seat 3: GIacius (€4.42 in chips) 
Seat 4: father2008 (€4.20 in chips) 
Seat 5: PLOttingerrr (€2 in chips) 
Seat 6: zicky78.r (€2.07 in chips) 
caduceus369: posts small blind €0.01
GIacius: posts big blind €0.02
*** HOLE CARDS ***
Dealt to caduceus369 [Tc Kd]
father2008: folds 
PLOttingerrr: folds 
zicky78.r: folds 
ADRIAN0_MEIS: folds 
caduceus369: calls €0.01
GIacius: checks 
*** FLOP *** [3h 9d 9h]
caduceus369: checks 
GIacius: bets €0.03
caduceus369: calls €0.03
*** TURN *** [3h 9d 9h] [2h]
caduceus369: checks 
GIacius: checks 
*** RIVER *** [3h 9d 9h 2h] [Td]
caduceus369: bets €0.08
GIacius: folds 
Uncalled bet (€0.08) returned to caduceus369
caduceus369 collected €0.10 from pot
caduceus369: doesn't show hand 
*** SUMMARY ***
Total pot €0.10 | Rake €0 
Board [3h 9d 9h 2h Td]
Seat 1: ADRIAN0_MEIS (button) folded before Flop (didn't bet)
Seat 2: caduceus369 (small blind) collected (€0.10)
Seat 3: GIacius (big blind) folded on the River
Seat 4: father2008 folded before Flop (didn't bet)
Seat 5: PLOttingerrr folded before Flop (didn't bet)
Seat 6: zicky78.r folded before Flop (didn't bet)



PokerStars Zoom Hand #257974418635:  Hold'em No Limit (€0.01/€0.02) [ADM ID: M62BA304494E32ST] - 2025/10/02 22:08:24 CET [2025/10/02 16:08:24 ET]
Table 'Sirio' 6-max Seat #1 is the button
Seat 1: EntitaOscura (€2.79 in chips) 
Seat 2: ADRIAN0_MEIS (€2.32 in chips) 
Seat 3: luchetto1990 (€3.22 in chips) 
Seat 4: caduceus369 (€2.13 in chips) 
Seat 5: stfuplzudonk (€1.86 in chips) 
Seat 6: QUATTRODAME (€1.36 in chips) 
ADRIAN0_MEIS: posts small blind €0.01
luchetto1990: posts big blind €0.02
*** HOLE CARDS ***
Dealt to caduceus369 [7s 7d]
caduceus369: calls €0.02
stfuplzudonk: folds 
QUATTRODAME: raises €0.04 to €0.06
EntitaOscura: folds 
ADRIAN0_MEIS: folds 
luchetto1990: folds 
caduceus369: calls €0.04
*** FLOP *** [Th 5h Jh]
caduceus369: checks 
QUATTRODAME: checks 
*** TURN *** [Th 5h Jh] [Td]
caduceus369: bets €0.06
QUATTRODAME: calls €0.06
*** RIVER *** [Th 5h Jh Td] [4c]
caduceus369: bets €0.08
QUATTRODAME: raises €0.42 to €0.50
caduceus369: folds 
Uncalled bet (€0.42) returned to QUATTRODAME
QUATTRODAME collected €0.41 from pot
QUATTRODAME: doesn't show hand 
*** SUMMARY ***
Total pot €0.43 | Rake €0.02 
Board [Th 5h Jh Td 4c]
Seat 1: EntitaOscura (button) folded before Flop (didn't bet)
Seat 2: ADRIAN0_MEIS (small blind) folded before Flop
Seat 3: luchetto1990 (big blind) folded before Flop
Seat 4: caduceus369 folded on the River
Seat 5: stfuplzudonk folded before Flop (didn't bet)
Seat 6: QUATTRODAME collected (€0.41)



PokerStars Zoom Hand #257974432679:  Hold'em No Limit (€0.01/€0.02) [ADM ID: M62BA304494E32ST] - 2025/10/02 22:09:23 CET [2025/10/02 16:09:23 ET]
Table 'Sirio' 6-max Seat #1 is the button
Seat 1: luchetto1990 (€3.32 in chips) 
Seat 2: peones95 (€1.81 in chips) 
Seat 3: caduceus369 (€1.93 in chips) 
Seat 4: father2008 (€4.16 in chips) 
Seat 5: stfuplzudonk (€2.23 in chips) 
Seat 6: IamJewels (€2 in chips) 
peones95: posts small blind €0.01
caduceus369: posts big blind €0.02
*** HOLE CARDS ***
Dealt to caduceus369 [Th 2d]
father2008: folds 
stfuplzudonk: raises €0.02 to €0.04
IamJewels: folds 
luchetto1990: calls €0.04
peones95: folds 
caduceus369: folds 
*** FLOP *** [Jd 5h 8h]
stfuplzudonk: checks 
luchetto1990: bets €0.10
stfuplzudonk: folds 
Uncalled bet (€0.10) returned to luchetto1990
luchetto1990 collected €0.11 from pot
luchetto1990: doesn't show hand 
*** SUMMARY ***
Total pot €0.11 | Rake €0 
Board [Jd 5h 8h]
Seat 1: luchetto1990 (button) collected (€0.11)
Seat 2: peones95 (small blind) folded before Flop
Seat 3: caduceus369 (big blind) folded before Flop
Seat 4: father2008 folded before Flop (didn't bet)
Seat 5: stfuplzudonk folded on the Flop
Seat 6: IamJewels folded before Flop (didn't bet)



PokerStars Zoom Hand #257974435190:  Hold'em No Limit (€0.01/€0.02) [ADM ID: M62BA304494E32ST] - 2025/10/02 22:09:34 CET [2025/10/02 16:09:34 ET]
Table 'Sirio' 6-max Seat #1 is the button
Seat 1: IamJewels (€2 in chips) 
Seat 2: VagALiss (€1.57 in chips) 
Seat 3: EntitaOscura (€2.86 in chips) 
Seat 4: ghosto69 (€2.29 in chips) 
Seat 5: caduceus369 (€1.91 in chips) 
Seat 6: caramellemis (€4.23 in chips) 
VagALiss: posts small blind €0.01
EntitaOscura: posts big blind €0.02
*** HOLE CARDS ***
Dealt to caduceus369 [4s Kd]
ghosto69: folds 
caduceus369: folds 
caramellemis: folds 
IamJewels: raises €0.02 to €0.04
VagALiss: folds 
EntitaOscura: folds 
Uncalled bet (€0.02) returned to IamJewels
IamJewels collected €0.05 from pot
IamJewels: doesn't show hand 
*** SUMMARY ***
Total pot €0.05 | Rake €0 
Seat 1: IamJewels (button) collected (€0.05)
Seat 2: VagALiss (small blind) folded before Flop
Seat 3: EntitaOscura (big blind) folded before Flop
Seat 4: ghosto69 folded before Flop (didn't bet)
Seat 5: caduceus369 folded before Flop (didn't bet)
Seat 6: caramellemis folded before Flop (didn't bet)



PokerStars Zoom Hand #257974416902:  Hold'em No Limit (€0.01/€0.02) [ADM ID: M62BA304494E32ST] - 2025/10/02 22:08:17 CET [2025/10/02 16:08:17 ET]
Table 'Sirio' 6-max Seat #1 is the button
Seat 1: father2008 (€4.18 in chips) 
Seat 2: VrDmNl (€2.48 in chips) 
Seat 3: xxcash88 (€2.39 in chips) 
Seat 4: caduceus369 (€2.13 in chips) 
Seat 5: ADRIAN0_MEIS (€4.16 in chips) 
Seat 6: de_toro_76 (€4.37 in chips) 
VrDmNl: posts small blind €0.01
xxcash88: posts big blind €0.02
*** HOLE CARDS ***
Dealt to caduceus369 [7s 8h]
caduceus369: folds 
ADRIAN0_MEIS: raises €0.04 to €0.06
de_toro_76: calls €0.06
father2008: folds 
VrDmNl: folds 
xxcash88: folds 
*** FLOP *** [3d Kc 5c]
ADRIAN0_MEIS: bets €0.08
de_toro_76: calls €0.08
*** TURN *** [3d Kc 5c] [Qh]
ADRIAN0_MEIS: bets €0.17
de_toro_76: calls €0.17
*** RIVER *** [3d Kc 5c Qh] [2d]
ADRIAN0_MEIS: checks 
de_toro_76: bets €0.42
ADRIAN0_MEIS: folds 
Uncalled bet (€0.42) returned to de_toro_76
de_toro_76 collected €0.62 from pot
de_toro_76: doesn't show hand 
*** SUMMARY ***
Total pot €0.65 | Rake €0.03 
Board [3d Kc 5c Qh 2d]
Seat 1: father2008 (button) folded before Flop (didn't bet)
Seat 2: VrDmNl (small blind) folded before Flop
Seat 3: xxcash88 (big blind) folded before Flop
Seat 4: caduceus369 folded before Flop (didn't bet)
Seat 5: ADRIAN0_MEIS folded on the River
Seat 6: de_toro_76 collected (€0.62)



PokerStars Zoom Hand #257974436651:  Hold'em No Limit (€0.01/€0.02) [ADM ID: M62BA304494E32ST] - 2025/10/02 22:09:40 CET [2025/10/02 16:09:40 ET]
Table 'Sirio' 6-max Seat #1 is the button
Seat 1: caduceus369 (€1.91 in chips) 
Seat 2: ghosto69 (€2.29 in chips) 
Seat 3: GIacius (€2.07 in chips) 
Seat 4: riki00000119 (€3.07 in chips) 
Seat 5: VagALiss (€1.56 in chips) 
Seat 6: stfuplzudonk (€1.57 in chips) 
ghosto69: posts small blind €0.01
GIacius: posts big blind €0.02
*** HOLE CARDS ***
Dealt to caduceus369 [7d 6c]
riki00000119: folds 
VagALiss: folds 
stfuplzudonk: raises €0.02 to €0.04
caduceus369: folds 
ghosto69: folds 
GIacius: folds 
Uncalled bet (€0.02) returned to stfuplzudonk
stfuplzudonk collected €0.05 from pot
stfuplzudonk: doesn't show hand 
*** SUMMARY ***
Total pot €0.05 | Rake €0 
Seat 1: caduceus369 (button) folded before Flop (didn't bet)
Seat 2: ghosto69 (small blind) folded before Flop
Seat 3: GIacius (big blind) folded before Flop
Seat 4: riki00000119 folded before Flop (didn't bet)
Seat 5: VagALiss folded before Flop (didn't bet)
Seat 6: stfuplzudonk collected (€0.05)



PokerStars Zoom Hand #257974440108:  Hold'em No Limit (€0.01/€0.02) [ADM ID: M62BA304494E32ST] - 2025/10/02 22:09:54 CET [2025/10/02 16:09:54 ET]
Table 'Sirio' 6-max Seat #1 is the button
Seat 1: monsterc99 (€1.02 in chips) 
Seat 2: de_toro_76 (€4.68 in chips) 
Seat 3: luchetto1990 (€3.39 in chips) 
Seat 4: AlfredP80 (€1.07 in chips) 
Seat 5: Pasdum57 (€1.87 in chips) 
Seat 6: caduceus369 (€1.91 in chips) 
de_toro_76: posts small blind €0.01
luchetto1990: posts big blind €0.02
*** HOLE CARDS ***
Dealt to caduceus369 [9c 2c]
AlfredP80: raises €0.04 to €0.06
Pasdum57: folds 
caduceus369: folds 
monsterc99: folds 
de_toro_76: folds 
luchetto1990: folds 
Uncalled bet (€0.04) returned to AlfredP80
AlfredP80 collected €0.05 from pot
AlfredP80: doesn't show hand 
*** SUMMARY ***
Total pot €0.05 | Rake €0 
Seat 1: monsterc99 (button) folded before Flop (didn't bet)
Seat 2: de_toro_76 (small blind) folded before Flop
Seat 3: luchetto1990 (big blind) folded before Flop
Seat 4: AlfredP80 collected (€0.05)
Seat 5: Pasdum57 folded before Flop (didn't bet)
Seat 6: caduceus369 folded before Flop (didn't bet)



PokerStars Zoom Hand #257974440990:  Hold'em No Limit (€0.01/€0.02) [ADM ID: M62BA304494E32ST] - 2025/10/02 22:09:58 CET [2025/10/02 16:09:58 ET]
Table 'Sirio' 6-max Seat #1 is the button
Seat 1: riki00000119 (€3.21 in chips) 
Seat 2: VrDmNl (€2.66 in chips) 
Seat 3: caduceus369 (€1.91 in chips) 
Seat 4: zicky78.r (€2.16 in chips) 
Seat 5: EntitaOscura (€2.83 in chips) 
Seat 6: monsterc99 (€1.02 in chips) 
VrDmNl: posts small blind €0.01
caduceus369: posts big blind €0.02
*** HOLE CARDS ***
Dealt to caduceus369 [Ad 9d]
zicky78.r: folds 
EntitaOscura: folds 
monsterc99: folds 
riki00000119: folds 
VrDmNl: calls €0.01
caduceus369: checks 
*** FLOP *** [5d 4h 2d]
VrDmNl: checks 
caduceus369: bets €0.02
VrDmNl: calls €0.02
*** TURN *** [5d 4h 2d] [Qh]
VrDmNl: checks 
caduceus369: bets €0.06
VrDmNl: folds 
Uncalled bet (€0.06) returned to caduceus369
caduceus369 collected €0.08 from pot
caduceus369: doesn't show hand 
*** SUMMARY ***
Total pot €0.08 | Rake €0 
Board [5d 4h 2d Qh]
Seat 1: riki00000119 (button) folded before Flop (didn't bet)
Seat 2: VrDmNl (small blind) folded on the Turn
Seat 3: caduceus369 (big blind) collected (€0.08)
Seat 4: zicky78.r folded before Flop (didn't bet)
Seat 5: EntitaOscura folded before Flop (didn't bet)
Seat 6: monsterc99 folded before Flop (didn't bet)



PokerStars Zoom Hand #257974450477:  Hold'em No Limit (€0.01/€0.02) [ADM ID: M62BA304494E32ST] - 2025/10/02 22:10:37 CET [2025/10/02 16:10:37 ET]
Table 'Sirio' 6-max Seat #1 is the button
Seat 1: EntitaOscura (€2.54 in chips) 
Seat 2: ghosto69 (€2.98 in chips) 
Seat 3: IamJewels (€2 in chips) 
Seat 4: caduceus369 (€1.95 in chips) 
Seat 5: father2008 (€2.09 in chips) 
Seat 6: RRgalp (€4.75 in chips) 
ghosto69: posts small blind €0.01
IamJewels: posts big blind €0.02
*** HOLE CARDS ***
Dealt to caduceus369 [As Ac]
caduceus369: raises €0.02 to €0.04
father2008: folds 
RRgalp: folds 
EntitaOscura: folds 
ghosto69: folds 
IamJewels: calls €0.02
*** FLOP *** [3s 2h 5d]
IamJewels: checks 
caduceus369: bets €0.05
IamJewels: folds 
Uncalled bet (€0.05) returned to caduceus369
caduceus369 collected €0.09 from pot
caduceus369: doesn't show hand 
*** SUMMARY ***
Total pot €0.09 | Rake €0 
Board [3s 2h 5d]
Seat 1: EntitaOscura (button) folded before Flop (didn't bet)
Seat 2: ghosto69 (small blind) folded before Flop
Seat 3: IamJewels (big blind) folded on the Flop
Seat 4: caduceus369 collected (€0.09)
Seat 5: father2008 folded before Flop (didn't bet)
Seat 6: RRgalp folded before Flop (didn't bet)



PokerStars Zoom Hand #257974456472:  Hold'em No Limit (€0.01/€0.02) [ADM ID: M62BA304494E32ST] - 2025/10/02 22:11:02 CET [2025/10/02 16:11:02 ET]
Table 'Sirio' 6-max Seat #1 is the button
Seat 1: IamJewels (€2.01 in chips) 
Seat 2: caduceus369 (€2 in chips) 
Seat 3: diesel197474 (€1.93 in chips) 
Seat 4: GIacius (€2 in chips) 
Seat 5: EntitaOscura (€2.80 in chips) 
Seat 6: luchetto1990 (€3.45 in chips) 
caduceus369: posts small blind €0.01
diesel197474: posts big blind €0.02
*** HOLE CARDS ***
Dealt to caduceus369 [3h Ks]
GIacius: folds 
EntitaOscura: folds 
luchetto1990: folds 
IamJewels: folds 
caduceus369: folds 
Uncalled bet (€0.01) returned to diesel197474
diesel197474 collected €0.02 from pot
diesel197474: doesn't show hand 
*** SUMMARY ***
Total pot €0.02 | Rake €0 
Seat 1: IamJewels (button) folded before Flop (didn't bet)
Seat 2: caduceus369 (small blind) folded before Flop
Seat 3: diesel197474 (big blind) collected (€0.02)
Seat 4: GIacius folded before Flop (didn't bet)
Seat 5: EntitaOscura folded before Flop (didn't bet)
Seat 6: luchetto1990 folded before Flop (didn't bet)



PokerStars Zoom Hand #257974459029:  Hold'em No Limit (€0.01/€0.02) [ADM ID: M62BA304494E32ST] - 2025/10/02 22:11:13 CET [2025/10/02 16:11:13 ET]
Table 'Sirio' 6-max Seat #1 is the button
Seat 1: GIacius (€2 in chips) 
Seat 2: EntitaOscura (€2.80 in chips) 
Seat 3: riki00000119 (€3.32 in chips) 
Seat 4: S'dj83 (€6.56 in chips) 
Seat 5: donkdelamesa (€2.02 in chips) 
Seat 6: caduceus369 (€1.99 in chips) 
EntitaOscura: posts small blind €0.01
riki00000119: posts big blind €0.02
*** HOLE CARDS ***
Dealt to caduceus369 [7c Qc]
S'dj83: folds 
donkdelamesa: folds 
caduceus369: folds 
GIacius: folds 
EntitaOscura: folds 
Uncalled bet (€0.01) returned to riki00000119
riki00000119 collected €0.02 from pot
riki00000119: doesn't show hand 
*** SUMMARY ***
Total pot €0.02 | Rake €0 
Seat 1: GIacius (button) folded before Flop (didn't bet)
Seat 2: EntitaOscura (small blind) folded before Flop
Seat 3: riki00000119 (big blind) collected (€0.02)
Seat 4: S'dj83 folded before Flop (didn't bet)
Seat 5: donkdelamesa folded before Flop (didn't bet)
Seat 6: caduceus369 folded before Flop (didn't bet)



PokerStars Zoom Hand #257974462101:  Hold'em No Limit (€0.01/€0.02) [ADM ID: M62BA304494E32ST] - 2025/10/02 22:11:26 CET [2025/10/02 16:11:26 ET]
Table 'Sirio' 6-max Seat #1 is the button
Seat 1: PLOttingerrr (€4.54 in chips) 
Seat 2: babanotop (€2 in chips) 
Seat 3: riki00000119 (€3.09 in chips) 
Seat 4: IamJewels (€2.03 in chips) 
Seat 5: caduceus369 (€1.99 in chips) 
Seat 6: Spillo.RN (€2.03 in chips) 
babanotop: posts small blind €0.01
riki00000119: posts big blind €0.02
*** HOLE CARDS ***
Dealt to caduceus369 [9h Ac]
IamJewels: folds 
caduceus369: folds 
Spillo.RN: folds 
PLOttingerrr: folds 
babanotop: raises €0.04 to €0.06
riki00000119: folds 
Uncalled bet (€0.04) returned to babanotop
babanotop collected €0.04 from pot
babanotop: doesn't show hand 
*** SUMMARY ***
Total pot €0.04 | Rake €0 
Seat 1: PLOttingerrr (button) folded before Flop (didn't bet)
Seat 2: babanotop (small blind) collected (€0.04)
Seat 3: riki00000119 (big blind) folded before Flop
Seat 4: IamJewels folded before Flop (didn't bet)
Seat 5: caduceus369 folded before Flop (didn't bet)
Seat 6: Spillo.RN folded before Flop (didn't bet)



PokerStars Zoom Hand #257974460802:  Hold'em No Limit (€0.01/€0.02) [ADM ID: M62BA304494E32ST] - 2025/10/02 22:11:20 CET [2025/10/02 16:11:20 ET]
Table 'Sirio' 6-max Seat #1 is the button
Seat 1: caduceus369 (€1.99 in chips) 
Seat 2: Catania838 (€1.71 in chips) 
Seat 3: father2008 (€2.08 in chips) 
Seat 4: ADRIAN0_MEIS (€3.85 in chips) 
Seat 5: zicky78.r (€2.09 in chips) 
Seat 6: gigiruk91 (€4.03 in chips) 
Catania838: posts small blind €0.01
father2008: posts big blind €0.02
*** HOLE CARDS ***
Dealt to caduceus369 [Ac 2d]
ADRIAN0_MEIS: folds 
zicky78.r: folds 
gigiruk91: folds 
caduceus369: folds 
Catania838: calls €0.01
father2008: checks 
*** FLOP *** [Qh 3c Jc]
Catania838: checks 
father2008: checks 
*** TURN *** [Qh 3c Jc] [Js]
Catania838: checks 
father2008: checks 
*** RIVER *** [Qh 3c Jc Js] [Qc]
Catania838: checks 
father2008: checks 
*** SHOW DOWN ***
Catania838: shows [7s Ad] (two pair, Queens and Jacks)
father2008: mucks hand 
Catania838 collected €0.04 from pot
*** SUMMARY ***
Total pot €0.04 | Rake €0 
Board [Qh 3c Jc Js Qc]
Seat 1: caduceus369 (button) folded before Flop (didn't bet)
Seat 2: Catania838 (small blind) showed [7s Ad] and won (€0.04) with two pair, Queens and Jacks
Seat 3: father2008 (big blind) mucked [Tc 3d]
Seat 4: ADRIAN0_MEIS folded before Flop (didn't bet)
Seat 5: zicky78.r folded before Flop (didn't bet)
Seat 6: gigiruk91 folded before Flop (didn't bet)



PokerStars Zoom Hand #257974463210:  Hold'em No Limit (€0.01/€0.02) [ADM ID: M62BA304494E32ST] - 2025/10/02 22:11:30 CET [2025/10/02 16:11:30 ET]
Table 'Sirio' 6-max Seat #1 is the button
Seat 1: zicky78.r (€2.09 in chips) 
Seat 2: riki00000119 (€3.33 in chips) 
Seat 3: caduceus369 (€1.99 in chips) 
Seat 4: PLOttingerrr (€4.54 in chips) 
Seat 5: AlfredP80 (€1.36 in chips) 
Seat 6: peones95 (€1.87 in chips) 
riki00000119: posts small blind €0.01
caduceus369: posts big blind €0.02
*** HOLE CARDS ***
Dealt to caduceus369 [Ac Jh]
PLOttingerrr: folds 
AlfredP80: folds 
peones95: raises €0.02 to €0.04
zicky78.r: folds 
riki00000119: folds 
caduceus369: calls €0.02
*** FLOP *** [Kc 3h 7h]
caduceus369: checks 
peones95: bets €0.05
caduceus369: calls €0.05
*** TURN *** [Kc 3h 7h] [Jd]
caduceus369: checks 
peones95: bets €0.09
caduceus369: raises €0.15 to €0.24
peones95: folds 
Uncalled bet (€0.15) returned to caduceus369
caduceus369 collected €0.35 from pot
caduceus369: doesn't show hand 
*** SUMMARY ***
Total pot €0.37 | Rake €0.02 
Board [Kc 3h 7h Jd]
Seat 1: zicky78.r (button) folded before Flop (didn't bet)
Seat 2: riki00000119 (small blind) folded before Flop
Seat 3: caduceus369 (big blind) collected (€0.35)
Seat 4: PLOttingerrr folded before Flop (didn't bet)
Seat 5: AlfredP80 folded before Flop (didn't bet)
Seat 6: peones95 folded on the Turn



PokerStars Zoom Hand #257974478920:  Hold'em No Limit (€0.01/€0.02) [ADM ID: M62BA304494E32ST] - 2025/10/02 22:12:36 CET [2025/10/02 16:12:36 ET]
Table 'Sirio' 6-max Seat #1 is the button
Seat 1: caduceus369 (€2.16 in chips) 
Seat 2: gigiruk91 (€3.31 in chips) 
Seat 3: EntitaOscura (€5.47 in chips) 
Seat 4: GIacius (€2.35 in chips) 
Seat 5: diesel197474 (€2 in chips) 
Seat 6: giocrouch (€2.08 in chips) 
gigiruk91: posts small blind €0.01
EntitaOscura: posts big blind €0.02
*** HOLE CARDS ***
Dealt to caduceus369 [4d Tc]
GIacius: raises €0.02 to €0.04
diesel197474: folds 
giocrouch: folds 
caduceus369: folds 
gigiruk91: folds 
EntitaOscura: folds 
Uncalled bet (€0.02) returned to GIacius
GIacius collected €0.05 from pot
GIacius: doesn't show hand 
*** SUMMARY ***
Total pot €0.05 | Rake €0 
Seat 1: caduceus369 (button) folded before Flop (didn't bet)
Seat 2: gigiruk91 (small blind) folded before Flop
Seat 3: EntitaOscura (big blind) folded before Flop
Seat 4: GIacius collected (€0.05)
Seat 5: diesel197474 folded before Flop (didn't bet)
Seat 6: giocrouch folded before Flop (didn't bet)



PokerStars Zoom Hand #257974480114:  Hold'em No Limit (€0.01/€0.02) [ADM ID: M62BA304494E32ST] - 2025/10/02 22:12:41 CET [2025/10/02 16:12:41 ET]
Table 'Sirio' 6-max Seat #1 is the button
Seat 1: de_toro_76 (€4.56 in chips) 
Seat 2: caduceus369 (€2.16 in chips) 
Seat 3: ADRIAN0_MEIS (€3.82 in chips) 
Seat 4: IamJewels (€2 in chips) 
Seat 5: Allino29 (€2.14 in chips) 
Seat 6: AlfredP80 (€1.29 in chips) 
caduceus369: posts small blind €0.01
ADRIAN0_MEIS: posts big blind €0.02
*** HOLE CARDS ***
Dealt to caduceus369 [Ac 4s]
IamJewels: folds 
Allino29: folds 
AlfredP80: folds 
de_toro_76: folds 
caduceus369: folds 
Uncalled bet (€0.01) returned to ADRIAN0_MEIS
ADRIAN0_MEIS collected €0.02 from pot
ADRIAN0_MEIS: doesn't show hand 
*** SUMMARY ***
Total pot €0.02 | Rake €0 
Seat 1: de_toro_76 (button) folded before Flop (didn't bet)
Seat 2: caduceus369 (small blind) folded before Flop
Seat 3: ADRIAN0_MEIS (big blind) collected (€0.02)
Seat 4: IamJewels folded before Flop (didn't bet)
Seat 5: Allino29 folded before Flop (didn't bet)
Seat 6: AlfredP80 folded before Flop (didn't bet)



PokerStars Zoom Hand #257974478173:  Hold'em No Limit (€0.01/€0.02) [ADM ID: M62BA304494E32ST] - 2025/10/02 22:12:33 CET [2025/10/02 16:12:33 ET]
Table 'Sirio' 6-max Seat #1 is the button
Seat 1: caramellemis (€4.29 in chips) 
Seat 2: EntitaOscura (€2.49 in chips) 
Seat 3: ADRIAN0_MEIS (€6.29 in chips) 
Seat 4: caduceus369 (€2.16 in chips) 
Seat 5: Allino29 (€5.75 in chips) 
Seat 6: eleonora50 (€2.84 in chips) 
EntitaOscura: posts small blind €0.01
ADRIAN0_MEIS: posts big blind €0.02
*** HOLE CARDS ***
Dealt to caduceus369 [As 9d]
caduceus369: folds 
Allino29: folds 
eleonora50: folds 
caramellemis: folds 
EntitaOscura: folds 
Uncalled bet (€0.01) returned to ADRIAN0_MEIS
ADRIAN0_MEIS collected €0.02 from pot
ADRIAN0_MEIS: doesn't show hand 
*** SUMMARY ***
Total pot €0.02 | Rake €0 
Seat 1: caramellemis (button) folded before Flop (didn't bet)
Seat 2: EntitaOscura (small blind) folded before Flop
Seat 3: ADRIAN0_MEIS (big blind) collected (€0.02)
Seat 4: caduceus369 folded before Flop (didn't bet)
Seat 5: Allino29 folded before Flop (didn't bet)
Seat 6: eleonora50 folded before Flop (didn't bet)



PokerStars Zoom Hand #257974481761:  Hold'em No Limit (€0.01/€0.02) [ADM ID: M62BA304494E32ST] - 2025/10/02 22:12:48 CET [2025/10/02 16:12:48 ET]
Table 'Sirio' 6-max Seat #1 is the button
Seat 1: AlfredP80 (€1.29 in chips) 
Seat 2: giocrouch (€2.98 in chips) 
Seat 3: VrDmNl (€2.52 in chips) 
Seat 4: zicky78.r (€2.09 in chips) 
Seat 5: EntitaOscura (€2.48 in chips) 
Seat 6: caduceus369 (€2.15 in chips) 
giocrouch: posts small blind €0.01
VrDmNl: posts big blind €0.02
*** HOLE CARDS ***
Dealt to caduceus369 [Ac Jh]
zicky78.r: folds 
EntitaOscura: folds 
caduceus369: raises €0.02 to €0.04
AlfredP80: folds 
giocrouch: folds 
VrDmNl: calls €0.02
*** FLOP *** [Kd 3d 9d]
VrDmNl: checks 
caduceus369: bets €0.03
VrDmNl: calls €0.03
*** TURN *** [Kd 3d 9d] [8h]
VrDmNl: checks 
caduceus369: checks 
*** RIVER *** [Kd 3d 9d 8h] [4s]
VrDmNl: bets €0.15
caduceus369: folds 
Uncalled bet (€0.15) returned to VrDmNl
VrDmNl collected €0.15 from pot
VrDmNl: doesn't show hand 
*** SUMMARY ***
Total pot €0.15 | Rake €0 
Board [Kd 3d 9d 8h 4s]
Seat 1: AlfredP80 (button) folded before Flop (didn't bet)
Seat 2: giocrouch (small blind) folded before Flop
Seat 3: VrDmNl (big blind) collected (€0.15)
Seat 4: zicky78.r folded before Flop (didn't bet)
Seat 5: EntitaOscura folded before Flop (didn't bet)
Seat 6: caduceus369 folded on the River



PokerStars Zoom Hand #257974499489:  Hold'em No Limit (€0.01/€0.02) [ADM ID: M62BA304494E32ST] - 2025/10/02 22:14:01 CET [2025/10/02 16:14:01 ET]
Table 'Sirio' 6-max Seat #1 is the button
Seat 1: father2008 (€4.15 in chips) 
Seat 2: zicky78.r (€2.03 in chips) 
Seat 3: giocrouch (€1.04 in chips) 
Seat 4: EntitaOscura (€2.43 in chips) 
Seat 5: caduceus369 (€2.08 in chips) 
Seat 6: monsterc99 (€0.87 in chips) 
zicky78.r: posts small blind €0.01
giocrouch: posts big blind €0.02
*** HOLE CARDS ***
Dealt to caduceus369 [As 5s]
EntitaOscura: folds 
caduceus369: raises €0.02 to €0.04
monsterc99: folds 
father2008: calls €0.04
zicky78.r: raises €0.18 to €0.22
giocrouch: folds 
caduceus369: folds 
father2008: folds 
Uncalled bet (€0.18) returned to zicky78.r
zicky78.r collected €0.14 from pot
zicky78.r: doesn't show hand 
*** SUMMARY ***
Total pot €0.14 | Rake €0 
Seat 1: father2008 (button) folded before Flop
Seat 2: zicky78.r (small blind) collected (€0.14)
Seat 3: giocrouch (big blind) folded before Flop
Seat 4: EntitaOscura folded before Flop (didn't bet)
Seat 5: caduceus369 folded before Flop
Seat 6: monsterc99 folded before Flop (didn't bet)



PokerStars Zoom Hand #257974504450:  Hold'em No Limit (€0.01/€0.02) [ADM ID: M62BA304494E32ST] - 2025/10/02 22:14:22 CET [2025/10/02 16:14:22 ET]
Table 'Sirio' 6-max Seat #1 is the button
Seat 1: Spillo.RN (€2.03 in chips) 
Seat 2: riki00000119 (€3.02 in chips) 
Seat 3: BAMBUZ90 (€1.61 in chips) 
Seat 4: caduceus369 (€2.04 in chips) 
Seat 5: peones95 (€1.45 in chips) 
Seat 6: IamJewels (€2 in chips) 
riki00000119: posts small blind €0.01
BAMBUZ90: posts big blind €0.02
*** HOLE CARDS ***
Dealt to caduceus369 [5s 3c]
caduceus369: folds 
peones95: raises €0.04 to €0.06
IamJewels: folds 
Spillo.RN: calls €0.06
riki00000119: folds 
BAMBUZ90: calls €0.04
*** FLOP *** [3d 2s 2c]
BAMBUZ90: checks 
peones95: bets €0.09
Spillo.RN: folds 
BAMBUZ90: folds 
Uncalled bet (€0.09) returned to peones95
peones95 collected €0.18 from pot
peones95: doesn't show hand 
*** SUMMARY ***
Total pot €0.19 | Rake €0.01 
Board [3d 2s 2c]
Seat 1: Spillo.RN (button) folded on the Flop
Seat 2: riki00000119 (small blind) folded before Flop
Seat 3: BAMBUZ90 (big blind) folded on the Flop
Seat 4: caduceus369 folded before Flop (didn't bet)
Seat 5: peones95 collected (€0.18)
Seat 6: IamJewels folded before Flop (didn't bet)



PokerStars Zoom Hand #257974505655:  Hold'em No Limit (€0.01/€0.02) [ADM ID: M62BA304494E32ST] - 2025/10/02 22:14:27 CET [2025/10/02 16:14:27 ET]
Table 'Sirio' 6-max Seat #1 is the button
Seat 1: stfuplzudonk (€1.48 in chips) 
Seat 2: IamJewels (€2.09 in chips) 
Seat 3: ADRIAN0_MEIS (€3.82 in chips) 
Seat 4: Alfio6565 (€1.11 in chips) 
Seat 5: zicky78.r (€2.07 in chips) 
Seat 6: caduceus369 (€2.04 in chips) 
IamJewels: posts small blind €0.01
ADRIAN0_MEIS: posts big blind €0.02
*** HOLE CARDS ***
Dealt to caduceus369 [4d 7d]
Alfio6565: folds 
zicky78.r: folds 
caduceus369: folds 
stfuplzudonk: raises €0.02 to €0.04
IamJewels: calls €0.03
ADRIAN0_MEIS: folds 
*** FLOP *** [9d 3h 4c]
IamJewels: checks 
stfuplzudonk: checks 
*** TURN *** [9d 3h 4c] [Qd]
IamJewels: bets €0.05
stfuplzudonk: calls €0.05
*** RIVER *** [9d 3h 4c Qd] [5s]
IamJewels: bets €0.14
stfuplzudonk: folds 
Uncalled bet (€0.14) returned to IamJewels
IamJewels collected €0.19 from pot
IamJewels: doesn't show hand 
*** SUMMARY ***
Total pot €0.20 | Rake €0.01 
Board [9d 3h 4c Qd 5s]
Seat 1: stfuplzudonk (button) folded on the River
Seat 2: IamJewels (small blind) collected (€0.19)
Seat 3: ADRIAN0_MEIS (big blind) folded before Flop
Seat 4: Alfio6565 folded before Flop (didn't bet)
Seat 5: zicky78.r folded before Flop (didn't bet)
Seat 6: caduceus369 folded before Flop (didn't bet)



PokerStars Zoom Hand #257974503449:  Hold'em No Limit (€0.01/€0.02) [ADM ID: M62BA304494E32ST] - 2025/10/02 22:14:18 CET [2025/10/02 16:14:18 ET]
Table 'Sirio' 6-max Seat #1 is the button
Seat 1: Parker853 (€3.99 in chips) 
Seat 2: EntitaOscura (€2.76 in chips) 
Seat 3: riki00000119 (€3.14 in chips) 
Seat 4: caduceus369 (€2.04 in chips) 
Seat 5: giocrouch (€1.28 in chips) 
Seat 6: IamJewels (€2 in chips) 
EntitaOscura: posts small blind €0.01
riki00000119: posts big blind €0.02
*** HOLE CARDS ***
Dealt to caduceus369 [7d 8s]
caduceus369: folds 
giocrouch: folds 
IamJewels: raises €0.02 to €0.04
Parker853: calls €0.04
EntitaOscura: folds 
riki00000119: folds 
*** FLOP *** [7s Jh 2h]
IamJewels: bets €0.06
Parker853 is disconnected 
Parker853 has timed out while disconnected
Parker853: folds 
Uncalled bet (€0.06) returned to IamJewels
IamJewels collected €0.11 from pot
IamJewels: doesn't show hand 
*** SUMMARY ***
Total pot €0.11 | Rake €0 
Board [7s Jh 2h]
Seat 1: Parker853 (button) folded on the Flop
Seat 2: EntitaOscura (small blind) folded before Flop
Seat 3: riki00000119 (big blind) folded before Flop
Seat 4: caduceus369 folded before Flop (didn't bet)
Seat 5: giocrouch folded before Flop (didn't bet)
Seat 6: IamJewels collected (€0.11)



PokerStars Zoom Hand #257974507287:  Hold'em No Limit (€0.01/€0.02) [ADM ID: M62BA304494E32ST] - 2025/10/02 22:14:34 CET [2025/10/02 16:14:34 ET]
Table 'Sirio' 6-max Seat #1 is the button
Seat 1: riki00000119 (€3.01 in chips) 
Seat 2: Catania838 (€1.83 in chips) 
Seat 3: caduceus369 (€2.04 in chips) 
Seat 4: Giuggiola64 (€2.05 in chips) 
Seat 5: GIacius (€6.02 in chips) 
Seat 6: BRT2491 (€1.62 in chips) 
Catania838: posts small blind €0.01
caduceus369: posts big blind €0.02
*** HOLE CARDS ***
Dealt to caduceus369 [5c 4s]
Giuggiola64: folds 
GIacius: folds 
BRT2491: folds 
riki00000119: folds 
Catania838: calls €0.01
caduceus369: checks 
*** FLOP *** [Kc Ac 4c]
Catania838: checks 
caduceus369: bets €0.02
Catania838: calls €0.02
*** TURN *** [Kc Ac 4c] [2d]
Catania838: checks 
caduceus369: checks 
*** RIVER *** [Kc Ac 4c 2d] [As]
Catania838: checks 
caduceus369: checks 
*** SHOW DOWN ***
Catania838: shows [7h Ah] (three of a kind, Aces)
caduceus369: mucks hand 
Catania838 collected €0.08 from pot
*** SUMMARY ***
Total pot €0.08 | Rake €0 
Board [Kc Ac 4c 2d As]
Seat 1: riki00000119 (button) folded before Flop (didn't bet)
Seat 2: Catania838 (small blind) showed [7h Ah] and won (€0.08) with three of a kind, Aces
Seat 3: caduceus369 (big blind) mucked [5c 4s]
Seat 4: Giuggiola64 folded before Flop (didn't bet)
Seat 5: GIacius folded before Flop (didn't bet)
Seat 6: BRT2491 folded before Flop (didn't bet)



PokerStars Zoom Hand #257974520731:  Hold'em No Limit (€0.01/€0.02) [ADM ID: M62BA304494E32ST] - 2025/10/02 22:15:30 CET [2025/10/02 16:15:30 ET]
Table 'Sirio' 6-max Seat #1 is the button
Seat 1: PLOttingerrr (€2.10 in chips) 
Seat 2: caduceus369 (€2 in chips) 
Seat 3: GIacius (€5.99 in chips) 
Seat 4: S'dj83 (€6.43 in chips) 
Seat 5: riki00000119 (€3.23 in chips) 
Seat 6: donkdelamesa (€2.09 in chips) 
caduceus369: posts small blind €0.01
GIacius: posts big blind €0.02
*** HOLE CARDS ***
Dealt to caduceus369 [9d 6h]
S'dj83: folds 
riki00000119: folds 
donkdelamesa: raises €0.03 to €0.05
PLOttingerrr: folds 
caduceus369: folds 
GIacius: calls €0.03
*** FLOP *** [3h Qc 7c]
GIacius: checks 
donkdelamesa: bets €0.06
GIacius: folds 
Uncalled bet (€0.06) returned to donkdelamesa
donkdelamesa collected €0.11 from pot
donkdelamesa: doesn't show hand 
*** SUMMARY ***
Total pot €0.11 | Rake €0 
Board [3h Qc 7c]
Seat 1: PLOttingerrr (button) folded before Flop (didn't bet)
Seat 2: caduceus369 (small blind) folded before Flop
Seat 3: GIacius (big blind) folded on the Flop
Seat 4: S'dj83 folded before Flop (didn't bet)
Seat 5: riki00000119 folded before Flop (didn't bet)
Seat 6: donkdelamesa collected (€0.11)



PokerStars Zoom Hand #257974523137:  Hold'em No Limit (€0.01/€0.02) [ADM ID: M62BA304494E32ST] - 2025/10/02 22:15:40 CET [2025/10/02 16:15:40 ET]
Table 'Sirio' 6-max Seat #1 is the button
Seat 1: caduceus369 (€1.99 in chips) 
Seat 2: EntitaOscura (€2 in chips) 
Seat 3: monsterc99 (€0.69 in chips) 
Seat 4: father2008 (€4.26 in chips) 
Seat 5: BubbleGum360 (€2.47 in chips) 
Seat 6: ADRIAN0_MEIS (€4.64 in chips) 
EntitaOscura: posts small blind €0.01
monsterc99: posts big blind €0.02
*** HOLE CARDS ***
Dealt to caduceus369 [Ac Kd]
father2008: folds 
BubbleGum360: folds 
ADRIAN0_MEIS: raises €0.03 to €0.05
caduceus369: raises €0.09 to €0.14
EntitaOscura: folds 
monsterc99: folds 
ADRIAN0_MEIS: calls €0.09
*** FLOP *** [8s Js 6d]
ADRIAN0_MEIS: checks 
caduceus369: bets €0.13
ADRIAN0_MEIS: calls €0.13
*** TURN *** [8s Js 6d] [9s]
ADRIAN0_MEIS: checks 
caduceus369: checks 
*** RIVER *** [8s Js 6d 9s] [Kh]
ADRIAN0_MEIS: checks 
caduceus369: bets €0.23
ADRIAN0_MEIS: folds 
Uncalled bet (€0.23) returned to caduceus369
caduceus369 collected €0.54 from pot
caduceus369: doesn't show hand 
*** SUMMARY ***
Total pot €0.57 | Rake €0.03 
Board [8s Js 6d 9s Kh]
Seat 1: caduceus369 (button) collected (€0.54)
Seat 2: EntitaOscura (small blind) folded before Flop
Seat 3: monsterc99 (big blind) folded before Flop
Seat 4: father2008 folded before Flop (didn't bet)
Seat 5: BubbleGum360 folded before Flop (didn't bet)
Seat 6: ADRIAN0_MEIS folded on the River



PokerStars Zoom Hand #257974545855:  Hold'em No Limit (€0.01/€0.02) [ADM ID: M62BA304494E32ST] - 2025/10/02 22:17:15 CET [2025/10/02 16:17:15 ET]
Table 'Sirio' 6-max Seat #1 is the button
Seat 1: 7mosigillo (€1.82 in chips) 
Seat 2: PLOttingerrr (€2.31 in chips) 
Seat 3: gigiruk91 (€3.15 in chips) 
Seat 4: diesel197474 (€1.12 in chips) 
Seat 5: caduceus369 (€2.26 in chips) 
Seat 6: stevalmg (€2.07 in chips) 
PLOttingerrr: posts small blind €0.01
gigiruk91: posts big blind €0.02
*** HOLE CARDS ***
Dealt to caduceus369 [2c Th]
diesel197474: folds 
caduceus369: folds 
stevalmg: folds 
7mosigillo: folds 
PLOttingerrr: folds 
Uncalled bet (€0.01) returned to gigiruk91
gigiruk91 collected €0.02 from pot
gigiruk91: doesn't show hand 
*** SUMMARY ***
Total pot €0.02 | Rake €0 
Seat 1: 7mosigillo (button) folded before Flop (didn't bet)
Seat 2: PLOttingerrr (small blind) folded before Flop
Seat 3: gigiruk91 (big blind) collected (€0.02)
Seat 4: diesel197474 folded before Flop (didn't bet)
Seat 5: caduceus369 folded before Flop (didn't bet)
Seat 6: stevalmg folded before Flop (didn't bet)



PokerStars Zoom Hand #257974546755:  Hold'em No Limit (€0.01/€0.02) [ADM ID: M62BA304494E32ST] - 2025/10/02 22:17:19 CET [2025/10/02 16:17:19 ET]
Table 'Sirio' 6-max Seat #1 is the button
Seat 1: riki00000119 (€2.70 in chips) 
Seat 2: diesel197474 (€1.12 in chips) 
Seat 3: caduceus369 (€2.26 in chips) 
Seat 4: ADRIAN0_MEIS (€2.19 in chips) 
Seat 5: ghosto69 (€3.09 in chips) 
Seat 6: luchetto1990 (€4.01 in chips) 
diesel197474: posts small blind €0.01
caduceus369: posts big blind €0.02
*** HOLE CARDS ***
Dealt to caduceus369 [3c 4h]
ADRIAN0_MEIS: raises €0.05 to €0.07
ghosto69: folds 
luchetto1990: folds 
riki00000119: folds 
diesel197474: folds 
caduceus369: folds 
Uncalled bet (€0.05) returned to ADRIAN0_MEIS
ADRIAN0_MEIS collected €0.05 from pot
ADRIAN0_MEIS: doesn't show hand 
*** SUMMARY ***
Total pot €0.05 | Rake €0 
Seat 1: riki00000119 (button) folded before Flop (didn't bet)
Seat 2: diesel197474 (small blind) folded before Flop
Seat 3: caduceus369 (big blind) folded before Flop
Seat 4: ADRIAN0_MEIS collected (€0.05)
Seat 5: ghosto69 folded before Flop (didn't bet)
Seat 6: luchetto1990 folded before Flop (didn't bet)



PokerStars Zoom Hand #257974563254:  Hold'em No Limit (€0.01/€0.02) [ADM ID: M62BA304494E32ST] - 2025/10/02 22:18:27 CET [2025/10/02 16:18:27 ET]
Table 'Sirio' 6-max Seat #1 is the button
Seat 1: caduceus369 (€2.23 in chips) 
Seat 2: giocrouch (€1.88 in chips) 
Seat 3: PLOttingerrr (€2.54 in chips) 
Seat 4: EntitaOscura (€2 in chips) 
Seat 5: zicky78.r (€2.97 in chips) 
Seat 6: AlfredP80 (€2 in chips) 
giocrouch: posts small blind €0.01
PLOttingerrr: posts big blind €0.02
*** HOLE CARDS ***
Dealt to caduceus369 [Kh 5c]
EntitaOscura: folds 
zicky78.r: raises €0.03 to €0.05
AlfredP80: calls €0.05
caduceus369: folds 
giocrouch: folds 
PLOttingerrr: folds 
*** FLOP *** [Tc 2h 7c]
zicky78.r: bets €0.13
AlfredP80: folds 
Uncalled bet (€0.13) returned to zicky78.r
zicky78.r collected €0.13 from pot
zicky78.r: doesn't show hand 
*** SUMMARY ***
Total pot €0.13 | Rake €0 
Board [Tc 2h 7c]
Seat 1: caduceus369 (button) folded before Flop (didn't bet)
Seat 2: giocrouch (small blind) folded before Flop
Seat 3: PLOttingerrr (big blind) folded before Flop
Seat 4: EntitaOscura folded before Flop (didn't bet)
Seat 5: zicky78.r collected (€0.13)
Seat 6: AlfredP80 folded on the Flop



PokerStars Zoom Hand #257974566809:  Hold'em No Limit (€0.01/€0.02) [ADM ID: M62BA304494E32ST] - 2025/10/02 22:18:42 CET [2025/10/02 16:18:42 ET]
Table 'Sirio' 6-max Seat #1 is the button
Seat 1: stfuplzudonk (€2.26 in chips) 
Seat 2: EntitaOscura (€2.56 in chips) 
Seat 3: kroll219 (€1.91 in chips) 
Seat 4: IamJewels (€2 in chips) 
Seat 5: caduceus369 (€2.23 in chips) 
Seat 6: riki00000119 (€3.29 in chips) 
EntitaOscura: posts small blind €0.01
kroll219: posts big blind €0.02
*** HOLE CARDS ***
Dealt to caduceus369 [7s Qc]
IamJewels: folds 
caduceus369: folds 
riki00000119 has timed out
riki00000119: folds 
stfuplzudonk: folds 
EntitaOscura: folds 
Uncalled bet (€0.01) returned to kroll219
kroll219 collected €0.02 from pot
kroll219: doesn't show hand 
*** SUMMARY ***
Total pot €0.02 | Rake €0 
Seat 1: stfuplzudonk (button) folded before Flop (didn't bet)
Seat 2: EntitaOscura (small blind) folded before Flop
Seat 3: kroll219 (big blind) collected (€0.02)
Seat 4: IamJewels folded before Flop (didn't bet)
Seat 5: caduceus369 folded before Flop (didn't bet)
Seat 6: riki00000119 folded before Flop (didn't bet)



PokerStars Zoom Hand #257974564288:  Hold'em No Limit (€0.01/€0.02) [ADM ID: M62BA304494E32ST] - 2025/10/02 22:18:31 CET [2025/10/02 16:18:31 ET]
Table 'Sirio' 6-max Seat #1 is the button
Seat 1: Catania838 (€3.44 in chips) 
Seat 2: monsterc99 (€0.18 in chips) 
Seat 3: GIacius (€2.65 in chips) 
Seat 4: ADRIAN0_MEIS (€3.93 in chips) 
Seat 5: de_toro_76 (€2.65 in chips) 
Seat 6: caduceus369 (€2.23 in chips) 
monsterc99: posts small blind €0.01
GIacius: posts big blind €0.02
*** HOLE CARDS ***
Dealt to caduceus369 [4c Ac]
ADRIAN0_MEIS: raises €0.05 to €0.07
de_toro_76: folds 
caduceus369: folds 
Catania838: folds 
monsterc99: folds 
GIacius: calls €0.05
*** FLOP *** [8s 4h 7d]
GIacius: checks 
ADRIAN0_MEIS: bets €0.08
GIacius: calls €0.08
*** TURN *** [8s 4h 7d] [9h]
GIacius: checks 
ADRIAN0_MEIS: bets €0.17
GIacius: folds 
Uncalled bet (€0.17) returned to ADRIAN0_MEIS
ADRIAN0_MEIS collected €0.30 from pot
ADRIAN0_MEIS: doesn't show hand 
*** SUMMARY ***
Total pot €0.31 | Rake €0.01 
Board [8s 4h 7d 9h]
Seat 1: Catania838 (button) folded before Flop (didn't bet)
Seat 2: monsterc99 (small blind) folded before Flop
Seat 3: GIacius (big blind) folded on the Turn
Seat 4: ADRIAN0_MEIS collected (€0.30)
Seat 5: de_toro_76 folded before Flop (didn't bet)
Seat 6: caduceus369 folded before Flop (didn't bet)



PokerStars Zoom Hand #257974561092:  Hold'em No Limit (€0.01/€0.02) [ADM ID: M62BA304494E32ST] - 2025/10/02 22:18:18 CET [2025/10/02 16:18:18 ET]
Table 'Sirio' 6-max Seat #1 is the button
Seat 1: GIacius (€2.65 in chips) 
Seat 2: caduceus369 (€2.24 in chips) 
Seat 3: 7mosigillo (€2.04 in chips) 
Seat 4: S'dj83 (€6.51 in chips) 
Seat 5: Genny040893 (€0.42 in chips) 
Seat 6: ghosto69 (€2.24 in chips) 
caduceus369: posts small blind €0.01
7mosigillo: posts big blind €0.02
*** HOLE CARDS ***
Dealt to caduceus369 [8c Ad]
S'dj83: raises €0.04 to €0.06
Genny040893: folds 
ghosto69: folds 
GIacius: folds 
caduceus369: folds 
7mosigillo: calls €0.04
*** FLOP *** [Th 9h Kd]
7mosigillo: checks 
S'dj83: bets €0.10
7mosigillo: calls €0.10
*** TURN *** [Th 9h Kd] [5c]
7mosigillo: checks 
S'dj83: bets €0.28
7mosigillo: calls €0.28
*** RIVER *** [Th 9h Kd 5c] [8s]
7mosigillo: checks 
S'dj83: checks 
*** SHOW DOWN ***
7mosigillo: shows [Kc Ac] (a pair of Kings)
S'dj83: mucks hand 
7mosigillo collected €0.85 from pot
*** SUMMARY ***
Total pot €0.89 | Rake €0.04 
Board [Th 9h Kd 5c 8s]
Seat 1: GIacius (button) folded before Flop (didn't bet)
Seat 2: caduceus369 (small blind) folded before Flop
Seat 3: 7mosigillo (big blind) showed [Kc Ac] and won (€0.85) with a pair of Kings
Seat 4: S'dj83 mucked [Ah Js]
Seat 5: Genny040893 folded before Flop (didn't bet)
Seat 6: ghosto69 folded before Flop (didn't bet)



PokerStars Zoom Hand #257974568036:  Hold'em No Limit (€0.01/€0.02) [ADM ID: M62BA304494E32ST] - 2025/10/02 22:18:47 CET [2025/10/02 16:18:47 ET]
Table 'Sirio' 6-max Seat #1 is the button
Seat 1: GIacius (€2.07 in chips) 
Seat 2: TheGreatSimba (€1.33 in chips) 
Seat 3: caduceus369 (€2.23 in chips) 
Seat 4: 7mosigillo (€1.85 in chips) 
Seat 5: Spillo.RN (€1.79 in chips) 
Seat 6: stfuplzudonk (€2.26 in chips) 
TheGreatSimba: posts small blind €0.01
caduceus369: posts big blind €0.02
*** HOLE CARDS ***
Dealt to caduceus369 [Qd Jc]
7mosigillo: folds 
Spillo.RN: folds 
stfuplzudonk: folds 
GIacius: folds 
TheGreatSimba: calls €0.01
caduceus369: checks 
*** FLOP *** [Qs Jh Td]
TheGreatSimba: bets €0.02
caduceus369: raises €0.02 to €0.04
TheGreatSimba: calls €0.02
*** TURN *** [Qs Jh Td] [Kc]
TheGreatSimba: bets €0.02
caduceus369: calls €0.02
*** RIVER *** [Qs Jh Td Kc] [6d]
TheGreatSimba: bets €0.10
caduceus369: folds 
Uncalled bet (€0.10) returned to TheGreatSimba
TheGreatSimba collected €0.16 from pot
TheGreatSimba: doesn't show hand 
*** SUMMARY ***
Total pot €0.16 | Rake €0 
Board [Qs Jh Td Kc 6d]
Seat 1: GIacius (button) folded before Flop (didn't bet)
Seat 2: TheGreatSimba (small blind) collected (€0.16)
Seat 3: caduceus369 (big blind) folded on the River
Seat 4: 7mosigillo folded before Flop (didn't bet)
Seat 5: Spillo.RN folded before Flop (didn't bet)
Seat 6: stfuplzudonk folded before Flop (didn't bet)



PokerStars Zoom Hand #257974581058:  Hold'em No Limit (€0.01/€0.02) [ADM ID: M62BA304494E32ST] - 2025/10/02 22:19:41 CET [2025/10/02 16:19:41 ET]
Table 'Sirio' 6-max Seat #1 is the button
Seat 1: Warterror90 (€4.23 in chips) 
Seat 2: caduceus369 (€2.15 in chips) 
Seat 3: stfuplzudonk (€1.56 in chips) 
Seat 4: PLOttingerrr (€4.02 in chips) 
Seat 5: GIacius (€2.04 in chips) 
Seat 6: zicky78.r (€2.20 in chips) 
caduceus369: posts small blind €0.01
stfuplzudonk: posts big blind €0.02
*** HOLE CARDS ***
Dealt to caduceus369 [Js Ad]
PLOttingerrr: folds 
GIacius: raises €0.02 to €0.04
zicky78.r: folds 
Warterror90: folds 
caduceus369: folds 
stfuplzudonk: calls €0.02
*** FLOP *** [2h Qs 3h]
stfuplzudonk: checks 
GIacius: bets €0.03
stfuplzudonk: folds 
Uncalled bet (€0.03) returned to GIacius
GIacius collected €0.09 from pot
GIacius: doesn't show hand 
*** SUMMARY ***
Total pot €0.09 | Rake €0 
Board [2h Qs 3h]
Seat 1: Warterror90 (button) folded before Flop (didn't bet)
Seat 2: caduceus369 (small blind) folded before Flop
Seat 3: stfuplzudonk (big blind) folded on the Flop
Seat 4: PLOttingerrr folded before Flop (didn't bet)
Seat 5: GIacius collected (€0.09)
Seat 6: zicky78.r folded before Flop (didn't bet)



PokerStars Zoom Hand #257974584107:  Hold'em No Limit (€0.01/€0.02) [ADM ID: M62BA304494E32ST] - 2025/10/02 22:19:54 CET [2025/10/02 16:19:54 ET]
Table 'Sirio' 6-max Seat #1 is the button
Seat 1: GIacius (€4.72 in chips) 
Seat 2: S'dj83 (€6.05 in chips) 
Seat 3: Spillo.RN (€1.81 in chips) 
Seat 4: IamJewels (€2 in chips) 
Seat 5: giocrouch (€2.28 in chips) 
Seat 6: caduceus369 (€2.14 in chips) 
S'dj83: posts small blind €0.01
Spillo.RN: posts big blind €0.02
*** HOLE CARDS ***
Dealt to caduceus369 [Kh Jd]
IamJewels: raises €0.02 to €0.04
giocrouch: folds 
caduceus369: calls €0.04
GIacius: folds 
S'dj83: folds 
Spillo.RN: folds 
*** FLOP *** [7d 2c 7h]
IamJewels: checks 
caduceus369: checks 
*** TURN *** [7d 2c 7h] [7c]
IamJewels: checks 
caduceus369: bets €0.03
IamJewels: calls €0.03
*** RIVER *** [7d 2c 7h 7c] [5h]
IamJewels: checks 
caduceus369: bets €0.04
IamJewels: folds 
Uncalled bet (€0.04) returned to caduceus369
caduceus369 collected €0.17 from pot
caduceus369: doesn't show hand 
*** SUMMARY ***
Total pot €0.17 | Rake €0 
Board [7d 2c 7h 7c 5h]
Seat 1: GIacius (button) folded before Flop (didn't bet)
Seat 2: S'dj83 (small blind) folded before Flop
Seat 3: Spillo.RN (big blind) folded before Flop
Seat 4: IamJewels folded on the River
Seat 5: giocrouch folded before Flop (didn't bet)
Seat 6: caduceus369 collected (€0.17)



PokerStars Zoom Hand #257974594865:  Hold'em No Limit (€0.01/€0.02) [ADM ID: M62BA304494E32ST] - 2025/10/02 22:20:37 CET [2025/10/02 16:20:37 ET]
Table 'Sirio' 6-max Seat #1 is the button
Seat 1: bruciapelo (€4.24 in chips) 
Seat 2: GIacius (€2.43 in chips) 
Seat 3: IamJewels (€2 in chips) 
Seat 4: father2008 (€3.93 in chips) 
Seat 5: caduceus369 (€2.24 in chips) 
Seat 6: gigiruk91 (€3.91 in chips) 
GIacius: posts small blind €0.01
IamJewels: posts big blind €0.02
*** HOLE CARDS ***
Dealt to caduceus369 [9c Th]
father2008: folds 
caduceus369: folds 
gigiruk91: folds 
bruciapelo: folds 
GIacius: folds 
Uncalled bet (€0.01) returned to IamJewels
IamJewels collected €0.02 from pot
IamJewels: doesn't show hand 
*** SUMMARY ***
Total pot €0.02 | Rake €0 
Seat 1: bruciapelo (button) folded before Flop (didn't bet)
Seat 2: GIacius (small blind) folded before Flop
Seat 3: IamJewels (big blind) collected (€0.02)
Seat 4: father2008 folded before Flop (didn't bet)
Seat 5: caduceus369 folded before Flop (didn't bet)
Seat 6: gigiruk91 folded before Flop (didn't bet)



PokerStars Zoom Hand #257974596682:  Hold'em No Limit (€0.01/€0.02) [ADM ID: M62BA304494E32ST] - 2025/10/02 22:20:45 CET [2025/10/02 16:20:45 ET]
Table 'Sirio' 6-max Seat #1 is the button
Seat 1: caduceus369 (€2.24 in chips) 
Seat 2: QUATTRODAME (€2.54 in chips) 
Seat 3: peones95 (€1.41 in chips) 
Seat 4: GIacius (€4.58 in chips) 
Seat 5: Spillo.RN (€1.73 in chips) 
Seat 6: zicky78.r (€2.21 in chips) 
QUATTRODAME: posts small blind €0.01
peones95: posts big blind €0.02
*** HOLE CARDS ***
Dealt to caduceus369 [As 8c]
GIacius: folds 
Spillo.RN: folds 
zicky78.r: folds 
caduceus369: raises €0.02 to €0.04
QUATTRODAME: folds 
peones95: calls €0.02
*** FLOP *** [2h Kh 7d]
peones95: checks 
caduceus369: bets €0.04
peones95: folds 
Uncalled bet (€0.04) returned to caduceus369
caduceus369 collected €0.09 from pot
caduceus369: doesn't show hand 
*** SUMMARY ***
Total pot €0.09 | Rake €0 
Board [2h Kh 7d]
Seat 1: caduceus369 (button) collected (€0.09)
Seat 2: QUATTRODAME (small blind) folded before Flop
Seat 3: peones95 (big blind) folded on the Flop
Seat 4: GIacius folded before Flop (didn't bet)
Seat 5: Spillo.RN folded before Flop (didn't bet)
Seat 6: zicky78.r folded before Flop (didn't bet)



PokerStars Zoom Hand #257974602579:  Hold'em No Limit (€0.01/€0.02) [ADM ID: M62BA304494E32ST] - 2025/10/02 22:21:09 CET [2025/10/02 16:21:09 ET]
Table 'Sirio' 6-max Seat #1 is the button
Seat 1: zicky78.r (€2.27 in chips) 
Seat 2: 7mosigillo (€2.54 in chips) 
Seat 3: GIacius (€4.61 in chips) 
Seat 4: caduceus369 (€2.29 in chips) 
Seat 5: c.ronaldo644 (€2.13 in chips) 
Seat 6: giocrouch (€2.16 in chips) 
7mosigillo: posts small blind €0.01
GIacius: posts big blind €0.02
*** HOLE CARDS ***
Dealt to caduceus369 [Qs Qc]
caduceus369: raises €0.02 to €0.04
c.ronaldo644: calls €0.04
giocrouch: folds 
zicky78.r: folds 
7mosigillo: folds 
GIacius: folds 
*** FLOP *** [5d 6h Ad]
caduceus369: checks 
c.ronaldo644: bets €0.06
caduceus369: folds 
Uncalled bet (€0.06) returned to c.ronaldo644
c.ronaldo644 collected €0.11 from pot
c.ronaldo644: doesn't show hand 
*** SUMMARY ***
Total pot €0.11 | Rake €0 
Board [5d 6h Ad]
Seat 1: zicky78.r (button) folded before Flop (didn't bet)
Seat 2: 7mosigillo (small blind) folded before Flop
Seat 3: GIacius (big blind) folded before Flop
Seat 4: caduceus369 folded on the Flop
Seat 5: c.ronaldo644 collected (€0.11)
Seat 6: giocrouch folded before Flop (didn't bet)



PokerStars Zoom Hand #257974608265:  Hold'em No Limit (€0.01/€0.02) [ADM ID: M62BA304494E32ST] - 2025/10/02 22:21:32 CET [2025/10/02 16:21:32 ET]
Table 'Sirio' 6-max Seat #1 is the button
Seat 1: EntitaOscura (€2.27 in chips) 
Seat 2: zicky78.r (€2.79 in chips) 
Seat 3: TheGreatSimba (€1.57 in chips) 
Seat 4: caduceus369 (€2.25 in chips) 
Seat 5: 7mosigillo (€1.91 in chips) 
Seat 6: stfuplzudonk (€1.54 in chips) 
zicky78.r: posts small blind €0.01
TheGreatSimba: posts big blind €0.02
*** HOLE CARDS ***
Dealt to caduceus369 [9h Th]
caduceus369: calls €0.02
7mosigillo: folds 
stfuplzudonk: calls €0.02
EntitaOscura: folds 
zicky78.r: folds 
TheGreatSimba: checks 
*** FLOP *** [6s As 8d]
TheGreatSimba: checks 
caduceus369: checks 
stfuplzudonk: bets €0.04
TheGreatSimba: calls €0.04
caduceus369: folds 
*** TURN *** [6s As 8d] [6d]
TheGreatSimba: checks 
stfuplzudonk: checks 
*** RIVER *** [6s As 8d 6d] [4s]
TheGreatSimba: bets €0.12
stfuplzudonk: folds 
Uncalled bet (€0.12) returned to TheGreatSimba
TheGreatSimba collected €0.15 from pot
TheGreatSimba: doesn't show hand 
*** SUMMARY ***
Total pot €0.15 | Rake €0 
Board [6s As 8d 6d 4s]
Seat 1: EntitaOscura (button) folded before Flop (didn't bet)
Seat 2: zicky78.r (small blind) folded before Flop
Seat 3: TheGreatSimba (big blind) collected (€0.15)
Seat 4: caduceus369 folded on the Flop
Seat 5: 7mosigillo folded before Flop (didn't bet)
Seat 6: stfuplzudonk folded on the River



PokerStars Zoom Hand #257974626815:  Hold'em No Limit (€0.01/€0.02) [ADM ID: M62BA304494E32ST] - 2025/10/02 22:22:47 CET [2025/10/02 16:22:47 ET]
Table 'Sirio' 6-max Seat #1 is the button
Seat 1: father2008 (€2.51 in chips) 
Seat 2: c.ronaldo644 (€2.09 in chips) 
Seat 3: IamJewels (€2 in chips) 
Seat 4: caduceus369 (€2.23 in chips) 
Seat 5: RRgalp (€4.76 in chips) 
Seat 6: S'dj83 (€6.37 in chips) 
c.ronaldo644: posts small blind €0.01
IamJewels: posts big blind €0.02
*** HOLE CARDS ***
Dealt to caduceus369 [5c 9h]
caduceus369: folds 
RRgalp: folds 
S'dj83: folds 
father2008: raises €0.04 to €0.06
c.ronaldo644: folds 
IamJewels: folds 
Uncalled bet (€0.04) returned to father2008
father2008 collected €0.05 from pot
father2008: doesn't show hand 
*** SUMMARY ***
Total pot €0.05 | Rake €0 
Seat 1: father2008 (button) collected (€0.05)
Seat 2: c.ronaldo644 (small blind) folded before Flop
Seat 3: IamJewels (big blind) folded before Flop
Seat 4: caduceus369 folded before Flop (didn't bet)
Seat 5: RRgalp folded before Flop (didn't bet)
Seat 6: S'dj83 folded before Flop (didn't bet)



PokerStars Zoom Hand #257974628422:  Hold'em No Limit (€0.01/€0.02) [ADM ID: M62BA304494E32ST] - 2025/10/02 22:22:54 CET [2025/10/02 16:22:54 ET]
Table 'Sirio' 6-max Seat #1 is the button
Seat 1: AlfredP80 (€2.12 in chips) 
Seat 2: TheGreatSimba (€1.66 in chips) 
Seat 3: caduceus369 (€2.23 in chips) 
Seat 4: Ptrcam (€0.87 in chips) 
Seat 5: EntitaOscura (€2.27 in chips) 
Seat 6: monsterc99 (€0.86 in chips) 
TheGreatSimba: posts small blind €0.01
caduceus369: posts big blind €0.02
*** HOLE CARDS ***
Dealt to caduceus369 [8h 2s]
Ptrcam: folds 
EntitaOscura: folds 
monsterc99: folds 
AlfredP80: folds 
TheGreatSimba: calls €0.01
caduceus369: checks 
*** FLOP *** [Jc Ad 3s]
TheGreatSimba: bets €0.02
caduceus369: folds 
Uncalled bet (€0.02) returned to TheGreatSimba
TheGreatSimba collected €0.04 from pot
TheGreatSimba: doesn't show hand 
*** SUMMARY ***
Total pot €0.04 | Rake €0 
Board [Jc Ad 3s]
Seat 1: AlfredP80 (button) folded before Flop (didn't bet)
Seat 2: TheGreatSimba (small blind) collected (€0.04)
Seat 3: caduceus369 (big blind) folded on the Flop
Seat 4: Ptrcam folded before Flop (didn't bet)
Seat 5: EntitaOscura folded before Flop (didn't bet)
Seat 6: monsterc99 folded before Flop (didn't bet)



PokerStars Zoom Hand #257974633363:  Hold'em No Limit (€0.01/€0.02) [ADM ID: M62BA304494E32ST] - 2025/10/02 22:23:14 CET [2025/10/02 16:23:14 ET]
Table 'Sirio' 6-max Seat #1 is the button
Seat 1: stfuplzudonk (€2.75 in chips) 
Seat 2: caduceus369 (€2.21 in chips) 
Seat 3: gigiruk91 (€3.35 in chips) 
Seat 4: zicky78.r (€2.19 in chips) 
Seat 5: ADRIAN0_MEIS (€2.12 in chips) 
Seat 6: Spillo.RN (€1.85 in chips) 
caduceus369: posts small blind €0.01
gigiruk91: posts big blind €0.02
*** HOLE CARDS ***
Dealt to caduceus369 [Kc 7d]
zicky78.r: folds 
ADRIAN0_MEIS: folds 
Spillo.RN: folds 
stfuplzudonk: folds 
caduceus369: calls €0.01
gigiruk91: checks 
*** FLOP *** [4h 8c 5h]
caduceus369: bets €0.02
gigiruk91: calls €0.02
*** TURN *** [4h 8c 5h] [5d]
caduceus369: checks 
gigiruk91: bets €0.04
caduceus369: folds 
Uncalled bet (€0.04) returned to gigiruk91
gigiruk91 collected €0.08 from pot
gigiruk91: doesn't show hand 
*** SUMMARY ***
Total pot €0.08 | Rake €0 
Board [4h 8c 5h 5d]
Seat 1: stfuplzudonk (button) folded before Flop (didn't bet)
Seat 2: caduceus369 (small blind) folded on the Turn
Seat 3: gigiruk91 (big blind) collected (€0.08)
Seat 4: zicky78.r folded before Flop (didn't bet)
Seat 5: ADRIAN0_MEIS folded before Flop (didn't bet)
Seat 6: Spillo.RN folded before Flop (didn't bet)



PokerStars Zoom Hand #257974645937:  Hold'em No Limit (€0.01/€0.02) [ADM ID: M62BA304494E32ST] - 2025/10/02 22:24:06 CET [2025/10/02 16:24:06 ET]
Table 'Sirio' 6-max Seat #1 is the button
Seat 1: giocrouch (€2.25 in chips) 
Seat 2: stoppaccino (€0.85 in chips) 
Seat 3: caduceus369 (€2.17 in chips) 
Seat 4: father2008 (€2.37 in chips) 
Seat 5: 19HinciaBS79 (€1.96 in chips) 
Seat 6: VagALiss (€2.03 in chips) 
stoppaccino: posts small blind €0.01
caduceus369: posts big blind €0.02
*** HOLE CARDS ***
Dealt to caduceus369 [Ac 7d]
father2008: folds 
19HinciaBS79: folds 
VagALiss: folds 
giocrouch: folds 
stoppaccino: folds 
Uncalled bet (€0.01) returned to caduceus369
caduceus369 collected €0.02 from pot
caduceus369: doesn't show hand 
*** SUMMARY ***
Total pot €0.02 | Rake €0 
Seat 1: giocrouch (button) folded before Flop (didn't bet)
Seat 2: stoppaccino (small blind) folded before Flop
Seat 3: caduceus369 (big blind) collected (€0.02)
Seat 4: father2008 folded before Flop (didn't bet)
Seat 5: 19HinciaBS79 folded before Flop (didn't bet)
Seat 6: VagALiss folded before Flop (didn't bet)



PokerStars Zoom Hand #257974644936:  Hold'em No Limit (€0.01/€0.02) [ADM ID: M62BA304494E32ST] - 2025/10/02 22:24:01 CET [2025/10/02 16:24:01 ET]
Table 'Sirio' 6-max Seat #1 is the button
Seat 1: caduceus369 (€2.17 in chips) 
Seat 2: de_toro_76 (€4.51 in chips) 
Seat 3: Warterror90 (€3.42 in chips) 
Seat 4: zicky78.r (€2.54 in chips) 
Seat 5: S'dj83 (€5.87 in chips) 
Seat 6: gigiruk91 (€9.37 in chips) 
de_toro_76: posts small blind €0.01
Warterror90: posts big blind €0.02
*** HOLE CARDS ***
Dealt to caduceus369 [6d 3d]
zicky78.r: raises €0.05 to €0.07
S'dj83: folds 
gigiruk91: folds 
caduceus369: folds 
de_toro_76: folds 
Warterror90: calls €0.05
*** FLOP *** [Jc 8d 5s]
Warterror90: checks 
zicky78.r: bets €0.15
Warterror90: folds 
Uncalled bet (€0.15) returned to zicky78.r
zicky78.r collected €0.15 from pot
zicky78.r: doesn't show hand 
*** SUMMARY ***
Total pot €0.15 | Rake €0 
Board [Jc 8d 5s]
Seat 1: caduceus369 (button) folded before Flop (didn't bet)
Seat 2: de_toro_76 (small blind) folded before Flop
Seat 3: Warterror90 (big blind) folded on the Flop
Seat 4: zicky78.r collected (€0.15)
Seat 5: S'dj83 folded before Flop (didn't bet)
Seat 6: gigiruk91 folded before Flop (didn't bet)



PokerStars Zoom Hand #257974649725:  Hold'em No Limit (€0.01/€0.02) [ADM ID: M62BA304494E32ST] - 2025/10/02 22:24:20 CET [2025/10/02 16:24:20 ET]
Table 'Sirio' 6-max Seat #1 is the button
Seat 1: Warterror90 (€4.58 in chips) 
Seat 2: RRgalp (€4.72 in chips) 
Seat 3: IamJewels (€2 in chips) 
Seat 4: gigiruk91 (€3.25 in chips) 
Seat 5: Spillo.RN (€1.77 in chips) 
Seat 6: caduceus369 (€2.18 in chips) 
RRgalp: posts small blind €0.01
IamJewels: posts big blind €0.02
*** HOLE CARDS ***
Dealt to caduceus369 [Tc Ks]
gigiruk91: folds 
Spillo.RN: folds 
caduceus369: raises €0.02 to €0.04
Warterror90: folds 
RRgalp: folds 
IamJewels: folds 
Uncalled bet (€0.02) returned to caduceus369
caduceus369 collected €0.05 from pot
caduceus369: doesn't show hand 
*** SUMMARY ***
Total pot €0.05 | Rake €0 
Seat 1: Warterror90 (button) folded before Flop (didn't bet)
Seat 2: RRgalp (small blind) folded before Flop
Seat 3: IamJewels (big blind) folded before Flop
Seat 4: gigiruk91 folded before Flop (didn't bet)
Seat 5: Spillo.RN folded before Flop (didn't bet)
Seat 6: caduceus369 collected (€0.05)



PokerStars Zoom Hand #257974659698:  Hold'em No Limit (€0.01/€0.02) [ADM ID: M62BA304494E32ST] - 2025/10/02 22:25:01 CET [2025/10/02 16:25:01 ET]
Table 'Sirio' 6-max Seat #1 is the button
Seat 1: stoppaccino (€0.79 in chips) 
Seat 2: 19HinciaBS79 (€1.91 in chips) 
Seat 3: AntonioKrakka (€1.53 in chips) 
Seat 4: BAMBUZ90 (€1.88 in chips) 
Seat 5: caduceus369 (€2.21 in chips) 
Seat 6: riki00000119 (€2.66 in chips) 
19HinciaBS79: posts small blind €0.01
AntonioKrakka: posts big blind €0.02
*** HOLE CARDS ***
Dealt to caduceus369 [Qd 6s]
BAMBUZ90: folds 
caduceus369: folds 
riki00000119: raises €0.04 to €0.06
stoppaccino: folds 
19HinciaBS79: folds 
AntonioKrakka: folds 
Uncalled bet (€0.04) returned to riki00000119
riki00000119 collected €0.05 from pot
riki00000119: doesn't show hand 
*** SUMMARY ***
Total pot €0.05 | Rake €0 
Seat 1: stoppaccino (button) folded before Flop (didn't bet)
Seat 2: 19HinciaBS79 (small blind) folded before Flop
Seat 3: AntonioKrakka (big blind) folded before Flop
Seat 4: BAMBUZ90 folded before Flop (didn't bet)
Seat 5: caduceus369 folded before Flop (didn't bet)
Seat 6: riki00000119 collected (€0.05)



PokerStars Zoom Hand #257974660543:  Hold'em No Limit (€0.01/€0.02) [ADM ID: M62BA304494E32ST] - 2025/10/02 22:25:04 CET [2025/10/02 16:25:04 ET]
Table 'Sirio' 6-max Seat #1 is the button
Seat 1: BAMBUZ90 (€1.88 in chips) 
Seat 2: caduceus369 (€2.21 in chips) 
Seat 3: DannyO985 (€1.88 in chips) 
Seat 4: axel75.s (€3.52 in chips) 
Seat 5: zicky78.r (€2.37 in chips) 
Seat 6: Warterror90 (€3.34 in chips) 
caduceus369: posts small blind €0.01
DannyO985: posts big blind €0.02
*** HOLE CARDS ***
Dealt to caduceus369 [5d Kc]
axel75.s: folds 
zicky78.r: folds 
Warterror90: raises €0.04 to €0.06
BAMBUZ90: folds 
caduceus369: folds 
DannyO985: folds 
Uncalled bet (€0.04) returned to Warterror90
Warterror90 collected €0.05 from pot
Warterror90: doesn't show hand 
*** SUMMARY ***
Total pot €0.05 | Rake €0 
Seat 1: BAMBUZ90 (button) folded before Flop (didn't bet)
Seat 2: caduceus369 (small blind) folded before Flop
Seat 3: DannyO985 (big blind) folded before Flop
Seat 4: axel75.s folded before Flop (didn't bet)
Seat 5: zicky78.r folded before Flop (didn't bet)
Seat 6: Warterror90 collected (€0.05)



PokerStars Zoom Hand #257974656379:  Hold'em No Limit (€0.01/€0.02) [ADM ID: M62BA304494E32ST] - 2025/10/02 22:24:47 CET [2025/10/02 16:24:47 ET]
Table 'Sirio' 6-max Seat #1 is the button
Seat 1: caduceus369 (€2.21 in chips) 
Seat 2: donkdelamesa (€2.38 in chips) 
Seat 3: giocrouch (€2.27 in chips) 
Seat 4: VagALiss (€2.02 in chips) 
Seat 5: riki00000119 (€2.66 in chips) 
Seat 6: zicky78.r (€2.39 in chips) 
donkdelamesa: posts small blind €0.01
giocrouch: posts big blind €0.02
*** HOLE CARDS ***
Dealt to caduceus369 [8d Ac]
VagALiss: raises €0.03 to €0.05
riki00000119: folds 
zicky78.r: folds 
caduceus369: folds 
donkdelamesa: folds 
giocrouch: calls €0.03
*** FLOP *** [Kd 3c 6s]
giocrouch: checks 
VagALiss: checks 
*** TURN *** [Kd 3c 6s] [2d]
giocrouch: bets €0.06
VagALiss: folds 
Uncalled bet (€0.06) returned to giocrouch
giocrouch collected €0.11 from pot
giocrouch: doesn't show hand 
*** SUMMARY ***
Total pot €0.11 | Rake €0 
Board [Kd 3c 6s 2d]
Seat 1: caduceus369 (button) folded before Flop (didn't bet)
Seat 2: donkdelamesa (small blind) folded before Flop
Seat 3: giocrouch (big blind) collected (€0.11)
Seat 4: VagALiss folded on the Turn
Seat 5: riki00000119 folded before Flop (didn't bet)
Seat 6: zicky78.r folded before Flop (didn't bet)



PokerStars Zoom Hand #257974661793:  Hold'em No Limit (€0.01/€0.02) [ADM ID: M62BA304494E32ST] - 2025/10/02 22:25:10 CET [2025/10/02 16:25:10 ET]
Table 'Sirio' 6-max Seat #1 is the button
Seat 1: riki00000119 (€3.72 in chips) 
Seat 2: zicky78.r (€2.37 in chips) 
Seat 3: Alfio6565 (€0.43 in chips) 
Seat 4: ADRIAN0_MEIS (€4.26 in chips) 
Seat 5: caduceus369 (€2.20 in chips) 
Seat 6: 19HinciaBS79 (€1.90 in chips) 
zicky78.r: posts small blind €0.01
Alfio6565: posts big blind €0.02
*** HOLE CARDS ***
Dealt to caduceus369 [Ks Qc]
ADRIAN0_MEIS: folds 
caduceus369: raises €0.02 to €0.04
19HinciaBS79: folds 
riki00000119: calls €0.04
zicky78.r: folds 
Alfio6565: calls €0.02
*** FLOP *** [4s 7s 7d]
Alfio6565: checks 
caduceus369: checks 
riki00000119: checks 
*** TURN *** [4s 7s 7d] [Tc]
Alfio6565: bets €0.02
caduceus369: folds 
riki00000119: calls €0.02
*** RIVER *** [4s 7s 7d Tc] [Ah]
Alfio6565: checks 
riki00000119: checks 
*** SHOW DOWN ***
Alfio6565: shows [6d Jd] (a pair of Sevens)
riki00000119: shows [Jh Qs] (a pair of Sevens - Ace+Queen kicker)
riki00000119 collected €0.17 from pot
*** SUMMARY ***
Total pot €0.17 | Rake €0 
Board [4s 7s 7d Tc Ah]
Seat 1: riki00000119 (button) showed [Jh Qs] and won (€0.17) with a pair of Sevens
Seat 2: zicky78.r (small blind) folded before Flop
Seat 3: Alfio6565 (big blind) showed [6d Jd] and lost with a pair of Sevens
Seat 4: ADRIAN0_MEIS folded before Flop (didn't bet)
Seat 5: caduceus369 folded on the Turn
Seat 6: 19HinciaBS79 folded before Flop (didn't bet)



PokerStars Zoom Hand #257974677200:  Hold'em No Limit (€0.01/€0.02) [ADM ID: M62BA304494E32ST] - 2025/10/02 22:26:12 CET [2025/10/02 16:26:12 ET]
Table 'Sirio' 6-max Seat #1 is the button
Seat 1: giocrouch (€2.26 in chips) 
Seat 2: BAMBUZ90 (€3.54 in chips) 
Seat 3: caduceus369 (€2.16 in chips) 
Seat 4: de_toro_76 (€3.17 in chips) 
Seat 5: kroll219 (€1.97 in chips) 
Seat 6: Gabrielefante (€6.26 in chips) 
BAMBUZ90: posts small blind €0.01
caduceus369: posts big blind €0.02
*** HOLE CARDS ***
Dealt to caduceus369 [Js Qd]
de_toro_76: folds 
kroll219: raises €0.02 to €0.04
Gabrielefante: folds 
giocrouch: folds 
BAMBUZ90: calls €0.03
caduceus369: calls €0.02
*** FLOP *** [Qc 8d Ah]
BAMBUZ90: bets €0.06
caduceus369: folds 
kroll219: calls €0.06
*** TURN *** [Qc 8d Ah] [Jd]
BAMBUZ90: checks 
kroll219: bets €0.12
BAMBUZ90: folds 
Uncalled bet (€0.12) returned to kroll219
kroll219 collected €0.23 from pot
kroll219: doesn't show hand 
*** SUMMARY ***
Total pot €0.24 | Rake €0.01 
Board [Qc 8d Ah Jd]
Seat 1: giocrouch (button) folded before Flop (didn't bet)
Seat 2: BAMBUZ90 (small blind) folded on the Turn
Seat 3: caduceus369 (big blind) folded on the Flop
Seat 4: de_toro_76 folded before Flop (didn't bet)
Seat 5: kroll219 collected (€0.23)
Seat 6: Gabrielefante folded before Flop (didn't bet)



PokerStars Zoom Hand #257974697488:  Hold'em No Limit (€0.01/€0.02) [ADM ID: M62BA304494E32ST] - 2025/10/02 22:27:35 CET [2025/10/02 16:27:35 ET]
Table 'Sirio' 6-max Seat #1 is the button
Seat 1: AntonioKrakka (€2.07 in chips) 
Seat 2: caduceus369 (€2.12 in chips) 
Seat 3: Warterror90 (€3.43 in chips) 
Seat 4: 7mosigillo (€2.65 in chips) 
Seat 5: stoppaccino (€0.77 in chips) 
Seat 6: DannyO985 (€2.92 in chips) 
caduceus369: posts small blind €0.01
Warterror90: posts big blind €0.02
*** HOLE CARDS ***
Dealt to caduceus369 [8s 3s]
7mosigillo: raises €0.04 to €0.06
stoppaccino: folds 
DannyO985: folds 
AntonioKrakka: folds 
caduceus369: folds 
Warterror90: folds 
Uncalled bet (€0.04) returned to 7mosigillo
7mosigillo collected €0.05 from pot
7mosigillo: doesn't show hand 
*** SUMMARY ***
Total pot €0.05 | Rake €0 
Seat 1: AntonioKrakka (button) folded before Flop (didn't bet)
Seat 2: caduceus369 (small blind) folded before Flop
Seat 3: Warterror90 (big blind) folded before Flop
Seat 4: 7mosigillo collected (€0.05)
Seat 5: stoppaccino folded before Flop (didn't bet)
Seat 6: DannyO985 folded before Flop (didn't bet)



PokerStars Zoom Hand #257974696015:  Hold'em No Limit (€0.01/€0.02) [ADM ID: M62BA304494E32ST] - 2025/10/02 22:27:29 CET [2025/10/02 16:27:29 ET]
Table 'Sirio' 6-max Seat #1 is the button
Seat 1: Warterror90 (€4.88 in chips) 
Seat 2: kroll219 (€2.10 in chips) 
Seat 3: bruciapelo (€4.14 in chips) 
Seat 4: k4l3l83 (€2.42 in chips) 
Seat 5: AntonioKrakka (€0.87 in chips) 
Seat 6: caduceus369 (€2.12 in chips) 
kroll219: posts small blind €0.01
bruciapelo: posts big blind €0.02
*** HOLE CARDS ***
Dealt to caduceus369 [8s 4c]
k4l3l83: raises €0.03 to €0.05
AntonioKrakka: folds 
caduceus369: folds 
Warterror90: calls €0.05
kroll219: folds 
bruciapelo: folds 
*** FLOP *** [5s 6s Th]
k4l3l83: checks 
Warterror90: checks 
*** TURN *** [5s 6s Th] [5h]
k4l3l83: bets €0.09
Warterror90: folds 
Uncalled bet (€0.09) returned to k4l3l83
k4l3l83 collected €0.13 from pot
k4l3l83: doesn't show hand 
*** SUMMARY ***
Total pot €0.13 | Rake €0 
Board [5s 6s Th 5h]
Seat 1: Warterror90 (button) folded on the Turn
Seat 2: kroll219 (small blind) folded before Flop
Seat 3: bruciapelo (big blind) folded before Flop
Seat 4: k4l3l83 collected (€0.13)
Seat 5: AntonioKrakka folded before Flop (didn't bet)
Seat 6: caduceus369 folded before Flop (didn't bet)



PokerStars Zoom Hand #257974699642:  Hold'em No Limit (€0.01/€0.02) [ADM ID: M62BA304494E32ST] - 2025/10/02 22:27:44 CET [2025/10/02 16:27:44 ET]
Table 'Sirio' 6-max Seat #1 is the button
Seat 1: caduceus369 (€2.11 in chips) 
Seat 2: VrDmNl (€3.02 in chips) 
Seat 3: AntonioKrakka (€0.87 in chips) 
Seat 4: ghosto69 (€3.14 in chips) 
Seat 5: stfuplzudonk (€3.38 in chips) 
Seat 6: riki00000119 (€3.74 in chips) 
VrDmNl: posts small blind €0.01
AntonioKrakka: posts big blind €0.02
*** HOLE CARDS ***
Dealt to caduceus369 [Qh 3h]
ghosto69: folds 
stfuplzudonk: folds 
riki00000119: folds 
caduceus369: folds 
VrDmNl: calls €0.01
AntonioKrakka: checks 
*** FLOP *** [Ah 9h 7s]
VrDmNl: checks 
AntonioKrakka: bets €0.04
VrDmNl: folds 
Uncalled bet (€0.04) returned to AntonioKrakka
AntonioKrakka collected €0.04 from pot
AntonioKrakka: doesn't show hand 
*** SUMMARY ***
Total pot €0.04 | Rake €0 
Board [Ah 9h 7s]
Seat 1: caduceus369 (button) folded before Flop (didn't bet)
Seat 2: VrDmNl (small blind) folded on the Flop
Seat 3: AntonioKrakka (big blind) collected (€0.04)
Seat 4: ghosto69 folded before Flop (didn't bet)
Seat 5: stfuplzudonk folded before Flop (didn't bet)
Seat 6: riki00000119 folded before Flop (didn't bet)



PokerStars Zoom Hand #257974702350:  Hold'em No Limit (€0.01/€0.02) [ADM ID: M62BA304494E32ST] - 2025/10/02 22:27:55 CET [2025/10/02 16:27:55 ET]
Table 'Sirio' 6-max Seat #1 is the button
Seat 1: potodds1979 (€2.03 in chips) 
Seat 2: kolain17 (€2.15 in chips) 
Seat 3: stfuplzudonk (€3.38 in chips) 
Seat 4: S'dj83 (€4.87 in chips) 
Seat 5: zicky78.r (€2.89 in chips) 
Seat 6: caduceus369 (€2.11 in chips) 
kolain17: posts small blind €0.01
stfuplzudonk: posts big blind €0.02
*** HOLE CARDS ***
Dealt to caduceus369 [Ac 8s]
S'dj83: folds 
zicky78.r: folds 
caduceus369: folds 
potodds1979: folds 
kolain17: calls €0.01
stfuplzudonk: checks 
*** FLOP *** [Jc 8h 4s]
kolain17: bets €0.02
stfuplzudonk: calls €0.02
*** TURN *** [Jc 8h 4s] [Qc]
kolain17: bets €0.02
stfuplzudonk: calls €0.02
*** RIVER *** [Jc 8h 4s Qc] [8d]
kolain17: bets €0.02
stfuplzudonk: calls €0.02
*** SHOW DOWN ***
kolain17: shows [Kh 2c] (a pair of Eights)
stfuplzudonk: shows [3d Js] (two pair, Jacks and Eights)
stfuplzudonk collected €0.16 from pot
*** SUMMARY ***
Total pot €0.16 | Rake €0 
Board [Jc 8h 4s Qc 8d]
Seat 1: potodds1979 (button) folded before Flop (didn't bet)
Seat 2: kolain17 (small blind) showed [Kh 2c] and lost with a pair of Eights
Seat 3: stfuplzudonk (big blind) showed [3d Js] and won (€0.16) with two pair, Jacks and Eights
Seat 4: S'dj83 folded before Flop (didn't bet)
Seat 5: zicky78.r folded before Flop (didn't bet)
Seat 6: caduceus369 folded before Flop (didn't bet)



PokerStars Zoom Hand #257974703896:  Hold'em No Limit (€0.01/€0.02) [ADM ID: M62BA304494E32ST] - 2025/10/02 22:28:01 CET [2025/10/02 16:28:01 ET]
Table 'Sirio' 6-max Seat #1 is the button
Seat 1: peones95 (€2.02 in chips) 
Seat 2: 19HinciaBS79 (€1.61 in chips) 
Seat 3: caduceus369 (€2.11 in chips) 
Seat 4: stfuplzudonk (€1.64 in chips) 
Seat 5: S'dj83 (€4.87 in chips) 
Seat 6: AntonioKrakka (€1.61 in chips) 
19HinciaBS79: posts small blind €0.01
caduceus369: posts big blind €0.02
*** HOLE CARDS ***
Dealt to caduceus369 [Jd 9s]
stfuplzudonk: folds 
S'dj83: raises €0.04 to €0.06
AntonioKrakka: folds 
peones95: folds 
19HinciaBS79: folds 
caduceus369: folds 
Uncalled bet (€0.04) returned to S'dj83
S'dj83 collected €0.05 from pot
S'dj83: doesn't show hand 
*** SUMMARY ***
Total pot €0.05 | Rake €0 
Seat 1: peones95 (button) folded before Flop (didn't bet)
Seat 2: 19HinciaBS79 (small blind) folded before Flop
Seat 3: caduceus369 (big blind) folded before Flop
Seat 4: stfuplzudonk folded before Flop (didn't bet)
Seat 5: S'dj83 collected (€0.05)
Seat 6: AntonioKrakka folded before Flop (didn't bet)



PokerStars Zoom Hand #257974701351:  Hold'em No Limit (€0.01/€0.02) [ADM ID: M62BA304494E32ST] - 2025/10/02 22:27:51 CET [2025/10/02 16:27:51 ET]
Table 'Sirio' 6-max Seat #1 is the button
Seat 1: zicky78.r (€2.89 in chips) 
Seat 2: jackkk03 (€2.17 in chips) 
Seat 3: Genny040893 (€0.64 in chips) 
Seat 4: diesel197474 (€1.54 in chips) 
Seat 5: caduceus369 (€2.11 in chips) 
Seat 6: ghosto69 (€1.89 in chips) 
jackkk03: posts small blind €0.01
Genny040893: posts big blind €0.02
*** HOLE CARDS ***
Dealt to caduceus369 [Th 4h]
diesel197474: raises €0.04 to €0.06
caduceus369: folds 
ghosto69: raises €0.15 to €0.21
zicky78.r: folds 
jackkk03: folds 
Genny040893: folds 
diesel197474: folds 
Uncalled bet (€0.15) returned to ghosto69
ghosto69 collected €0.15 from pot
ghosto69: doesn't show hand 
*** SUMMARY ***
Total pot €0.15 | Rake €0 
Seat 1: zicky78.r (button) folded before Flop (didn't bet)
Seat 2: jackkk03 (small blind) folded before Flop
Seat 3: Genny040893 (big blind) folded before Flop
Seat 4: diesel197474 folded before Flop
Seat 5: caduceus369 folded before Flop (didn't bet)
Seat 6: ghosto69 collected (€0.15)



PokerStars Zoom Hand #257974707227:  Hold'em No Limit (€0.01/€0.02) [ADM ID: M62BA304494E32ST] - 2025/10/02 22:28:15 CET [2025/10/02 16:28:15 ET]
Table 'Sirio' 6-max Seat #1 is the button
Seat 1: riki00000119 (€3.25 in chips) 
Seat 2: AntonioKrakka (€0.89 in chips) 
Seat 3: IamJewels (€2 in chips) 
Seat 4: zicky78.r (€2.14 in chips) 
Seat 5: caduceus369 (€2.09 in chips) 
Seat 6: diesel197474 (€1.48 in chips) 
AntonioKrakka: posts small blind €0.01
IamJewels: posts big blind €0.02
*** HOLE CARDS ***
Dealt to caduceus369 [Ah 4s]
zicky78.r: folds 
caduceus369: folds 
diesel197474: folds 
riki00000119: folds 
AntonioKrakka: folds 
Uncalled bet (€0.01) returned to IamJewels
IamJewels collected €0.02 from pot
IamJewels: doesn't show hand 
*** SUMMARY ***
Total pot €0.02 | Rake €0 
Seat 1: riki00000119 (button) folded before Flop (didn't bet)
Seat 2: AntonioKrakka (small blind) folded before Flop
Seat 3: IamJewels (big blind) collected (€0.02)
Seat 4: zicky78.r folded before Flop (didn't bet)
Seat 5: caduceus369 folded before Flop (didn't bet)
Seat 6: diesel197474 folded before Flop (didn't bet)



PokerStars Zoom Hand #257974700613:  Hold'em No Limit (€0.01/€0.02) [ADM ID: M62BA304494E32ST] - 2025/10/02 22:27:48 CET [2025/10/02 16:27:48 ET]
Table 'Sirio' 6-max Seat #1 is the button
Seat 1: ADRIAN0_MEIS (€5.70 in chips) 
Seat 2: gatto76 (€0.66 in chips) 
Seat 3: riki00000119 (€3.74 in chips) 
Seat 4: caduceus369 (€2.11 in chips) 
Seat 5: diesel197474 (€1.54 in chips) 
Seat 6: zicky78.r (€2.33 in chips) 
gatto76: posts small blind €0.01
riki00000119: posts big blind €0.02
*** HOLE CARDS ***
Dealt to caduceus369 [6c 8h]
caduceus369: folds 
diesel197474: folds 
zicky78.r: folds 
ADRIAN0_MEIS: raises €0.03 to €0.05
gatto76: calls €0.04
riki00000119: folds 
*** FLOP *** [5h Ks 6s]
gatto76: checks 
ADRIAN0_MEIS: bets €0.07
gatto76: calls €0.07
*** TURN *** [5h Ks 6s] [Qs]
gatto76: checks 
ADRIAN0_MEIS: checks 
*** RIVER *** [5h Ks 6s Qs] [5d]
gatto76: checks 
ADRIAN0_MEIS: checks 
*** SHOW DOWN ***
gatto76: shows [7h 9h] (a pair of Fives)
ADRIAN0_MEIS: shows [Jd Ac] (a pair of Fives - Ace kicker)
ADRIAN0_MEIS collected €0.25 from pot
*** SUMMARY ***
Total pot €0.26 | Rake €0.01 
Board [5h Ks 6s Qs 5d]
Seat 1: ADRIAN0_MEIS (button) showed [Jd Ac] and won (€0.25) with a pair of Fives
Seat 2: gatto76 (small blind) showed [7h 9h] and lost with a pair of Fives
Seat 3: riki00000119 (big blind) folded before Flop
Seat 4: caduceus369 folded before Flop (didn't bet)
Seat 5: diesel197474 folded before Flop (didn't bet)
Seat 6: zicky78.r folded before Flop (didn't bet)



PokerStars Zoom Hand #257974713347:  Hold'em No Limit (€0.01/€0.02) [ADM ID: M62BA304494E32ST] - 2025/10/02 22:28:40 CET [2025/10/02 16:28:40 ET]
Table 'Sirio' 6-max Seat #1 is the button
Seat 1: potodds1979 (€2 in chips) 
Seat 2: stfuplzudonk (€0.96 in chips) 
Seat 3: caduceus369 (€2.08 in chips) 
Seat 4: gigiruk91 (€3.70 in chips) 
Seat 5: zicky78.r (€2.60 in chips) 
Seat 6: IamJewels (€2.01 in chips) 
stfuplzudonk: posts small blind €0.01
caduceus369: posts big blind €0.02
*** HOLE CARDS ***
Dealt to caduceus369 [Jh 4d]
gigiruk91: folds 
zicky78.r: folds 
IamJewels: folds 
potodds1979: folds 
stfuplzudonk: folds 
Uncalled bet (€0.01) returned to caduceus369
caduceus369 collected €0.02 from pot
caduceus369: doesn't show hand 
*** SUMMARY ***
Total pot €0.02 | Rake €0 
Seat 1: potodds1979 (button) folded before Flop (didn't bet)
Seat 2: stfuplzudonk (small blind) folded before Flop
Seat 3: caduceus369 (big blind) collected (€0.02)
Seat 4: gigiruk91 folded before Flop (didn't bet)
Seat 5: zicky78.r folded before Flop (didn't bet)
Seat 6: IamJewels folded before Flop (didn't bet)



PokerStars Zoom Hand #257974708428:  Hold'em No Limit (€0.01/€0.02) [ADM ID: M62BA304494E32ST] - 2025/10/02 22:28:20 CET [2025/10/02 16:28:20 ET]
Table 'Sirio' 6-max Seat #1 is the button
Seat 1: VagALiss (€2.11 in chips) 
Seat 2: caduceus369 (€2.09 in chips) 
Seat 3: diesel197474 (€1.48 in chips) 
Seat 4: gigiruk91 (€3.29 in chips) 
Seat 5: kolain17 (€2.07 in chips) 
Seat 6: S'dj83 (€4.90 in chips) 
caduceus369: posts small blind €0.01
diesel197474: posts big blind €0.02
*** HOLE CARDS ***
Dealt to caduceus369 [5c 5s]
gigiruk91: raises €0.02 to €0.04
kolain17: raises €0.02 to €0.06
S'dj83: folds 
VagALiss: folds 
caduceus369: folds 
diesel197474: folds 
gigiruk91: calls €0.02
*** FLOP *** [7c Qh Jh]
gigiruk91: checks 
kolain17: checks 
*** TURN *** [7c Qh Jh] [3c]
gigiruk91: bets €0.15
kolain17: calls €0.15
*** RIVER *** [7c Qh Jh 3c] [Jc]
gigiruk91: bets €0.43
kolain17: calls €0.43
*** SHOW DOWN ***
gigiruk91: shows [3d 3s] (a full house, Threes full of Jacks)
kolain17: mucks hand 
gigiruk91 collected €1.24 from pot
*** SUMMARY ***
Total pot €1.31 | Rake €0.07 
Board [7c Qh Jh 3c Jc]
Seat 1: VagALiss (button) folded before Flop (didn't bet)
Seat 2: caduceus369 (small blind) folded before Flop
Seat 3: diesel197474 (big blind) folded before Flop
Seat 4: gigiruk91 showed [3d 3s] and won (€1.24) with a full house, Threes full of Jacks
Seat 5: kolain17 mucked [2c Ah]
Seat 6: S'dj83 folded before Flop (didn't bet)



PokerStars Zoom Hand #257974712162:  Hold'em No Limit (€0.01/€0.02) [ADM ID: M62BA304494E32ST] - 2025/10/02 22:28:35 CET [2025/10/02 16:28:35 ET]
Table 'Sirio' 6-max Seat #1 is the button
Seat 1: AntonioKrakka (€0.88 in chips) 
Seat 2: potodds1979 (€2.01 in chips) 
Seat 3: donkdelamesa (€2.07 in chips) 
Seat 4: caduceus369 (€2.08 in chips) 
Seat 5: axel75.s (€0.56 in chips) 
Seat 6: stoppaccino (€0.74 in chips) 
potodds1979: posts small blind €0.01
donkdelamesa: posts big blind €0.02
*** HOLE CARDS ***
Dealt to caduceus369 [9d 8s]
caduceus369: folds 
axel75.s: raises €0.02 to €0.04
stoppaccino: folds 
AntonioKrakka: folds 
potodds1979: folds 
donkdelamesa: calls €0.02
*** FLOP *** [9s Qh 5c]
donkdelamesa: checks 
axel75.s: checks 
*** TURN *** [9s Qh 5c] [Jc]
donkdelamesa: bets €0.06
axel75.s: calls €0.06
*** RIVER *** [9s Qh 5c Jc] [5s]
donkdelamesa: bets €0.15
axel75.s: folds 
Uncalled bet (€0.15) returned to donkdelamesa
donkdelamesa collected €0.20 from pot
donkdelamesa: doesn't show hand 
*** SUMMARY ***
Total pot €0.21 | Rake €0.01 
Board [9s Qh 5c Jc 5s]
Seat 1: AntonioKrakka (button) folded before Flop (didn't bet)
Seat 2: potodds1979 (small blind) folded before Flop
Seat 3: donkdelamesa (big blind) collected (€0.20)
Seat 4: caduceus369 folded before Flop (didn't bet)
Seat 5: axel75.s folded on the River
Seat 6: stoppaccino folded before Flop (didn't bet)



PokerStars Zoom Hand #257974720867:  Hold'em No Limit (€0.01/€0.02) [ADM ID: M62BA304494E32ST] - 2025/10/02 22:29:11 CET [2025/10/02 16:29:11 ET]
Table 'Sirio' 6-max Seat #1 is the button
Seat 1: caduceus369 (€2.09 in chips) 
Seat 2: mondie73100 (€2.20 in chips) 
Seat 3: 7mosigillo (€2.65 in chips) 
Seat 4: Warterror90 (€3.51 in chips) 
Seat 5: IamJewels (€2 in chips) 
Seat 6: zicky78.r (€2.88 in chips) 
mondie73100: posts small blind €0.01
7mosigillo: posts big blind €0.02
*** HOLE CARDS ***
Dealt to caduceus369 [5c 9h]
Warterror90: folds 
IamJewels: folds 
zicky78.r: folds 
caduceus369: folds 
mondie73100: folds 
Uncalled bet (€0.01) returned to 7mosigillo
7mosigillo collected €0.02 from pot
7mosigillo: doesn't show hand 
*** SUMMARY ***
Total pot €0.02 | Rake €0 
Seat 1: caduceus369 (button) folded before Flop (didn't bet)
Seat 2: mondie73100 (small blind) folded before Flop
Seat 3: 7mosigillo (big blind) collected (€0.02)
Seat 4: Warterror90 folded before Flop (didn't bet)
Seat 5: IamJewels folded before Flop (didn't bet)
Seat 6: zicky78.r folded before Flop (didn't bet)



PokerStars Zoom Hand #257974718768:  Hold'em No Limit (€0.01/€0.02) [ADM ID: M62BA304494E32ST] - 2025/10/02 22:29:02 CET [2025/10/02 16:29:02 ET]
Table 'Sirio' 6-max Seat #1 is the button
Seat 1: Giuggiola64 (€1.16 in chips) 
Seat 2: k4l3l83 (€2.53 in chips) 
Seat 3: RRgalp (€5.20 in chips) 
Seat 4: caramellemis (€5.48 in chips) 
Seat 5: stfuplzudonk (€3.48 in chips) 
Seat 6: caduceus369 (€2.09 in chips) 
k4l3l83: posts small blind €0.01
RRgalp: posts big blind €0.02
*** HOLE CARDS ***
Dealt to caduceus369 [3d Qc]
caramellemis: folds 
stfuplzudonk: folds 
caduceus369: folds 
Giuggiola64: raises €0.04 to €0.06
k4l3l83: calls €0.05
RRgalp: folds 
*** FLOP *** [Qh 2c 3c]
k4l3l83: checks 
Giuggiola64: checks 
*** TURN *** [Qh 2c 3c] [Js]
k4l3l83: bets €0.06
Giuggiola64: calls €0.06
*** RIVER *** [Qh 2c 3c Js] [8c]
k4l3l83: checks 
Giuggiola64: checks 
*** SHOW DOWN ***
k4l3l83: shows [Th Kh] (high card King)
Giuggiola64: shows [4s 4c] (a pair of Fours)
Giuggiola64 collected €0.25 from pot
*** SUMMARY ***
Total pot €0.26 | Rake €0.01 
Board [Qh 2c 3c Js 8c]
Seat 1: Giuggiola64 (button) showed [4s 4c] and won (€0.25) with a pair of Fours
Seat 2: k4l3l83 (small blind) showed [Th Kh] and lost with high card King
Seat 3: RRgalp (big blind) folded before Flop
Seat 4: caramellemis folded before Flop (didn't bet)
Seat 5: stfuplzudonk folded before Flop (didn't bet)
Seat 6: caduceus369 folded before Flop (didn't bet)



PokerStars Zoom Hand #257974716877:  Hold'em No Limit (€0.01/€0.02) [ADM ID: M62BA304494E32ST] - 2025/10/02 22:28:54 CET [2025/10/02 16:28:54 ET]
Table 'Sirio' 6-max Seat #1 is the button
Seat 1: diesel197474 (€1.45 in chips) 
Seat 2: AlfredP80 (€3.22 in chips) 
Seat 3: zicky78.r (€2.59 in chips) 
Seat 4: TheGreatSimba (€1.31 in chips) 
Seat 5: caduceus369 (€2.09 in chips) 
Seat 6: jackkk03 (€2.19 in chips) 
AlfredP80: posts small blind €0.01
zicky78.r: posts big blind €0.02
*** HOLE CARDS ***
Dealt to caduceus369 [9c 4c]
TheGreatSimba: folds 
caduceus369: folds 
jackkk03: raises €0.04 to €0.06
diesel197474: folds 
AlfredP80: calls €0.05
zicky78.r: calls €0.04
*** FLOP *** [9h Th Kd]
AlfredP80: bets €0.06
zicky78.r: folds 
jackkk03: raises €0.06 to €0.12
AlfredP80: calls €0.06
*** TURN *** [9h Th Kd] [4d]
AlfredP80: checks 
jackkk03: checks 
*** RIVER *** [9h Th Kd 4d] [2c]
AlfredP80: bets €0.20
jackkk03: folds 
Uncalled bet (€0.20) returned to AlfredP80
AlfredP80 collected €0.40 from pot
AlfredP80: doesn't show hand 
*** SUMMARY ***
Total pot €0.42 | Rake €0.02 
Board [9h Th Kd 4d 2c]
Seat 1: diesel197474 (button) folded before Flop (didn't bet)
Seat 2: AlfredP80 (small blind) collected (€0.40)
Seat 3: zicky78.r (big blind) folded on the Flop
Seat 4: TheGreatSimba folded before Flop (didn't bet)
Seat 5: caduceus369 folded before Flop (didn't bet)
Seat 6: jackkk03 folded on the River



PokerStars Zoom Hand #257974711470:  Hold'em No Limit (€0.01/€0.02) [ADM ID: M62BA304494E32ST] - 2025/10/02 22:28:32 CET [2025/10/02 16:28:32 ET]
Table 'Sirio' 6-max Seat #1 is the button
Seat 1: caduceus369 (€2.08 in chips) 
Seat 2: giocrouch (€2.41 in chips) 
Seat 3: S'dj83 (€4.90 in chips) 
Seat 4: mondie73100 (€2.22 in chips) 
Seat 5: DannyO985 (€2.80 in chips) 
Seat 6: monsterc99 (€0.90 in chips) 
giocrouch: posts small blind €0.01
S'dj83: posts big blind €0.02
*** HOLE CARDS ***
Dealt to caduceus369 [8h Ks]
mondie73100: folds 
DannyO985: raises €0.02 to €0.04
monsterc99: folds 
caduceus369: folds 
giocrouch: folds 
S'dj83: raises €0.16 to €0.20
DannyO985: calls €0.16
*** FLOP *** [6d Qc 4d]
S'dj83: bets €0.16
DannyO985: raises €0.16 to €0.32
S'dj83: calls €0.16
*** TURN *** [6d Qc 4d] [2h]
S'dj83: checks 
DannyO985: bets €2.28 and is all-in
S'dj83: folds 
Uncalled bet (€2.28) returned to DannyO985
DannyO985 collected €1 from pot
DannyO985: doesn't show hand 
*** SUMMARY ***
Total pot €1.05 | Rake €0.05 
Board [6d Qc 4d 2h]
Seat 1: caduceus369 (button) folded before Flop (didn't bet)
Seat 2: giocrouch (small blind) folded before Flop
Seat 3: S'dj83 (big blind) folded on the Turn
Seat 4: mondie73100 folded before Flop (didn't bet)
Seat 5: DannyO985 collected (€1)
Seat 6: monsterc99 folded before Flop (didn't bet)



PokerStars Zoom Hand #257974722514:  Hold'em No Limit (€0.01/€0.02) [ADM ID: M62BA304494E32ST] - 2025/10/02 22:29:17 CET [2025/10/02 16:29:17 ET]
Table 'Sirio' 6-max Seat #1 is the button
Seat 1: stfuplzudonk (€3.48 in chips) 
Seat 2: caduceus369 (€2.09 in chips) 
Seat 3: bisteccone90 (€1 in chips) 
Seat 4: diesel197474 (€1.46 in chips) 
Seat 5: ADRIAN0_MEIS (€2.95 in chips) 
Seat 6: VagALiss (€2.08 in chips) 
caduceus369: posts small blind €0.01
bisteccone90: posts big blind €0.02
*** HOLE CARDS ***
Dealt to caduceus369 [5h 3d]
diesel197474: calls €0.02
ADRIAN0_MEIS: folds 
VagALiss: folds 
stfuplzudonk: folds 
caduceus369: folds 
bisteccone90: checks 
*** FLOP *** [9d 8c 7d]
bisteccone90: checks 
diesel197474: bets €0.07
bisteccone90: calls €0.07
*** TURN *** [9d 8c 7d] [9c]
bisteccone90: checks 
diesel197474: bets €0.09
bisteccone90: calls €0.09
*** RIVER *** [9d 8c 7d 9c] [8s]
bisteccone90: checks 
diesel197474: bets €0.10
bisteccone90: raises €0.10 to €0.20
diesel197474: calls €0.10
*** SHOW DOWN ***
bisteccone90: shows [6h Td] (a straight, Six to Ten)
diesel197474: mucks hand 
bisteccone90 collected €0.73 from pot
*** SUMMARY ***
Total pot €0.77 | Rake €0.04 
Board [9d 8c 7d 9c 8s]
Seat 1: stfuplzudonk (button) folded before Flop (didn't bet)
Seat 2: caduceus369 (small blind) folded before Flop
Seat 3: bisteccone90 (big blind) showed [6h Td] and won (€0.73) with a straight, Six to Ten
Seat 4: diesel197474 mucked [Ad Ah]
Seat 5: ADRIAN0_MEIS folded before Flop (didn't bet)
Seat 6: VagALiss folded before Flop (didn't bet)



PokerStars Zoom Hand #257974724673:  Hold'em No Limit (€0.01/€0.02) [ADM ID: M62BA304494E32ST] - 2025/10/02 22:29:26 CET [2025/10/02 16:29:26 ET]
Table 'Sirio' 6-max Seat #1 is the button
Seat 1: ghosto69 (€2.93 in chips) 
Seat 2: stfuplzudonk (€3.48 in chips) 
Seat 3: pistaKKio23 (€2 in chips) 
Seat 4: caduceus369 (€2.08 in chips) 
Seat 5: ADRIAN0_MEIS (€2.95 in chips) 
Seat 6: riki00000119 (€3.10 in chips) 
stfuplzudonk: posts small blind €0.01
pistaKKio23: posts big blind €0.02
*** HOLE CARDS ***
Dealt to caduceus369 [Ts Tc]
caduceus369: raises €0.02 to €0.04
ADRIAN0_MEIS: folds 
riki00000119: folds 
ghosto69: folds 
stfuplzudonk: folds 
pistaKKio23: calls €0.02
*** FLOP *** [6h Qs 2d]
pistaKKio23: checks 
caduceus369: bets €0.02
pistaKKio23: folds 
Uncalled bet (€0.02) returned to caduceus369
caduceus369 collected €0.09 from pot
caduceus369: doesn't show hand 
*** SUMMARY ***
Total pot €0.09 | Rake €0 
Board [6h Qs 2d]
Seat 1: ghosto69 (button) folded before Flop (didn't bet)
Seat 2: stfuplzudonk (small blind) folded before Flop
Seat 3: pistaKKio23 (big blind) folded on the Flop
Seat 4: caduceus369 collected (€0.09)
Seat 5: ADRIAN0_MEIS folded before Flop (didn't bet)
Seat 6: riki00000119 folded before Flop (didn't bet)



PokerStars Zoom Hand #257974736348:  Hold'em No Limit (€0.01/€0.02) [ADM ID: M62BA304494E32ST] - 2025/10/02 22:30:14 CET [2025/10/02 16:30:14 ET]
Table 'Sirio' 6-max Seat #1 is the button
Seat 1: peones95 (€1.94 in chips) 
Seat 2: S'dj83 (€4.41 in chips) 
Seat 3: stfuplzudonk (€2.37 in chips) 
Seat 4: axel75.s (€0.54 in chips) 
Seat 5: ADRIAN0_MEIS (€2.92 in chips) 
Seat 6: caduceus369 (€2.13 in chips) 
S'dj83: posts small blind €0.01
stfuplzudonk: posts big blind €0.02
*** HOLE CARDS ***
Dealt to caduceus369 [Ts Tc]
axel75.s: folds 
ADRIAN0_MEIS: folds 
caduceus369: raises €0.02 to €0.04
peones95: folds 
S'dj83: folds 
stfuplzudonk: folds 
Uncalled bet (€0.02) returned to caduceus369
caduceus369 collected €0.05 from pot
caduceus369: doesn't show hand 
*** SUMMARY ***
Total pot €0.05 | Rake €0 
Seat 1: peones95 (button) folded before Flop (didn't bet)
Seat 2: S'dj83 (small blind) folded before Flop
Seat 3: stfuplzudonk (big blind) folded before Flop
Seat 4: axel75.s folded before Flop (didn't bet)
Seat 5: ADRIAN0_MEIS folded before Flop (didn't bet)
Seat 6: caduceus369 collected (€0.05)



PokerStars Zoom Hand #257974744904:  Hold'em No Limit (€0.01/€0.02) [ADM ID: M62BA304494E32ST] - 2025/10/02 22:30:49 CET [2025/10/02 16:30:49 ET]
Table 'Sirio' 6-max Seat #1 is the button
Seat 1: zicky78.r (€2.05 in chips) 
Seat 2: IamJewels (€2.13 in chips) 
Seat 3: caduceus369 (€2.16 in chips) 
Seat 4: BAMBUZ90 (€2.88 in chips) 
Seat 5: 19HinciaBS79 (€1.72 in chips) 
Seat 6: gigiruk91 (€3.57 in chips) 
IamJewels: posts small blind €0.01
caduceus369: posts big blind €0.02
*** HOLE CARDS ***
Dealt to caduceus369 [Qs 9d]
BAMBUZ90: folds 
19HinciaBS79: raises €0.04 to €0.06
gigiruk91: folds 
zicky78.r: folds 
IamJewels: folds 
caduceus369: folds 
Uncalled bet (€0.04) returned to 19HinciaBS79
19HinciaBS79 collected €0.05 from pot
19HinciaBS79: doesn't show hand 
*** SUMMARY ***
Total pot €0.05 | Rake €0 
Seat 1: zicky78.r (button) folded before Flop (didn't bet)
Seat 2: IamJewels (small blind) folded before Flop
Seat 3: caduceus369 (big blind) folded before Flop
Seat 4: BAMBUZ90 folded before Flop (didn't bet)
Seat 5: 19HinciaBS79 collected (€0.05)
Seat 6: gigiruk91 folded before Flop (didn't bet)



PokerStars Zoom Hand #257974748816:  Hold'em No Limit (€0.01/€0.02) [ADM ID: M62BA304494E32ST] - 2025/10/02 22:31:05 CET [2025/10/02 16:31:05 ET]
Table 'Sirio' 6-max Seat #1 is the button
Seat 1: pistaKKio23 (€1.96 in chips) 
Seat 2: IamJewels (€2.58 in chips) 
Seat 3: donkdelamesa (€2.08 in chips) 
Seat 4: caduceus369 (€2.14 in chips) 
Seat 5: RRgalp (€5.23 in chips) 
Seat 6: bisteccone90 (€1.31 in chips) 
IamJewels: posts small blind €0.01
donkdelamesa: posts big blind €0.02
*** HOLE CARDS ***
Dealt to caduceus369 [Ts Jd]
caduceus369: folds 
RRgalp: folds 
bisteccone90: folds 
pistaKKio23: folds 
IamJewels: raises €0.06 to €0.08
donkdelamesa: folds 
Uncalled bet (€0.06) returned to IamJewels
IamJewels collected €0.04 from pot
IamJewels: doesn't show hand 
*** SUMMARY ***
Total pot €0.04 | Rake €0 
Seat 1: pistaKKio23 (button) folded before Flop (didn't bet)
Seat 2: IamJewels (small blind) collected (€0.04)
Seat 3: donkdelamesa (big blind) folded before Flop
Seat 4: caduceus369 folded before Flop (didn't bet)
Seat 5: RRgalp folded before Flop (didn't bet)
Seat 6: bisteccone90 folded before Flop (didn't bet)



PokerStars Zoom Hand #257974751821:  Hold'em No Limit (€0.01/€0.02) [ADM ID: M62BA304494E32ST] - 2025/10/02 22:31:17 CET [2025/10/02 16:31:17 ET]
Table 'Sirio' 6-max Seat #1 is the button
Seat 1: AntonioKrakka (€2.49 in chips) 
Seat 2: caduceus369 (€2.14 in chips) 
Seat 3: riki00000119 (€2.07 in chips) 
Seat 4: bisteccone90 (€1.31 in chips) 
Seat 5: IamJewels (€2.10 in chips) 
Seat 6: pistaKKio23 (€1.96 in chips) 
caduceus369: posts small blind €0.01
riki00000119: posts big blind €0.02
*** HOLE CARDS ***
Dealt to caduceus369 [9c 2s]
bisteccone90: folds 
IamJewels: folds 
pistaKKio23: folds 
AntonioKrakka: raises €0.05 to €0.07
caduceus369: folds 
riki00000119: folds 
Uncalled bet (€0.05) returned to AntonioKrakka
AntonioKrakka collected €0.05 from pot
AntonioKrakka: doesn't show hand 
*** SUMMARY ***
Total pot €0.05 | Rake €0 
Seat 1: AntonioKrakka (button) collected (€0.05)
Seat 2: caduceus369 (small blind) folded before Flop
Seat 3: riki00000119 (big blind) folded before Flop
Seat 4: bisteccone90 folded before Flop (didn't bet)
Seat 5: IamJewels folded before Flop (didn't bet)
Seat 6: pistaKKio23 folded before Flop (didn't bet)



PokerStars Zoom Hand #257974753174:  Hold'em No Limit (€0.01/€0.02) [ADM ID: M62BA304494E32ST] - 2025/10/02 22:31:22 CET [2025/10/02 16:31:22 ET]
Table 'Sirio' 6-max Seat #1 is the button
Seat 1: zicky78.r (€2.22 in chips) 
Seat 2: IamJewels (€2.10 in chips) 
Seat 3: Sium12302 (€2 in chips) 
Seat 4: donkdelamesa (€2.06 in chips) 
Seat 5: sancarlo18 (€0.82 in chips) 
Seat 6: caduceus369 (€2.13 in chips) 
IamJewels: posts small blind €0.01
Sium12302: posts big blind €0.02
*** HOLE CARDS ***
Dealt to caduceus369 [Qd 4h]
donkdelamesa: folds 
sancarlo18: folds 
caduceus369: folds 
zicky78.r: folds 
IamJewels: folds 
Uncalled bet (€0.01) returned to Sium12302
Sium12302 collected €0.02 from pot
Sium12302: doesn't show hand 
*** SUMMARY ***
Total pot €0.02 | Rake €0 
Seat 1: zicky78.r (button) folded before Flop (didn't bet)
Seat 2: IamJewels (small blind) folded before Flop
Seat 3: Sium12302 (big blind) collected (€0.02)
Seat 4: donkdelamesa folded before Flop (didn't bet)
Seat 5: sancarlo18 folded before Flop (didn't bet)
Seat 6: caduceus369 folded before Flop (didn't bet)



PokerStars Zoom Hand #257974750027:  Hold'em No Limit (€0.01/€0.02) [ADM ID: M62BA304494E32ST] - 2025/10/02 22:31:10 CET [2025/10/02 16:31:10 ET]
Table 'Sirio' 6-max Seat #1 is the button
Seat 1: caduceus369 (€2.14 in chips) 
Seat 2: mondie73100 (€2.08 in chips) 
Seat 3: axel75.s (€0.53 in chips) 
Seat 4: stfuplzudonk (€3.75 in chips) 
Seat 5: Sium12302 (€2 in chips) 
Seat 6: potodds1979 (€2.11 in chips) 
mondie73100: posts small blind €0.01
axel75.s: posts big blind €0.02
*** HOLE CARDS ***
Dealt to caduceus369 [9c 3s]
stfuplzudonk: raises €0.04 to €0.06
Sium12302: folds 
potodds1979: raises €0.15 to €0.21
caduceus369: folds 
mondie73100: folds 
axel75.s: folds 
stfuplzudonk: calls €0.15
*** FLOP *** [8h 6c 4c]
stfuplzudonk: checks 
potodds1979: bets €0.22
stfuplzudonk: calls €0.22
*** TURN *** [8h 6c 4c] [7c]
stfuplzudonk: checks 
potodds1979: checks 
*** RIVER *** [8h 6c 4c 7c] [Jd]
stfuplzudonk: bets €0.85
potodds1979: folds 
Uncalled bet (€0.85) returned to stfuplzudonk
stfuplzudonk collected €0.85 from pot
stfuplzudonk: doesn't show hand 
*** SUMMARY ***
Total pot €0.89 | Rake €0.04 
Board [8h 6c 4c 7c Jd]
Seat 1: caduceus369 (button) folded before Flop (didn't bet)
Seat 2: mondie73100 (small blind) folded before Flop
Seat 3: axel75.s (big blind) folded before Flop
Seat 4: stfuplzudonk collected (€0.85)
Seat 5: Sium12302 folded before Flop (didn't bet)
Seat 6: potodds1979 folded on the River



PokerStars Zoom Hand #257974754020:  Hold'em No Limit (€0.01/€0.02) [ADM ID: M62BA304494E32ST] - 2025/10/02 22:31:26 CET [2025/10/02 16:31:26 ET]
Table 'Sirio' 6-max Seat #1 is the button
Seat 1: Warterror90 (€4.90 in chips) 
Seat 2: donkdelamesa (€2.06 in chips) 
Seat 3: 7mosigillo (€1.80 in chips) 
Seat 4: monsterc99 (€1.13 in chips) 
Seat 5: caduceus369 (€2.13 in chips) 
Seat 6: stfuplzudonk (€2.29 in chips) 
donkdelamesa: posts small blind €0.01
7mosigillo: posts big blind €0.02
*** HOLE CARDS ***
Dealt to caduceus369 [Qs Ts]
monsterc99: calls €0.02
caduceus369: raises €0.06 to €0.08
stfuplzudonk: calls €0.08
Warterror90: folds 
donkdelamesa: folds 
7mosigillo is disconnected 
7mosigillo: folds 
monsterc99: calls €0.06
*** FLOP *** [Qh Ah 3s]
monsterc99: bets €0.04
caduceus369: raises €0.10 to €0.14
stfuplzudonk: folds 
monsterc99: calls €0.10
*** TURN *** [Qh Ah 3s] [7d]
monsterc99: checks 
caduceus369: bets €0.12
monsterc99: calls €0.12
*** RIVER *** [Qh Ah 3s 7d] [Kd]
monsterc99: checks 
caduceus369: bets €0.18
monsterc99: calls €0.18
*** SHOW DOWN ***
caduceus369: shows [Qs Ts] (a pair of Queens)
monsterc99: shows [Ac Th] (a pair of Aces)
monsterc99 collected €1.09 from pot
*** SUMMARY ***
Total pot €1.15 | Rake €0.06 
Board [Qh Ah 3s 7d Kd]
Seat 1: Warterror90 (button) folded before Flop (didn't bet)
Seat 2: donkdelamesa (small blind) folded before Flop
Seat 3: 7mosigillo (big blind) folded before Flop
Seat 4: monsterc99 showed [Ac Th] and won (€1.09) with a pair of Aces
Seat 5: caduceus369 showed [Qs Ts] and lost with a pair of Queens
Seat 6: stfuplzudonk folded on the Flop



PokerStars Zoom Hand #257974779870:  Hold'em No Limit (€0.01/€0.02) [ADM ID: M62BA304494E32ST] - 2025/10/02 22:33:11 CET [2025/10/02 16:33:11 ET]
Table 'Sirio' 6-max Seat #1 is the button
Seat 1: caduceus369 (€1.59 in chips) 
Seat 2: pistaKKio23 (€2 in chips) 
Seat 3: IamJewels (€2.57 in chips) 
Seat 4: mondie73100 (€2.20 in chips) 
Seat 5: AntonioKrakka (€1.96 in chips) 
Seat 6: stfuplzudonk (€0.83 in chips) 
pistaKKio23: posts small blind €0.01
IamJewels: posts big blind €0.02
*** HOLE CARDS ***
Dealt to caduceus369 [Js 9d]
mondie73100: folds 
AntonioKrakka: folds 
stfuplzudonk: folds 
caduceus369: folds 
pistaKKio23: raises €0.04 to €0.06
IamJewels: folds 
Uncalled bet (€0.04) returned to pistaKKio23
pistaKKio23 collected €0.04 from pot
pistaKKio23: doesn't show hand 
*** SUMMARY ***
Total pot €0.04 | Rake €0 
Seat 1: caduceus369 (button) folded before Flop (didn't bet)
Seat 2: pistaKKio23 (small blind) collected (€0.04)
Seat 3: IamJewels (big blind) folded before Flop
Seat 4: mondie73100 folded before Flop (didn't bet)
Seat 5: AntonioKrakka folded before Flop (didn't bet)
Seat 6: stfuplzudonk folded before Flop (didn't bet)



PokerStars Zoom Hand #257974776177:  Hold'em No Limit (€0.01/€0.02) [ADM ID: M62BA304494E32ST] - 2025/10/02 22:32:56 CET [2025/10/02 16:32:56 ET]
Table 'Sirio' 6-max Seat #1 is the button
Seat 1: stfuplzudonk (€2.38 in chips) 
Seat 2: bisteccone90 (€1.36 in chips) 
Seat 3: ADRIAN0_MEIS (€5.92 in chips) 
Seat 4: AntonioKrakka (€3.57 in chips) 
Seat 5: caduceus369 (€1.61 in chips) 
Seat 6: BubbleGum360 (€2.04 in chips) 
bisteccone90: posts small blind €0.01
ADRIAN0_MEIS: posts big blind €0.02
*** HOLE CARDS ***
Dealt to caduceus369 [Ks 9h]
AntonioKrakka: folds 
caduceus369: folds 
BubbleGum360: folds 
stfuplzudonk: folds 
bisteccone90: calls €0.01
ADRIAN0_MEIS: checks 
*** FLOP *** [Ah 9s 6h]
bisteccone90: checks 
ADRIAN0_MEIS: checks 
*** TURN *** [Ah 9s 6h] [7c]
bisteccone90: bets €0.02
ADRIAN0_MEIS: calls €0.02
*** RIVER *** [Ah 9s 6h 7c] [4d]
bisteccone90: checks 
ADRIAN0_MEIS: checks 
*** SHOW DOWN ***
bisteccone90: shows [Qd Td] (high card Ace)
ADRIAN0_MEIS: mucks hand 
bisteccone90 collected €0.08 from pot
*** SUMMARY ***
Total pot €0.08 | Rake €0 
Board [Ah 9s 6h 7c 4d]
Seat 1: stfuplzudonk (button) folded before Flop (didn't bet)
Seat 2: bisteccone90 (small blind) showed [Qd Td] and won (€0.08) with high card Ace
Seat 3: ADRIAN0_MEIS (big blind) mucked [8d 3h]
Seat 4: AntonioKrakka folded before Flop (didn't bet)
Seat 5: caduceus369 folded before Flop (didn't bet)
Seat 6: BubbleGum360 folded before Flop (didn't bet)



PokerStars Zoom Hand #257974777657:  Hold'em No Limit (€0.01/€0.02) [ADM ID: M62BA304494E32ST] - 2025/10/02 22:33:02 CET [2025/10/02 16:33:02 ET]
Table 'Sirio' 6-max Seat #1 is the button
Seat 1: riki00000119 (€3.80 in chips) 
Seat 2: bubu1554 (€1.33 in chips) 
Seat 3: caduceus369 (€1.61 in chips) 
Seat 4: gigiruk91 (€3.64 in chips) 
Seat 5: k4l3l83 (€2.44 in chips) 
Seat 6: BAMBUZ90 (€3.10 in chips) 
bubu1554: posts small blind €0.01
caduceus369: posts big blind €0.02
*** HOLE CARDS ***
Dealt to caduceus369 [2d Jh]
gigiruk91: raises €0.02 to €0.04
k4l3l83: folds 
BAMBUZ90: calls €0.04
riki00000119: folds 
bubu1554: folds 
caduceus369: folds 
*** FLOP *** [9d 3h 8s]
gigiruk91: checks 
BAMBUZ90: bets €0.06
gigiruk91: calls €0.06
*** TURN *** [9d 3h 8s] [Ts]
gigiruk91: bets €0.06
BAMBUZ90: calls €0.06
*** RIVER *** [9d 3h 8s Ts] [8d]
gigiruk91: bets €0.08
BAMBUZ90: calls €0.08
*** SHOW DOWN ***
gigiruk91: shows [Td Js] (two pair, Tens and Eights)
BAMBUZ90: mucks hand 
gigiruk91 collected €0.49 from pot
*** SUMMARY ***
Total pot €0.51 | Rake €0.02 
Board [9d 3h 8s Ts 8d]
Seat 1: riki00000119 (button) folded before Flop (didn't bet)
Seat 2: bubu1554 (small blind) folded before Flop
Seat 3: caduceus369 (big blind) folded before Flop
Seat 4: gigiruk91 showed [Td Js] and won (€0.49) with two pair, Tens and Eights
Seat 5: k4l3l83 folded before Flop (didn't bet)
Seat 6: BAMBUZ90 mucked [Kh 9h]



PokerStars Zoom Hand #257974786056:  Hold'em No Limit (€0.01/€0.02) [ADM ID: M62BA304494E32ST] - 2025/10/02 22:33:36 CET [2025/10/02 16:33:36 ET]
Table 'Sirio' 6-max Seat #1 is the button
Seat 1: Giuggiola64 (€1.41 in chips) 
Seat 2: stevalmg (€2.66 in chips) 
Seat 3: Takedux (€1.97 in chips) 
Seat 4: father2008 (€3.76 in chips) 
Seat 5: caduceus369 (€1.58 in chips) 
Seat 6: Warterror90 (€5.30 in chips) 
stevalmg: posts small blind €0.01
Takedux: posts big blind €0.02
*** HOLE CARDS ***
Dealt to caduceus369 [3h 2c]
father2008: raises €0.04 to €0.06
caduceus369: folds 
Warterror90: folds 
Giuggiola64: folds 
stevalmg: folds 
Takedux: folds 
Uncalled bet (€0.04) returned to father2008
father2008 collected €0.05 from pot
father2008: doesn't show hand 
*** SUMMARY ***
Total pot €0.05 | Rake €0 
Seat 1: Giuggiola64 (button) folded before Flop (didn't bet)
Seat 2: stevalmg (small blind) folded before Flop
Seat 3: Takedux (big blind) folded before Flop
Seat 4: father2008 collected (€0.05)
Seat 5: caduceus369 folded before Flop (didn't bet)
Seat 6: Warterror90 folded before Flop (didn't bet)



PokerStars Zoom Hand #257974788313:  Hold'em No Limit (€0.01/€0.02) [ADM ID: M62BA304494E32ST] - 2025/10/02 22:33:45 CET [2025/10/02 16:33:45 ET]
Table 'Sirio' 6-max Seat #1 is the button
Seat 1: k4l3l83 (€2.38 in chips) 
Seat 2: riki00000119 (€2.20 in chips) 
Seat 3: caduceus369 (€1.58 in chips) 
Seat 4: Takedux (€1.95 in chips) 
Seat 5: mondie73100 (€2.20 in chips) 
Seat 6: burgaro24 (€0.79 in chips) 
riki00000119: posts small blind €0.01
caduceus369: posts big blind €0.02
*** HOLE CARDS ***
Dealt to caduceus369 [Qc 3h]
Takedux: folds 
mondie73100: raises €0.04 to €0.06
burgaro24: folds 
k4l3l83: folds 
riki00000119: folds 
caduceus369: folds 
Uncalled bet (€0.04) returned to mondie73100
mondie73100 collected €0.05 from pot
mondie73100: doesn't show hand 
*** SUMMARY ***
Total pot €0.05 | Rake €0 
Seat 1: k4l3l83 (button) folded before Flop (didn't bet)
Seat 2: riki00000119 (small blind) folded before Flop
Seat 3: caduceus369 (big blind) folded before Flop
Seat 4: Takedux folded before Flop (didn't bet)
Seat 5: mondie73100 collected (€0.05)
Seat 6: burgaro24 folded before Flop (didn't bet)



PokerStars Zoom Hand #257974786757:  Hold'em No Limit (€0.01/€0.02) [ADM ID: M62BA304494E32ST] - 2025/10/02 22:33:39 CET [2025/10/02 16:33:39 ET]
Table 'Sirio' 6-max Seat #1 is the button
Seat 1: F.Marotti (€2.26 in chips) 
Seat 2: AntonioKrakka (€1.96 in chips) 
Seat 3: cap e'bomb95 (€2 in chips) 
Seat 4: caduceus369 (€1.58 in chips) 
Seat 5: BAMBUZ90 (€2.86 in chips) 
Seat 6: gigiruk91 (€3.89 in chips) 
AntonioKrakka: posts small blind €0.01
cap e'bomb95: posts big blind €0.02
*** HOLE CARDS ***
Dealt to caduceus369 [6d Qd]
caduceus369: folds 
BAMBUZ90: folds 
gigiruk91: folds 
F.Marotti: raises €0.05 to €0.07
AntonioKrakka: folds 
cap e'bomb95: folds 
Uncalled bet (€0.05) returned to F.Marotti
F.Marotti collected €0.05 from pot
F.Marotti: doesn't show hand 
*** SUMMARY ***
Total pot €0.05 | Rake €0 
Seat 1: F.Marotti (button) collected (€0.05)
Seat 2: AntonioKrakka (small blind) folded before Flop
Seat 3: cap e'bomb95 (big blind) folded before Flop
Seat 4: caduceus369 folded before Flop (didn't bet)
Seat 5: BAMBUZ90 folded before Flop (didn't bet)
Seat 6: gigiruk91 folded before Flop (didn't bet)



PokerStars Zoom Hand #257974782406:  Hold'em No Limit (€0.01/€0.02) [ADM ID: M62BA304494E32ST] - 2025/10/02 22:33:21 CET [2025/10/02 16:33:21 ET]
Table 'Sirio' 6-max Seat #1 is the button
Seat 1: stfuplzudonk (€2.15 in chips) 
Seat 2: caduceus369 (€1.59 in chips) 
Seat 3: ghosto69 (€1.86 in chips) 
Seat 4: 19HinciaBS79 (€1.43 in chips) 
Seat 5: c.ronaldo644 (€1.95 in chips) 
Seat 6: IamJewels (€2 in chips) 
caduceus369: posts small blind €0.01
ghosto69: posts big blind €0.02
*** HOLE CARDS ***
Dealt to caduceus369 [Kd Th]
19HinciaBS79: folds 
c.ronaldo644: calls €0.02
IamJewels: folds 
stfuplzudonk: calls €0.02
caduceus369: folds 
ghosto69: checks 
*** FLOP *** [As Td Qh]
ghosto69: bets €0.02
c.ronaldo644: calls €0.02
stfuplzudonk: calls €0.02
*** TURN *** [As Td Qh] [Qs]
ghosto69: bets €0.04
c.ronaldo644: raises €0.08 to €0.12
stfuplzudonk: folds 
ghosto69: calls €0.08
*** RIVER *** [As Td Qh Qs] [Ks]
ghosto69: bets €0.04
c.ronaldo644: raises €0.10 to €0.14
ghosto69: calls €0.10
*** SHOW DOWN ***
c.ronaldo644: shows [7s Qc] (three of a kind, Queens)
ghosto69: shows [Qd Js] (a straight, Ten to Ace)
ghosto69 collected €0.62 from pot
*** SUMMARY ***
Total pot €0.65 | Rake €0.03 
Board [As Td Qh Qs Ks]
Seat 1: stfuplzudonk (button) folded on the Turn
Seat 2: caduceus369 (small blind) folded before Flop
Seat 3: ghosto69 (big blind) showed [Qd Js] and won (€0.62) with a straight, Ten to Ace
Seat 4: 19HinciaBS79 folded before Flop (didn't bet)
Seat 5: c.ronaldo644 showed [7s Qc] and lost with three of a kind, Queens
Seat 6: IamJewels folded before Flop (didn't bet)



PokerStars Zoom Hand #257974791776:  Hold'em No Limit (€0.01/€0.02) [ADM ID: M62BA304494E32ST] - 2025/10/02 22:33:59 CET [2025/10/02 16:33:59 ET]
Table 'Sirio' 6-max Seat #1 is the button
Seat 1: AntonioKrakka (€1.12 in chips) 
Seat 2: 7mosigillo (€1.90 in chips) 
Seat 3: eleonora50 (€3.06 in chips) 
Seat 4: caduceus369 (€1.56 in chips) 
Seat 5: zicky78.r (€2.02 in chips) 
Seat 6: Sium12302 (€2 in chips) 
7mosigillo: posts small blind €0.01
eleonora50: posts big blind €0.02
*** HOLE CARDS ***
Dealt to caduceus369 [8h 4s]
caduceus369: folds 
zicky78.r: raises €0.02 to €0.04
Sium12302: folds 
AntonioKrakka: calls €0.04
7mosigillo: calls €0.03
eleonora50: folds 
*** FLOP *** [4d 2h Ad]
7mosigillo: checks 
zicky78.r: checks 
AntonioKrakka: bets €0.14
7mosigillo: folds 
zicky78.r: folds 
Uncalled bet (€0.14) returned to AntonioKrakka
AntonioKrakka collected €0.14 from pot
AntonioKrakka: doesn't show hand 
*** SUMMARY ***
Total pot €0.14 | Rake €0 
Board [4d 2h Ad]
Seat 1: AntonioKrakka (button) collected (€0.14)
Seat 2: 7mosigillo (small blind) folded on the Flop
Seat 3: eleonora50 (big blind) folded before Flop
Seat 4: caduceus369 folded before Flop (didn't bet)
Seat 5: zicky78.r folded on the Flop
Seat 6: Sium12302 folded before Flop (didn't bet)



PokerStars Zoom Hand #257974790358:  Hold'em No Limit (€0.01/€0.02) [ADM ID: M62BA304494E32ST] - 2025/10/02 22:33:53 CET [2025/10/02 16:33:53 ET]
Table 'Sirio' 6-max Seat #1 is the button
Seat 1: ADRIAN0_MEIS (€5.88 in chips) 
Seat 2: AntonioKrakka (€1.13 in chips) 
Seat 3: monsterc99 (€0.80 in chips) 
Seat 4: bastiagero (€0.90 in chips) 
Seat 5: IamJewels (€2.54 in chips) 
Seat 6: caduceus369 (€1.56 in chips) 
AntonioKrakka: posts small blind €0.01
monsterc99: posts big blind €0.02
*** HOLE CARDS ***
Dealt to caduceus369 [Td 4h]
bastiagero: folds 
IamJewels: raises €0.02 to €0.04
caduceus369: folds 
ADRIAN0_MEIS: folds 
AntonioKrakka: folds 
monsterc99: calls €0.02
*** FLOP *** [Qh 4c 8d]
monsterc99: checks 
IamJewels: bets €0.03
monsterc99: calls €0.03
*** TURN *** [Qh 4c 8d] [7h]
monsterc99: checks 
IamJewels: checks 
*** RIVER *** [Qh 4c 8d 7h] [Jc]
monsterc99: bets €0.06
IamJewels: folds 
Uncalled bet (€0.06) returned to monsterc99
monsterc99 collected €0.15 from pot
monsterc99: doesn't show hand 
*** SUMMARY ***
Total pot €0.15 | Rake €0 
Board [Qh 4c 8d 7h Jc]
Seat 1: ADRIAN0_MEIS (button) folded before Flop (didn't bet)
Seat 2: AntonioKrakka (small blind) folded before Flop
Seat 3: monsterc99 (big blind) collected (€0.15)
Seat 4: bastiagero folded before Flop (didn't bet)
Seat 5: IamJewels folded on the River
Seat 6: caduceus369 folded before Flop (didn't bet)



PokerStars Zoom Hand #257974793400:  Hold'em No Limit (€0.01/€0.02) [ADM ID: M62BA304494E32ST] - 2025/10/02 22:34:06 CET [2025/10/02 16:34:06 ET]
Table 'Sirio' 6-max Seat #1 is the button
Seat 1: caramellemis (€6.09 in chips) 
Seat 2: caduceus369 (€1.56 in chips) 
Seat 3: VagALiss (€2.13 in chips) 
Seat 4: ADRIAN0_MEIS (€5.88 in chips) 
Seat 5: jackkk03 (€2.13 in chips) 
Seat 6: AntonioKrakka (€2.49 in chips) 
caduceus369: posts small blind €0.01
VagALiss: posts big blind €0.02
*** HOLE CARDS ***
Dealt to caduceus369 [Td Kh]
ADRIAN0_MEIS: folds 
jackkk03: folds 
AntonioKrakka: folds 
caramellemis: raises €0.08 to €0.10
caduceus369: folds 
VagALiss: folds 
Uncalled bet (€0.08) returned to caramellemis
caramellemis collected €0.05 from pot
caramellemis: doesn't show hand 
*** SUMMARY ***
Total pot €0.05 | Rake €0 
Seat 1: caramellemis (button) collected (€0.05)
Seat 2: caduceus369 (small blind) folded before Flop
Seat 3: VagALiss (big blind) folded before Flop
Seat 4: ADRIAN0_MEIS folded before Flop (didn't bet)
Seat 5: jackkk03 folded before Flop (didn't bet)
Seat 6: AntonioKrakka folded before Flop (didn't bet)



PokerStars Zoom Hand #257974800318:  Hold'em No Limit (€0.01/€0.02) [ADM ID: M62BA304494E32ST] - 2025/10/02 22:34:35 CET [2025/10/02 16:34:35 ET]
Table 'Sirio' 6-max Seat #1 is the button
Seat 1: caduceus369 (€1.55 in chips) 
Seat 2: ADRIAN0_MEIS (€5.87 in chips) 
Seat 3: burgaro24 (€0.80 in chips) 
Seat 4: riki00000119 (€2.03 in chips) 
Seat 5: AntonioKrakka (€3.71 in chips) 
Seat 6: cap e'bomb95 (€2 in chips) 
ADRIAN0_MEIS: posts small blind €0.01
burgaro24: posts big blind €0.02
*** HOLE CARDS ***
Dealt to caduceus369 [8h Ad]
riki00000119: folds 
AntonioKrakka: folds 
cap e'bomb95: folds 
caduceus369: folds 
ADRIAN0_MEIS: folds 
Uncalled bet (€0.01) returned to burgaro24
burgaro24 collected €0.02 from pot
burgaro24: doesn't show hand 
*** SUMMARY ***
Total pot €0.02 | Rake €0 
Seat 1: caduceus369 (button) folded before Flop (didn't bet)
Seat 2: ADRIAN0_MEIS (small blind) folded before Flop
Seat 3: burgaro24 (big blind) collected (€0.02)
Seat 4: riki00000119 folded before Flop (didn't bet)
Seat 5: AntonioKrakka folded before Flop (didn't bet)
Seat 6: cap e'bomb95 folded before Flop (didn't bet)



PokerStars Zoom Hand #257974801428:  Hold'em No Limit (€0.01/€0.02) [ADM ID: M62BA304494E32ST] - 2025/10/02 22:34:39 CET [2025/10/02 16:34:39 ET]
Table 'Sirio' 6-max Seat #1 is the button
Seat 1: cagliari59 (€1.13 in chips) 
Seat 2: riki00000119 (€3.59 in chips) 
Seat 3: ghosto69 (€2.68 in chips) 
Seat 4: caduceus369 (€1.55 in chips) 
Seat 5: VagALiss (€2.11 in chips) 
Seat 6: caramellemis (€6.12 in chips) 
riki00000119: posts small blind €0.01
ghosto69: posts big blind €0.02
*** HOLE CARDS ***
Dealt to caduceus369 [Qd 4d]
caduceus369: folds 
VagALiss: raises €0.03 to €0.05
caramellemis: folds 
cagliari59: folds 
riki00000119: folds 
ghosto69: folds 
Uncalled bet (€0.03) returned to VagALiss
VagALiss collected €0.05 from pot
VagALiss: doesn't show hand 
*** SUMMARY ***
Total pot €0.05 | Rake €0 
Seat 1: cagliari59 (button) folded before Flop (didn't bet)
Seat 2: riki00000119 (small blind) folded before Flop
Seat 3: ghosto69 (big blind) folded before Flop
Seat 4: caduceus369 folded before Flop (didn't bet)
Seat 5: VagALiss collected (€0.05)
Seat 6: caramellemis folded before Flop (didn't bet)



PokerStars Zoom Hand #257974802965:  Hold'em No Limit (€0.01/€0.02) [ADM ID: M62BA304494E32ST] - 2025/10/02 22:34:46 CET [2025/10/02 16:34:46 ET]
Table 'Sirio' 6-max Seat #1 is the button
Seat 1: caduceus369 (€1.55 in chips) 
Seat 2: IamJewels (€2 in chips) 
Seat 3: AntonioKrakka (€3.71 in chips) 
Seat 4: ADRIAN0_MEIS (€5.86 in chips) 
Seat 5: 19HinciaBS79 (€1.52 in chips) 
Seat 6: sancarlo18 (€1.13 in chips) 
IamJewels: posts small blind €0.01
AntonioKrakka: posts big blind €0.02
*** HOLE CARDS ***
Dealt to caduceus369 [Ks 5s]
ADRIAN0_MEIS: folds 
19HinciaBS79: folds 
sancarlo18: folds 
caduceus369: folds 
IamJewels: raises €0.05 to €0.07
AntonioKrakka: folds 
Uncalled bet (€0.05) returned to IamJewels
IamJewels collected €0.04 from pot
IamJewels: doesn't show hand 
*** SUMMARY ***
Total pot €0.04 | Rake €0 
Seat 1: caduceus369 (button) folded before Flop (didn't bet)
Seat 2: IamJewels (small blind) collected (€0.04)
Seat 3: AntonioKrakka (big blind) folded before Flop
Seat 4: ADRIAN0_MEIS folded before Flop (didn't bet)
Seat 5: 19HinciaBS79 folded before Flop (didn't bet)
Seat 6: sancarlo18 folded before Flop (didn't bet)



PokerStars Zoom Hand #257974805112:  Hold'em No Limit (€0.01/€0.02) [ADM ID: M62BA304494E32ST] - 2025/10/02 22:34:55 CET [2025/10/02 16:34:55 ET]
Table 'Sirio' 6-max Seat #1 is the button
Seat 1: IamJewels (€2.45 in chips) 
Seat 2: sancarlo18 (€1.13 in chips) 
Seat 3: caduceus369 (€1.55 in chips) 
Seat 4: Warterror90 (€4.97 in chips) 
Seat 5: AntonioKrakka (€1.87 in chips) 
Seat 6: VrDmNl (€2.83 in chips) 
sancarlo18: posts small blind €0.01
caduceus369: posts big blind €0.02
*** HOLE CARDS ***
Dealt to caduceus369 [2s Kh]
Warterror90: folds 
AntonioKrakka: folds 
VrDmNl: raises €0.05 to €0.07
IamJewels: folds 
sancarlo18: folds 
caduceus369: folds 
Uncalled bet (€0.05) returned to VrDmNl
VrDmNl collected €0.05 from pot
VrDmNl: doesn't show hand 
*** SUMMARY ***
Total pot €0.05 | Rake €0 
Seat 1: IamJewels (button) folded before Flop (didn't bet)
Seat 2: sancarlo18 (small blind) folded before Flop
Seat 3: caduceus369 (big blind) folded before Flop
Seat 4: Warterror90 folded before Flop (didn't bet)
Seat 5: AntonioKrakka folded before Flop (didn't bet)
Seat 6: VrDmNl collected (€0.05)



PokerStars Zoom Hand #257974808556:  Hold'em No Limit (€0.01/€0.02) [ADM ID: M62BA304494E32ST] - 2025/10/02 22:35:09 CET [2025/10/02 16:35:09 ET]
Table 'Sirio' 6-max Seat #1 is the button
Seat 1: ghosto69 (€2.10 in chips) 
Seat 2: ADRIAN0_MEIS (€2.88 in chips) 
Seat 3: sancarlo18 (€1.12 in chips) 
Seat 4: VrDmNl (€2.86 in chips) 
Seat 5: caduceus369 (€1.52 in chips) 
Seat 6: riki00000119 (€3.31 in chips) 
ADRIAN0_MEIS: posts small blind €0.01
sancarlo18: posts big blind €0.02
*** HOLE CARDS ***
Dealt to caduceus369 [7h Td]
VrDmNl: folds 
caduceus369: folds 
riki00000119: folds 
ghosto69: folds 
ADRIAN0_MEIS: folds 
Uncalled bet (€0.01) returned to sancarlo18
sancarlo18 collected €0.02 from pot
sancarlo18: doesn't show hand 
*** SUMMARY ***
Total pot €0.02 | Rake €0 
Seat 1: ghosto69 (button) folded before Flop (didn't bet)
Seat 2: ADRIAN0_MEIS (small blind) folded before Flop
Seat 3: sancarlo18 (big blind) collected (€0.02)
Seat 4: VrDmNl folded before Flop (didn't bet)
Seat 5: caduceus369 folded before Flop (didn't bet)
Seat 6: riki00000119 folded before Flop (didn't bet)



PokerStars Zoom Hand #257974807310:  Hold'em No Limit (€0.01/€0.02) [ADM ID: M62BA304494E32ST] - 2025/10/02 22:35:04 CET [2025/10/02 16:35:04 ET]
Table 'Sirio' 6-max Seat #1 is the button
Seat 1: monsterc99 (€0.90 in chips) 
Seat 2: caduceus369 (€1.53 in chips) 
Seat 3: gigiruk91 (€4.87 in chips) 
Seat 4: cap e'bomb95 (€1.97 in chips) 
Seat 5: axel75.s (€0.56 in chips) 
Seat 6: uomodimare62 (€1.20 in chips) 
caduceus369: posts small blind €0.01
gigiruk91: posts big blind €0.02
*** HOLE CARDS ***
Dealt to caduceus369 [2c 3s]
cap e'bomb95: raises €0.03 to €0.05
axel75.s: folds 
uomodimare62: folds 
monsterc99: folds 
caduceus369: folds 
gigiruk91: folds 
Uncalled bet (€0.03) returned to cap e'bomb95
cap e'bomb95 collected €0.05 from pot
cap e'bomb95: doesn't show hand 
*** SUMMARY ***
Total pot €0.05 | Rake €0 
Seat 1: monsterc99 (button) folded before Flop (didn't bet)
Seat 2: caduceus369 (small blind) folded before Flop
Seat 3: gigiruk91 (big blind) folded before Flop
Seat 4: cap e'bomb95 collected (€0.05)
Seat 5: axel75.s folded before Flop (didn't bet)
Seat 6: uomodimare62 folded before Flop (didn't bet)



PokerStars Zoom Hand #257974802224:  Hold'em No Limit (€0.01/€0.02) [ADM ID: M62BA304494E32ST] - 2025/10/02 22:34:43 CET [2025/10/02 16:34:43 ET]
Table 'Sirio' 6-max Seat #1 is the button
Seat 1: axel75.s (€0.56 in chips) 
Seat 2: gigiruk91 (€9.04 in chips) 
Seat 3: pistaKKio23 (€1.92 in chips) 
Seat 4: riki00000119 (€2.03 in chips) 
Seat 5: stfuplzudonk (€2.07 in chips) 
Seat 6: caduceus369 (€1.55 in chips) 
gigiruk91: posts small blind €0.01
pistaKKio23: posts big blind €0.02
*** HOLE CARDS ***
Dealt to caduceus369 [6h Qs]
riki00000119: raises €0.05 to €0.07
stfuplzudonk: folds 
caduceus369: folds 
axel75.s: folds 
gigiruk91: folds 
pistaKKio23: calls €0.05
*** FLOP *** [Ts 9d Tc]
pistaKKio23: checks 
riki00000119: bets €0.08
pistaKKio23: folds 
Uncalled bet (€0.08) returned to riki00000119
riki00000119 collected €0.15 from pot
riki00000119: doesn't show hand 
*** SUMMARY ***
Total pot €0.15 | Rake €0 
Board [Ts 9d Tc]
Seat 1: axel75.s (button) folded before Flop (didn't bet)
Seat 2: gigiruk91 (small blind) folded before Flop
Seat 3: pistaKKio23 (big blind) folded on the Flop
Seat 4: riki00000119 collected (€0.15)
Seat 5: stfuplzudonk folded before Flop (didn't bet)
Seat 6: caduceus369 folded before Flop (didn't bet)



PokerStars Zoom Hand #257974810588:  Hold'em No Limit (€0.01/€0.02) [ADM ID: M62BA304494E32ST] - 2025/10/02 22:35:17 CET [2025/10/02 16:35:17 ET]
Table 'Sirio' 6-max Seat #1 is the button
Seat 1: babanotop (€1.97 in chips) 
Seat 2: cap e'bomb95 (€1.91 in chips) 
Seat 3: ADRIAN0_MEIS (€2.87 in chips) 
Seat 4: caduceus369 (€1.52 in chips) 
Seat 5: monsterc99 (€0.90 in chips) 
Seat 6: diesel197474 (€1.29 in chips) 
cap e'bomb95: posts small blind €0.01
ADRIAN0_MEIS: posts big blind €0.02
*** HOLE CARDS ***
Dealt to caduceus369 [Ah 8h]
caduceus369: folds 
monsterc99: folds 
diesel197474: folds 
babanotop: folds 
cap e'bomb95: folds 
Uncalled bet (€0.01) returned to ADRIAN0_MEIS
ADRIAN0_MEIS collected €0.02 from pot
ADRIAN0_MEIS: doesn't show hand 
*** SUMMARY ***
Total pot €0.02 | Rake €0 
Seat 1: babanotop (button) folded before Flop (didn't bet)
Seat 2: cap e'bomb95 (small blind) folded before Flop
Seat 3: ADRIAN0_MEIS (big blind) collected (€0.02)
Seat 4: caduceus369 folded before Flop (didn't bet)
Seat 5: monsterc99 folded before Flop (didn't bet)
Seat 6: diesel197474 folded before Flop (didn't bet)



PokerStars Zoom Hand #257974809837:  Hold'em No Limit (€0.01/€0.02) [ADM ID: M62BA304494E32ST] - 2025/10/02 22:35:14 CET [2025/10/02 16:35:14 ET]
Table 'Sirio' 6-max Seat #1 is the button
Seat 1: zicky78.r (€2 in chips) 
Seat 2: AntonioKrakka (€1.87 in chips) 
Seat 3: S'dj83 (€3.90 in chips) 
Seat 4: riki00000119 (€3.31 in chips) 
Seat 5: caduceus369 (€1.52 in chips) 
Seat 6: Maur2507 (€1.02 in chips) 
AntonioKrakka: posts small blind €0.01
S'dj83: posts big blind €0.02
*** HOLE CARDS ***
Dealt to caduceus369 [Th Kd]
riki00000119: folds 
caduceus369: folds 
Maur2507: folds 
zicky78.r: raises €0.02 to €0.04
AntonioKrakka: folds 
S'dj83: raises €0.16 to €0.20
zicky78.r: folds 
Uncalled bet (€0.16) returned to S'dj83
S'dj83 collected €0.09 from pot
S'dj83: doesn't show hand 
*** SUMMARY ***
Total pot €0.09 | Rake €0 
Seat 1: zicky78.r (button) folded before Flop
Seat 2: AntonioKrakka (small blind) folded before Flop
Seat 3: S'dj83 (big blind) collected (€0.09)
Seat 4: riki00000119 folded before Flop (didn't bet)
Seat 5: caduceus369 folded before Flop (didn't bet)
Seat 6: Maur2507 folded before Flop (didn't bet)



PokerStars Zoom Hand #257974813918:  Hold'em No Limit (€0.01/€0.02) [ADM ID: M62BA304494E32ST] - 2025/10/02 22:35:30 CET [2025/10/02 16:35:30 ET]
Table 'Sirio' 6-max Seat #1 is the button
Seat 1: caduceus369 (€1.52 in chips) 
Seat 2: IamJewels (€2.55 in chips) 
Seat 3: pistaKKio23 (€1.75 in chips) 
Seat 4: gigiruk91 (€3.78 in chips) 
Seat 5: cap e'bomb95 (€2 in chips) 
Seat 6: Takedux (€2.25 in chips) 
IamJewels: posts small blind €0.01
pistaKKio23: posts big blind €0.02
*** HOLE CARDS ***
Dealt to caduceus369 [Jc 7d]
gigiruk91: folds 
cap e'bomb95: folds 
Takedux: folds 
caduceus369: folds 
IamJewels: folds 
Uncalled bet (€0.01) returned to pistaKKio23
pistaKKio23 collected €0.02 from pot
pistaKKio23: doesn't show hand 
*** SUMMARY ***
Total pot €0.02 | Rake €0 
Seat 1: caduceus369 (button) folded before Flop (didn't bet)
Seat 2: IamJewels (small blind) folded before Flop
Seat 3: pistaKKio23 (big blind) collected (€0.02)
Seat 4: gigiruk91 folded before Flop (didn't bet)
Seat 5: cap e'bomb95 folded before Flop (didn't bet)
Seat 6: Takedux folded before Flop (didn't bet)



PokerStars Zoom Hand #257974814718:  Hold'em No Limit (€0.01/€0.02) [ADM ID: M62BA304494E32ST] - 2025/10/02 22:35:34 CET [2025/10/02 16:35:34 ET]
Table 'Sirio' 6-max Seat #1 is the button
Seat 1: axel75.s (€0.53 in chips) 
Seat 2: cap e'bomb95 (€2 in chips) 
Seat 3: caduceus369 (€1.52 in chips) 
Seat 4: AntonioKrakka (€1.09 in chips) 
Seat 5: c.ronaldo644 (€1.60 in chips) 
Seat 6: riki00000119 (€2.09 in chips) 
cap e'bomb95: posts small blind €0.01
caduceus369: posts big blind €0.02
*** HOLE CARDS ***
Dealt to caduceus369 [5d Jh]
AntonioKrakka: raises €0.06 to €0.08
c.ronaldo644: folds 
riki00000119: folds 
axel75.s: folds 
cap e'bomb95: folds 
caduceus369: folds 
Uncalled bet (€0.06) returned to AntonioKrakka
AntonioKrakka collected €0.05 from pot
AntonioKrakka: doesn't show hand 
*** SUMMARY ***
Total pot €0.05 | Rake €0 
Seat 1: axel75.s (button) folded before Flop (didn't bet)
Seat 2: cap e'bomb95 (small blind) folded before Flop
Seat 3: caduceus369 (big blind) folded before Flop
Seat 4: AntonioKrakka collected (€0.05)
Seat 5: c.ronaldo644 folded before Flop (didn't bet)
Seat 6: riki00000119 folded before Flop (didn't bet)



PokerStars Zoom Hand #257974817387:  Hold'em No Limit (€0.01/€0.02) [ADM ID: M62BA304494E32ST] - 2025/10/02 22:35:45 CET [2025/10/02 16:35:45 ET]
Table 'Sirio' 6-max Seat #1 is the button
Seat 1: pistaKKio23 (€1.76 in chips) 
Seat 2: caduceus369 (€1.50 in chips) 
Seat 3: BAMBUZ90 (€2.21 in chips) 
Seat 4: IamJewels (€2.04 in chips) 
Seat 5: Takedux (€2.25 in chips) 
Seat 6: gigiruk91 (€4.84 in chips) 
caduceus369: posts small blind €0.01
BAMBUZ90: posts big blind €0.02
*** HOLE CARDS ***
Dealt to caduceus369 [3s Td]
IamJewels: folds 
Takedux: folds 
gigiruk91: folds 
pistaKKio23: folds 
caduceus369: folds 
Uncalled bet (€0.01) returned to BAMBUZ90
BAMBUZ90 collected €0.02 from pot
BAMBUZ90: doesn't show hand 
*** SUMMARY ***
Total pot €0.02 | Rake €0 
Seat 1: pistaKKio23 (button) folded before Flop (didn't bet)
Seat 2: caduceus369 (small blind) folded before Flop
Seat 3: BAMBUZ90 (big blind) collected (€0.02)
Seat 4: IamJewels folded before Flop (didn't bet)
Seat 5: Takedux folded before Flop (didn't bet)
Seat 6: gigiruk91 folded before Flop (didn't bet)



PokerStars Zoom Hand #257974818807:  Hold'em No Limit (€0.01/€0.02) [ADM ID: M62BA304494E32ST] - 2025/10/02 22:35:51 CET [2025/10/02 16:35:51 ET]
Table 'Sirio' 6-max Seat #1 is the button
Seat 1: stfuplzudonk (€0.75 in chips) 
Seat 2: IamJewels (€2.04 in chips) 
Seat 3: ADRIAN0_MEIS (€5.12 in chips) 
Seat 4: burgaro24 (€0.99 in chips) 
Seat 5: caduceus369 (€1.49 in chips) 
Seat 6: cap e'bomb95 (€1.87 in chips) 
IamJewels: posts small blind €0.01
ADRIAN0_MEIS: posts big blind €0.02
*** HOLE CARDS ***
Dealt to caduceus369 [8h Tc]
burgaro24: folds 
caduceus369: folds 
cap e'bomb95: folds 
stfuplzudonk: raises €0.02 to €0.04
IamJewels: folds 
ADRIAN0_MEIS: raises €0.09 to €0.13
stfuplzudonk: calls €0.09
*** FLOP *** [6d 9s Ad]
ADRIAN0_MEIS: bets €0.20
stfuplzudonk: folds 
Uncalled bet (€0.20) returned to ADRIAN0_MEIS
ADRIAN0_MEIS collected €0.26 from pot
ADRIAN0_MEIS: doesn't show hand 
*** SUMMARY ***
Total pot €0.27 | Rake €0.01 
Board [6d 9s Ad]
Seat 1: stfuplzudonk (button) folded on the Flop
Seat 2: IamJewels (small blind) folded before Flop
Seat 3: ADRIAN0_MEIS (big blind) collected (€0.26)
Seat 4: burgaro24 folded before Flop (didn't bet)
Seat 5: caduceus369 folded before Flop (didn't bet)
Seat 6: cap e'bomb95 folded before Flop (didn't bet)



PokerStars Zoom Hand #257974816579:  Hold'em No Limit (€0.01/€0.02) [ADM ID: M62BA304494E32ST] - 2025/10/02 22:35:42 CET [2025/10/02 16:35:42 ET]
Table 'Sirio' 6-max Seat #1 is the button
Seat 1: VagALiss (€2.11 in chips) 
Seat 2: riki00000119 (€3.56 in chips) 
Seat 3: bruciapelo (€5.45 in chips) 
Seat 4: BAMBUZ90 (€2.21 in chips) 
Seat 5: axel75.s (€0.53 in chips) 
Seat 6: caduceus369 (€1.50 in chips) 
riki00000119: posts small blind €0.01
bruciapelo: posts big blind €0.02
*** HOLE CARDS ***
Dealt to caduceus369 [4d 5c]
BAMBUZ90: folds 
axel75.s: folds 
caduceus369: folds 
VagALiss: folds 
riki00000119: raises €0.04 to €0.06
bruciapelo: calls €0.04
*** FLOP *** [2s Ah 7c]
riki00000119: checks 
bruciapelo: bets €0.11
riki00000119: folds 
Uncalled bet (€0.11) returned to bruciapelo
bruciapelo collected €0.12 from pot
bruciapelo: doesn't show hand 
*** SUMMARY ***
Total pot €0.12 | Rake €0 
Board [2s Ah 7c]
Seat 1: VagALiss (button) folded before Flop (didn't bet)
Seat 2: riki00000119 (small blind) folded on the Flop
Seat 3: bruciapelo (big blind) collected (€0.12)
Seat 4: BAMBUZ90 folded before Flop (didn't bet)
Seat 5: axel75.s folded before Flop (didn't bet)
Seat 6: caduceus369 folded before Flop (didn't bet)



PokerStars Zoom Hand #257974820535:  Hold'em No Limit (€0.01/€0.02) [ADM ID: M62BA304494E32ST] - 2025/10/02 22:35:58 CET [2025/10/02 16:35:58 ET]
Table 'Sirio' 6-max Seat #1 is the button
Seat 1: cap e'bomb95 (€1.91 in chips) 
Seat 2: gemini1682 (€1.97 in chips) 
Seat 3: caduceus369 (€1.49 in chips) 
Seat 4: ADRIAN0_MEIS (€2 in chips) 
Seat 5: Sium12302 (€2 in chips) 
Seat 6: VagALiss (€2.10 in chips) 
gemini1682: posts small blind €0.01
caduceus369: posts big blind €0.02
*** HOLE CARDS ***
Dealt to caduceus369 [Qd 2c]
ADRIAN0_MEIS: folds 
Sium12302: folds 
VagALiss: folds 
cap e'bomb95: folds 
gemini1682: folds 
Uncalled bet (€0.01) returned to caduceus369
caduceus369 collected €0.02 from pot
caduceus369: doesn't show hand 
*** SUMMARY ***
Total pot €0.02 | Rake €0 
Seat 1: cap e'bomb95 (button) folded before Flop (didn't bet)
Seat 2: gemini1682 (small blind) folded before Flop
Seat 3: caduceus369 (big blind) collected (€0.02)
Seat 4: ADRIAN0_MEIS folded before Flop (didn't bet)
Seat 5: Sium12302 folded before Flop (didn't bet)
Seat 6: VagALiss folded before Flop (didn't bet)



PokerStars Zoom Hand #257974819559:  Hold'em No Limit (€0.01/€0.02) [ADM ID: M62BA304494E32ST] - 2025/10/02 22:35:54 CET [2025/10/02 16:35:54 ET]
Table 'Sirio' 6-max Seat #1 is the button
Seat 1: caduceus369 (€1.49 in chips) 
Seat 2: VagALiss (€2.11 in chips) 
Seat 3: bubu1554 (€1.74 in chips) 
Seat 4: cap e'bomb95 (€1.87 in chips) 
Seat 5: gigiruk91 (€4.84 in chips) 
Seat 6: ghosto69 (€2.63 in chips) 
VagALiss: posts small blind €0.01
bubu1554: posts big blind €0.02
*** HOLE CARDS ***
Dealt to caduceus369 [6c Js]
cap e'bomb95: folds 
gigiruk91: raises €0.02 to €0.04
ghosto69: folds 
caduceus369: folds 
VagALiss: folds 
bubu1554: calls €0.02
*** FLOP *** [Kc 6s Ac]
bubu1554: checks 
gigiruk91: checks 
*** TURN *** [Kc 6s Ac] [Kd]
bubu1554: checks 
gigiruk91: checks 
*** RIVER *** [Kc 6s Ac Kd] [As]
bubu1554: checks 
gigiruk91: checks 
*** SHOW DOWN ***
bubu1554: shows [4s 3d] (two pair, Aces and Kings)
gigiruk91: shows [Jh Tc] (two pair, Aces and Kings - Jack kicker)
gigiruk91 collected €0.09 from pot
*** SUMMARY ***
Total pot €0.09 | Rake €0 
Board [Kc 6s Ac Kd As]
Seat 1: caduceus369 (button) folded before Flop (didn't bet)
Seat 2: VagALiss (small blind) folded before Flop
Seat 3: bubu1554 (big blind) showed [4s 3d] and lost with two pair, Aces and Kings
Seat 4: cap e'bomb95 folded before Flop (didn't bet)
Seat 5: gigiruk91 showed [Jh Tc] and won (€0.09) with two pair, Aces and Kings
Seat 6: ghosto69 folded before Flop (didn't bet)



PokerStars Zoom Hand #257974826054:  Hold'em No Limit (€0.01/€0.02) [ADM ID: M62BA304494E32ST] - 2025/10/02 22:36:20 CET [2025/10/02 16:36:20 ET]
Table 'Sirio' 6-max Seat #1 is the button
Seat 1: father2008 (€3.90 in chips) 
Seat 2: c.ronaldo644 (€1.54 in chips) 
Seat 3: gigiruk91 (€4.89 in chips) 
Seat 4: Warterror90 (€5.42 in chips) 
Seat 5: caduceus369 (€1.50 in chips) 
Seat 6: bubu1554 (€1.70 in chips) 
c.ronaldo644: posts small blind €0.01
gigiruk91: posts big blind €0.02
*** HOLE CARDS ***
Dealt to caduceus369 [2c 2s]
bubu1554 is disconnected 
Warterror90: folds 
caduceus369: folds 
bubu1554 has timed out while disconnected
bubu1554: folds 
father2008: folds 
c.ronaldo644: folds 
Uncalled bet (€0.01) returned to gigiruk91
gigiruk91 collected €0.02 from pot
gigiruk91: doesn't show hand 
*** SUMMARY ***
Total pot €0.02 | Rake €0 
Seat 1: father2008 (button) folded before Flop (didn't bet)
Seat 2: c.ronaldo644 (small blind) folded before Flop
Seat 3: gigiruk91 (big blind) collected (€0.02)
Seat 4: Warterror90 folded before Flop (didn't bet)
Seat 5: caduceus369 folded before Flop (didn't bet)
Seat 6: bubu1554 folded before Flop (didn't bet)



PokerStars Zoom Hand #257974827922:  Hold'em No Limit (€0.01/€0.02) [ADM ID: M62BA304494E32ST] - 2025/10/02 22:36:28 CET [2025/10/02 16:36:28 ET]
Table 'Sirio' 6-max Seat #1 is the button
Seat 1: Redfire827 (€1.49 in chips) 
Seat 2: Warterror90 (€5.42 in chips) 
Seat 3: eleonora50 (€3.38 in chips) 
Seat 4: pistaKKio23 (€1.87 in chips) 
Seat 5: VagALiss (€2.11 in chips) 
Seat 6: caduceus369 (€1.50 in chips) 
Warterror90: posts small blind €0.01
eleonora50: posts big blind €0.02
*** HOLE CARDS ***
Dealt to caduceus369 [6c Kd]
pistaKKio23: folds 
VagALiss: folds 
caduceus369: folds 
Redfire827: folds 
Warterror90: raises €0.04 to €0.06
eleonora50: folds 
Uncalled bet (€0.04) returned to Warterror90
Warterror90 collected €0.04 from pot
Warterror90: doesn't show hand 
*** SUMMARY ***
Total pot €0.04 | Rake €0 
Seat 1: Redfire827 (button) folded before Flop (didn't bet)
Seat 2: Warterror90 (small blind) collected (€0.04)
Seat 3: eleonora50 (big blind) folded before Flop
Seat 4: pistaKKio23 folded before Flop (didn't bet)
Seat 5: VagALiss folded before Flop (didn't bet)
Seat 6: caduceus369 folded before Flop (didn't bet)



PokerStars Zoom Hand #257974828982:  Hold'em No Limit (€0.01/€0.02) [ADM ID: M62BA304494E32ST] - 2025/10/02 22:36:32 CET [2025/10/02 16:36:32 ET]
Table 'Sirio' 6-max Seat #1 is the button
Seat 1: Nicoirca2004 (€1.84 in chips) 
Seat 2: caduceus369 (€1.50 in chips) 
Seat 3: pistaKKio23 (€1.87 in chips) 
Seat 4: Baba2010811 (€0.80 in chips) 
Seat 5: VagALiss (€2.11 in chips) 
Seat 6: Takedux (€2.16 in chips) 
caduceus369: posts small blind €0.01
pistaKKio23: posts big blind €0.02
*** HOLE CARDS ***
Dealt to caduceus369 [3h Th]
Baba2010811: folds 
VagALiss: folds 
Takedux: raises €0.04 to €0.06
Nicoirca2004: raises €0.06 to €0.12
caduceus369: folds 
pistaKKio23: folds 
Takedux: calls €0.06
*** FLOP *** [Td 3s Ks]
Takedux: checks 
Nicoirca2004: bets €0.10
Takedux: calls €0.10
*** TURN *** [Td 3s Ks] [3d]
Takedux: checks 
Nicoirca2004: checks 
*** RIVER *** [Td 3s Ks 3d] [6s]
Takedux: bets €0.23
Nicoirca2004: folds 
Uncalled bet (€0.23) returned to Takedux
Takedux collected €0.45 from pot
Takedux: doesn't show hand 
*** SUMMARY ***
Total pot €0.47 | Rake €0.02 
Board [Td 3s Ks 3d 6s]
Seat 1: Nicoirca2004 (button) folded on the River
Seat 2: caduceus369 (small blind) folded before Flop
Seat 3: pistaKKio23 (big blind) folded before Flop
Seat 4: Baba2010811 folded before Flop (didn't bet)
Seat 5: VagALiss folded before Flop (didn't bet)
Seat 6: Takedux collected (€0.45)



PokerStars Zoom Hand #257974830116:  Hold'em No Limit (€0.01/€0.02) [ADM ID: M62BA304494E32ST] - 2025/10/02 22:36:37 CET [2025/10/02 16:36:37 ET]
Table 'Sirio' 6-max Seat #1 is the button
Seat 1: kolain17 (€3.11 in chips) 
Seat 2: Baba2010811 (€0.80 in chips) 
Seat 3: Redfire827 (€1.49 in chips) 
Seat 4: AntonioKrakka (€1.20 in chips) 
Seat 5: cap e'bomb95 (€2.07 in chips) 
Seat 6: caduceus369 (€1.49 in chips) 
Baba2010811: posts small blind €0.01
Redfire827: posts big blind €0.02
*** HOLE CARDS ***
Dealt to caduceus369 [Ts 5d]
AntonioKrakka: folds 
cap e'bomb95: raises €0.03 to €0.05
caduceus369: folds 
kolain17: folds 
Baba2010811: calls €0.04
Redfire827 has timed out while disconnected
Redfire827: folds 
*** FLOP *** [6d 9c 9s]
Baba2010811: checks 
cap e'bomb95: checks 
*** TURN *** [6d 9c 9s] [2d]
Baba2010811: bets €0.02
cap e'bomb95: folds 
Uncalled bet (€0.02) returned to Baba2010811
Baba2010811 collected €0.12 from pot
Baba2010811: doesn't show hand 
*** SUMMARY ***
Total pot €0.12 | Rake €0 
Board [6d 9c 9s 2d]
Seat 1: kolain17 (button) folded before Flop (didn't bet)
Seat 2: Baba2010811 (small blind) collected (€0.12)
Seat 3: Redfire827 (big blind) folded before Flop
Seat 4: AntonioKrakka folded before Flop (didn't bet)
Seat 5: cap e'bomb95 folded on the Turn
Seat 6: caduceus369 folded before Flop (didn't bet)



PokerStars Zoom Hand #257974839196:  Hold'em No Limit (€0.01/€0.02) [ADM ID: M62BA304494E32ST] - 2025/10/02 22:37:14 CET [2025/10/02 16:37:14 ET]
Table 'Sirio' 6-max Seat #1 is the button
Seat 1: cap e'bomb95 (€1.82 in chips) 
Seat 2: caduceus369 (€1.47 in chips) 
Seat 3: c.ronaldo644 (€1.54 in chips) 
Seat 4: riki00000119 (€3.43 in chips) 
Seat 5: zicky78.r (€4.56 in chips) 
Seat 6: gigiruk91 (€4.89 in chips) 
caduceus369: posts small blind €0.01
c.ronaldo644: posts big blind €0.02
*** HOLE CARDS ***
Dealt to caduceus369 [2c Jc]
riki00000119: folds 
zicky78.r: raises €0.05 to €0.07
gigiruk91: folds 
cap e'bomb95: folds 
caduceus369: folds 
c.ronaldo644: folds 
Uncalled bet (€0.05) returned to zicky78.r
zicky78.r collected €0.05 from pot
zicky78.r: doesn't show hand 
*** SUMMARY ***
Total pot €0.05 | Rake €0 
Seat 1: cap e'bomb95 (button) folded before Flop (didn't bet)
Seat 2: caduceus369 (small blind) folded before Flop
Seat 3: c.ronaldo644 (big blind) folded before Flop
Seat 4: riki00000119 folded before Flop (didn't bet)
Seat 5: zicky78.r collected (€0.05)
Seat 6: gigiruk91 folded before Flop (didn't bet)



PokerStars Zoom Hand #257974842409:  Hold'em No Limit (€0.01/€0.02) [ADM ID: M62BA304494E32ST] - 2025/10/02 22:37:27 CET [2025/10/02 16:37:27 ET]
Table 'Sirio' 6-max Seat #1 is the button
Seat 1: caduceus369 (€1.44 in chips) 
Seat 2: ghosto69 (€2 in chips) 
Seat 3: Nicoirca2004 (€1.61 in chips) 
Seat 4: aleKG5 (€0.86 in chips) 
Seat 5: eleonora50 (€3.33 in chips) 
Seat 6: uomodimare62 (€1.25 in chips) 
ghosto69: posts small blind €0.01
Nicoirca2004: posts big blind €0.02
*** HOLE CARDS ***
Dealt to caduceus369 [3c 6h]
aleKG5: folds 
eleonora50: folds 
uomodimare62: folds 
caduceus369: folds 
ghosto69: folds 
Uncalled bet (€0.01) returned to Nicoirca2004
Nicoirca2004 collected €0.02 from pot
Nicoirca2004: doesn't show hand 
*** SUMMARY ***
Total pot €0.02 | Rake €0 
Seat 1: caduceus369 (button) folded before Flop (didn't bet)
Seat 2: ghosto69 (small blind) folded before Flop
Seat 3: Nicoirca2004 (big blind) collected (€0.02)
Seat 4: aleKG5 folded before Flop (didn't bet)
Seat 5: eleonora50 folded before Flop (didn't bet)
Seat 6: uomodimare62 folded before Flop (didn't bet)



PokerStars Zoom Hand #257974840234:  Hold'em No Limit (€0.01/€0.02) [ADM ID: M62BA304494E32ST] - 2025/10/02 22:37:18 CET [2025/10/02 16:37:18 ET]
Table 'Sirio' 6-max Seat #1 is the button
Seat 1: Nicoirca2004 (€1.62 in chips) 
Seat 2: mondie73100 (€2.63 in chips) 
Seat 3: caduceus369 (€1.46 in chips) 
Seat 4: cap e'bomb95 (€1.82 in chips) 
Seat 5: burgaro24 (€1.21 in chips) 
Seat 6: cagliari59 (€1.18 in chips) 
mondie73100: posts small blind €0.01
caduceus369: posts big blind €0.02
*** HOLE CARDS ***
Dealt to caduceus369 [4d 5c]
cap e'bomb95: folds 
burgaro24: folds 
cagliari59: raises €0.05 to €0.07
Nicoirca2004: folds 
mondie73100: calls €0.06
caduceus369: folds 
*** FLOP *** [5d 9c As]
mondie73100: checks 
cagliari59: bets €0.16
mondie73100: folds 
Uncalled bet (€0.16) returned to cagliari59
cagliari59 collected €0.16 from pot
cagliari59: doesn't show hand 
*** SUMMARY ***
Total pot €0.16 | Rake €0 
Board [5d 9c As]
Seat 1: Nicoirca2004 (button) folded before Flop (didn't bet)
Seat 2: mondie73100 (small blind) folded on the Flop
Seat 3: caduceus369 (big blind) folded before Flop
Seat 4: cap e'bomb95 folded before Flop (didn't bet)
Seat 5: burgaro24 folded before Flop (didn't bet)
Seat 6: cagliari59 collected (€0.16)



PokerStars Zoom Hand #257974831142:  Hold'em No Limit (€0.01/€0.02) [ADM ID: M62BA304494E32ST] - 2025/10/02 22:36:41 CET [2025/10/02 16:36:41 ET]
Table 'Sirio' 6-max Seat #1 is the button
Seat 1: mondie73100 (€2.65 in chips) 
Seat 2: monsterc99 (€0.87 in chips) 
Seat 3: AntonioKrakka (€1.20 in chips) 
Seat 4: caduceus369 (€1.49 in chips) 
Seat 5: ADRIAN0_MEIS (€2.85 in chips) 
Seat 6: kolain17 (€3.11 in chips) 
monsterc99: posts small blind €0.01
AntonioKrakka: posts big blind €0.02
*** HOLE CARDS ***
Dealt to caduceus369 [7d 8d]
caduceus369: calls €0.02
ADRIAN0_MEIS: folds 
kolain17: calls €0.02
mondie73100: folds 
monsterc99: calls €0.01
AntonioKrakka: checks 
*** FLOP *** [4s Ts Kc]
monsterc99: checks 
AntonioKrakka: checks 
caduceus369: checks 
kolain17: bets €0.08
monsterc99: folds 
AntonioKrakka: calls €0.08
caduceus369: folds 
*** TURN *** [4s Ts Kc] [Th]
AntonioKrakka: checks 
kolain17: bets €0.30
AntonioKrakka: calls €0.30
*** RIVER *** [4s Ts Kc Th] [Ad]
AntonioKrakka: checks 
kolain17: bets €0.40
AntonioKrakka: calls €0.40
*** SHOW DOWN ***
kolain17: shows [Js Kd] (two pair, Kings and Tens)
AntonioKrakka: shows [7h Td] (three of a kind, Tens)
AntonioKrakka collected €1.55 from pot
*** SUMMARY ***
Total pot €1.64 | Rake €0.09 
Board [4s Ts Kc Th Ad]
Seat 1: mondie73100 (button) folded before Flop (didn't bet)
Seat 2: monsterc99 (small blind) folded on the Flop
Seat 3: AntonioKrakka (big blind) showed [7h Td] and won (€1.55) with three of a kind, Tens
Seat 4: caduceus369 folded on the Flop
Seat 5: ADRIAN0_MEIS folded before Flop (didn't bet)
Seat 6: kolain17 showed [Js Kd] and lost with two pair, Kings and Tens



PokerStars Zoom Hand #257974845588:  Hold'em No Limit (€0.01/€0.02) [ADM ID: M62BA304494E32ST] - 2025/10/02 22:37:40 CET [2025/10/02 16:37:40 ET]
Table 'Sirio' 6-max Seat #1 is the button
Seat 1: sancarlo18 (€1.06 in chips) 
Seat 2: caduceus369 (€1.44 in chips) 
Seat 3: VagALiss (€2.13 in chips) 
Seat 4: peones95 (€1.94 in chips) 
Seat 5: zicky78.r (€4.59 in chips) 
Seat 6: Nicoirca2004 (€1.62 in chips) 
caduceus369: posts small blind €0.01
VagALiss: posts big blind €0.02
*** HOLE CARDS ***
Dealt to caduceus369 [Jh 5s]
peones95: folds 
zicky78.r: folds 
Nicoirca2004: folds 
sancarlo18: folds 
caduceus369: calls €0.01
VagALiss: checks 
*** FLOP *** [Ah 8c As]
caduceus369: bets €0.02
VagALiss: folds 
Uncalled bet (€0.02) returned to caduceus369
caduceus369 collected €0.04 from pot
caduceus369: doesn't show hand 
*** SUMMARY ***
Total pot €0.04 | Rake €0 
Board [Ah 8c As]
Seat 1: sancarlo18 (button) folded before Flop (didn't bet)
Seat 2: caduceus369 (small blind) collected (€0.04)
Seat 3: VagALiss (big blind) folded on the Flop
Seat 4: peones95 folded before Flop (didn't bet)
Seat 5: zicky78.r folded before Flop (didn't bet)
Seat 6: Nicoirca2004 folded before Flop (didn't bet)



PokerStars Zoom Hand #257974843226:  Hold'em No Limit (€0.01/€0.02) [ADM ID: M62BA304494E32ST] - 2025/10/02 22:37:30 CET [2025/10/02 16:37:30 ET]
Table 'Sirio' 6-max Seat #1 is the button
Seat 1: aleKG5 (€0.86 in chips) 
Seat 2: AntonioKrakka (€3.72 in chips) 
Seat 3: monsterc99 (€0.85 in chips) 
Seat 4: caduceus369 (€1.44 in chips) 
Seat 5: pistaKKio23 (€1.84 in chips) 
Seat 6: stfuplzudonk (€1.83 in chips) 
AntonioKrakka: posts small blind €0.01
monsterc99: posts big blind €0.02
*** HOLE CARDS ***
Dealt to caduceus369 [5d 4s]
caduceus369: folds 
pistaKKio23: folds 
stfuplzudonk: raises €0.02 to €0.04
aleKG5: folds 
AntonioKrakka: folds 
monsterc99: calls €0.02
*** FLOP *** [3d 7c Qd]
monsterc99: checks 
stfuplzudonk: checks 
*** TURN *** [3d 7c Qd] [Ks]
monsterc99: bets €0.04
stfuplzudonk: folds 
Uncalled bet (€0.04) returned to monsterc99
monsterc99 collected €0.09 from pot
monsterc99: doesn't show hand 
*** SUMMARY ***
Total pot €0.09 | Rake €0 
Board [3d 7c Qd Ks]
Seat 1: aleKG5 (button) folded before Flop (didn't bet)
Seat 2: AntonioKrakka (small blind) folded before Flop
Seat 3: monsterc99 (big blind) collected (€0.09)
Seat 4: caduceus369 folded before Flop (didn't bet)
Seat 5: pistaKKio23 folded before Flop (didn't bet)
Seat 6: stfuplzudonk folded on the Turn



PokerStars Zoom Hand #257974843858:  Hold'em No Limit (€0.01/€0.02) [ADM ID: M62BA304494E32ST] - 2025/10/02 22:37:33 CET [2025/10/02 16:37:33 ET]
Table 'Sirio' 6-max Seat #1 is the button
Seat 1: peones95 (€1.94 in chips) 
Seat 2: father2008 (€2.06 in chips) 
Seat 3: thomas7029 (€1.20 in chips) 
Seat 4: ghosto69 (€1.99 in chips) 
Seat 5: Alfio6565 (€0.95 in chips) 
Seat 6: caduceus369 (€1.44 in chips) 
father2008: posts small blind €0.01
thomas7029: posts big blind €0.02
*** HOLE CARDS ***
Dealt to caduceus369 [3c 7h]
ghosto69: folds 
Alfio6565: raises €0.02 to €0.04
caduceus369: folds 
peones95: folds 
father2008: calls €0.03
thomas7029: calls €0.02
*** FLOP *** [2d 4d Ks]
father2008: checks 
thomas7029: checks 
Alfio6565: bets €0.02
father2008: calls €0.02
thomas7029: calls €0.02
*** TURN *** [2d 4d Ks] [Ah]
father2008: checks 
thomas7029: checks 
Alfio6565: bets €0.09
father2008: folds 
thomas7029: folds 
Uncalled bet (€0.09) returned to Alfio6565
Alfio6565 collected €0.18 from pot
Alfio6565: doesn't show hand 
*** SUMMARY ***
Total pot €0.18 | Rake €0 
Board [2d 4d Ks Ah]
Seat 1: peones95 (button) folded before Flop (didn't bet)
Seat 2: father2008 (small blind) folded on the Turn
Seat 3: thomas7029 (big blind) folded on the Turn
Seat 4: ghosto69 folded before Flop (didn't bet)
Seat 5: Alfio6565 collected (€0.18)
Seat 6: caduceus369 folded before Flop (didn't bet)



PokerStars Zoom Hand #257974844827:  Hold'em No Limit (€0.01/€0.02) [ADM ID: M62BA304494E32ST] - 2025/10/02 22:37:37 CET [2025/10/02 16:37:37 ET]
Table 'Sirio' 6-max Seat #1 is the button
Seat 1: jackkk03 (€2.09 in chips) 
Seat 2: VrDmNl (€2.79 in chips) 
Seat 3: ghosto69 (€1.99 in chips) 
Seat 4: Genny040893 (€0.47 in chips) 
Seat 5: caduceus369 (€1.44 in chips) 
Seat 6: pistaKKio23 (€1.84 in chips) 
VrDmNl: posts small blind €0.01
ghosto69: posts big blind €0.02
*** HOLE CARDS ***
Dealt to caduceus369 [5h 2d]
Genny040893: calls €0.02
caduceus369: folds 
pistaKKio23: folds 
jackkk03: folds 
VrDmNl: calls €0.01
ghosto69: raises €0.04 to €0.06
Genny040893: calls €0.04
VrDmNl: calls €0.04
*** FLOP *** [2c Ah 3h]
VrDmNl: checks 
ghosto69: bets €0.06
Genny040893: calls €0.06
VrDmNl: folds 
*** TURN *** [2c Ah 3h] [Kd]
ghosto69: checks 
Genny040893: checks 
*** RIVER *** [2c Ah 3h Kd] [8c]
ghosto69: bets €0.22
Genny040893: folds 
Uncalled bet (€0.22) returned to ghosto69
ghosto69 collected €0.29 from pot
ghosto69: doesn't show hand 
*** SUMMARY ***
Total pot €0.30 | Rake €0.01 
Board [2c Ah 3h Kd 8c]
Seat 1: jackkk03 (button) folded before Flop (didn't bet)
Seat 2: VrDmNl (small blind) folded on the Flop
Seat 3: ghosto69 (big blind) collected (€0.29)
Seat 4: Genny040893 folded on the River
Seat 5: caduceus369 folded before Flop (didn't bet)
Seat 6: pistaKKio23 folded before Flop (didn't bet)



PokerStars Zoom Hand #257974851650:  Hold'em No Limit (€0.01/€0.02) [ADM ID: M62BA304494E32ST] - 2025/10/02 22:38:05 CET [2025/10/02 16:38:05 ET]
Table 'Sirio' 6-max Seat #1 is the button
Seat 1: monsterc99 (€0.90 in chips) 
Seat 2: Alfio6565 (€1.07 in chips) 
Seat 3: caduceus369 (€1.46 in chips) 
Seat 4: AntonioKrakka (€2.04 in chips) 
Seat 5: pistaKKio23 (€1.51 in chips) 
Seat 6: Warterror90 (€4.82 in chips) 
Alfio6565: posts small blind €0.01
caduceus369: posts big blind €0.02
*** HOLE CARDS ***
Dealt to caduceus369 [7d 5c]
AntonioKrakka: raises €0.05 to €0.07
pistaKKio23: folds 
Warterror90: raises €0.15 to €0.22
monsterc99: folds 
Alfio6565: folds 
caduceus369: folds 
AntonioKrakka: folds 
Uncalled bet (€0.15) returned to Warterror90
Warterror90 collected €0.17 from pot
Warterror90: doesn't show hand 
*** SUMMARY ***
Total pot €0.17 | Rake €0 
Seat 1: monsterc99 (button) folded before Flop (didn't bet)
Seat 2: Alfio6565 (small blind) folded before Flop
Seat 3: caduceus369 (big blind) folded before Flop
Seat 4: AntonioKrakka folded before Flop
Seat 5: pistaKKio23 folded before Flop (didn't bet)
Seat 6: Warterror90 collected (€0.17)



PokerStars Zoom Hand #257974854950:  Hold'em No Limit (€0.01/€0.02) [ADM ID: M62BA304494E32ST] - 2025/10/02 22:38:18 CET [2025/10/02 16:38:18 ET]
Table 'Sirio' 6-max Seat #1 is the button
Seat 1: caduceus369 (€1.44 in chips) 
Seat 2: gemini1682 (€2.44 in chips) 
Seat 3: Warterror90 (€5.11 in chips) 
Seat 4: Takedux (€2.45 in chips) 
Seat 5: cagliari59 (€1.23 in chips) 
Seat 6: zicky78.r (€2.82 in chips) 
gemini1682: posts small blind €0.01
Warterror90: posts big blind €0.02
*** HOLE CARDS ***
Dealt to caduceus369 [3c Qs]
Takedux: folds 
cagliari59: folds 
zicky78.r: folds 
caduceus369: folds 
gemini1682: raises €0.04 to €0.06
Warterror90: folds 
Uncalled bet (€0.04) returned to gemini1682
gemini1682 collected €0.04 from pot
gemini1682: doesn't show hand 
*** SUMMARY ***
Total pot €0.04 | Rake €0 
Seat 1: caduceus369 (button) folded before Flop (didn't bet)
Seat 2: gemini1682 (small blind) collected (€0.04)
Seat 3: Warterror90 (big blind) folded before Flop
Seat 4: Takedux folded before Flop (didn't bet)
Seat 5: cagliari59 folded before Flop (didn't bet)
Seat 6: zicky78.r folded before Flop (didn't bet)



PokerStars Zoom Hand #257974857684:  Hold'em No Limit (€0.01/€0.02) [ADM ID: M62BA304494E32ST] - 2025/10/02 22:38:29 CET [2025/10/02 16:38:29 ET]
Table 'Sirio' 6-max Seat #1 is the button
Seat 1: caduceus369 (€1.44 in chips) 
Seat 2: gigiruk91 (€3.69 in chips) 
Seat 3: AntonioKrakka (€3.65 in chips) 
Seat 4: pistaKKio23 (€1.77 in chips) 
Seat 5: ghosto69 (€2.16 in chips) 
Seat 6: mondie73100 (€2.06 in chips) 
gigiruk91: posts small blind €0.01
AntonioKrakka: posts big blind €0.02
*** HOLE CARDS ***
Dealt to caduceus369 [Kc 9s]
pistaKKio23: folds 
ghosto69: folds 
mondie73100: folds 
caduceus369: raises €0.02 to €0.04
gigiruk91: folds 
AntonioKrakka: raises €0.06 to €0.10
caduceus369: folds 
Uncalled bet (€0.06) returned to AntonioKrakka
AntonioKrakka collected €0.09 from pot
AntonioKrakka: doesn't show hand 
*** SUMMARY ***
Total pot €0.09 | Rake €0 
Seat 1: caduceus369 (button) folded before Flop
Seat 2: gigiruk91 (small blind) folded before Flop
Seat 3: AntonioKrakka (big blind) collected (€0.09)
Seat 4: pistaKKio23 folded before Flop (didn't bet)
Seat 5: ghosto69 folded before Flop (didn't bet)
Seat 6: mondie73100 folded before Flop (didn't bet)



PokerStars Zoom Hand #257974856899:  Hold'em No Limit (€0.01/€0.02) [ADM ID: M62BA304494E32ST] - 2025/10/02 22:38:26 CET [2025/10/02 16:38:26 ET]
Table 'Sirio' 6-max Seat #1 is the button
Seat 1: zicky78.r (€2.08 in chips) 
Seat 2: thomas7029 (€1.13 in chips) 
Seat 3: Warterror90 (€4.92 in chips) 
Seat 4: Baba2010811 (€0.83 in chips) 
Seat 5: VagALiss (€2.10 in chips) 
Seat 6: caduceus369 (€1.44 in chips) 
thomas7029: posts small blind €0.01
Warterror90: posts big blind €0.02
*** HOLE CARDS ***
Dealt to caduceus369 [4h 5c]
Baba2010811: calls €0.02
VagALiss: folds 
caduceus369: folds 
zicky78.r: raises €0.03 to €0.05
thomas7029: calls €0.04
Warterror90: folds 
Baba2010811: calls €0.03
*** FLOP *** [8d Kd 2d]
thomas7029: checks 
Baba2010811: checks 
zicky78.r: checks 
*** TURN *** [8d Kd 2d] [Ah]
thomas7029: checks 
Baba2010811: checks 
zicky78.r: bets €0.09
thomas7029: folds 
Baba2010811: folds 
Uncalled bet (€0.09) returned to zicky78.r
zicky78.r collected €0.17 from pot
zicky78.r: doesn't show hand 
*** SUMMARY ***
Total pot €0.17 | Rake €0 
Board [8d Kd 2d Ah]
Seat 1: zicky78.r (button) collected (€0.17)
Seat 2: thomas7029 (small blind) folded on the Turn
Seat 3: Warterror90 (big blind) folded before Flop
Seat 4: Baba2010811 folded on the Turn
Seat 5: VagALiss folded before Flop (didn't bet)
Seat 6: caduceus369 folded before Flop (didn't bet)



PokerStars Zoom Hand #257974864300:  Hold'em No Limit (€0.01/€0.02) [ADM ID: M62BA304494E32ST] - 2025/10/02 22:38:56 CET [2025/10/02 16:38:56 ET]
Table 'Sirio' 6-max Seat #1 is the button
Seat 1: 7mosigillo (€2.80 in chips) 
Seat 2: IamJewels (€2.52 in chips) 
Seat 3: riki00000119 (€3.50 in chips) 
Seat 4: caduceus369 (€1.40 in chips) 
Seat 5: gigiruk91 (€3.66 in chips) 
Seat 6: AntonioKrakka (€1.96 in chips) 
IamJewels: posts small blind €0.01
riki00000119: posts big blind €0.02
*** HOLE CARDS ***
Dealt to caduceus369 [2c 2s]
caduceus369: folds 
gigiruk91: folds 
AntonioKrakka: folds 
7mosigillo: raises €0.04 to €0.06
IamJewels: folds 
riki00000119: folds 
Uncalled bet (€0.04) returned to 7mosigillo
7mosigillo collected €0.05 from pot
7mosigillo: doesn't show hand 
*** SUMMARY ***
Total pot €0.05 | Rake €0 
Seat 1: 7mosigillo (button) collected (€0.05)
Seat 2: IamJewels (small blind) folded before Flop
Seat 3: riki00000119 (big blind) folded before Flop
Seat 4: caduceus369 folded before Flop (didn't bet)
Seat 5: gigiruk91 folded before Flop (didn't bet)
Seat 6: AntonioKrakka folded before Flop (didn't bet)



PokerStars Zoom Hand #257974855921:  Hold'em No Limit (€0.01/€0.02) [ADM ID: M62BA304494E32ST] - 2025/10/02 22:38:22 CET [2025/10/02 16:38:22 ET]
Table 'Sirio' 6-max Seat #1 is the button
Seat 1: VagALiss (€2.10 in chips) 
Seat 2: stfuplzudonk (€1.04 in chips) 
Seat 3: bastiagero (€1.47 in chips) 
Seat 4: BAMBUZ90 (€1.39 in chips) 
Seat 5: caduceus369 (€1.44 in chips) 
Seat 6: gigiruk91 (€3.69 in chips) 
stfuplzudonk: posts small blind €0.01
bastiagero: posts big blind €0.02
*** HOLE CARDS ***
Dealt to caduceus369 [Qh 5d]
BAMBUZ90: raises €0.04 to €0.06
caduceus369: folds 
gigiruk91: folds 
VagALiss: folds 
stfuplzudonk: calls €0.05
bastiagero: calls €0.04
*** FLOP *** [3s 3h 3c]
stfuplzudonk: checks 
bastiagero: checks 
BAMBUZ90: bets €0.09
stfuplzudonk: calls €0.09
bastiagero: calls €0.09
*** TURN *** [3s 3h 3c] [8h]
stfuplzudonk: checks 
bastiagero: checks 
BAMBUZ90: bets €0.22
stfuplzudonk: calls €0.22
bastiagero: calls €0.22
*** RIVER *** [3s 3h 3c 8h] [5c]
stfuplzudonk: checks 
bastiagero: checks 
BAMBUZ90: bets €0.53
stfuplzudonk: raises €0.14 to €0.67 and is all-in
bastiagero: calls €0.67
BAMBUZ90: folds 
*** SHOW DOWN ***
stfuplzudonk: shows [3d 7d] (four of a kind, Threes)
bastiagero: shows [Qs Qd] (a full house, Threes full of Queens)
stfuplzudonk collected €2.82 from pot
*** SUMMARY ***
Total pot €2.98 | Rake €0.16 
Board [3s 3h 3c 8h 5c]
Seat 1: VagALiss (button) folded before Flop (didn't bet)
Seat 2: stfuplzudonk (small blind) showed [3d 7d] and won (€2.82) with four of a kind, Threes
Seat 3: bastiagero (big blind) showed [Qs Qd] and lost with a full house, Threes full of Queens
Seat 4: BAMBUZ90 folded on the River
Seat 5: caduceus369 folded before Flop (didn't bet)
Seat 6: gigiruk91 folded before Flop (didn't bet)



PokerStars Zoom Hand #257974865363:  Hold'em No Limit (€0.01/€0.02) [ADM ID: M62BA304494E32ST] - 2025/10/02 22:39:01 CET [2025/10/02 16:39:01 ET]
Table 'Sirio' 6-max Seat #1 is the button
Seat 1: c.ronaldo644 (€1.93 in chips) 
Seat 2: riki00000119 (€3.35 in chips) 
Seat 3: caduceus369 (€1.40 in chips) 
Seat 4: AntonioKrakka (€2.53 in chips) 
Seat 5: cap e'bomb95 (€1.77 in chips) 
Seat 6: ghosto69 (€2.17 in chips) 
riki00000119: posts small blind €0.01
caduceus369: posts big blind €0.02
*** HOLE CARDS ***
Dealt to caduceus369 [9d 6d]
AntonioKrakka: folds 
cap e'bomb95: folds 
ghosto69: folds 
c.ronaldo644: raises €0.02 to €0.04
riki00000119: folds 
caduceus369: calls €0.02
*** FLOP *** [2s 3c 2c]
caduceus369: bets €0.04
c.ronaldo644: calls €0.04
*** TURN *** [2s 3c 2c] [Ts]
caduceus369: checks 
c.ronaldo644: bets €0.17
caduceus369: folds 
Uncalled bet (€0.17) returned to c.ronaldo644
c.ronaldo644 collected €0.17 from pot
c.ronaldo644: doesn't show hand 
*** SUMMARY ***
Total pot €0.17 | Rake €0 
Board [2s 3c 2c Ts]
Seat 1: c.ronaldo644 (button) collected (€0.17)
Seat 2: riki00000119 (small blind) folded before Flop
Seat 3: caduceus369 (big blind) folded on the Turn
Seat 4: AntonioKrakka folded before Flop (didn't bet)
Seat 5: cap e'bomb95 folded before Flop (didn't bet)
Seat 6: ghosto69 folded before Flop (didn't bet)



PokerStars Zoom Hand #257974874969:  Hold'em No Limit (€0.01/€0.02) [ADM ID: M62BA304494E32ST] - 2025/10/02 22:39:40 CET [2025/10/02 16:39:40 ET]
Table 'Sirio' 6-max Seat #1 is the button
Seat 1: RRgalp (€6.88 in chips) 
Seat 2: caduceus369 (€1.32 in chips) 
Seat 3: Maur2507 (€0.83 in chips) 
Seat 4: Sium12302 (€2 in chips) 
Seat 5: 7mosigillo (€1.62 in chips) 
Seat 6: zicky78.r (€2.18 in chips) 
caduceus369: posts small blind €0.01
Maur2507: posts big blind €0.02
*** HOLE CARDS ***
Dealt to caduceus369 [Tc 2h]
Sium12302: folds 
7mosigillo: folds 
zicky78.r: raises €0.02 to €0.04
RRgalp: folds 
caduceus369: folds 
Maur2507: folds 
Uncalled bet (€0.02) returned to zicky78.r
zicky78.r collected €0.05 from pot
zicky78.r: doesn't show hand 
*** SUMMARY ***
Total pot €0.05 | Rake €0 
Seat 1: RRgalp (button) folded before Flop (didn't bet)
Seat 2: caduceus369 (small blind) folded before Flop
Seat 3: Maur2507 (big blind) folded before Flop
Seat 4: Sium12302 folded before Flop (didn't bet)
Seat 5: 7mosigillo folded before Flop (didn't bet)
Seat 6: zicky78.r collected (€0.05)



PokerStars Zoom Hand #257974876875:  Hold'em No Limit (€0.01/€0.02) [ADM ID: M62BA304494E32ST] - 2025/10/02 22:39:48 CET [2025/10/02 16:39:48 ET]
Table 'Sirio' 6-max Seat #1 is the button
Seat 1: VagALiss (€2.07 in chips) 
Seat 2: AntonioKrakka (€1.90 in chips) 
Seat 3: IamJewels (€2.68 in chips) 
Seat 4: pistaKKio23 (€1.82 in chips) 
Seat 5: mondie73100 (€2.48 in chips) 
Seat 6: caduceus369 (€1.31 in chips) 
AntonioKrakka: posts small blind €0.01
IamJewels: posts big blind €0.02
*** HOLE CARDS ***
Dealt to caduceus369 [8s 2h]
pistaKKio23: folds 
mondie73100: folds 
caduceus369: folds 
VagALiss: raises €0.03 to €0.05
AntonioKrakka: folds 
IamJewels: folds 
Uncalled bet (€0.03) returned to VagALiss
VagALiss collected €0.05 from pot
VagALiss: doesn't show hand 
*** SUMMARY ***
Total pot €0.05 | Rake €0 
Seat 1: VagALiss (button) collected (€0.05)
Seat 2: AntonioKrakka (small blind) folded before Flop
Seat 3: IamJewels (big blind) folded before Flop
Seat 4: pistaKKio23 folded before Flop (didn't bet)
Seat 5: mondie73100 folded before Flop (didn't bet)
Seat 6: caduceus369 folded before Flop (didn't bet)



PokerStars Zoom Hand #257974880377:  Hold'em No Limit (€0.01/€0.02) [ADM ID: M62BA304494E32ST] - 2025/10/02 22:40:02 CET [2025/10/02 16:40:02 ET]
Table 'Sirio' 6-max Seat #1 is the button
Seat 1: kroll219 (€0.96 in chips) 
Seat 2: pistaKKio23 (€1.82 in chips) 
Seat 3: cap e'bomb95 (€2.16 in chips) 
Seat 4: caduceus369 (€1.31 in chips) 
Seat 5: BAMBUZ90 (€0.64 in chips) 
Seat 6: zicky78.r (€2.72 in chips) 
pistaKKio23: posts small blind €0.01
cap e'bomb95: posts big blind €0.02
*** HOLE CARDS ***
Dealt to caduceus369 [6h Kc]
caduceus369: folds 
BAMBUZ90: folds 
zicky78.r: folds 
kroll219: raises €0.02 to €0.04
pistaKKio23: folds 
cap e'bomb95: folds 
Uncalled bet (€0.02) returned to kroll219
kroll219 collected €0.05 from pot
kroll219: doesn't show hand 
*** SUMMARY ***
Total pot €0.05 | Rake €0 
Seat 1: kroll219 (button) collected (€0.05)
Seat 2: pistaKKio23 (small blind) folded before Flop
Seat 3: cap e'bomb95 (big blind) folded before Flop
Seat 4: caduceus369 folded before Flop (didn't bet)
Seat 5: BAMBUZ90 folded before Flop (didn't bet)
Seat 6: zicky78.r folded before Flop (didn't bet)



PokerStars Zoom Hand #257974881788:  Hold'em No Limit (€0.01/€0.02) [ADM ID: M62BA304494E32ST] - 2025/10/02 22:40:08 CET [2025/10/02 16:40:08 ET]
Table 'Sirio' 6-max Seat #1 is the button
Seat 1: caduceus369 (€1.31 in chips) 
Seat 2: burgaro24 (€1.40 in chips) 
Seat 3: S'dj83 (€3.75 in chips) 
Seat 4: cap e'bomb95 (€1.80 in chips) 
Seat 5: father2008 (€2 in chips) 
Seat 6: VrDmNl (€2.73 in chips) 
burgaro24: posts small blind €0.01
S'dj83: posts big blind €0.02
*** HOLE CARDS ***
Dealt to caduceus369 [Kd As]
cap e'bomb95: folds 
father2008: raises €0.04 to €0.06
VrDmNl: folds 
caduceus369: raises €0.14 to €0.20
burgaro24: folds 
S'dj83: folds 
father2008: folds 
Uncalled bet (€0.14) returned to caduceus369
caduceus369 collected €0.15 from pot
caduceus369: doesn't show hand 
*** SUMMARY ***
Total pot €0.15 | Rake €0 
Seat 1: caduceus369 (button) collected (€0.15)
Seat 2: burgaro24 (small blind) folded before Flop
Seat 3: S'dj83 (big blind) folded before Flop
Seat 4: cap e'bomb95 folded before Flop (didn't bet)
Seat 5: father2008 folded before Flop
Seat 6: VrDmNl folded before Flop (didn't bet)



PokerStars Zoom Hand #257974878056:  Hold'em No Limit (€0.01/€0.02) [ADM ID: M62BA304494E32ST] - 2025/10/02 22:39:52 CET [2025/10/02 16:39:52 ET]
Table 'Sirio' 6-max Seat #1 is the button
Seat 1: ghosto69 (€2.10 in chips) 
Seat 2: axel75.s (€0.56 in chips) 
Seat 3: Catania838 (€1.57 in chips) 
Seat 4: gigiruk91 (€8.62 in chips) 
Seat 5: caduceus369 (€1.31 in chips) 
Seat 6: Takedux (€3.32 in chips) 
axel75.s: posts small blind €0.01
Catania838: posts big blind €0.02
*** HOLE CARDS ***
Dealt to caduceus369 [2d 3h]
gigiruk91: folds 
caduceus369: folds 
Takedux: folds 
ghosto69: folds 
axel75.s: calls €0.01
Catania838: checks 
*** FLOP *** [Qd 2s 9s]
axel75.s: bets €0.02
Catania838: folds 
Uncalled bet (€0.02) returned to axel75.s
axel75.s collected €0.04 from pot
axel75.s: doesn't show hand 
*** SUMMARY ***
Total pot €0.04 | Rake €0 
Board [Qd 2s 9s]
Seat 1: ghosto69 (button) folded before Flop (didn't bet)
Seat 2: axel75.s (small blind) collected (€0.04)
Seat 3: Catania838 (big blind) folded on the Flop
Seat 4: gigiruk91 folded before Flop (didn't bet)
Seat 5: caduceus369 folded before Flop (didn't bet)
Seat 6: Takedux folded before Flop (didn't bet)



PokerStars Zoom Hand #257974887691:  Hold'em No Limit (€0.01/€0.02) [ADM ID: M62BA304494E32ST] - 2025/10/02 22:40:32 CET [2025/10/02 16:40:32 ET]
Table 'Sirio' 6-max Seat #1 is the button
Seat 1: kroll219 (€0.99 in chips) 
Seat 2: IamJewels (€2.66 in chips) 
Seat 3: diesel197474 (€1.87 in chips) 
Seat 4: caduceus369 (€1.40 in chips) 
Seat 5: father2008 (€3.73 in chips) 
Seat 6: zicky78.r (€4.08 in chips) 
IamJewels: posts small blind €0.01
diesel197474: posts big blind €0.02
*** HOLE CARDS ***
Dealt to caduceus369 [Ah 8d]
caduceus369: folds 
father2008: folds 
zicky78.r: folds 
kroll219: folds 
IamJewels: raises €0.06 to €0.08
diesel197474: folds 
Uncalled bet (€0.06) returned to IamJewels
IamJewels collected €0.04 from pot
IamJewels: doesn't show hand 
*** SUMMARY ***
Total pot €0.04 | Rake €0 
Seat 1: kroll219 (button) folded before Flop (didn't bet)
Seat 2: IamJewels (small blind) collected (€0.04)
Seat 3: diesel197474 (big blind) folded before Flop
Seat 4: caduceus369 folded before Flop (didn't bet)
Seat 5: father2008 folded before Flop (didn't bet)
Seat 6: zicky78.r folded before Flop (didn't bet)



PokerStars Zoom Hand #257974888914:  Hold'em No Limit (€0.01/€0.02) [ADM ID: M62BA304494E32ST] - 2025/10/02 22:40:37 CET [2025/10/02 16:40:37 ET]
Table 'Sirio' 6-max Seat #1 is the button
Seat 1: IamJewels (€2.45 in chips) 
Seat 2: caduceus369 (€1.40 in chips) 
Seat 3: pistaKKio23 (€1.55 in chips) 
Seat 4: mondie73100 (€2 in chips) 
Seat 5: bastiagero (€0.27 in chips) 
Seat 6: father2008 (€2 in chips) 
caduceus369: posts small blind €0.01
pistaKKio23: posts big blind €0.02
*** HOLE CARDS ***
Dealt to caduceus369 [7d 7c]
mondie73100: folds 
bastiagero: folds 
father2008: folds 
IamJewels: folds 
caduceus369: raises €0.02 to €0.04
pistaKKio23: folds 
Uncalled bet (€0.02) returned to caduceus369
caduceus369 collected €0.04 from pot
caduceus369: doesn't show hand 
*** SUMMARY ***
Total pot €0.04 | Rake €0 
Seat 1: IamJewels (button) folded before Flop (didn't bet)
Seat 2: caduceus369 (small blind) collected (€0.04)
Seat 3: pistaKKio23 (big blind) folded before Flop
Seat 4: mondie73100 folded before Flop (didn't bet)
Seat 5: bastiagero folded before Flop (didn't bet)
Seat 6: father2008 folded before Flop (didn't bet)



PokerStars Zoom Hand #257974894186:  Hold'em No Limit (€0.01/€0.02) [ADM ID: M62BA304494E32ST] - 2025/10/02 22:40:58 CET [2025/10/02 16:40:58 ET]
Table 'Sirio' 6-max Seat #1 is the button
Seat 1: pistaKKio23 (€1.53 in chips) 
Seat 2: AntonioKrakka (€3.68 in chips) 
Seat 3: caduceus369 (€1.42 in chips) 
Seat 4: father2008 (€2 in chips) 
Seat 5: VagALiss (€2.14 in chips) 
Seat 6: caramellemis (€6.03 in chips) 
AntonioKrakka: posts small blind €0.01
caduceus369: posts big blind €0.02
*** HOLE CARDS ***
Dealt to caduceus369 [3h 8h]
father2008: folds 
VagALiss: folds 
caramellemis: folds 
pistaKKio23: raises €0.04 to €0.06
AntonioKrakka: folds 
caduceus369: folds 
Uncalled bet (€0.04) returned to pistaKKio23
pistaKKio23 collected €0.05 from pot
pistaKKio23: doesn't show hand 
*** SUMMARY ***
Total pot €0.05 | Rake €0 
Seat 1: pistaKKio23 (button) collected (€0.05)
Seat 2: AntonioKrakka (small blind) folded before Flop
Seat 3: caduceus369 (big blind) folded before Flop
Seat 4: father2008 folded before Flop (didn't bet)
Seat 5: VagALiss folded before Flop (didn't bet)
Seat 6: caramellemis folded before Flop (didn't bet)



PokerStars Zoom Hand #257974906503:  Hold'em No Limit (€0.01/€0.02) [ADM ID: M62BA304494E32ST] - 2025/10/02 22:41:49 CET [2025/10/02 16:41:49 ET]
Table 'Sirio' 6-max Seat #1 is the button
Seat 1: ADRIAN0_MEIS (€5.24 in chips) 
Seat 2: Warterror90 (€5.24 in chips) 
Seat 3: IamJewels (€2 in chips) 
Seat 4: AntonioKrakka (€3.65 in chips) 
Seat 5: pistaKKio23 (€1.59 in chips) 
Seat 6: caduceus369 (€1.40 in chips) 
Warterror90: posts small blind €0.01
IamJewels: posts big blind €0.02
*** HOLE CARDS ***
Dealt to caduceus369 [6d 4s]
AntonioKrakka: folds 
pistaKKio23: folds 
caduceus369: folds 
ADRIAN0_MEIS: folds 
Warterror90: calls €0.01
IamJewels: checks 
*** FLOP *** [Jh 7d As]
Warterror90: checks 
IamJewels: checks 
*** TURN *** [Jh 7d As] [9h]
Warterror90: checks 
IamJewels: checks 
*** RIVER *** [Jh 7d As 9h] [7c]
Warterror90: checks 
IamJewels: checks 
*** SHOW DOWN ***
Warterror90: shows [8s 6s] (a pair of Sevens)
IamJewels: shows [5h Kc] (a pair of Sevens - Ace+King kicker)
IamJewels collected €0.04 from pot
*** SUMMARY ***
Total pot €0.04 | Rake €0 
Board [Jh 7d As 9h 7c]
Seat 1: ADRIAN0_MEIS (button) folded before Flop (didn't bet)
Seat 2: Warterror90 (small blind) showed [8s 6s] and lost with a pair of Sevens
Seat 3: IamJewels (big blind) showed [5h Kc] and won (€0.04) with a pair of Sevens
Seat 4: AntonioKrakka folded before Flop (didn't bet)
Seat 5: pistaKKio23 folded before Flop (didn't bet)
Seat 6: caduceus369 folded before Flop (didn't bet)



PokerStars Zoom Hand #257974905031:  Hold'em No Limit (€0.01/€0.02) [ADM ID: M62BA304494E32ST] - 2025/10/02 22:41:43 CET [2025/10/02 16:41:43 ET]
Table 'Sirio' 6-max Seat #1 is the button
Seat 1: father2008 (€2.03 in chips) 
Seat 2: Alfio6565 (€0.94 in chips) 
Seat 3: pistaKKio23 (€1.76 in chips) 
Seat 4: caduceus369 (€1.40 in chips) 
Seat 5: IamJewels (€2 in chips) 
Seat 6: Lizi855 (€0.68 in chips) 
Alfio6565: posts small blind €0.01
pistaKKio23: posts big blind €0.02
*** HOLE CARDS ***
Dealt to caduceus369 [2s 9h]
caduceus369: folds 
IamJewels: folds 
Lizi855 is disconnected 
Lizi855 has timed out while disconnected
Lizi855: folds 
father2008: raises €0.04 to €0.06
Alfio6565: calls €0.05
pistaKKio23: folds 
*** FLOP *** [Qd 5d 2h]
Alfio6565: checks 
father2008: bets €0.10
Alfio6565: folds 
Uncalled bet (€0.10) returned to father2008
father2008 collected €0.14 from pot
father2008: doesn't show hand 
*** SUMMARY ***
Total pot €0.14 | Rake €0 
Board [Qd 5d 2h]
Seat 1: father2008 (button) collected (€0.14)
Seat 2: Alfio6565 (small blind) folded on the Flop
Seat 3: pistaKKio23 (big blind) folded before Flop
Seat 4: caduceus369 folded before Flop (didn't bet)
Seat 5: IamJewels folded before Flop (didn't bet)
Seat 6: Lizi855 folded before Flop (didn't bet)



PokerStars Zoom Hand #257974908017:  Hold'em No Limit (€0.01/€0.02) [ADM ID: M62BA304494E32ST] - 2025/10/02 22:41:55 CET [2025/10/02 16:41:55 ET]
Table 'Sirio' 6-max Seat #1 is the button
Seat 1: caduceus369 (€1.40 in chips) 
Seat 2: IamJewels (€2.64 in chips) 
Seat 3: Genny040893 (€0.71 in chips) 
Seat 4: aleKG5 (€0.96 in chips) 
Seat 5: cap e'bomb95 (€1.83 in chips) 
Seat 6: S'dj83 (€2.61 in chips) 
IamJewels: posts small blind €0.01
Genny040893: posts big blind €0.02
*** HOLE CARDS ***
Dealt to caduceus369 [Tc Ks]
aleKG5: folds 
cap e'bomb95: folds 
S'dj83: folds 
caduceus369: raises €0.02 to €0.04
IamJewels: folds 
Genny040893: raises €0.02 to €0.06
caduceus369: calls €0.02
*** FLOP *** [3s Jd 7h]
Genny040893: bets €0.02
caduceus369: calls €0.02
*** TURN *** [3s Jd 7h] [2h]
Genny040893: checks 
caduceus369: bets €0.04
Genny040893: folds 
Uncalled bet (€0.04) returned to caduceus369
caduceus369 collected €0.17 from pot
caduceus369: doesn't show hand 
*** SUMMARY ***
Total pot €0.17 | Rake €0 
Board [3s Jd 7h 2h]
Seat 1: caduceus369 (button) collected (€0.17)
Seat 2: IamJewels (small blind) folded before Flop
Seat 3: Genny040893 (big blind) folded on the Turn
Seat 4: aleKG5 folded before Flop (didn't bet)
Seat 5: cap e'bomb95 folded before Flop (didn't bet)
Seat 6: S'dj83 folded before Flop (didn't bet)



PokerStars Zoom Hand #257974918474:  Hold'em No Limit (€0.01/€0.02) [ADM ID: M62BA304494E32ST] - 2025/10/02 22:42:38 CET [2025/10/02 16:42:38 ET]
Table 'Sirio' 6-max Seat #1 is the button
Seat 1: Genny040893 (€0.63 in chips) 
Seat 2: caduceus369 (€1.49 in chips) 
Seat 3: eleonora50 (€1.46 in chips) 
Seat 4: monsterc99 (€0.56 in chips) 
Seat 5: zicky78.r (€3.40 in chips) 
Seat 6: pistaKKio23 (€1.54 in chips) 
caduceus369: posts small blind €0.01
eleonora50: posts big blind €0.02
*** HOLE CARDS ***
Dealt to caduceus369 [4c 8h]
monsterc99: calls €0.02
zicky78.r: folds 
pistaKKio23: folds 
Genny040893: folds 
caduceus369: folds 
eleonora50: checks 
*** FLOP *** [2c Qd Qc]
eleonora50: checks 
monsterc99: checks 
*** TURN *** [2c Qd Qc] [Jd]
eleonora50: checks 
monsterc99: bets €0.02
eleonora50: folds 
Uncalled bet (€0.02) returned to monsterc99
monsterc99 collected €0.05 from pot
monsterc99: doesn't show hand 
*** SUMMARY ***
Total pot €0.05 | Rake €0 
Board [2c Qd Qc Jd]
Seat 1: Genny040893 (button) folded before Flop (didn't bet)
Seat 2: caduceus369 (small blind) folded before Flop
Seat 3: eleonora50 (big blind) folded on the Turn
Seat 4: monsterc99 collected (€0.05)
Seat 5: zicky78.r folded before Flop (didn't bet)
Seat 6: pistaKKio23 folded before Flop (didn't bet)



PokerStars Zoom Hand #257974919765:  Hold'em No Limit (€0.01/€0.02) [ADM ID: M62BA304494E32ST] - 2025/10/02 22:42:44 CET [2025/10/02 16:42:44 ET]
Table 'Sirio' 6-max Seat #1 is the button
Seat 1: IamJewels (€4.15 in chips) 
Seat 2: father2008 (€2.14 in chips) 
Seat 3: caduceus369 (€1.48 in chips) 
Seat 4: mondie73100 (€2.01 in chips) 
Seat 5: AntonioKrakka (€2.59 in chips) 
Seat 6: babanotop (€2.03 in chips) 
father2008: posts small blind €0.01
caduceus369: posts big blind €0.02
*** HOLE CARDS ***
Dealt to caduceus369 [Ah 9h]
mondie73100: folds 
AntonioKrakka: raises €0.04 to €0.06
babanotop: folds 
IamJewels: folds 
father2008: folds 
caduceus369: raises €0.20 to €0.26
AntonioKrakka: folds 
Uncalled bet (€0.20) returned to caduceus369
caduceus369 collected €0.13 from pot
caduceus369: doesn't show hand 
*** SUMMARY ***
Total pot €0.13 | Rake €0 
Seat 1: IamJewels (button) folded before Flop (didn't bet)
Seat 2: father2008 (small blind) folded before Flop
Seat 3: caduceus369 (big blind) collected (€0.13)
Seat 4: mondie73100 folded before Flop (didn't bet)
Seat 5: AntonioKrakka folded before Flop
Seat 6: babanotop folded before Flop (didn't bet)



PokerStars Zoom Hand #257974931741:  Hold'em No Limit (€0.01/€0.02) [ADM ID: M62BA304494E32ST] - 2025/10/02 22:43:33 CET [2025/10/02 16:43:33 ET]
Table 'Sirio' 6-max Seat #1 is the button
Seat 1: babanotop (€2.08 in chips) 
Seat 2: cap e'bomb95 (€1.94 in chips) 
Seat 3: IamJewels (€4.17 in chips) 
Seat 4: caduceus369 (€1.55 in chips) 
Seat 5: AntonioKrakka (€3.12 in chips) 
Seat 6: zicky78.r (€2.58 in chips) 
cap e'bomb95: posts small blind €0.01
IamJewels: posts big blind €0.02
*** HOLE CARDS ***
Dealt to caduceus369 [9h Ts]
caduceus369: folds 
AntonioKrakka: folds 
zicky78.r: raises €0.02 to €0.04
babanotop: folds 
cap e'bomb95: folds 
IamJewels: folds 
Uncalled bet (€0.02) returned to zicky78.r
zicky78.r collected €0.05 from pot
zicky78.r: doesn't show hand 
*** SUMMARY ***
Total pot €0.05 | Rake €0 
Seat 1: babanotop (button) folded before Flop (didn't bet)
Seat 2: cap e'bomb95 (small blind) folded before Flop
Seat 3: IamJewels (big blind) folded before Flop
Seat 4: caduceus369 folded before Flop (didn't bet)
Seat 5: AntonioKrakka folded before Flop (didn't bet)
Seat 6: zicky78.r collected (€0.05)



PokerStars Zoom Hand #257974934402:  Hold'em No Limit (€0.01/€0.02) [ADM ID: M62BA304494E32ST] - 2025/10/02 22:43:44 CET [2025/10/02 16:43:44 ET]
Table 'Sirio' 6-max Seat #1 is the button
Seat 1: IamJewels (€2 in chips) 
Seat 2: ghosto69 (€0.95 in chips) 
Seat 3: caduceus369 (€1.54 in chips) 
Seat 4: monsterc99 (€0.59 in chips) 
Seat 5: MiticoDepa (€2.54 in chips) 
Seat 6: aleKG5 (€0.99 in chips) 
ghosto69: posts small blind €0.01
caduceus369: posts big blind €0.02
*** HOLE CARDS ***
Dealt to caduceus369 [Ac Th]
monsterc99: folds 
MiticoDepa: folds 
aleKG5: folds 
IamJewels: folds 
ghosto69: folds 
Uncalled bet (€0.01) returned to caduceus369
caduceus369 collected €0.02 from pot
caduceus369: doesn't show hand 
*** SUMMARY ***
Total pot €0.02 | Rake €0 
Seat 1: IamJewels (button) folded before Flop (didn't bet)
Seat 2: ghosto69 (small blind) folded before Flop
Seat 3: caduceus369 (big blind) collected (€0.02)
Seat 4: monsterc99 folded before Flop (didn't bet)
Seat 5: MiticoDepa folded before Flop (didn't bet)
Seat 6: aleKG5 folded before Flop (didn't bet)



PokerStars Zoom Hand #257974932754:  Hold'em No Limit (€0.01/€0.02) [ADM ID: M62BA304494E32ST] - 2025/10/02 22:43:37 CET [2025/10/02 16:43:37 ET]
Table 'Sirio' 6-max Seat #1 is the button
Seat 1: father2008 (€2.09 in chips) 
Seat 2: caduceus369 (€1.55 in chips) 
Seat 3: kroll219 (€0.92 in chips) 
Seat 4: cap e'bomb95 (€1.93 in chips) 
Seat 5: ADRIAN0_MEIS (€2.85 in chips) 
Seat 6: stfuplzudonk (€4.35 in chips) 
caduceus369: posts small blind €0.01
kroll219: posts big blind €0.02
*** HOLE CARDS ***
Dealt to caduceus369 [3d 7h]
cap e'bomb95: folds 
ADRIAN0_MEIS: folds 
stfuplzudonk: folds 
father2008: raises €0.04 to €0.06
caduceus369: folds 
kroll219: folds 
Uncalled bet (€0.04) returned to father2008
father2008 collected €0.05 from pot
father2008: doesn't show hand 
*** SUMMARY ***
Total pot €0.05 | Rake €0 
Seat 1: father2008 (button) collected (€0.05)
Seat 2: caduceus369 (small blind) folded before Flop
Seat 3: kroll219 (big blind) folded before Flop
Seat 4: cap e'bomb95 folded before Flop (didn't bet)
Seat 5: ADRIAN0_MEIS folded before Flop (didn't bet)
Seat 6: stfuplzudonk folded before Flop (didn't bet)



PokerStars Zoom Hand #257974930520:  Hold'em No Limit (€0.01/€0.02) [ADM ID: M62BA304494E32ST] - 2025/10/02 22:43:28 CET [2025/10/02 16:43:28 ET]
Table 'Sirio' 6-max Seat #1 is the button
Seat 1: IamJewels (€2.31 in chips) 
Seat 2: k4l3l83 (€2.51 in chips) 
Seat 3: stfuplzudonk (€2.63 in chips) 
Seat 4: pistaKKio23 (€1.41 in chips) 
Seat 5: caduceus369 (€1.55 in chips) 
Seat 6: AntonioKrakka (€2.29 in chips) 
k4l3l83: posts small blind €0.01
stfuplzudonk: posts big blind €0.02
*** HOLE CARDS ***
Dealt to caduceus369 [2d 5c]
pistaKKio23: raises €0.04 to €0.06
caduceus369: folds 
AntonioKrakka: folds 
IamJewels: folds 
k4l3l83: calls €0.05
stfuplzudonk: calls €0.04
*** FLOP *** [3d 3h Ad]
k4l3l83: checks 
stfuplzudonk: checks 
pistaKKio23: bets €0.18
k4l3l83: folds 
stfuplzudonk: folds 
Uncalled bet (€0.18) returned to pistaKKio23
pistaKKio23 collected €0.18 from pot
pistaKKio23: doesn't show hand 
*** SUMMARY ***
Total pot €0.18 | Rake €0 
Board [3d 3h Ad]
Seat 1: IamJewels (button) folded before Flop (didn't bet)
Seat 2: k4l3l83 (small blind) folded on the Flop
Seat 3: stfuplzudonk (big blind) folded on the Flop
Seat 4: pistaKKio23 collected (€0.18)
Seat 5: caduceus369 folded before Flop (didn't bet)
Seat 6: AntonioKrakka folded before Flop (didn't bet)



PokerStars Zoom Hand #257974916732:  Hold'em No Limit (€0.01/€0.02) [ADM ID: M62BA304494E32ST] - 2025/10/02 22:42:31 CET [2025/10/02 16:42:31 ET]
Table 'Sirio' 6-max Seat #1 is the button
Seat 1: Genny040893 (€0.63 in chips) 
Seat 2: cap e'bomb95 (€1.09 in chips) 
Seat 3: AntonioKrakka (€3.12 in chips) 
Seat 4: IamJewels (€4.15 in chips) 
Seat 5: caduceus369 (€1.49 in chips) 
Seat 6: ghosto69 (€2.24 in chips) 
cap e'bomb95: posts small blind €0.01
AntonioKrakka: posts big blind €0.02
*** HOLE CARDS ***
Dealt to caduceus369 [Th 3h]
IamJewels: folds 
caduceus369: folds 
ghosto69: raises €0.04 to €0.06
Genny040893: folds 
cap e'bomb95: calls €0.05
AntonioKrakka: folds 
*** FLOP *** [6h Tc 9s]
cap e'bomb95: checks 
ghosto69: bets €0.05
cap e'bomb95: calls €0.05
*** TURN *** [6h Tc 9s] [Kh]
cap e'bomb95: checks 
ghosto69: bets €0.08
cap e'bomb95: raises €0.24 to €0.32
ghosto69: calls €0.24
*** RIVER *** [6h Tc 9s Kh] [7d]
cap e'bomb95: checks 
ghosto69: bets €0.84
cap e'bomb95: folds 
Uncalled bet (€0.84) returned to ghosto69
ghosto69 collected €0.84 from pot
ghosto69: doesn't show hand 
*** SUMMARY ***
Total pot €0.88 | Rake €0.04 
Board [6h Tc 9s Kh 7d]
Seat 1: Genny040893 (button) folded before Flop (didn't bet)
Seat 2: cap e'bomb95 (small blind) folded on the River
Seat 3: AntonioKrakka (big blind) folded before Flop
Seat 4: IamJewels folded before Flop (didn't bet)
Seat 5: caduceus369 folded before Flop (didn't bet)
Seat 6: ghosto69 collected (€0.84)



PokerStars Zoom Hand #257974936424:  Hold'em No Limit (€0.01/€0.02) [ADM ID: M62BA304494E32ST] - 2025/10/02 22:43:52 CET [2025/10/02 16:43:52 ET]
Table 'Sirio' 6-max Seat #1 is the button
Seat 1: caduceus369 (€1.55 in chips) 
Seat 2: monsterc99 (€0.59 in chips) 
Seat 3: Genny040893 (€0.67 in chips) 
Seat 4: cagliari59 (€2.59 in chips) 
Seat 5: IamJewels (€4.14 in chips) 
Seat 6: diesel197474 (€1.50 in chips) 
monsterc99: posts small blind €0.01
Genny040893: posts big blind €0.02
*** HOLE CARDS ***
Dealt to caduceus369 [6s 7d]
cagliari59: calls €0.02
IamJewels: folds 
diesel197474: folds 
caduceus369: folds 
monsterc99: folds 
Genny040893: checks 
*** FLOP *** [Kd 3h 4h]
Genny040893: checks 
cagliari59: checks 
*** TURN *** [Kd 3h 4h] [2c]
Genny040893: checks 
cagliari59: checks 
*** RIVER *** [Kd 3h 4h 2c] [Ac]
Genny040893: checks 
cagliari59: checks 
*** SHOW DOWN ***
Genny040893: shows [8h 7c] (high card Ace)
cagliari59: shows [9c Ts] (high card Ace - King+Ten kicker)
cagliari59 collected €0.05 from pot
*** SUMMARY ***
Total pot €0.05 | Rake €0 
Board [Kd 3h 4h 2c Ac]
Seat 1: caduceus369 (button) folded before Flop (didn't bet)
Seat 2: monsterc99 (small blind) folded before Flop
Seat 3: Genny040893 (big blind) showed [8h 7c] and lost with high card Ace
Seat 4: cagliari59 showed [9c Ts] and won (€0.05) with high card Ace
Seat 5: IamJewels folded before Flop (didn't bet)
Seat 6: diesel197474 folded before Flop (didn't bet)



PokerStars Zoom Hand #257974938780:  Hold'em No Limit (€0.01/€0.02) [ADM ID: M62BA304494E32ST] - 2025/10/02 22:44:02 CET [2025/10/02 16:44:02 ET]
Table 'Sirio' 6-max Seat #1 is the button
Seat 1: IamJewels (€2 in chips) 
Seat 2: aleKG5 (€1 in chips) 
Seat 3: Catania838 (€1.95 in chips) 
Seat 4: gigiruk91 (€2.98 in chips) 
Seat 5: ADRIAN0_MEIS (€5.95 in chips) 
Seat 6: caduceus369 (€1.55 in chips) 
aleKG5: posts small blind €0.01
Catania838: posts big blind €0.02
*** HOLE CARDS ***
Dealt to caduceus369 [Ks As]
gigiruk91: raises €0.04 to €0.06
ADRIAN0_MEIS: folds 
caduceus369: raises €0.16 to €0.22
IamJewels: folds 
aleKG5: folds 
Catania838: folds 
gigiruk91: calls €0.16
*** FLOP *** [9s 5c Qh]
gigiruk91: checks 
caduceus369: bets €0.14
gigiruk91: raises €0.37 to €0.51
caduceus369: raises €0.82 to €1.33 and is all-in
gigiruk91: calls €0.82
*** TURN *** [9s 5c Qh] [4d]
*** RIVER *** [9s 5c Qh 4d] [2c]
*** SHOW DOWN ***
gigiruk91: shows [Kc Kh] (a pair of Kings)
caduceus369: shows [Ks As] (high card Ace)
gigiruk91 collected €2.96 from pot
*** SUMMARY ***
Total pot €3.13 | Rake €0.17 
Board [9s 5c Qh 4d 2c]
Seat 1: IamJewels (button) folded before Flop (didn't bet)
Seat 2: aleKG5 (small blind) folded before Flop
Seat 3: Catania838 (big blind) folded before Flop
Seat 4: gigiruk91 showed [Kc Kh] and won (€2.96) with a pair of Kings
Seat 5: ADRIAN0_MEIS folded before Flop (didn't bet)
Seat 6: caduceus369 showed [Ks As] and lost with high card Ace



PokerStars Zoom Hand #257974961981:  Hold'em No Limit (€0.01/€0.02) [ADM ID: M62BA304494E32ST] - 2025/10/02 22:45:37 CET [2025/10/02 16:45:37 ET]
Table 'Sirio' 6-max Seat #1 is the button
Seat 1: Lizi855 (€0.83 in chips) 
Seat 2: zicky78.r (€5.34 in chips) 
Seat 3: jackkk03 (€2.69 in chips) 
Seat 4: IamJewels (€2 in chips) 
Seat 5: Kingo690 (€0.82 in chips) 
Seat 6: caduceus369 (€2 in chips) 
zicky78.r: posts small blind €0.01
jackkk03: posts big blind €0.02
*** HOLE CARDS ***
Dealt to caduceus369 [5s Qh]
IamJewels: folds 
Kingo690: folds 
caduceus369: folds 
Lizi855: calls €0.02
zicky78.r: folds 
jackkk03: checks 
*** FLOP *** [Ad Kh 2h]
jackkk03: checks 
Lizi855: checks 
*** TURN *** [Ad Kh 2h] [4d]
jackkk03: checks 
Lizi855: checks 
*** RIVER *** [Ad Kh 2h 4d] [8h]
jackkk03: checks 
Lizi855: checks 
*** SHOW DOWN ***
jackkk03: shows [6c 4s] (a pair of Fours)
Lizi855: mucks hand 
jackkk03 collected €0.05 from pot
*** SUMMARY ***
Total pot €0.05 | Rake €0 
Board [Ad Kh 2h 4d 8h]
Seat 1: Lizi855 (button) mucked [9c Tc]
Seat 2: zicky78.r (small blind) folded before Flop
Seat 3: jackkk03 (big blind) showed [6c 4s] and won (€0.05) with a pair of Fours
Seat 4: IamJewels folded before Flop (didn't bet)
Seat 5: Kingo690 folded before Flop (didn't bet)
Seat 6: caduceus369 folded before Flop (didn't bet)



PokerStars Zoom Hand #257974960859:  Hold'em No Limit (€0.01/€0.02) [ADM ID: M62BA304494E32ST] - 2025/10/02 22:45:32 CET [2025/10/02 16:45:32 ET]
Table 'Sirio' 6-max Seat #1 is the button
Seat 1: zicky78.r (€2.03 in chips) 
Seat 2: father2008 (€3.48 in chips) 
Seat 3: gigiruk91 (€4.92 in chips) 
Seat 4: AntonioKrakka (€3.12 in chips) 
Seat 5: caduceus369 (€2 in chips) 
Seat 6: Catania838 (€1.97 in chips) 
father2008: posts small blind €0.01
gigiruk91: posts big blind €0.02
*** HOLE CARDS ***
Dealt to caduceus369 [5h 3s]
AntonioKrakka: raises €0.04 to €0.06
caduceus369: folds 
Catania838: folds 
zicky78.r: folds 
father2008: calls €0.05
gigiruk91: folds 
*** FLOP *** [3c 3h Ts]
father2008: checks 
AntonioKrakka: checks 
*** TURN *** [3c 3h Ts] [6h]
father2008: checks 
AntonioKrakka: checks 
*** RIVER *** [3c 3h Ts 6h] [Kd]
father2008: checks 
AntonioKrakka: checks 
*** SHOW DOWN ***
father2008: shows [Qd Ac] (a pair of Threes)
AntonioKrakka: mucks hand 
father2008 collected €0.14 from pot
*** SUMMARY ***
Total pot €0.14 | Rake €0 
Board [3c 3h Ts 6h Kd]
Seat 1: zicky78.r (button) folded before Flop (didn't bet)
Seat 2: father2008 (small blind) showed [Qd Ac] and won (€0.14) with a pair of Threes
Seat 3: gigiruk91 (big blind) folded before Flop
Seat 4: AntonioKrakka mucked [Jh Ad]
Seat 5: caduceus369 folded before Flop (didn't bet)
Seat 6: Catania838 folded before Flop (didn't bet)



PokerStars Zoom Hand #257974966330:  Hold'em No Limit (€0.01/€0.02) [ADM ID: M62BA304494E32ST] - 2025/10/02 22:45:54 CET [2025/10/02 16:45:54 ET]
Table 'Sirio' 6-max Seat #1 is the button
Seat 1: 19HinciaBS79 (€2.69 in chips) 
Seat 2: IamJewels (€2.21 in chips) 
Seat 3: caduceus369 (€2 in chips) 
Seat 4: pistaKKio23 (€1.83 in chips) 
Seat 5: ghosto69 (€1.10 in chips) 
Seat 6: Maur2507 (€0.50 in chips) 
IamJewels: posts small blind €0.01
caduceus369: posts big blind €0.02
*** HOLE CARDS ***
Dealt to caduceus369 [8s 3c]
pistaKKio23: raises €0.04 to €0.06
ghosto69: folds 
Maur2507: folds 
19HinciaBS79: calls €0.06
IamJewels: folds 
caduceus369: folds 
*** FLOP *** [8c 8h 4c]
pistaKKio23: bets €0.15
19HinciaBS79: folds 
Uncalled bet (€0.15) returned to pistaKKio23
pistaKKio23 collected €0.15 from pot
pistaKKio23: doesn't show hand 
*** SUMMARY ***
Total pot €0.15 | Rake €0 
Board [8c 8h 4c]
Seat 1: 19HinciaBS79 (button) folded on the Flop
Seat 2: IamJewels (small blind) folded before Flop
Seat 3: caduceus369 (big blind) folded before Flop
Seat 4: pistaKKio23 collected (€0.15)
Seat 5: ghosto69 folded before Flop (didn't bet)
Seat 6: Maur2507 folded before Flop (didn't bet)



PokerStars Zoom Hand #257974963431:  Hold'em No Limit (€0.01/€0.02) [ADM ID: M62BA304494E32ST] - 2025/10/02 22:45:43 CET [2025/10/02 16:45:43 ET]
Table 'Sirio' 6-max Seat #1 is the button
Seat 1: caduceus369 (€2 in chips) 
Seat 2: Takedux (€3.16 in chips) 
Seat 3: 7mosigillo (€2.42 in chips) 
Seat 4: cagliari59 (€2.65 in chips) 
Seat 5: k4l3l83 (€3.08 in chips) 
Seat 6: ghosto69 (€1.10 in chips) 
Takedux: posts small blind €0.01
7mosigillo: posts big blind €0.02
*** HOLE CARDS ***
Dealt to caduceus369 [Qh 9s]
cagliari59: folds 
k4l3l83: raises €0.03 to €0.05
ghosto69: folds 
caduceus369: folds 
Takedux: raises €0.07 to €0.12
7mosigillo: folds 
k4l3l83: calls €0.07
*** FLOP *** [2h Js 4d]
Takedux: checks 
k4l3l83: checks 
*** TURN *** [2h Js 4d] [2d]
Takedux: checks 
k4l3l83: bets €0.17
Takedux: calls €0.17
*** RIVER *** [2h Js 4d 2d] [8s]
Takedux: checks 
k4l3l83: checks 
*** SHOW DOWN ***
Takedux: shows [As Ts] (a pair of Deuces)
k4l3l83: mucks hand 
Takedux collected €0.57 from pot
*** SUMMARY ***
Total pot €0.60 | Rake €0.03 
Board [2h Js 4d 2d 8s]
Seat 1: caduceus369 (button) folded before Flop (didn't bet)
Seat 2: Takedux (small blind) showed [As Ts] and won (€0.57) with a pair of Deuces
Seat 3: 7mosigillo (big blind) folded before Flop
Seat 4: cagliari59 folded before Flop (didn't bet)
Seat 5: k4l3l83 mucked [Td Kd]
Seat 6: ghosto69 folded before Flop (didn't bet)



PokerStars Zoom Hand #257974968159:  Hold'em No Limit (€0.01/€0.02) [ADM ID: M62BA304494E32ST] - 2025/10/02 22:46:02 CET [2025/10/02 16:46:02 ET]
Table 'Sirio' 6-max Seat #1 is the button
Seat 1: AlfredP80 (€3.15 in chips) 
Seat 2: Kingo690 (€0.83 in chips) 
Seat 3: AntonioKrakka (€2.16 in chips) 
Seat 4: aleKG5 (€0.96 in chips) 
Seat 5: caduceus369 (€1.98 in chips) 
Seat 6: 7mosigillo (€2.40 in chips) 
Kingo690: posts small blind €0.01
AntonioKrakka: posts big blind €0.02
*** HOLE CARDS ***
Dealt to caduceus369 [6h 4c]
aleKG5: raises €0.02 to €0.04
caduceus369: folds 
7mosigillo: folds 
AlfredP80: calls €0.04
Kingo690: folds 
AntonioKrakka: calls €0.02
*** FLOP *** [Th 8d Js]
AntonioKrakka: checks 
aleKG5: checks 
AlfredP80: bets €0.06
AntonioKrakka: folds 
aleKG5: folds 
Uncalled bet (€0.06) returned to AlfredP80
AlfredP80 collected €0.13 from pot
AlfredP80: doesn't show hand 
*** SUMMARY ***
Total pot €0.13 | Rake €0 
Board [Th 8d Js]
Seat 1: AlfredP80 (button) collected (€0.13)
Seat 2: Kingo690 (small blind) folded before Flop
Seat 3: AntonioKrakka (big blind) folded on the Flop
Seat 4: aleKG5 folded on the Flop
Seat 5: caduceus369 folded before Flop (didn't bet)
Seat 6: 7mosigillo folded before Flop (didn't bet)



PokerStars Zoom Hand #257974969852:  Hold'em No Limit (€0.01/€0.02) [ADM ID: M62BA304494E32ST] - 2025/10/02 22:46:09 CET [2025/10/02 16:46:09 ET]
Table 'Sirio' 6-max Seat #1 is the button
Seat 1: IamJewels (€2.20 in chips) 
Seat 2: caduceus369 (€1.98 in chips) 
Seat 3: mondie73100 (€2.06 in chips) 
Seat 4: pistaKKio23 (€1.77 in chips) 
Seat 5: AntonioKrakka (€3.06 in chips) 
Seat 6: Giuggiola64 (€1.76 in chips) 
caduceus369: posts small blind €0.01
mondie73100: posts big blind €0.02
*** HOLE CARDS ***
Dealt to caduceus369 [Ks 7h]
pistaKKio23: raises €0.02 to €0.04
AntonioKrakka: folds 
Giuggiola64: calls €0.04
IamJewels: folds 
caduceus369: folds 
mondie73100: folds 
*** FLOP *** [4c 9c 4h]
pistaKKio23: checks 
Giuggiola64: checks 
*** TURN *** [4c 9c 4h] [Ac]
pistaKKio23: checks 
Giuggiola64: checks 
*** RIVER *** [4c 9c 4h Ac] [5h]
pistaKKio23: checks 
Giuggiola64: bets €0.02
pistaKKio23: folds 
Uncalled bet (€0.02) returned to Giuggiola64
Giuggiola64 collected €0.11 from pot
Giuggiola64: doesn't show hand 
*** SUMMARY ***
Total pot €0.11 | Rake €0 
Board [4c 9c 4h Ac 5h]
Seat 1: IamJewels (button) folded before Flop (didn't bet)
Seat 2: caduceus369 (small blind) folded before Flop
Seat 3: mondie73100 (big blind) folded before Flop
Seat 4: pistaKKio23 folded on the River
Seat 5: AntonioKrakka folded before Flop (didn't bet)
Seat 6: Giuggiola64 collected (€0.11)



PokerStars Zoom Hand #257974971431:  Hold'em No Limit (€0.01/€0.02) [ADM ID: M62BA304494E32ST] - 2025/10/02 22:46:16 CET [2025/10/02 16:46:16 ET]
Table 'Sirio' 6-max Seat #1 is the button
Seat 1: babanotop (€1.41 in chips) 
Seat 2: ghosto69 (€2.30 in chips) 
Seat 3: Tremolina547 (€0.69 in chips) 
Seat 4: Catania838 (€2.03 in chips) 
Seat 5: gigiruk91 (€3.08 in chips) 
Seat 6: caduceus369 (€1.97 in chips) 
ghosto69: posts small blind €0.01
Tremolina547: posts big blind €0.02
*** HOLE CARDS ***
Dealt to caduceus369 [Td Ac]
Catania838: folds 
gigiruk91: folds 
caduceus369: raises €0.02 to €0.04
babanotop: folds 
ghosto69: folds 
Tremolina547: calls €0.02
*** FLOP *** [As Jh 9s]
Tremolina547: bets €0.05
caduceus369: calls €0.05
*** TURN *** [As Jh 9s] [Jd]
Tremolina547: bets €0.08
caduceus369: calls €0.08
*** RIVER *** [As Jh 9s Jd] [9c]
Tremolina547: bets €0.06
caduceus369: calls €0.06
*** SHOW DOWN ***
Tremolina547: shows [Ad 5h] (two pair, Aces and Jacks)
caduceus369: shows [Td Ac] (two pair, Aces and Jacks - Ten kicker)
caduceus369 collected €0.45 from pot
*** SUMMARY ***
Total pot €0.47 | Rake €0.02 
Board [As Jh 9s Jd 9c]
Seat 1: babanotop (button) folded before Flop (didn't bet)
Seat 2: ghosto69 (small blind) folded before Flop
Seat 3: Tremolina547 (big blind) showed [Ad 5h] and lost with two pair, Aces and Jacks
Seat 4: Catania838 folded before Flop (didn't bet)
Seat 5: gigiruk91 folded before Flop (didn't bet)
Seat 6: caduceus369 showed [Td Ac] and won (€0.45) with two pair, Aces and Jacks



PokerStars Zoom Hand #257974987057:  Hold'em No Limit (€0.01/€0.02) [ADM ID: M62BA304494E32ST] - 2025/10/02 22:47:19 CET [2025/10/02 16:47:19 ET]
Table 'Sirio' 6-max Seat #1 is the button
Seat 1: Tremolina547 (€0.46 in chips) 
Seat 2: Kingo690 (€0.87 in chips) 
Seat 3: ghosto69 (€1.19 in chips) 
Seat 4: caduceus369 (€2.19 in chips) 
Seat 5: AlfredP80 (€3.22 in chips) 
Seat 6: cap e'bomb95 (€1.45 in chips) 
Kingo690: posts small blind €0.01
ghosto69: posts big blind €0.02
*** HOLE CARDS ***
Dealt to caduceus369 [8s Td]
caduceus369: folds 
AlfredP80: raises €0.04 to €0.06
cap e'bomb95: folds 
Tremolina547: folds 
Kingo690: folds 
ghosto69: folds 
Uncalled bet (€0.04) returned to AlfredP80
AlfredP80 collected €0.05 from pot
AlfredP80: doesn't show hand 
*** SUMMARY ***
Total pot €0.05 | Rake €0 
Seat 1: Tremolina547 (button) folded before Flop (didn't bet)
Seat 2: Kingo690 (small blind) folded before Flop
Seat 3: ghosto69 (big blind) folded before Flop
Seat 4: caduceus369 folded before Flop (didn't bet)
Seat 5: AlfredP80 collected (€0.05)
Seat 6: cap e'bomb95 folded before Flop (didn't bet)



PokerStars Zoom Hand #257974988314:  Hold'em No Limit (€0.01/€0.02) [ADM ID: M62BA304494E32ST] - 2025/10/02 22:47:24 CET [2025/10/02 16:47:24 ET]
Table 'Sirio' 6-max Seat #1 is the button
Seat 1: Kingo690 (€0.86 in chips) 
Seat 2: IamJewels (€2 in chips) 
Seat 3: Catania838 (€1.82 in chips) 
Seat 4: caduceus369 (€2.19 in chips) 
Seat 5: luchetto1990 (€2 in chips) 
Seat 6: 13pietro (€4 in chips) 
IamJewels: posts small blind €0.01
Catania838: posts big blind €0.02
*** HOLE CARDS ***
Dealt to caduceus369 [5s 7s]
caduceus369: folds 
luchetto1990: raises €0.02 to €0.04
13pietro: folds 
Kingo690: folds 
IamJewels: folds 
Catania838: folds 
Uncalled bet (€0.02) returned to luchetto1990
luchetto1990 collected €0.05 from pot
luchetto1990: doesn't show hand 
*** SUMMARY ***
Total pot €0.05 | Rake €0 
Seat 1: Kingo690 (button) folded before Flop (didn't bet)
Seat 2: IamJewels (small blind) folded before Flop
Seat 3: Catania838 (big blind) folded before Flop
Seat 4: caduceus369 folded before Flop (didn't bet)
Seat 5: luchetto1990 collected (€0.05)
Seat 6: 13pietro folded before Flop (didn't bet)



PokerStars Zoom Hand #257974989093:  Hold'em No Limit (€0.01/€0.02) [ADM ID: M62BA304494E32ST] - 2025/10/02 22:47:27 CET [2025/10/02 16:47:27 ET]
Table 'Sirio' 6-max Seat #1 is the button
Seat 1: IamJewels (€2 in chips) 
Seat 2: caduceus369 (€2.19 in chips) 
Seat 3: gigiruk91 (€4.35 in chips) 
Seat 4: ghosto69 (€2.25 in chips) 
Seat 5: amandaknox (€2.42 in chips) 
Seat 6: pistaKKio23 (€1.70 in chips) 
caduceus369: posts small blind €0.01
gigiruk91: posts big blind €0.02
*** HOLE CARDS ***
Dealt to caduceus369 [3h Kd]
ghosto69: folds 
amandaknox: folds 
pistaKKio23: raises €0.04 to €0.06
IamJewels: folds 
caduceus369: folds 
gigiruk91: folds 
Uncalled bet (€0.04) returned to pistaKKio23
pistaKKio23 collected €0.05 from pot
pistaKKio23: doesn't show hand 
*** SUMMARY ***
Total pot €0.05 | Rake €0 
Seat 1: IamJewels (button) folded before Flop (didn't bet)
Seat 2: caduceus369 (small blind) folded before Flop
Seat 3: gigiruk91 (big blind) folded before Flop
Seat 4: ghosto69 folded before Flop (didn't bet)
Seat 5: amandaknox folded before Flop (didn't bet)
Seat 6: pistaKKio23 collected (€0.05)



PokerStars Zoom Hand #257974991755:  Hold'em No Limit (€0.01/€0.02) [ADM ID: M62BA304494E32ST] - 2025/10/02 22:47:38 CET [2025/10/02 16:47:38 ET]
Table 'Sirio' 6-max Seat #1 is the button
Seat 1: caduceus369 (€2.18 in chips) 
Seat 2: luchetto1990 (€2.03 in chips) 
Seat 3: IamJewels (€2 in chips) 
Seat 4: Catania838 (€1.79 in chips) 
Seat 5: Warterror90 (€4.71 in chips) 
Seat 6: S'dj83 (€2.48 in chips) 
luchetto1990: posts small blind €0.01
IamJewels: posts big blind €0.02
*** HOLE CARDS ***
Dealt to caduceus369 [Qs Kd]
Catania838: folds 
Warterror90: folds 
S'dj83: folds 
caduceus369: raises €0.02 to €0.04
luchetto1990: raises €0.10 to €0.14
IamJewels: folds 
caduceus369: calls €0.10
*** FLOP *** [Kh 9d Td]
luchetto1990: bets €0.20
caduceus369: calls €0.20
*** TURN *** [Kh 9d Td] [9s]
luchetto1990: bets €0.47
caduceus369: raises €0.47 to €0.94
luchetto1990: folds 
Uncalled bet (€0.47) returned to caduceus369
caduceus369 collected €1.55 from pot
caduceus369: doesn't show hand 
*** SUMMARY ***
Total pot €1.64 | Rake €0.09 
Board [Kh 9d Td 9s]
Seat 1: caduceus369 (button) collected (€1.55)
Seat 2: luchetto1990 (small blind) folded on the Turn
Seat 3: IamJewels (big blind) folded before Flop
Seat 4: Catania838 folded before Flop (didn't bet)
Seat 5: Warterror90 folded before Flop (didn't bet)
Seat 6: S'dj83 folded before Flop (didn't bet)



PokerStars Zoom Hand #257975012133:  Hold'em No Limit (€0.01/€0.02) [ADM ID: M62BA304494E32ST] - 2025/10/02 22:49:01 CET [2025/10/02 16:49:01 ET]
Table 'Sirio' 6-max Seat #1 is the button
Seat 1: cap e'bomb95 (€1.76 in chips) 
Seat 2: ADRIAN0_MEIS (€6.76 in chips) 
Seat 3: caduceus369 (€2.92 in chips) 
Seat 4: c.ronaldo644 (€2.04 in chips) 
Seat 5: aleKG5 (€1.42 in chips) 
Seat 6: AntonioKrakka (€3.76 in chips) 
ADRIAN0_MEIS: posts small blind €0.01
caduceus369: posts big blind €0.02
*** HOLE CARDS ***
Dealt to caduceus369 [Kc Th]
c.ronaldo644: raises €0.06 to €0.08
aleKG5: folds 
AntonioKrakka: folds 
cap e'bomb95: calls €0.08
ADRIAN0_MEIS: folds 
caduceus369: folds 
*** FLOP *** [Qc 3h 7h]
c.ronaldo644: checks 
cap e'bomb95: bets €0.12
c.ronaldo644: folds 
Uncalled bet (€0.12) returned to cap e'bomb95
cap e'bomb95 collected €0.18 from pot
cap e'bomb95: doesn't show hand 
*** SUMMARY ***
Total pot €0.19 | Rake €0.01 
Board [Qc 3h 7h]
Seat 1: cap e'bomb95 (button) collected (€0.18)
Seat 2: ADRIAN0_MEIS (small blind) folded before Flop
Seat 3: caduceus369 (big blind) folded before Flop
Seat 4: c.ronaldo644 folded on the Flop
Seat 5: aleKG5 folded before Flop (didn't bet)
Seat 6: AntonioKrakka folded before Flop (didn't bet)



PokerStars Zoom Hand #257975014812:  Hold'em No Limit (€0.01/€0.02) [ADM ID: M62BA304494E32ST] - 2025/10/02 22:49:12 CET [2025/10/02 16:49:12 ET]
Table 'Sirio' 6-max Seat #1 is the button
Seat 1: zicky78.r (€2.85 in chips) 
Seat 2: VagALiss (€2.36 in chips) 
Seat 3: monsterc99 (€1.78 in chips) 
Seat 4: rush572 (€0.69 in chips) 
Seat 5: caduceus369 (€2.90 in chips) 
Seat 6: Kingo690 (€0.88 in chips) 
VagALiss: posts small blind €0.01
monsterc99: posts big blind €0.02
*** HOLE CARDS ***
Dealt to caduceus369 [9h Qd]
rush572: folds 
caduceus369: folds 
Kingo690: folds 
zicky78.r: folds 
VagALiss: raises €0.06 to €0.08
monsterc99: calls €0.06
*** FLOP *** [8d 2c Ks]
VagALiss: checks 
monsterc99: bets €0.08
VagALiss: folds 
Uncalled bet (€0.08) returned to monsterc99
monsterc99 collected €0.16 from pot
monsterc99: doesn't show hand 
*** SUMMARY ***
Total pot €0.16 | Rake €0 
Board [8d 2c Ks]
Seat 1: zicky78.r (button) folded before Flop (didn't bet)
Seat 2: VagALiss (small blind) folded on the Flop
Seat 3: monsterc99 (big blind) collected (€0.16)
Seat 4: rush572 folded before Flop (didn't bet)
Seat 5: caduceus369 folded before Flop (didn't bet)
Seat 6: Kingo690 folded before Flop (didn't bet)



PokerStars Zoom Hand #257975016062:  Hold'em No Limit (€0.01/€0.02) [ADM ID: M62BA304494E32ST] - 2025/10/02 22:49:17 CET [2025/10/02 16:49:17 ET]
Table 'Sirio' 6-max Seat #1 is the button
Seat 1: zicky78.r (€2 in chips) 
Seat 2: ghosto69 (€1.19 in chips) 
Seat 3: ADRIAN0_MEIS (€5.27 in chips) 
Seat 4: AntonioKrakka (€3.46 in chips) 
Seat 5: mondie73100 (€2 in chips) 
Seat 6: caduceus369 (€2.90 in chips) 
ghosto69: posts small blind €0.01
ADRIAN0_MEIS: posts big blind €0.02
*** HOLE CARDS ***
Dealt to caduceus369 [2d 3d]
AntonioKrakka: folds 
mondie73100: folds 
caduceus369: folds 
zicky78.r: raises €0.02 to €0.04
ghosto69: folds 
ADRIAN0_MEIS: folds 
Uncalled bet (€0.02) returned to zicky78.r
zicky78.r collected €0.05 from pot
zicky78.r: doesn't show hand 
*** SUMMARY ***
Total pot €0.05 | Rake €0 
Seat 1: zicky78.r (button) collected (€0.05)
Seat 2: ghosto69 (small blind) folded before Flop
Seat 3: ADRIAN0_MEIS (big blind) folded before Flop
Seat 4: AntonioKrakka folded before Flop (didn't bet)
Seat 5: mondie73100 folded before Flop (didn't bet)
Seat 6: caduceus369 folded before Flop (didn't bet)



PokerStars Zoom Hand #257975017801:  Hold'em No Limit (€0.01/€0.02) [ADM ID: M62BA304494E32ST] - 2025/10/02 22:49:24 CET [2025/10/02 16:49:24 ET]
Table 'Sirio' 6-max Seat #1 is the button
Seat 1: father2008 (€2 in chips) 
Seat 2: ghosto69 (€2.18 in chips) 
Seat 3: Nicoirca2004 (€1.19 in chips) 
Seat 4: caduceus369 (€2.90 in chips) 
Seat 5: AntonioKrakka (€3.46 in chips) 
Seat 6: Catania838 (€2.14 in chips) 
ghosto69: posts small blind €0.01
Nicoirca2004: posts big blind €0.02
*** HOLE CARDS ***
Dealt to caduceus369 [5d 4h]
caduceus369: folds 
AntonioKrakka: folds 
Catania838: raises €0.06 to €0.08
father2008: folds 
ghosto69: calls €0.07
Nicoirca2004: folds 
*** FLOP *** [3c 6s 6d]
ghosto69: checks 
Catania838: bets €0.18
ghosto69: folds 
Uncalled bet (€0.18) returned to Catania838
Catania838 collected €0.18 from pot
Catania838: doesn't show hand 
*** SUMMARY ***
Total pot €0.18 | Rake €0 
Board [3c 6s 6d]
Seat 1: father2008 (button) folded before Flop (didn't bet)
Seat 2: ghosto69 (small blind) folded on the Flop
Seat 3: Nicoirca2004 (big blind) folded before Flop
Seat 4: caduceus369 folded before Flop (didn't bet)
Seat 5: AntonioKrakka folded before Flop (didn't bet)
Seat 6: Catania838 collected (€0.18)



PokerStars Zoom Hand #257975018781:  Hold'em No Limit (€0.01/€0.02) [ADM ID: M62BA304494E32ST] - 2025/10/02 22:49:28 CET [2025/10/02 16:49:28 ET]
Table 'Sirio' 6-max Seat #1 is the button
Seat 1: caduceus369 (€2.90 in chips) 
Seat 2: aleKG5 (€1.40 in chips) 
Seat 3: AntonioKrakka (€3.76 in chips) 
Seat 4: kroll219 (€0.81 in chips) 
Seat 5: gigiruk91 (€10.13 in chips) 
Seat 6: father2008 (€3.75 in chips) 
aleKG5: posts small blind €0.01
AntonioKrakka: posts big blind €0.02
*** HOLE CARDS ***
Dealt to caduceus369 [Ts Jh]
kroll219: folds 
gigiruk91: folds 
father2008: folds 
caduceus369: folds 
aleKG5: calls €0.01
AntonioKrakka: checks 
*** FLOP *** [Qc Td Kc]
aleKG5: checks 
AntonioKrakka: bets €0.04
aleKG5: folds 
Uncalled bet (€0.04) returned to AntonioKrakka
AntonioKrakka collected €0.04 from pot
AntonioKrakka: doesn't show hand 
*** SUMMARY ***
Total pot €0.04 | Rake €0 
Board [Qc Td Kc]
Seat 1: caduceus369 (button) folded before Flop (didn't bet)
Seat 2: aleKG5 (small blind) folded on the Flop
Seat 3: AntonioKrakka (big blind) collected (€0.04)
Seat 4: kroll219 folded before Flop (didn't bet)
Seat 5: gigiruk91 folded before Flop (didn't bet)
Seat 6: father2008 folded before Flop (didn't bet)



PokerStars Zoom Hand #257975021652:  Hold'em No Limit (€0.01/€0.02) [ADM ID: M62BA304494E32ST] - 2025/10/02 22:49:40 CET [2025/10/02 16:49:40 ET]
Table 'Sirio' 6-max Seat #1 is the button
Seat 1: luchetto1990 (€3.13 in chips) 
Seat 2: cap e'bomb95 (€1.30 in chips) 
Seat 3: caduceus369 (€2.90 in chips) 
Seat 4: robertoH2O (€2 in chips) 
Seat 5: AlfredP80 (€1.88 in chips) 
Seat 6: c.ronaldo644 (€1.95 in chips) 
cap e'bomb95: posts small blind €0.01
caduceus369: posts big blind €0.02
*** HOLE CARDS ***
Dealt to caduceus369 [5h As]
robertoH2O has timed out
robertoH2O: folds 
AlfredP80: folds 
c.ronaldo644: raises €0.06 to €0.08
luchetto1990: folds 
cap e'bomb95: calls €0.07
caduceus369: folds 
*** FLOP *** [Qd Js 8h]
cap e'bomb95: checks 
c.ronaldo644: bets €0.08
cap e'bomb95: folds 
Uncalled bet (€0.08) returned to c.ronaldo644
c.ronaldo644 collected €0.18 from pot
c.ronaldo644: doesn't show hand 
*** SUMMARY ***
Total pot €0.18 | Rake €0 
Board [Qd Js 8h]
Seat 1: luchetto1990 (button) folded before Flop (didn't bet)
Seat 2: cap e'bomb95 (small blind) folded on the Flop
Seat 3: caduceus369 (big blind) folded before Flop
Seat 4: robertoH2O folded before Flop (didn't bet)
Seat 5: AlfredP80 folded before Flop (didn't bet)
Seat 6: c.ronaldo644 collected (€0.18)



PokerStars Zoom Hand #257975030119:  Hold'em No Limit (€0.01/€0.02) [ADM ID: M62BA304494E32ST] - 2025/10/02 22:50:15 CET [2025/10/02 16:50:15 ET]
Table 'Sirio' 6-max Seat #1 is the button
Seat 1: cap e'bomb95 (€1.22 in chips) 
Seat 2: gigiruk91 (€10.19 in chips) 
Seat 3: Warterror90 (€5.96 in chips) 
Seat 4: zicky78.r (€4.40 in chips) 
Seat 5: father2008 (€2.03 in chips) 
Seat 6: caduceus369 (€2.87 in chips) 
gigiruk91: posts small blind €0.01
Warterror90: posts big blind €0.02
*** HOLE CARDS ***
Dealt to caduceus369 [Ac 8d]
zicky78.r: folds 
father2008: folds 
caduceus369: folds 
cap e'bomb95: folds 
gigiruk91: folds 
Uncalled bet (€0.01) returned to Warterror90
Warterror90 collected €0.02 from pot
Warterror90: doesn't show hand 
*** SUMMARY ***
Total pot €0.02 | Rake €0 
Seat 1: cap e'bomb95 (button) folded before Flop (didn't bet)
Seat 2: gigiruk91 (small blind) folded before Flop
Seat 3: Warterror90 (big blind) collected (€0.02)
Seat 4: zicky78.r folded before Flop (didn't bet)
Seat 5: father2008 folded before Flop (didn't bet)
Seat 6: caduceus369 folded before Flop (didn't bet)



PokerStars Zoom Hand #257975028035:  Hold'em No Limit (€0.01/€0.02) [ADM ID: M62BA304494E32ST] - 2025/10/02 22:50:07 CET [2025/10/02 16:50:07 ET]
Table 'Sirio' 6-max Seat #1 is the button
Seat 1: zicky78.r (€2.02 in chips) 
Seat 2: aleKG5 (€1.38 in chips) 
Seat 3: ghosto69 (€2.09 in chips) 
Seat 4: Lizi855 (€0.52 in chips) 
Seat 5: caduceus369 (€2.87 in chips) 
Seat 6: cap e'bomb95 (€1.92 in chips) 
aleKG5: posts small blind €0.01
ghosto69: posts big blind €0.02
*** HOLE CARDS ***
Dealt to caduceus369 [9d 3c]
Lizi855: calls €0.02
caduceus369: folds 
cap e'bomb95: raises €0.03 to €0.05
zicky78.r: folds 
aleKG5: folds 
ghosto69: folds 
Lizi855: calls €0.03
*** FLOP *** [6h 4h Qd]
Lizi855: checks 
cap e'bomb95: bets €0.09
Lizi855: folds 
Uncalled bet (€0.09) returned to cap e'bomb95
cap e'bomb95 collected €0.13 from pot
cap e'bomb95: doesn't show hand 
*** SUMMARY ***
Total pot €0.13 | Rake €0 
Board [6h 4h Qd]
Seat 1: zicky78.r (button) folded before Flop (didn't bet)
Seat 2: aleKG5 (small blind) folded before Flop
Seat 3: ghosto69 (big blind) folded before Flop
Seat 4: Lizi855 folded on the Flop
Seat 5: caduceus369 folded before Flop (didn't bet)
Seat 6: cap e'bomb95 collected (€0.13)



PokerStars Zoom Hand #257975031110:  Hold'em No Limit (€0.01/€0.02) [ADM ID: M62BA304494E32ST] - 2025/10/02 22:50:19 CET [2025/10/02 16:50:19 ET]
Table 'Sirio' 6-max Seat #1 is the button
Seat 1: 7mosigillo (€2.30 in chips) 
Seat 2: AntonioKrakka (€3.02 in chips) 
Seat 3: zicky78.r (€4.40 in chips) 
Seat 4: caduceus369 (€2.87 in chips) 
Seat 5: Giuggiola64 (€1.60 in chips) 
Seat 6: cap e'bomb95 (€0.55 in chips) 
AntonioKrakka: posts small blind €0.01
zicky78.r: posts big blind €0.02
*** HOLE CARDS ***
Dealt to caduceus369 [Ac 2h]
caduceus369: folds 
Giuggiola64: folds 
cap e'bomb95: folds 
7mosigillo: raises €0.02 to €0.04
AntonioKrakka: calls €0.03
zicky78.r: folds 
*** FLOP *** [2s Qd 4d]
AntonioKrakka: checks 
7mosigillo: bets €0.02
AntonioKrakka: folds 
Uncalled bet (€0.02) returned to 7mosigillo
7mosigillo collected €0.10 from pot
7mosigillo: doesn't show hand 
*** SUMMARY ***
Total pot €0.10 | Rake €0 
Board [2s Qd 4d]
Seat 1: 7mosigillo (button) collected (€0.10)
Seat 2: AntonioKrakka (small blind) folded on the Flop
Seat 3: zicky78.r (big blind) folded before Flop
Seat 4: caduceus369 folded before Flop (didn't bet)
Seat 5: Giuggiola64 folded before Flop (didn't bet)
Seat 6: cap e'bomb95 folded before Flop (didn't bet)



PokerStars Zoom Hand #257975032631:  Hold'em No Limit (€0.01/€0.02) [ADM ID: M62BA304494E32ST] - 2025/10/02 22:50:25 CET [2025/10/02 16:50:25 ET]
Table 'Sirio' 6-max Seat #1 is the button
Seat 1: caduceus369 (€2.87 in chips) 
Seat 2: ADRIAN0_MEIS (€2.03 in chips) 
Seat 3: babanotop (€1.99 in chips) 
Seat 4: Ciro9934 (€0.98 in chips) 
Seat 5: aleKG5 (€1.37 in chips) 
Seat 6: AlfredP80 (€1.80 in chips) 
ADRIAN0_MEIS: posts small blind €0.01
babanotop: posts big blind €0.02
*** HOLE CARDS ***
Dealt to caduceus369 [5c Tc]
Ciro9934: folds 
aleKG5: raises €0.02 to €0.04
AlfredP80: folds 
caduceus369: folds 
ADRIAN0_MEIS: folds 
babanotop: folds 
Uncalled bet (€0.02) returned to aleKG5
aleKG5 collected €0.05 from pot
aleKG5: doesn't show hand 
*** SUMMARY ***
Total pot €0.05 | Rake €0 
Seat 1: caduceus369 (button) folded before Flop (didn't bet)
Seat 2: ADRIAN0_MEIS (small blind) folded before Flop
Seat 3: babanotop (big blind) folded before Flop
Seat 4: Ciro9934 folded before Flop (didn't bet)
Seat 5: aleKG5 collected (€0.05)
Seat 6: AlfredP80 folded before Flop (didn't bet)



PokerStars Zoom Hand #257975025593:  Hold'em No Limit (€0.01/€0.02) [ADM ID: M62BA304494E32ST] - 2025/10/02 22:49:56 CET [2025/10/02 16:49:56 ET]
Table 'Sirio' 6-max Seat #1 is the button
Seat 1: mondie73100 (€2 in chips) 
Seat 2: caduceus369 (€2.88 in chips) 
Seat 3: pistaKKio23 (€1.86 in chips) 
Seat 4: ADRIAN0_MEIS (€7.05 in chips) 
Seat 5: Catania838 (€1.99 in chips) 
Seat 6: gigiruk91 (€4.85 in chips) 
caduceus369: posts small blind €0.01
pistaKKio23: posts big blind €0.02
*** HOLE CARDS ***
Dealt to caduceus369 [Ac 8s]
ADRIAN0_MEIS: raises €0.03 to €0.05
Catania838: calls €0.05
gigiruk91: folds 
mondie73100: folds 
caduceus369: folds 
pistaKKio23: folds 
*** FLOP *** [2s 8c 4d]
ADRIAN0_MEIS: checks 
Catania838: bets €0.13
ADRIAN0_MEIS: calls €0.13
*** TURN *** [2s 8c 4d] [6c]
ADRIAN0_MEIS: checks 
Catania838: bets €0.37
ADRIAN0_MEIS: folds 
Uncalled bet (€0.37) returned to Catania838
Catania838 collected €0.37 from pot
Catania838: doesn't show hand 
*** SUMMARY ***
Total pot €0.39 | Rake €0.02 
Board [2s 8c 4d 6c]
Seat 1: mondie73100 (button) folded before Flop (didn't bet)
Seat 2: caduceus369 (small blind) folded before Flop
Seat 3: pistaKKio23 (big blind) folded before Flop
Seat 4: ADRIAN0_MEIS folded on the Turn
Seat 5: Catania838 collected (€0.37)
Seat 6: gigiruk91 folded before Flop (didn't bet)



PokerStars Zoom Hand #257975033570:  Hold'em No Limit (€0.01/€0.02) [ADM ID: M62BA304494E32ST] - 2025/10/02 22:50:29 CET [2025/10/02 16:50:29 ET]
Table 'Sirio' 6-max Seat #1 is the button
Seat 1: cap e'bomb95 (€1.22 in chips) 
Seat 2: Catania838 (€1.68 in chips) 
Seat 3: Ciro9934 (€0.98 in chips) 
Seat 4: gemini1682 (€3.09 in chips) 
Seat 5: caduceus369 (€2.87 in chips) 
Seat 6: jackkk03 (€3.75 in chips) 
Catania838: posts small blind €0.01
Ciro9934: posts big blind €0.02
*** HOLE CARDS ***
Dealt to caduceus369 [Qs Kd]
gemini1682: folds 
caduceus369: calls €0.02
jackkk03: folds 
cap e'bomb95: folds 
Catania838: folds 
Ciro9934: raises €0.02 to €0.04
caduceus369: raises €0.10 to €0.14
Ciro9934: calls €0.10
*** FLOP *** [Tc Jd Qd]
Ciro9934: bets €0.14
caduceus369: raises €2.59 to €2.73 and is all-in
Ciro9934: calls €0.70 and is all-in
Uncalled bet (€1.89) returned to caduceus369
*** TURN *** [Tc Jd Qd] [Ks]
*** RIVER *** [Tc Jd Qd Ks] [Td]
*** SHOW DOWN ***
Ciro9934: shows [As Ac] (a straight, Ten to Ace)
caduceus369: shows [Qs Kd] (two pair, Kings and Queens)
Ciro9934 collected €1.87 from pot
*** SUMMARY ***
Total pot €1.97 | Rake €0.10 
Board [Tc Jd Qd Ks Td]
Seat 1: cap e'bomb95 (button) folded before Flop (didn't bet)
Seat 2: Catania838 (small blind) folded before Flop
Seat 3: Ciro9934 (big blind) showed [As Ac] and won (€1.87) with a straight, Ten to Ace
Seat 4: gemini1682 folded before Flop (didn't bet)
Seat 5: caduceus369 showed [Qs Kd] and lost with two pair, Kings and Queens
Seat 6: jackkk03 folded before Flop (didn't bet)



PokerStars Zoom Hand #257975042721:  Hold'em No Limit (€0.01/€0.02) [ADM ID: M62BA304494E32ST] - 2025/10/02 22:51:07 CET [2025/10/02 16:51:07 ET]
Table 'Sirio' 6-max Seat #1 is the button
Seat 1: fantaasso (€1.60 in chips) 
Seat 2: AntonioKrakka (€2.98 in chips) 
Seat 3: caduceus369 (€1.89 in chips) 
Seat 4: aleKG5 (€1.38 in chips) 
Seat 5: jackkk03 (€3.76 in chips) 
Seat 6: Ciro9934 (€1.87 in chips) 
AntonioKrakka: posts small blind €0.01
caduceus369: posts big blind €0.02
*** HOLE CARDS ***
Dealt to caduceus369 [7s Kc]
aleKG5: folds 
jackkk03: folds 
Ciro9934: calls €0.02
fantaasso: folds 
AntonioKrakka: folds 
caduceus369: checks 
*** FLOP *** [Ad Qc 8s]
caduceus369: checks 
Ciro9934: bets €0.02
caduceus369: folds 
Uncalled bet (€0.02) returned to Ciro9934
Ciro9934 collected €0.05 from pot
Ciro9934: doesn't show hand 
*** SUMMARY ***
Total pot €0.05 | Rake €0 
Board [Ad Qc 8s]
Seat 1: fantaasso (button) folded before Flop (didn't bet)
Seat 2: AntonioKrakka (small blind) folded before Flop
Seat 3: caduceus369 (big blind) folded on the Flop
Seat 4: aleKG5 folded before Flop (didn't bet)
Seat 5: jackkk03 folded before Flop (didn't bet)
Seat 6: Ciro9934 collected (€0.05)



PokerStars Zoom Hand #257975048326:  Hold'em No Limit (€0.01/€0.02) [ADM ID: M62BA304494E32ST] - 2025/10/02 22:51:30 CET [2025/10/02 16:51:30 ET]
Table 'Sirio' 6-max Seat #1 is the button
Seat 1: monsterc99 (€1.63 in chips) 
Seat 2: caduceus369 (€1.87 in chips) 
Seat 3: robertoH2O (€2 in chips) 
Seat 4: Nicoirca2004 (€1.16 in chips) 
Seat 5: bastiagero (€0.33 in chips) 
Seat 6: ADRIAN0_MEIS (€6.89 in chips) 
caduceus369: posts small blind €0.01
robertoH2O: posts big blind €0.02
*** HOLE CARDS ***
Dealt to caduceus369 [Ks Th]
Nicoirca2004: folds 
bastiagero: folds 
ADRIAN0_MEIS: folds 
monsterc99: folds 
caduceus369: folds 
Uncalled bet (€0.01) returned to robertoH2O
robertoH2O collected €0.02 from pot
robertoH2O: doesn't show hand 
*** SUMMARY ***
Total pot €0.02 | Rake €0 
Seat 1: monsterc99 (button) folded before Flop (didn't bet)
Seat 2: caduceus369 (small blind) folded before Flop
Seat 3: robertoH2O (big blind) collected (€0.02)
Seat 4: Nicoirca2004 folded before Flop (didn't bet)
Seat 5: bastiagero folded before Flop (didn't bet)
Seat 6: ADRIAN0_MEIS folded before Flop (didn't bet)



PokerStars Zoom Hand #257975051227:  Hold'em No Limit (€0.01/€0.02) [ADM ID: M62BA304494E32ST] - 2025/10/02 22:51:41 CET [2025/10/02 16:51:41 ET]
Table 'Sirio' 6-max Seat #1 is the button
Seat 1: 7mosigillo (€2.44 in chips) 
Seat 2: father2008 (€3.80 in chips) 
Seat 3: mondie73100 (€2 in chips) 
Seat 4: caduceus369 (€1.86 in chips) 
Seat 5: luchetto1990 (€2.99 in chips) 
Seat 6: cagliari59 (€2.86 in chips) 
father2008: posts small blind €0.01
mondie73100: posts big blind €0.02
*** HOLE CARDS ***
Dealt to caduceus369 [8s 9c]
caduceus369: folds 
luchetto1990: folds 
cagliari59: folds 
7mosigillo: folds 
father2008: folds 
Uncalled bet (€0.01) returned to mondie73100
mondie73100 collected €0.02 from pot
mondie73100: doesn't show hand 
*** SUMMARY ***
Total pot €0.02 | Rake €0 
Seat 1: 7mosigillo (button) folded before Flop (didn't bet)
Seat 2: father2008 (small blind) folded before Flop
Seat 3: mondie73100 (big blind) collected (€0.02)
Seat 4: caduceus369 folded before Flop (didn't bet)
Seat 5: luchetto1990 folded before Flop (didn't bet)
Seat 6: cagliari59 folded before Flop (didn't bet)



PokerStars Zoom Hand #257975049524:  Hold'em No Limit (€0.01/€0.02) [ADM ID: M62BA304494E32ST] - 2025/10/02 22:51:34 CET [2025/10/02 16:51:34 ET]
Table 'Sirio' 6-max Seat #1 is the button
Seat 1: Warterror90 (€6.11 in chips) 
Seat 2: AntonioKrakka (€3.74 in chips) 
Seat 3: Nicoirca2004 (€1.16 in chips) 
Seat 4: pistaKKio23 (€1.77 in chips) 
Seat 5: c.ronaldo644 (€2.28 in chips) 
Seat 6: caduceus369 (€1.86 in chips) 
AntonioKrakka: posts small blind €0.01
Nicoirca2004: posts big blind €0.02
*** HOLE CARDS ***
Dealt to caduceus369 [8c Kd]
pistaKKio23: folds 
c.ronaldo644: folds 
caduceus369: folds 
Warterror90: raises €0.04 to €0.06
AntonioKrakka: folds 
Nicoirca2004: folds 
Uncalled bet (€0.04) returned to Warterror90
Warterror90 collected €0.05 from pot
Warterror90: doesn't show hand 
*** SUMMARY ***
Total pot €0.05 | Rake €0 
Seat 1: Warterror90 (button) collected (€0.05)
Seat 2: AntonioKrakka (small blind) folded before Flop
Seat 3: Nicoirca2004 (big blind) folded before Flop
Seat 4: pistaKKio23 folded before Flop (didn't bet)
Seat 5: c.ronaldo644 folded before Flop (didn't bet)
Seat 6: caduceus369 folded before Flop (didn't bet)



PokerStars Zoom Hand #257975052430:  Hold'em No Limit (€0.01/€0.02) [ADM ID: M62BA304494E32ST] - 2025/10/02 22:51:46 CET [2025/10/02 16:51:46 ET]
Table 'Sirio' 6-max Seat #1 is the button
Seat 1: zicky78.r (€2.02 in chips) 
Seat 2: 7mosigillo (€2.33 in chips) 
Seat 3: gigiruk91 (€3.04 in chips) 
Seat 4: caduceus369 (€1.86 in chips) 
Seat 5: fantaasso (€2.37 in chips) 
Seat 6: Gabrielefante (€4.48 in chips) 
7mosigillo: posts small blind €0.01
gigiruk91: posts big blind €0.02
*** HOLE CARDS ***
Dealt to caduceus369 [Kd Kh]
caduceus369: raises €0.02 to €0.04
fantaasso: folds 
Gabrielefante: folds 
zicky78.r: folds 
7mosigillo: folds 
gigiruk91: folds 
Uncalled bet (€0.02) returned to caduceus369
caduceus369 collected €0.05 from pot
caduceus369: doesn't show hand 
*** SUMMARY ***
Total pot €0.05 | Rake €0 
Seat 1: zicky78.r (button) folded before Flop (didn't bet)
Seat 2: 7mosigillo (small blind) folded before Flop
Seat 3: gigiruk91 (big blind) folded before Flop
Seat 4: caduceus369 collected (€0.05)
Seat 5: fantaasso folded before Flop (didn't bet)
Seat 6: Gabrielefante folded before Flop (didn't bet)



PokerStars Zoom Hand #257975055550:  Hold'em No Limit (€0.01/€0.02) [ADM ID: M62BA304494E32ST] - 2025/10/02 22:51:59 CET [2025/10/02 16:51:59 ET]
Table 'Sirio' 6-max Seat #1 is the button
Seat 1: caduceus369 (€1.89 in chips) 
Seat 2: ghosto69 (€2.02 in chips) 
Seat 3: Eudy26 (€0.89 in chips) 
Seat 4: rush572 (€0.44 in chips) 
Seat 5: fantaasso (€1.72 in chips) 
Seat 6: Ciro9934 (€1.92 in chips) 
ghosto69: posts small blind €0.01
Eudy26: posts big blind €0.02
*** HOLE CARDS ***
Dealt to caduceus369 [9s 9c]
rush572: folds 
fantaasso: folds 
Ciro9934: calls €0.02
caduceus369: calls €0.02
ghosto69: folds 
Eudy26: checks 
*** FLOP *** [Ad Js 3h]
Eudy26: bets €0.02
Ciro9934: folds 
caduceus369: calls €0.02
*** TURN *** [Ad Js 3h] [6h]
Eudy26: bets €0.02
caduceus369: raises €0.04 to €0.06
Eudy26: calls €0.04
*** RIVER *** [Ad Js 3h 6h] [Th]
Eudy26: checks 
caduceus369: bets €0.06
Eudy26: folds 
Uncalled bet (€0.06) returned to caduceus369
caduceus369 collected €0.22 from pot
caduceus369: doesn't show hand 
*** SUMMARY ***
Total pot €0.23 | Rake €0.01 
Board [Ad Js 3h 6h Th]
Seat 1: caduceus369 (button) collected (€0.22)
Seat 2: ghosto69 (small blind) folded before Flop
Seat 3: Eudy26 (big blind) folded on the River
Seat 4: rush572 folded before Flop (didn't bet)
Seat 5: fantaasso folded before Flop (didn't bet)
Seat 6: Ciro9934 folded on the Flop



PokerStars Zoom Hand #257975069380:  Hold'em No Limit (€0.01/€0.02) [ADM ID: M62BA304494E32ST] - 2025/10/02 22:52:56 CET [2025/10/02 16:52:56 ET]
Table 'Sirio' 6-max Seat #1 is the button
Seat 1: Warterror90 (€5.15 in chips) 
Seat 2: caduceus369 (€2.01 in chips) 
Seat 3: caballeros10 (€2 in chips) 
Seat 4: 19HinciaBS79 (€2.54 in chips) 
Seat 5: zicky78.r (€2.80 in chips) 
Seat 6: Catania838 (€1.87 in chips) 
caduceus369: posts small blind €0.01
caballeros10: posts big blind €0.02
*** HOLE CARDS ***
Dealt to caduceus369 [Jd 7c]
19HinciaBS79: raises €0.06 to €0.08
zicky78.r: folds 
Catania838: folds 
Warterror90: folds 
caduceus369: folds 
caballeros10: calls €0.06
*** FLOP *** [3h Td 6h]
caballeros10: bets €0.02
19HinciaBS79: calls €0.02
*** TURN *** [3h Td 6h] [2c]
caballeros10: bets €0.02
19HinciaBS79: calls €0.02
*** RIVER *** [3h Td 6h 2c] [4d]
caballeros10: checks 
19HinciaBS79: checks 
*** SHOW DOWN ***
caballeros10: shows [2s Kd] (a pair of Deuces)
19HinciaBS79: mucks hand 
caballeros10 collected €0.24 from pot
*** SUMMARY ***
Total pot €0.25 | Rake €0.01 
Board [3h Td 6h 2c 4d]
Seat 1: Warterror90 (button) folded before Flop (didn't bet)
Seat 2: caduceus369 (small blind) folded before Flop
Seat 3: caballeros10 (big blind) showed [2s Kd] and won (€0.24) with a pair of Deuces
Seat 4: 19HinciaBS79 mucked [Qc As]
Seat 5: zicky78.r folded before Flop (didn't bet)
Seat 6: Catania838 folded before Flop (didn't bet)



PokerStars Zoom Hand #257975070687:  Hold'em No Limit (€0.01/€0.02) [ADM ID: M62BA304494E32ST] - 2025/10/02 22:53:01 CET [2025/10/02 16:53:01 ET]
Table 'Sirio' 6-max Seat #1 is the button
Seat 1: Eudy26 (€0.78 in chips) 
Seat 2: jackkk03 (€3.75 in chips) 
Seat 3: caduceus369 (€2 in chips) 
Seat 4: AlfredP80 (€1.21 in chips) 
Seat 5: AntonioKrakka (€2.71 in chips) 
Seat 6: gigiruk91 (€10.04 in chips) 
jackkk03: posts small blind €0.01
caduceus369: posts big blind €0.02
*** HOLE CARDS ***
Dealt to caduceus369 [Jc Th]
AlfredP80: folds 
AntonioKrakka: folds 
gigiruk91: raises €0.02 to €0.04
Eudy26: raises €0.04 to €0.08
jackkk03: folds 
caduceus369: folds 
gigiruk91: calls €0.04
*** FLOP *** [7c 2c 9c]
gigiruk91: checks 
Eudy26: bets €0.08
gigiruk91: raises €0.10 to €0.18
Eudy26: calls €0.10
*** TURN *** [7c 2c 9c] [Kd]
gigiruk91: bets €0.26
Eudy26: calls €0.26
*** RIVER *** [7c 2c 9c Kd] [Qd]
gigiruk91: bets €0.51
Eudy26: calls €0.26 and is all-in
Uncalled bet (€0.25) returned to gigiruk91
*** SHOW DOWN ***
gigiruk91: shows [5c Ac] (a flush, Ace high)
Eudy26: shows [Js Jh] (a pair of Jacks)
gigiruk91 collected €1.51 from pot
*** SUMMARY ***
Total pot €1.59 | Rake €0.08 
Board [7c 2c 9c Kd Qd]
Seat 1: Eudy26 (button) showed [Js Jh] and lost with a pair of Jacks
Seat 2: jackkk03 (small blind) folded before Flop
Seat 3: caduceus369 (big blind) folded before Flop
Seat 4: AlfredP80 folded before Flop (didn't bet)
Seat 5: AntonioKrakka folded before Flop (didn't bet)
Seat 6: gigiruk91 showed [5c Ac] and won (€1.51) with a flush, Ace high



PokerStars Zoom Hand #257975083346:  Hold'em No Limit (€0.01/€0.02) [ADM ID: M62BA304494E32ST] - 2025/10/02 22:53:53 CET [2025/10/02 16:53:53 ET]
Table 'Sirio' 6-max Seat #1 is the button
Seat 1: cap e'bomb95 (€2.15 in chips) 
Seat 2: VagALiss (€2.17 in chips) 
Seat 3: robertoH2O (€2.04 in chips) 
Seat 4: RRgalp (€6.89 in chips) 
Seat 5: Warterror90 (€5.39 in chips) 
Seat 6: caduceus369 (€1.98 in chips) 
VagALiss: posts small blind €0.01
robertoH2O: posts big blind €0.02
*** HOLE CARDS ***
Dealt to caduceus369 [2d 3c]
RRgalp: folds 
Warterror90: folds 
caduceus369: folds 
cap e'bomb95: folds 
VagALiss: folds 
Uncalled bet (€0.01) returned to robertoH2O
robertoH2O collected €0.02 from pot
robertoH2O: doesn't show hand 
*** SUMMARY ***
Total pot €0.02 | Rake €0 
Seat 1: cap e'bomb95 (button) folded before Flop (didn't bet)
Seat 2: VagALiss (small blind) folded before Flop
Seat 3: robertoH2O (big blind) collected (€0.02)
Seat 4: RRgalp folded before Flop (didn't bet)
Seat 5: Warterror90 folded before Flop (didn't bet)
Seat 6: caduceus369 folded before Flop (didn't bet)



PokerStars Zoom Hand #257975084285:  Hold'em No Limit (€0.01/€0.02) [ADM ID: M62BA304494E32ST] - 2025/10/02 22:53:57 CET [2025/10/02 16:53:57 ET]
Table 'Sirio' 6-max Seat #1 is the button
Seat 1: caduceus369 (€1.98 in chips) 
Seat 2: AntonioKrakka (€3.58 in chips) 
Seat 3: cap e'bomb95 (€2.15 in chips) 
Seat 4: ADRIAN0_MEIS (€6.91 in chips) 
Seat 5: mondie73100 (€2 in chips) 
Seat 6: Eudy26 (€1.20 in chips) 
AntonioKrakka: posts small blind €0.01
cap e'bomb95: posts big blind €0.02
*** HOLE CARDS ***
Dealt to caduceus369 [As 9h]
ADRIAN0_MEIS: folds 
mondie73100: folds 
Eudy26: folds 
caduceus369: folds 
AntonioKrakka: folds 
Uncalled bet (€0.01) returned to cap e'bomb95
cap e'bomb95 collected €0.02 from pot
cap e'bomb95: doesn't show hand 
*** SUMMARY ***
Total pot €0.02 | Rake €0 
Seat 1: caduceus369 (button) folded before Flop (didn't bet)
Seat 2: AntonioKrakka (small blind) folded before Flop
Seat 3: cap e'bomb95 (big blind) collected (€0.02)
Seat 4: ADRIAN0_MEIS folded before Flop (didn't bet)
Seat 5: mondie73100 folded before Flop (didn't bet)
Seat 6: Eudy26 folded before Flop (didn't bet)



PokerStars Zoom Hand #257975086951:  Hold'em No Limit (€0.01/€0.02) [ADM ID: M62BA304494E32ST] - 2025/10/02 22:54:08 CET [2025/10/02 16:54:08 ET]
Table 'Sirio' 6-max Seat #1 is the button
Seat 1: S'dj83 (€2.99 in chips) 
Seat 2: fantaasso (€3.02 in chips) 
Seat 3: Nicoirca2004 (€1.20 in chips) 
Seat 4: mondie73100 (€2 in chips) 
Seat 5: caduceus369 (€1.98 in chips) 
Seat 6: luchetto1990 (€2.54 in chips) 
fantaasso: posts small blind €0.01
Nicoirca2004: posts big blind €0.02
*** HOLE CARDS ***
Dealt to caduceus369 [Ts 5h]
mondie73100: folds 
caduceus369: folds 
luchetto1990: raises €0.04 to €0.06
S'dj83: folds 
fantaasso: folds 
Nicoirca2004: folds 
Uncalled bet (€0.04) returned to luchetto1990
luchetto1990 collected €0.05 from pot
luchetto1990: doesn't show hand 
*** SUMMARY ***
Total pot €0.05 | Rake €0 
Seat 1: S'dj83 (button) folded before Flop (didn't bet)
Seat 2: fantaasso (small blind) folded before Flop
Seat 3: Nicoirca2004 (big blind) folded before Flop
Seat 4: mondie73100 folded before Flop (didn't bet)
Seat 5: caduceus369 folded before Flop (didn't bet)
Seat 6: luchetto1990 collected (€0.05)



PokerStars Zoom Hand #257975088674:  Hold'em No Limit (€0.01/€0.02) [ADM ID: M62BA304494E32ST] - 2025/10/02 22:54:15 CET [2025/10/02 16:54:15 ET]
Table 'Sirio' 6-max Seat #1 is the button
Seat 1: monsterc99 (€1.41 in chips) 
Seat 2: fantaasso (€1.64 in chips) 
Seat 3: bruciapelo (€5.19 in chips) 
Seat 4: muhozhuk788 (€2.14 in chips) 
Seat 5: caduceus369 (€1.98 in chips) 
Seat 6: ghosto69 (€1.93 in chips) 
fantaasso: posts small blind €0.01
bruciapelo: posts big blind €0.02
*** HOLE CARDS ***
Dealt to caduceus369 [Td Ac]
muhozhuk788: folds 
caduceus369: calls €0.02
ghosto69: folds 
monsterc99: folds 
fantaasso: calls €0.01
bruciapelo: checks 
*** FLOP *** [5c Ah 6d]
fantaasso: checks 
bruciapelo: bets €0.03
caduceus369: calls €0.03
fantaasso: folds 
*** TURN *** [5c Ah 6d] [Qd]
bruciapelo: checks 
caduceus369: checks 
*** RIVER *** [5c Ah 6d Qd] [3d]
bruciapelo: bets €0.06
caduceus369: calls €0.06
*** SHOW DOWN ***
bruciapelo: shows [2d 4s] (a straight, Deuce to Six)
caduceus369: mucks hand 
bruciapelo collected €0.23 from pot
*** SUMMARY ***
Total pot €0.24 | Rake €0.01 
Board [5c Ah 6d Qd 3d]
Seat 1: monsterc99 (button) folded before Flop (didn't bet)
Seat 2: fantaasso (small blind) folded on the Flop
Seat 3: bruciapelo (big blind) showed [2d 4s] and won (€0.23) with a straight, Deuce to Six
Seat 4: muhozhuk788 folded before Flop (didn't bet)
Seat 5: caduceus369 mucked [Td Ac]
Seat 6: ghosto69 folded before Flop (didn't bet)



PokerStars Zoom Hand #257975099738:  Hold'em No Limit (€0.01/€0.02) [ADM ID: M62BA304494E32ST] - 2025/10/02 22:55:01 CET [2025/10/02 16:55:01 ET]
Table 'Sirio' 6-max Seat #1 is the button
Seat 1: eleonora50 (€1.39 in chips) 
Seat 2: AntonioKrakka (€0.34 in chips) 
Seat 3: caduceus369 (€1.87 in chips) 
Seat 4: Gabrielefante (€4.52 in chips) 
Seat 5: cap e'bomb95 (€2.42 in chips) 
Seat 6: aleKG5 (€1.28 in chips) 
AntonioKrakka: posts small blind €0.01
caduceus369: posts big blind €0.02
*** HOLE CARDS ***
Dealt to caduceus369 [7d 5h]
Gabrielefante: folds 
cap e'bomb95: folds 
aleKG5: folds 
eleonora50: folds 
AntonioKrakka: folds 
Uncalled bet (€0.01) returned to caduceus369
caduceus369 collected €0.02 from pot
caduceus369: doesn't show hand 
*** SUMMARY ***
Total pot €0.02 | Rake €0 
Seat 1: eleonora50 (button) folded before Flop (didn't bet)
Seat 2: AntonioKrakka (small blind) folded before Flop
Seat 3: caduceus369 (big blind) collected (€0.02)
Seat 4: Gabrielefante folded before Flop (didn't bet)
Seat 5: cap e'bomb95 folded before Flop (didn't bet)
Seat 6: aleKG5 folded before Flop (didn't bet)



PokerStars Zoom Hand #257975102080:  Hold'em No Limit (€0.01/€0.02) [ADM ID: M62BA304494E32ST] - 2025/10/02 22:55:11 CET [2025/10/02 16:55:11 ET]
Table 'Sirio' 6-max Seat #1 is the button
Seat 1: KnaveFlush (€2.04 in chips) 
Seat 2: caduceus369 (€1.88 in chips) 
Seat 3: bastiagero (€0.34 in chips) 
Seat 4: Warterror90 (€7.17 in chips) 
Seat 5: cap e'bomb95 (€1.80 in chips) 
Seat 6: ghosto69 (€1.28 in chips) 
caduceus369: posts small blind €0.01
bastiagero: posts big blind €0.02
*** HOLE CARDS ***
Dealt to caduceus369 [3c 3h]
Warterror90: raises €0.04 to €0.06
cap e'bomb95: folds 
ghosto69: folds 
KnaveFlush: calls €0.06
caduceus369: folds 
bastiagero: folds 
*** FLOP *** [7c Js 9h]
Warterror90: checks 
KnaveFlush: checks 
*** TURN *** [7c Js 9h] [3d]
Warterror90: checks 
KnaveFlush: bets €0.09
Warterror90: folds 
Uncalled bet (€0.09) returned to KnaveFlush
KnaveFlush collected €0.15 from pot
KnaveFlush: doesn't show hand 
*** SUMMARY ***
Total pot €0.15 | Rake €0 
Board [7c Js 9h 3d]
Seat 1: KnaveFlush (button) collected (€0.15)
Seat 2: caduceus369 (small blind) folded before Flop
Seat 3: bastiagero (big blind) folded before Flop
Seat 4: Warterror90 folded on the Turn
Seat 5: cap e'bomb95 folded before Flop (didn't bet)
Seat 6: ghosto69 folded before Flop (didn't bet)



PokerStars Zoom Hand #257975106883:  Hold'em No Limit (€0.01/€0.02) [ADM ID: M62BA304494E32ST] - 2025/10/02 22:55:38 CET [2025/10/02 16:55:38 ET]
Table 'Sirio' 6-max Seat #1 is the button
Seat 1: caduceus369 (€1.87 in chips) 
Seat 2: ghosto69 (€1.88 in chips) 
Seat 3: VagALiss (€2.01 in chips) 
Seat 4: mondie73100 (€2.03 in chips) 
Seat 5: Nicoirca2004 (€1.22 in chips) 
Seat 6: cap e'bomb95 (€1.79 in chips) 
ghosto69: posts small blind €0.01
VagALiss: posts big blind €0.02
*** HOLE CARDS ***
Dealt to caduceus369 [4h 6h]
mondie73100: folds 
Nicoirca2004: folds 
cap e'bomb95: folds 
caduceus369: folds 
ghosto69: raises €0.04 to €0.06
VagALiss: folds 
Uncalled bet (€0.04) returned to ghosto69
ghosto69 collected €0.04 from pot
ghosto69: doesn't show hand 
*** SUMMARY ***
Total pot €0.04 | Rake €0 
Seat 1: caduceus369 (button) folded before Flop (didn't bet)
Seat 2: ghosto69 (small blind) collected (€0.04)
Seat 3: VagALiss (big blind) folded before Flop
Seat 4: mondie73100 folded before Flop (didn't bet)
Seat 5: Nicoirca2004 folded before Flop (didn't bet)
Seat 6: cap e'bomb95 folded before Flop (didn't bet)



PokerStars Zoom Hand #257975103967:  Hold'em No Limit (€0.01/€0.02) [ADM ID: M62BA304494E32ST] - 2025/10/02 22:55:20 CET [2025/10/02 16:55:20 ET]
Table 'Sirio' 6-max Seat #1 is the button
Seat 1: pistaKKio23 (€2.10 in chips) 
Seat 2: cap e'bomb95 (€2.03 in chips) 
Seat 3: Mmmaccio (€2.55 in chips) 
Seat 4: AntonioKrakka (€2.18 in chips) 
Seat 5: kolain17 (€1.03 in chips) 
Seat 6: caduceus369 (€1.87 in chips) 
cap e'bomb95: posts small blind €0.01
Mmmaccio: posts big blind €0.02
*** HOLE CARDS ***
Dealt to caduceus369 [Kh Td]
AntonioKrakka: folds 
kolain17: raises €0.05 to €0.07
caduceus369: folds 
pistaKKio23: folds 
cap e'bomb95: calls €0.06
Mmmaccio: calls €0.05
*** FLOP *** [Jc 4c 9h]
cap e'bomb95: checks 
Mmmaccio: checks 
kolain17: bets €0.20
cap e'bomb95: folds 
Mmmaccio: folds 
Uncalled bet (€0.20) returned to kolain17
kolain17 collected €0.20 from pot
kolain17: doesn't show hand 
*** SUMMARY ***
Total pot €0.21 | Rake €0.01 
Board [Jc 4c 9h]
Seat 1: pistaKKio23 (button) folded before Flop (didn't bet)
Seat 2: cap e'bomb95 (small blind) folded on the Flop
Seat 3: Mmmaccio (big blind) folded on the Flop
Seat 4: AntonioKrakka folded before Flop (didn't bet)
Seat 5: kolain17 collected (€0.20)
Seat 6: caduceus369 folded before Flop (didn't bet)



PokerStars Zoom Hand #257975105859:  Hold'em No Limit (€0.01/€0.02) [ADM ID: M62BA304494E32ST] - 2025/10/02 22:55:32 CET [2025/10/02 16:55:32 ET]
Table 'Sirio' 6-max Seat #1 is the button
Seat 1: gigiruk91 (€3.03 in chips) 
Seat 2: Catania838 (€2 in chips) 
Seat 3: Gabrielefante (€4.49 in chips) 
Seat 4: caduceus369 (€1.87 in chips) 
Seat 5: AntonioKrakka (€0.39 in chips) 
Seat 6: father2008 (€3.91 in chips) 
Catania838: posts small blind €0.01
Gabrielefante: posts big blind €0.02
*** HOLE CARDS ***
Dealt to caduceus369 [Jh 9h]
caduceus369: folds 
AntonioKrakka: folds 
father2008: raises €0.05 to €0.07
gigiruk91: folds 
Catania838: folds 
Gabrielefante: raises €0.15 to €0.22
father2008: calls €0.15
*** FLOP *** [Kh 4c 6d]
Gabrielefante: bets €0.22
father2008: calls €0.22
*** TURN *** [Kh 4c 6d] [3d]
Gabrielefante: bets €0.32
father2008: calls €0.32
*** RIVER *** [Kh 4c 6d 3d] [Qc]
Gabrielefante: bets €0.32
father2008: calls €0.32
*** SHOW DOWN ***
Gabrielefante: shows [As Ks] (a pair of Kings)
father2008: shows [Kc Ac] (a pair of Kings)
Gabrielefante collected €1.03 from pot
father2008 collected €1.03 from pot
*** SUMMARY ***
Total pot €2.17 | Rake €0.11 
Board [Kh 4c 6d 3d Qc]
Seat 1: gigiruk91 (button) folded before Flop (didn't bet)
Seat 2: Catania838 (small blind) folded before Flop
Seat 3: Gabrielefante (big blind) showed [As Ks] and won (€1.03) with a pair of Kings
Seat 4: caduceus369 folded before Flop (didn't bet)
Seat 5: AntonioKrakka folded before Flop (didn't bet)
Seat 6: father2008 showed [Kc Ac] and won (€1.03) with a pair of Kings



PokerStars Zoom Hand #257975107355:  Hold'em No Limit (€0.01/€0.02) [ADM ID: M62BA304494E32ST] - 2025/10/02 22:55:41 CET [2025/10/02 16:55:41 ET]
Table 'Sirio' 6-max Seat #1 is the button
Seat 1: Kingo690 (€1.42 in chips) 
Seat 2: gigiruk91 (€3.03 in chips) 
Seat 3: amandaknox (€2.76 in chips) 
Seat 4: bastiagero (€0.32 in chips) 
Seat 5: caduceus369 (€1.87 in chips) 
Seat 6: Simons484 (€0.80 in chips) 
gigiruk91: posts small blind €0.01
amandaknox: posts big blind €0.02
*** HOLE CARDS ***
Dealt to caduceus369 [2d 8d]
bastiagero: folds 
caduceus369: folds 
Simons484: raises €0.02 to €0.04
Kingo690: calls €0.04
gigiruk91: folds 
amandaknox: folds 
*** FLOP *** [5d Jc 6h]
Simons484: bets €0.06
Kingo690: raises €0.06 to €0.12
Simons484: calls €0.06
*** TURN *** [5d Jc 6h] [4s]
Simons484: checks 
Kingo690: bets €0.11
Simons484: calls €0.11
*** RIVER *** [5d Jc 6h 4s] [7d]
Simons484: checks 
Kingo690: bets €0.16
Simons484: folds 
Uncalled bet (€0.16) returned to Kingo690
Kingo690 collected €0.54 from pot
Kingo690: doesn't show hand 
*** SUMMARY ***
Total pot €0.57 | Rake €0.03 
Board [5d Jc 6h 4s 7d]
Seat 1: Kingo690 (button) collected (€0.54)
Seat 2: gigiruk91 (small blind) folded before Flop
Seat 3: amandaknox (big blind) folded before Flop
Seat 4: bastiagero folded before Flop (didn't bet)
Seat 5: caduceus369 folded before Flop (didn't bet)
Seat 6: Simons484 folded on the River



PokerStars Zoom Hand #257975108336:  Hold'em No Limit (€0.01/€0.02) [ADM ID: M62BA304494E32ST] - 2025/10/02 22:55:47 CET [2025/10/02 16:55:47 ET]
Table 'Sirio' 6-max Seat #1 is the button
Seat 1: AlfredP80 (€1.15 in chips) 
Seat 2: caduceus369 (€1.87 in chips) 
Seat 3: cap e'bomb95 (€1.79 in chips) 
Seat 4: aleKG5 (€1.25 in chips) 
Seat 5: ADRIAN0_MEIS (€2.23 in chips) 
Seat 6: KnaveFlush (€2.03 in chips) 
caduceus369: posts small blind €0.01
cap e'bomb95: posts big blind €0.02
*** HOLE CARDS ***
Dealt to caduceus369 [Qc Ac]
aleKG5: folds 
ADRIAN0_MEIS: folds 
KnaveFlush: folds 
AlfredP80: folds 
caduceus369: calls €0.01
cap e'bomb95: checks 
*** FLOP *** [3h 7d 4s]
caduceus369: checks 
cap e'bomb95: bets €0.03
caduceus369: calls €0.03
*** TURN *** [3h 7d 4s] [Ah]
caduceus369: checks 
cap e'bomb95: bets €0.07
caduceus369: calls €0.07
*** RIVER *** [3h 7d 4s Ah] [Jc]
caduceus369: checks 
cap e'bomb95: checks 
*** SHOW DOWN ***
caduceus369: shows [Qc Ac] (a pair of Aces)
cap e'bomb95: mucks hand 
caduceus369 collected €0.23 from pot
*** SUMMARY ***
Total pot €0.24 | Rake €0.01 
Board [3h 7d 4s Ah Jc]
Seat 1: AlfredP80 (button) folded before Flop (didn't bet)
Seat 2: caduceus369 (small blind) showed [Qc Ac] and won (€0.23) with a pair of Aces
Seat 3: cap e'bomb95 (big blind) mucked [7c 8d]
Seat 4: aleKG5 folded before Flop (didn't bet)
Seat 5: ADRIAN0_MEIS folded before Flop (didn't bet)
Seat 6: KnaveFlush folded before Flop (didn't bet)



PokerStars Zoom Hand #257975116151:  Hold'em No Limit (€0.01/€0.02) [ADM ID: M62BA304494E32ST] - 2025/10/02 22:56:35 CET [2025/10/02 16:56:35 ET]
Table 'Sirio' 6-max Seat #1 is the button
Seat 1: aleKG5 (€1.25 in chips) 
Seat 2: Oiad (€2.01 in chips) 
Seat 3: caduceus369 (€1.98 in chips) 
Seat 4: cagliari59 (€3.08 in chips) 
Seat 5: cap e'bomb95 (€1.67 in chips) 
Seat 6: ADRIAN0_MEIS (€6.88 in chips) 
Oiad: posts small blind €0.01
caduceus369: posts big blind €0.02
*** HOLE CARDS ***
Dealt to caduceus369 [Td 4h]
cagliari59: raises €0.02 to €0.04
cap e'bomb95: raises €0.11 to €0.15
ADRIAN0_MEIS: folds 
aleKG5: folds 
Oiad: folds 
caduceus369: folds 
cagliari59: folds 
Uncalled bet (€0.11) returned to cap e'bomb95
cap e'bomb95 collected €0.11 from pot
cap e'bomb95: doesn't show hand 
*** SUMMARY ***
Total pot €0.11 | Rake €0 
Seat 1: aleKG5 (button) folded before Flop (didn't bet)
Seat 2: Oiad (small blind) folded before Flop
Seat 3: caduceus369 (big blind) folded before Flop
Seat 4: cagliari59 folded before Flop
Seat 5: cap e'bomb95 collected (€0.11)
Seat 6: ADRIAN0_MEIS folded before Flop (didn't bet)



PokerStars Zoom Hand #257975117162:  Hold'em No Limit (€0.01/€0.02) [ADM ID: M62BA304494E32ST] - 2025/10/02 22:56:41 CET [2025/10/02 16:56:41 ET]
Table 'Sirio' 6-max Seat #1 is the button
Seat 1: KnaveFlush (€2.09 in chips) 
Seat 2: balai72 (€0.93 in chips) 
Seat 3: Kingo690 (€1.69 in chips) 
Seat 4: caduceus369 (€1.96 in chips) 
Seat 5: fantaasso (€1.42 in chips) 
Seat 6: aleKG5 (€1.25 in chips) 
balai72: posts small blind €0.01
Kingo690: posts big blind €0.02
*** HOLE CARDS ***
Dealt to caduceus369 [9d 9c]
caduceus369: calls €0.02
fantaasso: raises €0.06 to €0.08
aleKG5: folds 
KnaveFlush: folds 
balai72: folds 
Kingo690: folds 
caduceus369: raises €0.18 to €0.26
fantaasso: calls €0.18
*** FLOP *** [Jh Ac 2d]
caduceus369: bets €0.16
fantaasso: calls €0.16
*** TURN *** [Jh Ac 2d] [6h]
caduceus369: checks 
fantaasso: bets €0.42
caduceus369: folds 
Uncalled bet (€0.42) returned to fantaasso
fantaasso collected €0.83 from pot
fantaasso: doesn't show hand 
*** SUMMARY ***
Total pot €0.87 | Rake €0.04 
Board [Jh Ac 2d 6h]
Seat 1: KnaveFlush (button) folded before Flop (didn't bet)
Seat 2: balai72 (small blind) folded before Flop
Seat 3: Kingo690 (big blind) folded before Flop
Seat 4: caduceus369 folded on the Turn
Seat 5: fantaasso collected (€0.83)
Seat 6: aleKG5 folded before Flop (didn't bet)



PokerStars Zoom Hand #257975126811:  Hold'em No Limit (€0.01/€0.02) [ADM ID: M62BA304494E32ST] - 2025/10/02 22:57:41 CET [2025/10/02 16:57:41 ET]
Table 'Sirio' 6-max Seat #1 is the button
Seat 1: AntonioKrakka (€2.16 in chips) 
Seat 2: ADRIAN0_MEIS (€6.86 in chips) 
Seat 3: kolain17 (€1.88 in chips) 
Seat 4: caduceus369 (€1.54 in chips) 
Seat 5: Gabrielefante (€4.43 in chips) 
Seat 6: father2008 (€3.79 in chips) 
ADRIAN0_MEIS: posts small blind €0.01
kolain17: posts big blind €0.02
*** HOLE CARDS ***
Dealt to caduceus369 [7h Ks]
caduceus369: folds 
Gabrielefante: folds 
father2008: folds 
AntonioKrakka: folds 
ADRIAN0_MEIS: raises €0.04 to €0.06
kolain17: folds 
Uncalled bet (€0.04) returned to ADRIAN0_MEIS
ADRIAN0_MEIS collected €0.04 from pot
ADRIAN0_MEIS: doesn't show hand 
*** SUMMARY ***
Total pot €0.04 | Rake €0 
Seat 1: AntonioKrakka (button) folded before Flop (didn't bet)
Seat 2: ADRIAN0_MEIS (small blind) collected (€0.04)
Seat 3: kolain17 (big blind) folded before Flop
Seat 4: caduceus369 folded before Flop (didn't bet)
Seat 5: Gabrielefante folded before Flop (didn't bet)
Seat 6: father2008 folded before Flop (didn't bet)



PokerStars Zoom Hand #257975127675:  Hold'em No Limit (€0.01/€0.02) [ADM ID: M62BA304494E32ST] - 2025/10/02 22:57:46 CET [2025/10/02 16:57:46 ET]
Table 'Sirio' 6-max Seat #1 is the button
Seat 1: pistaKKio23 (€2.62 in chips) 
Seat 2: Oiad (€2.03 in chips) 
Seat 3: balai72 (€0.89 in chips) 
Seat 4: luchetto1990 (€3.01 in chips) 
Seat 5: KnaveFlush (€2.06 in chips) 
Seat 6: caduceus369 (€1.54 in chips) 
Oiad: posts small blind €0.01
balai72: posts big blind €0.02
*** HOLE CARDS ***
Dealt to caduceus369 [7h 2c]
luchetto1990: raises €0.04 to €0.06
KnaveFlush: folds 
caduceus369: folds 
pistaKKio23: folds 
Oiad: folds 
balai72: folds 
Uncalled bet (€0.04) returned to luchetto1990
luchetto1990 collected €0.05 from pot
luchetto1990: doesn't show hand 
*** SUMMARY ***
Total pot €0.05 | Rake €0 
Seat 1: pistaKKio23 (button) folded before Flop (didn't bet)
Seat 2: Oiad (small blind) folded before Flop
Seat 3: balai72 (big blind) folded before Flop
Seat 4: luchetto1990 collected (€0.05)
Seat 5: KnaveFlush folded before Flop (didn't bet)
Seat 6: caduceus369 folded before Flop (didn't bet)



PokerStars Zoom Hand #257975126016:  Hold'em No Limit (€0.01/€0.02) [ADM ID: M62BA304494E32ST] - 2025/10/02 22:57:36 CET [2025/10/02 16:57:36 ET]
Table 'Sirio' 6-max Seat #1 is the button
Seat 1: KnaveFlush (€2.06 in chips) 
Seat 2: Gabrielefante (€4.44 in chips) 
Seat 3: cap e'bomb95 (€2.87 in chips) 
Seat 4: balai72 (€0.89 in chips) 
Seat 5: Mimmuzzi89 (€0.98 in chips) 
Seat 6: caduceus369 (€1.54 in chips) 
Gabrielefante: posts small blind €0.01
cap e'bomb95: posts big blind €0.02
*** HOLE CARDS ***
Dealt to caduceus369 [6s 8h]
balai72: folds 
Mimmuzzi89: calls €0.02
caduceus369: folds 
KnaveFlush: folds 
Gabrielefante: folds 
cap e'bomb95: checks 
*** FLOP *** [Js 5d Td]
cap e'bomb95: checks 
Mimmuzzi89: checks 
*** TURN *** [Js 5d Td] [As]
cap e'bomb95: checks 
Mimmuzzi89: bets €0.05
cap e'bomb95: folds 
Uncalled bet (€0.05) returned to Mimmuzzi89
Mimmuzzi89 collected €0.05 from pot
Mimmuzzi89: doesn't show hand 
*** SUMMARY ***
Total pot €0.05 | Rake €0 
Board [Js 5d Td As]
Seat 1: KnaveFlush (button) folded before Flop (didn't bet)
Seat 2: Gabrielefante (small blind) folded before Flop
Seat 3: cap e'bomb95 (big blind) folded on the Turn
Seat 4: balai72 folded before Flop (didn't bet)
Seat 5: Mimmuzzi89 collected (€0.05)
Seat 6: caduceus369 folded before Flop (didn't bet)



PokerStars Zoom Hand #257975128351:  Hold'em No Limit (€0.01/€0.02) [ADM ID: M62BA304494E32ST] - 2025/10/02 22:57:50 CET [2025/10/02 16:57:50 ET]
Table 'Sirio' 6-max Seat #1 is the button
Seat 1: irenuccia33 (€1.82 in chips) 
Seat 2: AntonioKrakka (€0.82 in chips) 
Seat 3: caduceus369 (€1.54 in chips) 
Seat 4: sancarlo18 (€2.11 in chips) 
Seat 5: AlfredP80 (€1.10 in chips) 
Seat 6: father2008 (€3.47 in chips) 
AntonioKrakka: posts small blind €0.01
caduceus369: posts big blind €0.02
*** HOLE CARDS ***
Dealt to caduceus369 [7s 7d]
sancarlo18: folds 
AlfredP80: raises €0.04 to €0.06
father2008: folds 
irenuccia33: folds 
AntonioKrakka: folds 
caduceus369: calls €0.04
*** FLOP *** [5s 4c 2d]
caduceus369: checks 
AlfredP80: bets €0.06
caduceus369: raises €0.10 to €0.16
AlfredP80: calls €0.10
*** TURN *** [5s 4c 2d] [Qh]
caduceus369: checks 
AlfredP80: bets €0.06
caduceus369: calls €0.06
*** RIVER *** [5s 4c 2d Qh] [6d]
caduceus369: bets €0.27
AlfredP80: folds 
Uncalled bet (€0.27) returned to caduceus369
caduceus369 collected €0.54 from pot
caduceus369: doesn't show hand 
*** SUMMARY ***
Total pot €0.57 | Rake €0.03 
Board [5s 4c 2d Qh 6d]
Seat 1: irenuccia33 (button) folded before Flop (didn't bet)
Seat 2: AntonioKrakka (small blind) folded before Flop
Seat 3: caduceus369 (big blind) collected (€0.54)
Seat 4: sancarlo18 folded before Flop (didn't bet)
Seat 5: AlfredP80 folded on the River
Seat 6: father2008 folded before Flop (didn't bet)



PokerStars Zoom Hand #257975137842:  Hold'em No Limit (€0.01/€0.02) [ADM ID: M62BA304494E32ST] - 2025/10/02 22:58:48 CET [2025/10/02 16:58:48 ET]
Table 'Sirio' 6-max Seat #1 is the button
Seat 1: father2008 (€3.53 in chips) 
Seat 2: caduceus369 (€1.80 in chips) 
Seat 3: Nicoirca2004 (€2.40 in chips) 
Seat 4: fantaasso (€1.69 in chips) 
Seat 5: ADRIAN0_MEIS (€2.17 in chips) 
Seat 6: sancarlo18 (€2.11 in chips) 
caduceus369: posts small blind €0.01
Nicoirca2004: posts big blind €0.02
*** HOLE CARDS ***
Dealt to caduceus369 [3d 4h]
fantaasso: folds 
ADRIAN0_MEIS: folds 
sancarlo18: raises €0.04 to €0.06
father2008: folds 
caduceus369: folds 
Nicoirca2004: calls €0.04
*** FLOP *** [7s 8d 6d]
Nicoirca2004: checks 
sancarlo18: checks 
*** TURN *** [7s 8d 6d] [Jc]
Nicoirca2004: checks 
sancarlo18: bets €0.07
Nicoirca2004: calls €0.07
*** RIVER *** [7s 8d 6d Jc] [3h]
Nicoirca2004: checks 
sancarlo18: bets €0.15
Nicoirca2004: calls €0.15
*** SHOW DOWN ***
sancarlo18: shows [3s 3c] (three of a kind, Threes)
Nicoirca2004: mucks hand 
sancarlo18 collected €0.54 from pot
*** SUMMARY ***
Total pot €0.57 | Rake €0.03 
Board [7s 8d 6d Jc 3h]
Seat 1: father2008 (button) folded before Flop (didn't bet)
Seat 2: caduceus369 (small blind) folded before Flop
Seat 3: Nicoirca2004 (big blind) mucked [Kc Jd]
Seat 4: fantaasso folded before Flop (didn't bet)
Seat 5: ADRIAN0_MEIS folded before Flop (didn't bet)
Seat 6: sancarlo18 showed [3s 3c] and won (€0.54) with three of a kind, Threes



PokerStars Zoom Hand #257975138497:  Hold'em No Limit (€0.01/€0.02) [ADM ID: M62BA304494E32ST] - 2025/10/02 22:58:52 CET [2025/10/02 16:58:52 ET]
Table 'Sirio' 6-max Seat #1 is the button
Seat 1: caduceus369 (€1.79 in chips) 
Seat 2: kroll219 (€0.87 in chips) 
Seat 3: mondie73100 (€2.04 in chips) 
Seat 4: ADRIAN0_MEIS (€2.17 in chips) 
Seat 5: Warterror90 (€4.43 in chips) 
Seat 6: cap e'bomb95 (€1.89 in chips) 
kroll219: posts small blind €0.01
mondie73100: posts big blind €0.02
*** HOLE CARDS ***
Dealt to caduceus369 [Qh Ks]
ADRIAN0_MEIS: folds 
Warterror90: raises €0.04 to €0.06
cap e'bomb95: folds 
caduceus369: calls €0.06
kroll219: folds 
mondie73100: folds 
*** FLOP *** [2h 4d Ac]
Warterror90: checks 
caduceus369: bets €0.06
Warterror90: calls €0.06
*** TURN *** [2h 4d Ac] [9h]
Warterror90: checks 
caduceus369: checks 
*** RIVER *** [2h 4d Ac 9h] [Kh]
Warterror90: checks 
caduceus369: checks 
*** SHOW DOWN ***
Warterror90: shows [6c 8c] (high card Ace)
caduceus369: shows [Qh Ks] (a pair of Kings)
caduceus369 collected €0.26 from pot
*** SUMMARY ***
Total pot €0.27 | Rake €0.01 
Board [2h 4d Ac 9h Kh]
Seat 1: caduceus369 (button) showed [Qh Ks] and won (€0.26) with a pair of Kings
Seat 2: kroll219 (small blind) folded before Flop
Seat 3: mondie73100 (big blind) folded before Flop
Seat 4: ADRIAN0_MEIS folded before Flop (didn't bet)
Seat 5: Warterror90 showed [6c 8c] and lost with high card Ace
Seat 6: cap e'bomb95 folded before Flop (didn't bet)



PokerStars Zoom Hand #257975152929:  Hold'em No Limit (€0.01/€0.02) [ADM ID: M62BA304494E32ST] - 2025/10/02 23:00:19 CET [2025/10/02 17:00:19 ET]
Table 'Sirio' 6-max Seat #1 is the button
Seat 1: lapo1987 (€2 in chips) 
Seat 2: mondie73100 (€2.11 in chips) 
Seat 3: c.ronaldo644 (€2 in chips) 
Seat 4: Oiad (€2 in chips) 
Seat 5: caduceus369 (€1.92 in chips) 
Seat 6: gigiruk91 (€2.86 in chips) 
mondie73100: posts small blind €0.01
c.ronaldo644: posts big blind €0.02
*** HOLE CARDS ***
Dealt to caduceus369 [7h Jd]
Oiad: folds 
caduceus369: folds 
gigiruk91: folds 
lapo1987: folds 
mondie73100: folds 
Uncalled bet (€0.01) returned to c.ronaldo644
c.ronaldo644 collected €0.02 from pot
c.ronaldo644: doesn't show hand 
*** SUMMARY ***
Total pot €0.02 | Rake €0 
Seat 1: lapo1987 (button) folded before Flop (didn't bet)
Seat 2: mondie73100 (small blind) folded before Flop
Seat 3: c.ronaldo644 (big blind) collected (€0.02)
Seat 4: Oiad folded before Flop (didn't bet)
Seat 5: caduceus369 folded before Flop (didn't bet)
Seat 6: gigiruk91 folded before Flop (didn't bet)



PokerStars Zoom Hand #257975151409:  Hold'em No Limit (€0.01/€0.02) [ADM ID: M62BA304494E32ST] - 2025/10/02 23:00:10 CET [2025/10/02 17:00:10 ET]
Table 'Sirio' 6-max Seat #1 is the button
Seat 1: stfuplzudonk (€1.69 in chips) 
Seat 2: gemini1682 (€2.50 in chips) 
Seat 3: fantaasso (€3.05 in chips) 
Seat 4: Oiad (€2 in chips) 
Seat 5: caduceus369 (€1.93 in chips) 
Seat 6: c.ronaldo644 (€2 in chips) 
gemini1682: posts small blind €0.01
fantaasso: posts big blind €0.02
*** HOLE CARDS ***
Dealt to caduceus369 [7s 9c]
Oiad: raises €0.08 to €0.10
caduceus369: folds 
c.ronaldo644: folds 
stfuplzudonk: folds 
gemini1682: folds 
fantaasso: folds 
Uncalled bet (€0.08) returned to Oiad
Oiad collected €0.05 from pot
Oiad: doesn't show hand 
*** SUMMARY ***
Total pot €0.05 | Rake €0 
Seat 1: stfuplzudonk (button) folded before Flop (didn't bet)
Seat 2: gemini1682 (small blind) folded before Flop
Seat 3: fantaasso (big blind) folded before Flop
Seat 4: Oiad collected (€0.05)
Seat 5: caduceus369 folded before Flop (didn't bet)
Seat 6: c.ronaldo644 folded before Flop (didn't bet)



PokerStars Zoom Hand #257975148940:  Hold'em No Limit (€0.01/€0.02) [ADM ID: M62BA304494E32ST] - 2025/10/02 22:59:55 CET [2025/10/02 16:59:55 ET]
Table 'Sirio' 6-max Seat #1 is the button
Seat 1: caduceus369 (€1.93 in chips) 
Seat 2: AntonioKrakka (€0.59 in chips) 
Seat 3: Warterror90 (€4.31 in chips) 
Seat 4: mondie73100 (€2.11 in chips) 
Seat 5: Oiad (€2 in chips) 
Seat 6: fantaasso (€3.05 in chips) 
AntonioKrakka: posts small blind €0.01
Warterror90: posts big blind €0.02
*** HOLE CARDS ***
Dealt to caduceus369 [4c Jc]
mondie73100: folds 
Oiad: folds 
fantaasso: folds 
caduceus369: folds 
AntonioKrakka: calls €0.01
Warterror90: checks 
*** FLOP *** [2d 2c 9d]
AntonioKrakka: checks 
Warterror90: checks 
*** TURN *** [2d 2c 9d] [3h]
AntonioKrakka: checks 
Warterror90: checks 
*** RIVER *** [2d 2c 9d 3h] [Qc]
AntonioKrakka: checks 
Warterror90: checks 
*** SHOW DOWN ***
AntonioKrakka: shows [8c Kd] (a pair of Deuces)
Warterror90: shows [4h Ac] (a pair of Deuces - Ace kicker)
Warterror90 collected €0.04 from pot
*** SUMMARY ***
Total pot €0.04 | Rake €0 
Board [2d 2c 9d 3h Qc]
Seat 1: caduceus369 (button) folded before Flop (didn't bet)
Seat 2: AntonioKrakka (small blind) showed [8c Kd] and lost with a pair of Deuces
Seat 3: Warterror90 (big blind) showed [4h Ac] and won (€0.04) with a pair of Deuces
Seat 4: mondie73100 folded before Flop (didn't bet)
Seat 5: Oiad folded before Flop (didn't bet)
Seat 6: fantaasso folded before Flop (didn't bet)



PokerStars Zoom Hand #257975153647:  Hold'em No Limit (€0.01/€0.02) [ADM ID: M62BA304494E32ST] - 2025/10/02 23:00:23 CET [2025/10/02 17:00:23 ET]
Table 'Sirio' 6-max Seat #1 is the button
Seat 1: mondie73100 (€2.07 in chips) 
Seat 2: Oiad (€2 in chips) 
Seat 3: caduceus369 (€1.92 in chips) 
Seat 4: monsterc99 (€1.65 in chips) 
Seat 5: luchetto1990 (€3.42 in chips) 
Seat 6: Mimmuzzi89 (€1.51 in chips) 
Oiad: posts small blind €0.01
caduceus369: posts big blind €0.02
*** HOLE CARDS ***
Dealt to caduceus369 [Ks Js]
monsterc99: folds 
luchetto1990: raises €0.04 to €0.06
Mimmuzzi89: calls €0.06
mondie73100: folds 
Oiad: folds 
caduceus369: calls €0.04
*** FLOP *** [Ad 9d 7s]
caduceus369: checks 
luchetto1990: bets €0.14
Mimmuzzi89: folds 
caduceus369: folds 
Uncalled bet (€0.14) returned to luchetto1990
luchetto1990 collected €0.18 from pot
luchetto1990: doesn't show hand 
*** SUMMARY ***
Total pot €0.19 | Rake €0.01 
Board [Ad 9d 7s]
Seat 1: mondie73100 (button) folded before Flop (didn't bet)
Seat 2: Oiad (small blind) folded before Flop
Seat 3: caduceus369 (big blind) folded on the Flop
Seat 4: monsterc99 folded before Flop (didn't bet)
Seat 5: luchetto1990 collected (€0.18)
Seat 6: Mimmuzzi89 folded on the Flop



PokerStars Zoom Hand #257975150398:  Hold'em No Limit (€0.01/€0.02) [ADM ID: M62BA304494E32ST] - 2025/10/02 23:00:04 CET [2025/10/02 17:00:04 ET]
Table 'Sirio' 6-max Seat #1 is the button
Seat 1: pistaKKio23 (€2.24 in chips) 
Seat 2: gigiruk91 (€2.87 in chips) 
Seat 3: rush572 (€0.30 in chips) 
Seat 4: father2008 (€3.82 in chips) 
Seat 5: fantaasso (€3.05 in chips) 
Seat 6: caduceus369 (€1.93 in chips) 
gigiruk91: posts small blind €0.01
rush572: posts big blind €0.02
*** HOLE CARDS ***
Dealt to caduceus369 [5h 6d]
father2008: raises €0.05 to €0.07
fantaasso: folds 
caduceus369: folds 
pistaKKio23: calls €0.07
gigiruk91: folds 
rush572: folds 
*** FLOP *** [4s Tc Jd]
father2008: bets €0.10
pistaKKio23: calls €0.10
*** TURN *** [4s Tc Jd] [2h]
father2008: checks 
pistaKKio23: bets €0.18
father2008: calls €0.18
*** RIVER *** [4s Tc Jd 2h] [3s]
father2008: checks 
pistaKKio23: checks 
*** SHOW DOWN ***
father2008: shows [Jh Ad] (a pair of Jacks)
pistaKKio23: mucks hand 
father2008 collected €0.69 from pot
*** SUMMARY ***
Total pot €0.73 | Rake €0.04 
Board [4s Tc Jd 2h 3s]
Seat 1: pistaKKio23 (button) mucked [Ks Ts]
Seat 2: gigiruk91 (small blind) folded before Flop
Seat 3: rush572 (big blind) folded before Flop
Seat 4: father2008 showed [Jh Ad] and won (€0.69) with a pair of Jacks
Seat 5: fantaasso folded before Flop (didn't bet)
Seat 6: caduceus369 folded before Flop (didn't bet)



PokerStars Zoom Hand #257975152062:  Hold'em No Limit (€0.01/€0.02) [ADM ID: M62BA304494E32ST] - 2025/10/02 23:00:14 CET [2025/10/02 17:00:14 ET]
Table 'Sirio' 6-max Seat #1 is the button
Seat 1: ADRIAN0_MEIS (€2.23 in chips) 
Seat 2: caduceus369 (€1.93 in chips) 
Seat 3: Lizi855 (€0.94 in chips) 
Seat 4: jackkk03 (€3.40 in chips) 
Seat 5: DANYXXX86 (€1.51 in chips) 
Seat 6: gemini1682 (€2.49 in chips) 
caduceus369: posts small blind €0.01
Lizi855: posts big blind €0.02
*** HOLE CARDS ***
Dealt to caduceus369 [8h 3s]
jackkk03: folds 
DANYXXX86: calls €0.02
gemini1682: folds 
ADRIAN0_MEIS: folds 
caduceus369: folds 
Lizi855: checks 
*** FLOP *** [Jd Qc Ts]
Lizi855: checks 
DANYXXX86: bets €0.02
Lizi855: calls €0.02
*** TURN *** [Jd Qc Ts] [9s]
Lizi855: checks 
DANYXXX86: bets €0.02
Lizi855: calls €0.02
*** RIVER *** [Jd Qc Ts 9s] [9h]
Lizi855: bets €0.02
DANYXXX86: raises €0.18 to €0.20
Lizi855: folds 
Uncalled bet (€0.18) returned to DANYXXX86
DANYXXX86 collected €0.17 from pot
DANYXXX86: doesn't show hand 
*** SUMMARY ***
Total pot €0.17 | Rake €0 
Board [Jd Qc Ts 9s 9h]
Seat 1: ADRIAN0_MEIS (button) folded before Flop (didn't bet)
Seat 2: caduceus369 (small blind) folded before Flop
Seat 3: Lizi855 (big blind) folded on the River
Seat 4: jackkk03 folded before Flop (didn't bet)
Seat 5: DANYXXX86 collected (€0.17)
Seat 6: gemini1682 folded before Flop (didn't bet)



PokerStars Zoom Hand #257975161583:  Hold'em No Limit (€0.01/€0.02) [ADM ID: M62BA304494E32ST] - 2025/10/02 23:01:05 CET [2025/10/02 17:01:05 ET]
Table 'Sirio' 6-max Seat #1 is the button
Seat 1: luchetto1990 (€3.54 in chips) 
Seat 2: Giuggiola64 (€3.31 in chips) 
Seat 3: father2008 (€4.16 in chips) 
Seat 4: Warterror90 (€4.32 in chips) 
Seat 5: balai72 (€0.83 in chips) 
Seat 6: caduceus369 (€1.86 in chips) 
Giuggiola64: posts small blind €0.01
father2008: posts big blind €0.02
*** HOLE CARDS ***
Dealt to caduceus369 [Jc 9s]
Warterror90: raises €0.04 to €0.06
balai72: folds 
caduceus369: folds 
luchetto1990: folds 
Giuggiola64: calls €0.05
father2008: folds 
*** FLOP *** [Jd 3d 2d]
Giuggiola64: checks 
Warterror90: bets €0.06
Giuggiola64: calls €0.06
*** TURN *** [Jd 3d 2d] [6h]
Giuggiola64: checks 
Warterror90: bets €0.08
Giuggiola64: calls €0.08
*** RIVER *** [Jd 3d 2d 6h] [2h]
Giuggiola64: checks 
Warterror90: checks 
*** SHOW DOWN ***
Giuggiola64: shows [Jh Td] (two pair, Jacks and Deuces)
Warterror90: mucks hand 
Giuggiola64 collected €0.40 from pot
*** SUMMARY ***
Total pot €0.42 | Rake €0.02 
Board [Jd 3d 2d 6h 2h]
Seat 1: luchetto1990 (button) folded before Flop (didn't bet)
Seat 2: Giuggiola64 (small blind) showed [Jh Td] and won (€0.40) with two pair, Jacks and Deuces
Seat 3: father2008 (big blind) folded before Flop
Seat 4: Warterror90 mucked [7s Ad]
Seat 5: balai72 folded before Flop (didn't bet)
Seat 6: caduceus369 folded before Flop (didn't bet)



PokerStars Zoom Hand #257975162790:  Hold'em No Limit (€0.01/€0.02) [ADM ID: M62BA304494E32ST] - 2025/10/02 23:01:12 CET [2025/10/02 17:01:12 ET]
Table 'Sirio' 6-max Seat #1 is the button
Seat 1: Lizi855 (€0.86 in chips) 
Seat 2: stfuplzudonk (€1.84 in chips) 
Seat 3: caduceus369 (€1.86 in chips) 
Seat 4: AntonioKrakka (€2.95 in chips) 
Seat 5: Nicoirca2004 (€1.92 in chips) 
Seat 6: ADRIAN0_MEIS (€4.21 in chips) 
stfuplzudonk: posts small blind €0.01
caduceus369: posts big blind €0.02
*** HOLE CARDS ***
Dealt to caduceus369 [Kc 6s]
AntonioKrakka: folds 
Nicoirca2004: folds 
ADRIAN0_MEIS: folds 
Lizi855: folds 
stfuplzudonk: calls €0.01
caduceus369: checks 
*** FLOP *** [4d 8s 6c]
stfuplzudonk: checks 
caduceus369: checks 
*** TURN *** [4d 8s 6c] [4s]
stfuplzudonk: checks 
caduceus369: bets €0.02
stfuplzudonk: folds 
Uncalled bet (€0.02) returned to caduceus369
caduceus369 collected €0.04 from pot
caduceus369: doesn't show hand 
*** SUMMARY ***
Total pot €0.04 | Rake €0 
Board [4d 8s 6c 4s]
Seat 1: Lizi855 (button) folded before Flop (didn't bet)
Seat 2: stfuplzudonk (small blind) folded on the Turn
Seat 3: caduceus369 (big blind) collected (€0.04)
Seat 4: AntonioKrakka folded before Flop (didn't bet)
Seat 5: Nicoirca2004 folded before Flop (didn't bet)
Seat 6: ADRIAN0_MEIS folded before Flop (didn't bet)



PokerStars Zoom Hand #257975160240:  Hold'em No Limit (€0.01/€0.02) [ADM ID: M62BA304494E32ST] - 2025/10/02 23:00:59 CET [2025/10/02 17:00:59 ET]
Table 'Sirio' 6-max Seat #1 is the button
Seat 1: Catania838 (€1.70 in chips) 
Seat 2: amandaknox (€2.46 in chips) 
Seat 3: Nicoirca2004 (€1.95 in chips) 
Seat 4: caduceus369 (€1.86 in chips) 
Seat 5: Kingo690 (€1.66 in chips) 
Seat 6: mondie73100 (€2 in chips) 
amandaknox: posts small blind €0.01
Nicoirca2004: posts big blind €0.02
*** HOLE CARDS ***
Dealt to caduceus369 [2s 9s]
caduceus369: folds 
Kingo690: raises €0.04 to €0.06
mondie73100: folds 
Catania838: folds 
amandaknox: calls €0.05
Nicoirca2004: folds 
*** FLOP *** [Ad Js 4d]
amandaknox: checks 
Kingo690: bets €0.14
amandaknox: raises €0.23 to €0.37
Kingo690: calls €0.23
*** TURN *** [Ad Js 4d] [7h]
amandaknox: bets €2.03 and is all-in
Kingo690: folds 
Uncalled bet (€2.03) returned to amandaknox
amandaknox collected €0.84 from pot
amandaknox: doesn't show hand 
*** SUMMARY ***
Total pot €0.88 | Rake €0.04 
Board [Ad Js 4d 7h]
Seat 1: Catania838 (button) folded before Flop (didn't bet)
Seat 2: amandaknox (small blind) collected (€0.84)
Seat 3: Nicoirca2004 (big blind) folded before Flop
Seat 4: caduceus369 folded before Flop (didn't bet)
Seat 5: Kingo690 folded on the Turn
Seat 6: mondie73100 folded before Flop (didn't bet)



PokerStars Zoom Hand #257975170221:  Hold'em No Limit (€0.01/€0.02) [ADM ID: M62BA304494E32ST] - 2025/10/02 23:01:45 CET [2025/10/02 17:01:45 ET]
Table 'Sirio' 6-max Seat #1 is the button
Seat 1: stfuplzudonk (€1.82 in chips) 
Seat 2: caduceus369 (€1.88 in chips) 
Seat 3: Kingo690 (€1.23 in chips) 
Seat 4: gigiruk91 (€5.06 in chips) 
Seat 5: VagALiss (€1.97 in chips) 
Seat 6: pistaKKio23 (€1.90 in chips) 
caduceus369: posts small blind €0.01
Kingo690: posts big blind €0.02
*** HOLE CARDS ***
Dealt to caduceus369 [9c 2s]
gigiruk91: folds 
VagALiss: folds 
pistaKKio23: folds 
stfuplzudonk: folds 
caduceus369: folds 
Uncalled bet (€0.01) returned to Kingo690
Kingo690 collected €0.02 from pot
Kingo690: doesn't show hand 
*** SUMMARY ***
Total pot €0.02 | Rake €0 
Seat 1: stfuplzudonk (button) folded before Flop (didn't bet)
Seat 2: caduceus369 (small blind) folded before Flop
Seat 3: Kingo690 (big blind) collected (€0.02)
Seat 4: gigiruk91 folded before Flop (didn't bet)
Seat 5: VagALiss folded before Flop (didn't bet)
Seat 6: pistaKKio23 folded before Flop (didn't bet)



PokerStars Zoom Hand #257975171797:  Hold'em No Limit (€0.01/€0.02) [ADM ID: M62BA304494E32ST] - 2025/10/02 23:01:53 CET [2025/10/02 17:01:53 ET]
Table 'Sirio' 6-max Seat #1 is the button
Seat 1: caduceus369 (€1.87 in chips) 
Seat 2: sancarlo18 (€2.29 in chips) 
Seat 3: AntonioKrakka (€3.37 in chips) 
Seat 4: Nicoirca2004 (€1.98 in chips) 
Seat 5: mondie73100 (€2.16 in chips) 
Seat 6: 19HinciaBS79 (€2.21 in chips) 
sancarlo18: posts small blind €0.01
AntonioKrakka: posts big blind €0.02
*** HOLE CARDS ***
Dealt to caduceus369 [6h 2s]
Nicoirca2004: folds 
mondie73100: folds 
19HinciaBS79: folds 
caduceus369: folds 
sancarlo18: calls €0.01
AntonioKrakka: checks 
*** FLOP *** [7d 4c 7h]
sancarlo18: checks 
AntonioKrakka: checks 
*** TURN *** [7d 4c 7h] [9d]
sancarlo18: checks 
AntonioKrakka: checks 
*** RIVER *** [7d 4c 7h 9d] [Qd]
sancarlo18: checks 
AntonioKrakka: checks 
*** SHOW DOWN ***
sancarlo18: shows [6c Ah] (a pair of Sevens)
AntonioKrakka: mucks hand 
sancarlo18 collected €0.04 from pot
*** SUMMARY ***
Total pot €0.04 | Rake €0 
Board [7d 4c 7h 9d Qd]
Seat 1: caduceus369 (button) folded before Flop (didn't bet)
Seat 2: sancarlo18 (small blind) showed [6c Ah] and won (€0.04) with a pair of Sevens
Seat 3: AntonioKrakka (big blind) mucked [8c Jd]
Seat 4: Nicoirca2004 folded before Flop (didn't bet)
Seat 5: mondie73100 folded before Flop (didn't bet)
Seat 6: 19HinciaBS79 folded before Flop (didn't bet)



PokerStars Zoom Hand #257975175206:  Hold'em No Limit (€0.01/€0.02) [ADM ID: M62BA304494E32ST] - 2025/10/02 23:02:07 CET [2025/10/02 17:02:07 ET]
Table 'Sirio' 6-max Seat #1 is the button
Seat 1: gemini1682 (€2.41 in chips) 
Seat 2: jackkk03 (€3.27 in chips) 
Seat 3: gigiruk91 (€5.09 in chips) 
Seat 4: lapo1987 (€2.03 in chips) 
Seat 5: caduceus369 (€1.87 in chips) 
Seat 6: AntonioKrakka (€3.07 in chips) 
jackkk03: posts small blind €0.01
gigiruk91: posts big blind €0.02
*** HOLE CARDS ***
Dealt to caduceus369 [Qc Ac]
lapo1987: folds 
caduceus369: raises €0.02 to €0.04
AntonioKrakka: folds 
gemini1682: folds 
jackkk03: calls €0.03
gigiruk91: folds 
*** FLOP *** [Kd 6d Kc]
jackkk03: checks 
caduceus369: bets €0.04
jackkk03: folds 
Uncalled bet (€0.04) returned to caduceus369
caduceus369 collected €0.10 from pot
caduceus369: doesn't show hand 
*** SUMMARY ***
Total pot €0.10 | Rake €0 
Board [Kd 6d Kc]
Seat 1: gemini1682 (button) folded before Flop (didn't bet)
Seat 2: jackkk03 (small blind) folded on the Flop
Seat 3: gigiruk91 (big blind) folded before Flop
Seat 4: lapo1987 folded before Flop (didn't bet)
Seat 5: caduceus369 collected (€0.10)
Seat 6: AntonioKrakka folded before Flop (didn't bet)



PokerStars Zoom Hand #257975173400:  Hold'em No Limit (€0.01/€0.02) [ADM ID: M62BA304494E32ST] - 2025/10/02 23:01:59 CET [2025/10/02 17:01:59 ET]
Table 'Sirio' 6-max Seat #1 is the button
Seat 1: Oiad (€3.03 in chips) 
Seat 2: Catania838 (€1.75 in chips) 
Seat 3: pistaKKio23 (€1.90 in chips) 
Seat 4: caduceus369 (€1.87 in chips) 
Seat 5: stfuplzudonk (€1.82 in chips) 
Seat 6: TripInter (€1.18 in chips) 
Catania838: posts small blind €0.01
pistaKKio23: posts big blind €0.02
*** HOLE CARDS ***
Dealt to caduceus369 [4s 3d]
caduceus369: folds 
stfuplzudonk: folds 
TripInter: calls €0.02
Oiad: raises €0.08 to €0.10
Catania838: folds 
pistaKKio23: folds 
TripInter: calls €0.08
*** FLOP *** [3c Kh Kc]
TripInter: bets €0.02
Oiad: calls €0.02
*** TURN *** [3c Kh Kc] [5s]
TripInter: bets €0.02
Oiad: calls €0.02
*** RIVER *** [3c Kh Kc 5s] [8d]
TripInter: bets €0.02
Oiad: raises €1.02 to €1.04
TripInter: folds 
Uncalled bet (€1.02) returned to Oiad
Oiad collected €0.34 from pot
Oiad: doesn't show hand 
*** SUMMARY ***
Total pot €0.35 | Rake €0.01 
Board [3c Kh Kc 5s 8d]
Seat 1: Oiad (button) collected (€0.34)
Seat 2: Catania838 (small blind) folded before Flop
Seat 3: pistaKKio23 (big blind) folded before Flop
Seat 4: caduceus369 folded before Flop (didn't bet)
Seat 5: stfuplzudonk folded before Flop (didn't bet)
Seat 6: TripInter folded on the River



PokerStars Zoom Hand #257975181743:  Hold'em No Limit (€0.01/€0.02) [ADM ID: M62BA304494E32ST] - 2025/10/02 23:02:36 CET [2025/10/02 17:02:36 ET]
Table 'Sirio' 6-max Seat #1 is the button
Seat 1: lapo1987 (€2.14 in chips) 
Seat 2: gigiruk91 (€2.72 in chips) 
Seat 3: cap e'bomb95 (€2 in chips) 
Seat 4: caduceus369 (€1.93 in chips) 
Seat 5: fantaasso (€1.45 in chips) 
Seat 6: father2008 (€3.36 in chips) 
gigiruk91: posts small blind €0.01
cap e'bomb95: posts big blind €0.02
*** HOLE CARDS ***
Dealt to caduceus369 [Ad 9d]
caduceus369: raises €0.02 to €0.04
fantaasso: folds 
father2008: folds 
lapo1987: folds 
gigiruk91: folds 
cap e'bomb95: folds 
Uncalled bet (€0.02) returned to caduceus369
caduceus369 collected €0.05 from pot
caduceus369: doesn't show hand 
*** SUMMARY ***
Total pot €0.05 | Rake €0 
Seat 1: lapo1987 (button) folded before Flop (didn't bet)
Seat 2: gigiruk91 (small blind) folded before Flop
Seat 3: cap e'bomb95 (big blind) folded before Flop
Seat 4: caduceus369 collected (€0.05)
Seat 5: fantaasso folded before Flop (didn't bet)
Seat 6: father2008 folded before Flop (didn't bet)



PokerStars Zoom Hand #257975186935:  Hold'em No Limit (€0.01/€0.02) [ADM ID: M62BA304494E32ST] - 2025/10/02 23:02:56 CET [2025/10/02 17:02:56 ET]
Table 'Sirio' 6-max Seat #1 is the button
Seat 1: stfuplzudonk (€1.70 in chips) 
Seat 2: caduceus369 (€1.96 in chips) 
Seat 3: TripInter (€1.02 in chips) 
Seat 4: pistaKKio23 (€2.45 in chips) 
Seat 5: Oiad (€3.21 in chips) 
Seat 6: ADRIAN0_MEIS (€6.95 in chips) 
caduceus369: posts small blind €0.01
TripInter: posts big blind €0.02
*** HOLE CARDS ***
Dealt to caduceus369 [Ad 7h]
pistaKKio23: folds 
Oiad: folds 
ADRIAN0_MEIS: folds 
stfuplzudonk: raises €0.02 to €0.04
caduceus369: folds 
TripInter: folds 
Uncalled bet (€0.02) returned to stfuplzudonk
stfuplzudonk collected €0.05 from pot
stfuplzudonk: doesn't show hand 
*** SUMMARY ***
Total pot €0.05 | Rake €0 
Seat 1: stfuplzudonk (button) collected (€0.05)
Seat 2: caduceus369 (small blind) folded before Flop
Seat 3: TripInter (big blind) folded before Flop
Seat 4: pistaKKio23 folded before Flop (didn't bet)
Seat 5: Oiad folded before Flop (didn't bet)
Seat 6: ADRIAN0_MEIS folded before Flop (didn't bet)



PokerStars Zoom Hand #257975192086:  Hold'em No Limit (€0.01/€0.02) [ADM ID: M62BA304494E32ST] - 2025/10/02 23:03:18 CET [2025/10/02 17:03:18 ET]
Table 'Sirio' 6-max Seat #1 is the button
Seat 1: Warterror90 (€4.37 in chips) 
Seat 2: pistaKKio23 (€1.93 in chips) 
Seat 3: caduceus369 (€1.95 in chips) 
Seat 4: babanotop (€2.20 in chips) 
Seat 5: gigiruk91 (€2.69 in chips) 
Seat 6: father2008 (€4.59 in chips) 
pistaKKio23: posts small blind €0.01
caduceus369: posts big blind €0.02
*** HOLE CARDS ***
Dealt to caduceus369 [Ts 6h]
babanotop: folds 
gigiruk91: folds 
father2008: folds 
Warterror90: raises €0.04 to €0.06
pistaKKio23: folds 
caduceus369: folds 
Uncalled bet (€0.04) returned to Warterror90
Warterror90 collected €0.05 from pot
Warterror90: doesn't show hand 
*** SUMMARY ***
Total pot €0.05 | Rake €0 
Seat 1: Warterror90 (button) collected (€0.05)
Seat 2: pistaKKio23 (small blind) folded before Flop
Seat 3: caduceus369 (big blind) folded before Flop
Seat 4: babanotop folded before Flop (didn't bet)
Seat 5: gigiruk91 folded before Flop (didn't bet)
Seat 6: father2008 folded before Flop (didn't bet)



PokerStars Zoom Hand #257975194861:  Hold'em No Limit (€0.01/€0.02) [ADM ID: M62BA304494E32ST] - 2025/10/02 23:03:29 CET [2025/10/02 17:03:29 ET]
Table 'Sirio' 6-max Seat #1 is the button
Seat 1: caduceus369 (€1.93 in chips) 
Seat 2: Giuggiola64 (€3.34 in chips) 
Seat 3: pistaKKio23 (€1.87 in chips) 
Seat 4: cap e'bomb95 (€2.05 in chips) 
Seat 5: lapo1987 (€2 in chips) 
Seat 6: Catania838 (€3.16 in chips) 
Giuggiola64: posts small blind €0.01
pistaKKio23: posts big blind €0.02
*** HOLE CARDS ***
Dealt to caduceus369 [2h 9h]
cap e'bomb95: folds 
lapo1987: folds 
Catania838: folds 
caduceus369: folds 
Giuggiola64: folds 
Uncalled bet (€0.01) returned to pistaKKio23
pistaKKio23 collected €0.02 from pot
pistaKKio23: doesn't show hand 
*** SUMMARY ***
Total pot €0.02 | Rake €0 
Seat 1: caduceus369 (button) folded before Flop (didn't bet)
Seat 2: Giuggiola64 (small blind) folded before Flop
Seat 3: pistaKKio23 (big blind) collected (€0.02)
Seat 4: cap e'bomb95 folded before Flop (didn't bet)
Seat 5: lapo1987 folded before Flop (didn't bet)
Seat 6: Catania838 folded before Flop (didn't bet)



PokerStars Zoom Hand #257975196157:  Hold'em No Limit (€0.01/€0.02) [ADM ID: M62BA304494E32ST] - 2025/10/02 23:03:35 CET [2025/10/02 17:03:35 ET]
Table 'Sirio' 6-max Seat #1 is the button
Seat 1: ADRIAN0_MEIS (€6.95 in chips) 
Seat 2: kolain17 (€0.85 in chips) 
Seat 3: AntonioKrakka (€3.28 in chips) 
Seat 4: mondie73100 (€2.58 in chips) 
Seat 5: lapo1987 (€2 in chips) 
Seat 6: caduceus369 (€1.93 in chips) 
kolain17: posts small blind €0.01
AntonioKrakka: posts big blind €0.02
*** HOLE CARDS ***
Dealt to caduceus369 [6c 6s]
mondie73100: folds 
lapo1987: folds 
caduceus369: calls €0.02
ADRIAN0_MEIS: raises €0.07 to €0.09
kolain17: raises €0.35 to €0.44
AntonioKrakka: folds 
caduceus369: folds 
ADRIAN0_MEIS: folds 
Uncalled bet (€0.35) returned to kolain17
kolain17 collected €0.22 from pot
kolain17: doesn't show hand 
*** SUMMARY ***
Total pot €0.22 | Rake €0 
Seat 1: ADRIAN0_MEIS (button) folded before Flop
Seat 2: kolain17 (small blind) collected (€0.22)
Seat 3: AntonioKrakka (big blind) folded before Flop
Seat 4: mondie73100 folded before Flop (didn't bet)
Seat 5: lapo1987 folded before Flop (didn't bet)
Seat 6: caduceus369 folded before Flop



PokerStars Zoom Hand #257975200946:  Hold'em No Limit (€0.01/€0.02) [ADM ID: M62BA304494E32ST] - 2025/10/02 23:03:54 CET [2025/10/02 17:03:54 ET]
Table 'Sirio' 6-max Seat #1 is the button
Seat 1: monsterc99 (€1.55 in chips) 
Seat 2: pistaKKio23 (€1.81 in chips) 
Seat 3: stfuplzudonk (€1.47 in chips) 
Seat 4: mondie73100 (€2.11 in chips) 
Seat 5: caduceus369 (€1.91 in chips) 
Seat 6: diesel197474 (€1.76 in chips) 
pistaKKio23: posts small blind €0.01
stfuplzudonk: posts big blind €0.02
*** HOLE CARDS ***
Dealt to caduceus369 [5h 8d]
mondie73100: folds 
caduceus369: folds 
diesel197474: folds 
monsterc99: folds 
pistaKKio23: folds 
Uncalled bet (€0.01) returned to stfuplzudonk
stfuplzudonk collected €0.02 from pot
stfuplzudonk: doesn't show hand 
*** SUMMARY ***
Total pot €0.02 | Rake €0 
Seat 1: monsterc99 (button) folded before Flop (didn't bet)
Seat 2: pistaKKio23 (small blind) folded before Flop
Seat 3: stfuplzudonk (big blind) collected (€0.02)
Seat 4: mondie73100 folded before Flop (didn't bet)
Seat 5: caduceus369 folded before Flop (didn't bet)
Seat 6: diesel197474 folded before Flop (didn't bet)



PokerStars Zoom Hand #257975202119:  Hold'em No Limit (€0.01/€0.02) [ADM ID: M62BA304494E32ST] - 2025/10/02 23:03:59 CET [2025/10/02 17:03:59 ET]
Table 'Sirio' 6-max Seat #1 is the button
Seat 1: ADRIAN0_MEIS (€2.91 in chips) 
Seat 2: AntonioKrakka (€3.26 in chips) 
Seat 3: gigiruk91 (€4.35 in chips) 
Seat 4: muhozhuk788 (€1.65 in chips) 
Seat 5: kroll219 (€0.61 in chips) 
Seat 6: caduceus369 (€1.91 in chips) 
AntonioKrakka: posts small blind €0.01
gigiruk91: posts big blind €0.02
*** HOLE CARDS ***
Dealt to caduceus369 [5d 9s]
muhozhuk788: raises €0.02 to €0.04
kroll219: folds 
caduceus369: folds 
ADRIAN0_MEIS: folds 
AntonioKrakka: calls €0.03
gigiruk91: folds 
*** FLOP *** [Jh Th 2d]
AntonioKrakka: bets €0.10
muhozhuk788: calls €0.10
*** TURN *** [Jh Th 2d] [6c]
AntonioKrakka: checks 
muhozhuk788: bets €0.18
AntonioKrakka: calls €0.18
*** RIVER *** [Jh Th 2d 6c] [Ks]
AntonioKrakka: checks 
muhozhuk788: checks 
*** SHOW DOWN ***
AntonioKrakka: shows [9d 8c] (high card King)
muhozhuk788: shows [Jc Ac] (a pair of Jacks)
muhozhuk788 collected €0.63 from pot
*** SUMMARY ***
Total pot €0.66 | Rake €0.03 
Board [Jh Th 2d 6c Ks]
Seat 1: ADRIAN0_MEIS (button) folded before Flop (didn't bet)
Seat 2: AntonioKrakka (small blind) showed [9d 8c] and lost with high card King
Seat 3: gigiruk91 (big blind) folded before Flop
Seat 4: muhozhuk788 showed [Jc Ac] and won (€0.63) with a pair of Jacks
Seat 5: kroll219 folded before Flop (didn't bet)
Seat 6: caduceus369 folded before Flop (didn't bet)



PokerStars Zoom Hand #257975203140:  Hold'em No Limit (€0.01/€0.02) [ADM ID: M62BA304494E32ST] - 2025/10/02 23:04:03 CET [2025/10/02 17:04:03 ET]
Table 'Sirio' 6-max Seat #1 is the button
Seat 1: rush572 (€0.24 in chips) 
Seat 2: caduceus369 (€1.91 in chips) 
Seat 3: kroll219 (€0.61 in chips) 
Seat 4: fantaasso (€1.44 in chips) 
Seat 5: cap e'bomb95 (€4.03 in chips) 
Seat 6: AntonioKrakka (€0.38 in chips) 
caduceus369: posts small blind €0.01
kroll219: posts big blind €0.02
*** HOLE CARDS ***
Dealt to caduceus369 [5s Ac]
fantaasso: folds 
cap e'bomb95: folds 
AntonioKrakka: folds 
rush572: folds 
caduceus369: calls €0.01
kroll219: checks 
*** FLOP *** [Ad 2c 8h]
caduceus369: checks 
kroll219: checks 
*** TURN *** [Ad 2c 8h] [7h]
caduceus369: checks 
kroll219: checks 
*** RIVER *** [Ad 2c 8h 7h] [Kc]
caduceus369: bets €0.02
kroll219: folds 
Uncalled bet (€0.02) returned to caduceus369
caduceus369 collected €0.04 from pot
caduceus369: doesn't show hand 
*** SUMMARY ***
Total pot €0.04 | Rake €0 
Board [Ad 2c 8h 7h Kc]
Seat 1: rush572 (button) folded before Flop (didn't bet)
Seat 2: caduceus369 (small blind) collected (€0.04)
Seat 3: kroll219 (big blind) folded on the River
Seat 4: fantaasso folded before Flop (didn't bet)
Seat 5: cap e'bomb95 folded before Flop (didn't bet)
Seat 6: AntonioKrakka folded before Flop (didn't bet)



PokerStars Zoom Hand #257975213694:  Hold'em No Limit (€0.01/€0.02) [ADM ID: M62BA304494E32ST] - 2025/10/02 23:04:46 CET [2025/10/02 17:04:46 ET]
Table 'Sirio' 6-max Seat #1 is the button
Seat 1: Gabrielefante (€4.95 in chips) 
Seat 2: TripInter (€1.11 in chips) 
Seat 3: caduceus369 (€1.93 in chips) 
Seat 4: stfuplzudonk (€1.47 in chips) 
Seat 5: sancarlo18 (€2.20 in chips) 
Seat 6: 7mosigillo (€1.96 in chips) 
TripInter: posts small blind €0.01
caduceus369: posts big blind €0.02
*** HOLE CARDS ***
Dealt to caduceus369 [Ks 9s]
stfuplzudonk: folds 
sancarlo18: folds 
7mosigillo: folds 
Gabrielefante: folds 
TripInter: folds 
Uncalled bet (€0.01) returned to caduceus369
caduceus369 collected €0.02 from pot
caduceus369: doesn't show hand 
*** SUMMARY ***
Total pot €0.02 | Rake €0 
Seat 1: Gabrielefante (button) folded before Flop (didn't bet)
Seat 2: TripInter (small blind) folded before Flop
Seat 3: caduceus369 (big blind) collected (€0.02)
Seat 4: stfuplzudonk folded before Flop (didn't bet)
Seat 5: sancarlo18 folded before Flop (didn't bet)
Seat 6: 7mosigillo folded before Flop (didn't bet)



PokerStars Zoom Hand #257975216536:  Hold'em No Limit (€0.01/€0.02) [ADM ID: M62BA304494E32ST] - 2025/10/02 23:04:58 CET [2025/10/02 17:04:58 ET]
Table 'Sirio' 6-max Seat #1 is the button
Seat 1: caduceus369 (€1.94 in chips) 
Seat 2: gigiruk91 (€4.33 in chips) 
Seat 3: kolain17 (€1.09 in chips) 
Seat 4: babanotop (€2.47 in chips) 
Seat 5: pistaKKio23 (€2.63 in chips) 
Seat 6: Giuggiola64 (€3.16 in chips) 
gigiruk91: posts small blind €0.01
kolain17: posts big blind €0.02
*** HOLE CARDS ***
Dealt to caduceus369 [4s 5s]
babanotop: folds 
pistaKKio23: folds 
Giuggiola64: folds 
caduceus369: folds 
gigiruk91: raises €0.02 to €0.04
kolain17: calls €0.02
*** FLOP *** [Qc Qh 8s]
gigiruk91: checks 
kolain17: checks 
*** TURN *** [Qc Qh 8s] [Ks]
gigiruk91: bets €0.04
kolain17: raises €0.04 to €0.08
gigiruk91: folds 
Uncalled bet (€0.04) returned to kolain17
kolain17 collected €0.16 from pot
kolain17: doesn't show hand 
*** SUMMARY ***
Total pot €0.16 | Rake €0 
Board [Qc Qh 8s Ks]
Seat 1: caduceus369 (button) folded before Flop (didn't bet)
Seat 2: gigiruk91 (small blind) folded on the Turn
Seat 3: kolain17 (big blind) collected (€0.16)
Seat 4: babanotop folded before Flop (didn't bet)
Seat 5: pistaKKio23 folded before Flop (didn't bet)
Seat 6: Giuggiola64 folded before Flop (didn't bet)



PokerStars Zoom Hand #257975222515:  Hold'em No Limit (€0.01/€0.02) [ADM ID: M62BA304494E32ST] - 2025/10/02 23:05:22 CET [2025/10/02 17:05:22 ET]
Table 'Sirio' 6-max Seat #1 is the button
Seat 1: stfuplzudonk (€1.61 in chips) 
Seat 2: caduceus369 (€1.94 in chips) 
Seat 3: lapo1987 (€2 in chips) 
Seat 4: Giuggiola64 (€3.18 in chips) 
Seat 5: gigiruk91 (€5.03 in chips) 
Seat 6: fantaasso (€2.77 in chips) 
caduceus369: posts small blind €0.01
lapo1987: posts big blind €0.02
*** HOLE CARDS ***
Dealt to caduceus369 [7d 5d]
Giuggiola64: folds 
gigiruk91: folds 
fantaasso: folds 
stfuplzudonk: folds 
caduceus369: folds 
Uncalled bet (€0.01) returned to lapo1987
lapo1987 collected €0.02 from pot
lapo1987: doesn't show hand 
*** SUMMARY ***
Total pot €0.02 | Rake €0 
Seat 1: stfuplzudonk (button) folded before Flop (didn't bet)
Seat 2: caduceus369 (small blind) folded before Flop
Seat 3: lapo1987 (big blind) collected (€0.02)
Seat 4: Giuggiola64 folded before Flop (didn't bet)
Seat 5: gigiruk91 folded before Flop (didn't bet)
Seat 6: fantaasso folded before Flop (didn't bet)



PokerStars Zoom Hand #257975224379:  Hold'em No Limit (€0.01/€0.02) [ADM ID: M62BA304494E32ST] - 2025/10/02 23:05:30 CET [2025/10/02 17:05:30 ET]
Table 'Sirio' 6-max Seat #1 is the button
Seat 1: caduceus369 (€1.93 in chips) 
Seat 2: Warterror90 (€7.25 in chips) 
Seat 3: pistaKKio23 (€2.63 in chips) 
Seat 4: ADRIAN0_MEIS (€4.10 in chips) 
Seat 5: AlfredP80 (€3.18 in chips) 
Seat 6: Oiad (€3.24 in chips) 
Warterror90: posts small blind €0.01
pistaKKio23: posts big blind €0.02
*** HOLE CARDS ***
Dealt to caduceus369 [As 9h]
ADRIAN0_MEIS: folds 
AlfredP80: folds 
Oiad: folds 
caduceus369: folds 
Warterror90: raises €0.04 to €0.06
pistaKKio23: folds 
Uncalled bet (€0.04) returned to Warterror90
Warterror90 collected €0.04 from pot
Warterror90: doesn't show hand 
*** SUMMARY ***
Total pot €0.04 | Rake €0 
Seat 1: caduceus369 (button) folded before Flop (didn't bet)
Seat 2: Warterror90 (small blind) collected (€0.04)
Seat 3: pistaKKio23 (big blind) folded before Flop
Seat 4: ADRIAN0_MEIS folded before Flop (didn't bet)
Seat 5: AlfredP80 folded before Flop (didn't bet)
Seat 6: Oiad folded before Flop (didn't bet)



PokerStars Zoom Hand #257975220423:  Hold'em No Limit (€0.01/€0.02) [ADM ID: M62BA304494E32ST] - 2025/10/02 23:05:14 CET [2025/10/02 17:05:14 ET]
Table 'Sirio' 6-max Seat #1 is the button
Seat 1: AlfredP80 (€3.18 in chips) 
Seat 2: wilsson1974 (€0.76 in chips) 
Seat 3: stfuplzudonk (€1.47 in chips) 
Seat 4: caduceus369 (€1.94 in chips) 
Seat 5: AntonioKrakka (€3.15 in chips) 
Seat 6: sancarlo18 (€2.18 in chips) 
wilsson1974: posts small blind €0.01
stfuplzudonk: posts big blind €0.02
*** HOLE CARDS ***
Dealt to caduceus369 [Th 5s]
caduceus369: folds 
AntonioKrakka: folds 
sancarlo18: folds 
AlfredP80: folds 
wilsson1974: calls €0.01
stfuplzudonk: checks 
*** FLOP *** [Ad 3s 4s]
wilsson1974: checks 
stfuplzudonk: checks 
*** TURN *** [Ad 3s 4s] [4d]
wilsson1974: checks 
stfuplzudonk: checks 
*** RIVER *** [Ad 3s 4s 4d] [Ts]
wilsson1974: checks 
stfuplzudonk: checks 
*** SHOW DOWN ***
wilsson1974: shows [Jh Td] (two pair, Tens and Fours)
stfuplzudonk: mucks hand 
wilsson1974 collected €0.04 from pot
*** SUMMARY ***
Total pot €0.04 | Rake €0 
Board [Ad 3s 4s 4d Ts]
Seat 1: AlfredP80 (button) folded before Flop (didn't bet)
Seat 2: wilsson1974 (small blind) showed [Jh Td] and won (€0.04) with two pair, Tens and Fours
Seat 3: stfuplzudonk (big blind) mucked [Qs 7h]
Seat 4: caduceus369 folded before Flop (didn't bet)
Seat 5: AntonioKrakka folded before Flop (didn't bet)
Seat 6: sancarlo18 folded before Flop (didn't bet)



PokerStars Zoom Hand #257975221610:  Hold'em No Limit (€0.01/€0.02) [ADM ID: M62BA304494E32ST] - 2025/10/02 23:05:18 CET [2025/10/02 17:05:18 ET]
Table 'Sirio' 6-max Seat #1 is the button
Seat 1: AntonioKrakka (€2 in chips) 
Seat 2: ilpensatore83 (€1.20 in chips) 
Seat 3: cap e'bomb95 (€1.87 in chips) 
Seat 4: caduceus369 (€1.94 in chips) 
Seat 5: father2008 (€3.45 in chips) 
Seat 6: pistaKKio23 (€2.63 in chips) 
ilpensatore83: posts small blind €0.01
cap e'bomb95: posts big blind €0.02
*** HOLE CARDS ***
Dealt to caduceus369 [7d 3c]
caduceus369: folds 
father2008: folds 
pistaKKio23: folds 
AntonioKrakka: raises €0.04 to €0.06
ilpensatore83: folds 
cap e'bomb95: calls €0.04
*** FLOP *** [5c Qd 7c]
cap e'bomb95: checks 
AntonioKrakka: checks 
*** TURN *** [5c Qd 7c] [3s]
cap e'bomb95: checks 
AntonioKrakka: checks 
*** RIVER *** [5c Qd 7c 3s] [8h]
cap e'bomb95: checks 
AntonioKrakka: checks 
*** SHOW DOWN ***
cap e'bomb95: shows [Jh Kd] (high card King)
AntonioKrakka: shows [As Tc] (high card Ace)
AntonioKrakka collected €0.13 from pot
*** SUMMARY ***
Total pot €0.13 | Rake €0 
Board [5c Qd 7c 3s 8h]
Seat 1: AntonioKrakka (button) showed [As Tc] and won (€0.13) with high card Ace
Seat 2: ilpensatore83 (small blind) folded before Flop
Seat 3: cap e'bomb95 (big blind) showed [Jh Kd] and lost with high card King
Seat 4: caduceus369 folded before Flop (didn't bet)
Seat 5: father2008 folded before Flop (didn't bet)
Seat 6: pistaKKio23 folded before Flop (didn't bet)



PokerStars Zoom Hand #257975230161:  Hold'em No Limit (€0.01/€0.02) [ADM ID: M62BA304494E32ST] - 2025/10/02 23:05:53 CET [2025/10/02 17:05:53 ET]
Table 'Sirio' 6-max Seat #1 is the button
Seat 1: father2008 (€4.56 in chips) 
Seat 2: pistaKKio23 (€1.84 in chips) 
Seat 3: AlfredP80 (€3.18 in chips) 
Seat 4: Warterror90 (€7.27 in chips) 
Seat 5: caduceus369 (€1.91 in chips) 
Seat 6: gigiruk91 (€4.25 in chips) 
pistaKKio23: posts small blind €0.01
AlfredP80: posts big blind €0.02
*** HOLE CARDS ***
Dealt to caduceus369 [7s 4s]
Warterror90: raises €0.04 to €0.06
caduceus369: folds 
gigiruk91: folds 
father2008: folds 
pistaKKio23: folds 
AlfredP80: folds 
Uncalled bet (€0.04) returned to Warterror90
Warterror90 collected €0.05 from pot
Warterror90: doesn't show hand 
*** SUMMARY ***
Total pot €0.05 | Rake €0 
Seat 1: father2008 (button) folded before Flop (didn't bet)
Seat 2: pistaKKio23 (small blind) folded before Flop
Seat 3: AlfredP80 (big blind) folded before Flop
Seat 4: Warterror90 collected (€0.05)
Seat 5: caduceus369 folded before Flop (didn't bet)
Seat 6: gigiruk91 folded before Flop (didn't bet)



PokerStars Zoom Hand #257975218448:  Hold'em No Limit (€0.01/€0.02) [ADM ID: M62BA304494E32ST] - 2025/10/02 23:05:05 CET [2025/10/02 17:05:05 ET]
Table 'Sirio' 6-max Seat #1 is the button
Seat 1: TonyPir97 (€1.55 in chips) 
Seat 2: gigiruk91 (€10.35 in chips) 
Seat 3: fantaasso (€1.40 in chips) 
Seat 4: AntonioKrakka (€3.15 in chips) 
Seat 5: caduceus369 (€1.94 in chips) 
Seat 6: ADRIAN0_MEIS (€6.82 in chips) 
gigiruk91: posts small blind €0.01
fantaasso: posts big blind €0.02
*** HOLE CARDS ***
Dealt to caduceus369 [6c Qc]
AntonioKrakka: folds 
caduceus369: folds 
ADRIAN0_MEIS: folds 
TonyPir97: calls €0.02
gigiruk91: raises €0.02 to €0.04
fantaasso: calls €0.02
TonyPir97: calls €0.02
*** FLOP *** [5s Jd 7h]
gigiruk91: checks 
fantaasso: bets €0.06
TonyPir97: calls €0.06
gigiruk91: folds 
*** TURN *** [5s Jd 7h] [Js]
fantaasso: bets €0.12
TonyPir97: calls €0.12
*** RIVER *** [5s Jd 7h Js] [7c]
fantaasso: bets €0.25
TonyPir97: calls €0.25
*** SHOW DOWN ***
fantaasso: shows [Jh Th] (a full house, Jacks full of Sevens)
TonyPir97: mucks hand 
fantaasso collected €0.93 from pot
*** SUMMARY ***
Total pot €0.98 | Rake €0.05 
Board [5s Jd 7h Js 7c]
Seat 1: TonyPir97 (button) mucked [Ad 7s]
Seat 2: gigiruk91 (small blind) folded on the Flop
Seat 3: fantaasso (big blind) showed [Jh Th] and won (€0.93) with a full house, Jacks full of Sevens
Seat 4: AntonioKrakka folded before Flop (didn't bet)
Seat 5: caduceus369 folded before Flop (didn't bet)
Seat 6: ADRIAN0_MEIS folded before Flop (didn't bet)



PokerStars Zoom Hand #257975227503:  Hold'em No Limit (€0.01/€0.02) [ADM ID: M62BA304494E32ST] - 2025/10/02 23:05:43 CET [2025/10/02 17:05:43 ET]
Table 'Sirio' 6-max Seat #1 is the button
Seat 1: diesel197474 (€1.69 in chips) 
Seat 2: irenuccia33 (€2.91 in chips) 
Seat 3: caduceus369 (€1.93 in chips) 
Seat 4: fantaasso (€2.77 in chips) 
Seat 5: cap e'bomb95 (€4.14 in chips) 
Seat 6: monsterc99 (€1.57 in chips) 
irenuccia33: posts small blind €0.01
caduceus369: posts big blind €0.02
*** HOLE CARDS ***
Dealt to caduceus369 [Ts 7d]
fantaasso: folds 
cap e'bomb95: raises €0.03 to €0.05
monsterc99: calls €0.05
diesel197474: folds 
irenuccia33: folds 
caduceus369: folds 
*** FLOP *** [6h 2d 3h]
cap e'bomb95: bets €0.09
monsterc99: folds 
Uncalled bet (€0.09) returned to cap e'bomb95
cap e'bomb95 collected €0.13 from pot
cap e'bomb95: doesn't show hand 
*** SUMMARY ***
Total pot €0.13 | Rake €0 
Board [6h 2d 3h]
Seat 1: diesel197474 (button) folded before Flop (didn't bet)
Seat 2: irenuccia33 (small blind) folded before Flop
Seat 3: caduceus369 (big blind) folded before Flop
Seat 4: fantaasso folded before Flop (didn't bet)
Seat 5: cap e'bomb95 collected (€0.13)
Seat 6: monsterc99 folded on the Flop



PokerStars Zoom Hand #257975231453:  Hold'em No Limit (€0.01/€0.02) [ADM ID: M62BA304494E32ST] - 2025/10/02 23:05:59 CET [2025/10/02 17:05:59 ET]
Table 'Sirio' 6-max Seat #1 is the button
Seat 1: sancarlo18 (€2.18 in chips) 
Seat 2: AlfredP80 (€3.16 in chips) 
Seat 3: irenuccia33 (€2.90 in chips) 
Seat 4: stfuplzudonk (€1.59 in chips) 
Seat 5: ADRIAN0_MEIS (€2.96 in chips) 
Seat 6: caduceus369 (€1.91 in chips) 
AlfredP80: posts small blind €0.01
irenuccia33: posts big blind €0.02
*** HOLE CARDS ***
Dealt to caduceus369 [Td Qc]
stfuplzudonk: folds 
ADRIAN0_MEIS: folds 
caduceus369: folds 
sancarlo18: raises €0.04 to €0.06
AlfredP80: folds 
irenuccia33: folds 
Uncalled bet (€0.04) returned to sancarlo18
sancarlo18 collected €0.05 from pot
sancarlo18: doesn't show hand 
*** SUMMARY ***
Total pot €0.05 | Rake €0 
Seat 1: sancarlo18 (button) collected (€0.05)
Seat 2: AlfredP80 (small blind) folded before Flop
Seat 3: irenuccia33 (big blind) folded before Flop
Seat 4: stfuplzudonk folded before Flop (didn't bet)
Seat 5: ADRIAN0_MEIS folded before Flop (didn't bet)
Seat 6: caduceus369 folded before Flop (didn't bet)



PokerStars Zoom Hand #257975235565:  Hold'em No Limit (€0.01/€0.02) [ADM ID: M62BA304494E32ST] - 2025/10/02 23:06:16 CET [2025/10/02 17:06:16 ET]
Table 'Sirio' 6-max Seat #1 is the button
Seat 1: monsterc99 (€1.52 in chips) 
Seat 2: cap e'bomb95 (€3.24 in chips) 
Seat 3: caduceus369 (€1.91 in chips) 
Seat 4: father2008 (€3.40 in chips) 
Seat 5: Giuggiola64 (€3.26 in chips) 
Seat 6: Warterror90 (€7.30 in chips) 
cap e'bomb95: posts small blind €0.01
caduceus369: posts big blind €0.02
*** HOLE CARDS ***
Dealt to caduceus369 [3c 5d]
father2008: folds 
Giuggiola64: folds 
Warterror90: raises €0.04 to €0.06
monsterc99: folds 
cap e'bomb95: folds 
caduceus369: folds 
Uncalled bet (€0.04) returned to Warterror90
Warterror90 collected €0.05 from pot
Warterror90: doesn't show hand 
*** SUMMARY ***
Total pot €0.05 | Rake €0 
Seat 1: monsterc99 (button) folded before Flop (didn't bet)
Seat 2: cap e'bomb95 (small blind) folded before Flop
Seat 3: caduceus369 (big blind) folded before Flop
Seat 4: father2008 folded before Flop (didn't bet)
Seat 5: Giuggiola64 folded before Flop (didn't bet)
Seat 6: Warterror90 collected (€0.05)



PokerStars Zoom Hand #257975234090:  Hold'em No Limit (€0.01/€0.02) [ADM ID: M62BA304494E32ST] - 2025/10/02 23:06:10 CET [2025/10/02 17:06:10 ET]
Table 'Sirio' 6-max Seat #1 is the button
Seat 1: Warterror90 (€7.30 in chips) 
Seat 2: AntonioKrakka (€2.87 in chips) 
Seat 3: 7mosigillo (€1.81 in chips) 
Seat 4: caduceus369 (€1.91 in chips) 
Seat 5: diesel197474 (€1.03 in chips) 
Seat 6: TonyPir97 (€1.08 in chips) 
AntonioKrakka: posts small blind €0.01
7mosigillo: posts big blind €0.02
*** HOLE CARDS ***
Dealt to caduceus369 [9c Th]
caduceus369: folds 
diesel197474: folds 
TonyPir97: folds 
Warterror90: folds 
AntonioKrakka: calls €0.01
7mosigillo: checks 
*** FLOP *** [5h 5c Jd]
AntonioKrakka: bets €0.04
7mosigillo: calls €0.04
*** TURN *** [5h 5c Jd] [7c]
AntonioKrakka: checks 
7mosigillo: checks 
*** RIVER *** [5h 5c Jd 7c] [2c]
AntonioKrakka: checks 
7mosigillo: checks 
*** SHOW DOWN ***
AntonioKrakka: shows [4h Ad] (a pair of Fives)
7mosigillo: shows [Qd Js] (two pair, Jacks and Fives)
7mosigillo collected €0.12 from pot
*** SUMMARY ***
Total pot €0.12 | Rake €0 
Board [5h 5c Jd 7c 2c]
Seat 1: Warterror90 (button) folded before Flop (didn't bet)
Seat 2: AntonioKrakka (small blind) showed [4h Ad] and lost with a pair of Fives
Seat 3: 7mosigillo (big blind) showed [Qd Js] and won (€0.12) with two pair, Jacks and Fives
Seat 4: caduceus369 folded before Flop (didn't bet)
Seat 5: diesel197474 folded before Flop (didn't bet)
Seat 6: TonyPir97 folded before Flop (didn't bet)



PokerStars Zoom Hand #257975238940:  Hold'em No Limit (€0.01/€0.02) [ADM ID: M62BA304494E32ST] - 2025/10/02 23:06:30 CET [2025/10/02 17:06:30 ET]
Table 'Sirio' 6-max Seat #1 is the button
Seat 1: kolain17 (€1.10 in chips) 
Seat 2: caduceus369 (€1.89 in chips) 
Seat 3: meteco79 (€0.64 in chips) 
Seat 4: diesel197474 (€1.03 in chips) 
Seat 5: gigiruk91 (€2 in chips) 
Seat 6: sancarlo18 (€2.21 in chips) 
caduceus369: posts small blind €0.01
meteco79: posts big blind €0.02
*** HOLE CARDS ***
Dealt to caduceus369 [5h 6d]
diesel197474: calls €0.02
gigiruk91: folds 
sancarlo18: folds 
kolain17: calls €0.02
caduceus369: folds 
meteco79: checks 
*** FLOP *** [Th 5c 7s]
meteco79: checks 
diesel197474: bets €0.04
kolain17: calls €0.04
meteco79: folds 
*** TURN *** [Th 5c 7s] [3s]
diesel197474: checks 
kolain17: checks 
*** RIVER *** [Th 5c 7s 3s] [Tc]
diesel197474: checks 
kolain17: checks 
*** SHOW DOWN ***
diesel197474: shows [Ah Qh] (a pair of Tens)
kolain17: mucks hand 
diesel197474 collected €0.15 from pot
*** SUMMARY ***
Total pot €0.15 | Rake €0 
Board [Th 5c 7s 3s Tc]
Seat 1: kolain17 (button) mucked [Jd 6c]
Seat 2: caduceus369 (small blind) folded before Flop
Seat 3: meteco79 (big blind) folded on the Flop
Seat 4: diesel197474 showed [Ah Qh] and won (€0.15) with a pair of Tens
Seat 5: gigiruk91 folded before Flop (didn't bet)
Seat 6: sancarlo18 folded before Flop (didn't bet)



PokerStars Zoom Hand #257975234834:  Hold'em No Limit (€0.01/€0.02) [ADM ID: M62BA304494E32ST] - 2025/10/02 23:06:13 CET [2025/10/02 17:06:13 ET]
Table 'Sirio' 6-max Seat #1 is the button
Seat 1: caduceus369 (€1.91 in chips) 
Seat 2: RRgalp (€7.48 in chips) 
Seat 3: pistaKKio23 (€1.86 in chips) 
Seat 4: 7mosigillo (€2.05 in chips) 
Seat 5: eleonora50 (€1.42 in chips) 
Seat 6: ADRIAN0_MEIS (€6.82 in chips) 
RRgalp: posts small blind €0.01
pistaKKio23: posts big blind €0.02
*** HOLE CARDS ***
Dealt to caduceus369 [3s 7d]
7mosigillo: raises €0.02 to €0.04
eleonora50: calls €0.04
ADRIAN0_MEIS: folds 
caduceus369: folds 
RRgalp: folds 
pistaKKio23: calls €0.02
*** FLOP *** [4s 6s Jd]
pistaKKio23: checks 
7mosigillo: checks 
eleonora50: checks 
*** TURN *** [4s 6s Jd] [9s]
pistaKKio23: checks 
7mosigillo: checks 
eleonora50: checks 
*** RIVER *** [4s 6s Jd 9s] [Qd]
pistaKKio23: bets €0.07
7mosigillo: folds 
eleonora50: folds 
Uncalled bet (€0.07) returned to pistaKKio23
pistaKKio23 collected €0.13 from pot
pistaKKio23: doesn't show hand 
*** SUMMARY ***
Total pot €0.13 | Rake €0 
Board [4s 6s Jd 9s Qd]
Seat 1: caduceus369 (button) folded before Flop (didn't bet)
Seat 2: RRgalp (small blind) folded before Flop
Seat 3: pistaKKio23 (big blind) collected (€0.13)
Seat 4: 7mosigillo folded on the River
Seat 5: eleonora50 folded on the River
Seat 6: ADRIAN0_MEIS folded before Flop (didn't bet)



PokerStars Zoom Hand #257975240916:  Hold'em No Limit (€0.01/€0.02) [ADM ID: M62BA304494E32ST] - 2025/10/02 23:06:38 CET [2025/10/02 17:06:38 ET]
Table 'Sirio' 6-max Seat #1 is the button
Seat 1: TonyPir97 (€1.06 in chips) 
Seat 2: Gabrielefante (€5.12 in chips) 
Seat 3: luchetto1990 (€3.73 in chips) 
Seat 4: lapo1987 (€2.47 in chips) 
Seat 5: diesel197474 (€1.69 in chips) 
Seat 6: caduceus369 (€1.88 in chips) 
Gabrielefante: posts small blind €0.01
luchetto1990: posts big blind €0.02
*** HOLE CARDS ***
Dealt to caduceus369 [Th As]
lapo1987: folds 
diesel197474: calls €0.02
caduceus369: calls €0.02
TonyPir97: calls €0.02
Gabrielefante: folds 
luchetto1990: checks 
*** FLOP *** [Qh 4s 2d]
luchetto1990: checks 
diesel197474: bets €0.02
caduceus369: calls €0.02
TonyPir97: calls €0.02
luchetto1990: folds 
*** TURN *** [Qh 4s 2d] [Qd]
diesel197474: checks 
caduceus369: bets €0.04
TonyPir97: folds 
diesel197474: calls €0.04
*** RIVER *** [Qh 4s 2d Qd] [5h]
diesel197474: checks 
caduceus369: bets €0.10
diesel197474: raises €0.16 to €0.26
caduceus369: folds 
Uncalled bet (€0.16) returned to diesel197474
diesel197474 collected €0.41 from pot
diesel197474: doesn't show hand 
*** SUMMARY ***
Total pot €0.43 | Rake €0.02 
Board [Qh 4s 2d Qd 5h]
Seat 1: TonyPir97 (button) folded on the Turn
Seat 2: Gabrielefante (small blind) folded before Flop
Seat 3: luchetto1990 (big blind) folded on the Flop
Seat 4: lapo1987 folded before Flop (didn't bet)
Seat 5: diesel197474 collected (€0.41)
Seat 6: caduceus369 folded on the River



PokerStars Zoom Hand #257975261372:  Hold'em No Limit (€0.01/€0.02) [ADM ID: M62BA304494E32ST] - 2025/10/02 23:08:02 CET [2025/10/02 17:08:02 ET]
Table 'Sirio' 6-max Seat #1 is the button
Seat 1: pistaKKio23 (€2.38 in chips) 
Seat 2: AlfredP80 (€3.28 in chips) 
Seat 3: stfuplzudonk (€1.63 in chips) 
Seat 4: cap e'bomb95 (€3.13 in chips) 
Seat 5: caduceus369 (€1.70 in chips) 
Seat 6: Redraw2Flush (€0.77 in chips) 
AlfredP80: posts small blind €0.01
stfuplzudonk: posts big blind €0.02
*** HOLE CARDS ***
Dealt to caduceus369 [6s Td]
cap e'bomb95: folds 
caduceus369: folds 
Redraw2Flush: folds 
pistaKKio23: folds 
AlfredP80: calls €0.01
stfuplzudonk: checks 
*** FLOP *** [2s 8s 9d]
AlfredP80: checks 
stfuplzudonk: checks 
*** TURN *** [2s 8s 9d] [Qd]
AlfredP80: bets €0.02
stfuplzudonk: folds 
Uncalled bet (€0.02) returned to AlfredP80
AlfredP80 collected €0.04 from pot
AlfredP80: doesn't show hand 
*** SUMMARY ***
Total pot €0.04 | Rake €0 
Board [2s 8s 9d Qd]
Seat 1: pistaKKio23 (button) folded before Flop (didn't bet)
Seat 2: AlfredP80 (small blind) collected (€0.04)
Seat 3: stfuplzudonk (big blind) folded on the Turn
Seat 4: cap e'bomb95 folded before Flop (didn't bet)
Seat 5: caduceus369 folded before Flop (didn't bet)
Seat 6: Redraw2Flush folded before Flop (didn't bet)



PokerStars Zoom Hand #257975262563:  Hold'em No Limit (€0.01/€0.02) [ADM ID: M62BA304494E32ST] - 2025/10/02 23:08:07 CET [2025/10/02 17:08:07 ET]
Table 'Sirio' 6-max Seat #1 is the button
Seat 1: caduceus369 (€1.70 in chips) 
Seat 2: AntonioKrakka (€2.77 in chips) 
Seat 3: pistaKKio23 (€2.55 in chips) 
Seat 4: cap e'bomb95 (€3.13 in chips) 
Seat 5: TripInter (€1.55 in chips) 
Seat 6: meteco79 (€0.57 in chips) 
AntonioKrakka: posts small blind €0.01
pistaKKio23: posts big blind €0.02
*** HOLE CARDS ***
Dealt to caduceus369 [Qc Jh]
cap e'bomb95: folds 
TripInter: folds 
meteco79: calls €0.02
caduceus369: calls €0.02
AntonioKrakka: folds 
pistaKKio23: checks 
*** FLOP *** [3h Js Ah]
pistaKKio23: checks 
meteco79: checks 
caduceus369: bets €0.02
pistaKKio23: folds 
meteco79: calls €0.02
*** TURN *** [3h Js Ah] [4s]
meteco79: bets €0.02
caduceus369: calls €0.02
*** RIVER *** [3h Js Ah 4s] [Qs]
meteco79: checks 
caduceus369: bets €0.16
meteco79: calls €0.16
*** SHOW DOWN ***
caduceus369: shows [Qc Jh] (two pair, Queens and Jacks)
meteco79: shows [4c Ac] (two pair, Aces and Fours)
meteco79 collected €0.45 from pot
*** SUMMARY ***
Total pot €0.47 | Rake €0.02 
Board [3h Js Ah 4s Qs]
Seat 1: caduceus369 (button) showed [Qc Jh] and lost with two pair, Queens and Jacks
Seat 2: AntonioKrakka (small blind) folded before Flop
Seat 3: pistaKKio23 (big blind) folded on the Flop
Seat 4: cap e'bomb95 folded before Flop (didn't bet)
Seat 5: TripInter folded before Flop (didn't bet)
Seat 6: meteco79 showed [4c Ac] and won (€0.45) with two pair, Aces and Fours



PokerStars Zoom Hand #257975274951:  Hold'em No Limit (€0.01/€0.02) [ADM ID: M62BA304494E32ST] - 2025/10/02 23:08:58 CET [2025/10/02 17:08:58 ET]
Table 'Sirio' 6-max Seat #1 is the button
Seat 1: diesel197474 (€1.98 in chips) 
Seat 2: Giuggiola64 (€3.13 in chips) 
Seat 3: Alex83l310 (€2 in chips) 
Seat 4: caduceus369 (€1.48 in chips) 
Seat 5: rush572 (€0.89 in chips) 
Seat 6: eleonora50 (€1.34 in chips) 
Giuggiola64: posts small blind €0.01
Alex83l310: posts big blind €0.02
*** HOLE CARDS ***
Dealt to caduceus369 [Td Tc]
caduceus369: raises €0.02 to €0.04
rush572: folds 
eleonora50: folds 
diesel197474: folds 
Giuggiola64: calls €0.03
Alex83l310: folds 
*** FLOP *** [Kd As Ad]
Giuggiola64: bets €0.02
caduceus369: calls €0.02
*** TURN *** [Kd As Ad] [Qc]
Giuggiola64: bets €0.04
caduceus369: raises €0.10 to €0.14
Giuggiola64: folds 
Uncalled bet (€0.10) returned to caduceus369
caduceus369 collected €0.21 from pot
caduceus369: doesn't show hand 
*** SUMMARY ***
Total pot €0.22 | Rake €0.01 
Board [Kd As Ad Qc]
Seat 1: diesel197474 (button) folded before Flop (didn't bet)
Seat 2: Giuggiola64 (small blind) folded on the Turn
Seat 3: Alex83l310 (big blind) folded before Flop
Seat 4: caduceus369 collected (€0.21)
Seat 5: rush572 folded before Flop (didn't bet)
Seat 6: eleonora50 folded before Flop (didn't bet)



PokerStars Zoom Hand #257975285209:  Hold'em No Limit (€0.01/€0.02) [ADM ID: M62BA304494E32ST] - 2025/10/02 23:09:41 CET [2025/10/02 17:09:41 ET]
Table 'Sirio' 6-max Seat #1 is the button
Seat 1: cap e'bomb95 (€1.93 in chips) 
Seat 2: lapo1987 (€2.35 in chips) 
Seat 3: caduceus369 (€1.58 in chips) 
Seat 4: sancarlo18 (€2.56 in chips) 
Seat 5: muhozhuk788 (€2.07 in chips) 
Seat 6: gemini1682 (€1.48 in chips) 
lapo1987: posts small blind €0.01
caduceus369: posts big blind €0.02
*** HOLE CARDS ***
Dealt to caduceus369 [5s 2c]
sancarlo18: folds 
muhozhuk788: folds 
gemini1682: folds 
cap e'bomb95: folds 
lapo1987: folds 
Uncalled bet (€0.01) returned to caduceus369
caduceus369 collected €0.02 from pot
caduceus369: doesn't show hand 
*** SUMMARY ***
Total pot €0.02 | Rake €0 
Seat 1: cap e'bomb95 (button) folded before Flop (didn't bet)
Seat 2: lapo1987 (small blind) folded before Flop
Seat 3: caduceus369 (big blind) collected (€0.02)
Seat 4: sancarlo18 folded before Flop (didn't bet)
Seat 5: muhozhuk788 folded before Flop (didn't bet)
Seat 6: gemini1682 folded before Flop (didn't bet)



PokerStars Zoom Hand #257975284229:  Hold'em No Limit (€0.01/€0.02) [ADM ID: M62BA304494E32ST] - 2025/10/02 23:09:36 CET [2025/10/02 17:09:36 ET]
Table 'Sirio' 6-max Seat #1 is the button
Seat 1: stfuplzudonk (€1.50 in chips) 
Seat 2: caduceus369 (€1.59 in chips) 
Seat 3: gigiruk91 (€5.91 in chips) 
Seat 4: Oiad (€2.13 in chips) 
Seat 5: AntonioKrakka (€1.84 in chips) 
Seat 6: Warterror90 (€3.71 in chips) 
caduceus369: posts small blind €0.01
gigiruk91: posts big blind €0.02
*** HOLE CARDS ***
Dealt to caduceus369 [3s 7s]
Oiad: folds 
AntonioKrakka: folds 
Warterror90: folds 
stfuplzudonk: raises €0.04 to €0.06
caduceus369: folds 
gigiruk91: folds 
Uncalled bet (€0.04) returned to stfuplzudonk
stfuplzudonk collected €0.05 from pot
stfuplzudonk: doesn't show hand 
*** SUMMARY ***
Total pot €0.05 | Rake €0 
Seat 1: stfuplzudonk (button) collected (€0.05)
Seat 2: caduceus369 (small blind) folded before Flop
Seat 3: gigiruk91 (big blind) folded before Flop
Seat 4: Oiad folded before Flop (didn't bet)
Seat 5: AntonioKrakka folded before Flop (didn't bet)
Seat 6: Warterror90 folded before Flop (didn't bet)



PokerStars Zoom Hand #257975292831:  Hold'em No Limit (€0.01/€0.02) [ADM ID: M62BA304494E32ST] - 2025/10/02 23:10:12 CET [2025/10/02 17:10:12 ET]
Table 'Sirio' 6-max Seat #1 is the button
Seat 1: Oiad (€2.11 in chips) 
Seat 2: monsterc99 (€1.60 in chips) 
Seat 3: caduceus369 (€1.59 in chips) 
Seat 4: father2008 (€4.50 in chips) 
Seat 5: luchetto1990 (€3.93 in chips) 
Seat 6: AntonioKrakka (€1.81 in chips) 
monsterc99: posts small blind €0.01
caduceus369: posts big blind €0.02
*** HOLE CARDS ***
Dealt to caduceus369 [3s 2s]
father2008: folds 
luchetto1990: folds 
AntonioKrakka: raises €0.05 to €0.07
Oiad: folds 
monsterc99: folds 
caduceus369: folds 
Uncalled bet (€0.05) returned to AntonioKrakka
AntonioKrakka collected €0.05 from pot
AntonioKrakka: doesn't show hand 
*** SUMMARY ***
Total pot €0.05 | Rake €0 
Seat 1: Oiad (button) folded before Flop (didn't bet)
Seat 2: monsterc99 (small blind) folded before Flop
Seat 3: caduceus369 (big blind) folded before Flop
Seat 4: father2008 folded before Flop (didn't bet)
Seat 5: luchetto1990 folded before Flop (didn't bet)
Seat 6: AntonioKrakka collected (€0.05)



PokerStars Zoom Hand #257975289571:  Hold'em No Limit (€0.01/€0.02) [ADM ID: M62BA304494E32ST] - 2025/10/02 23:09:59 CET [2025/10/02 17:09:59 ET]
Table 'Sirio' 6-max Seat #1 is the button
Seat 1: lapo1987 (€2.35 in chips) 
Seat 2: AntonioKrakka (€1.82 in chips) 
Seat 3: muhozhuk788 (€2.07 in chips) 
Seat 4: bravo1270 (€0.81 in chips) 
Seat 5: caduceus369 (€1.59 in chips) 
Seat 6: TonyPir97 (€0.92 in chips) 
AntonioKrakka: posts small blind €0.01
muhozhuk788: posts big blind €0.02
*** HOLE CARDS ***
Dealt to caduceus369 [5h Ac]
bravo1270: folds 
caduceus369: folds 
TonyPir97: folds 
lapo1987: raises €0.02 to €0.04
AntonioKrakka: folds 
muhozhuk788: calls €0.02
*** FLOP *** [Jd 6h 4s]
muhozhuk788: bets €0.05
lapo1987: calls €0.05
*** TURN *** [Jd 6h 4s] [Th]
muhozhuk788: checks 
lapo1987: checks 
*** RIVER *** [Jd 6h 4s Th] [Tc]
muhozhuk788: checks 
lapo1987: checks 
*** SHOW DOWN ***
muhozhuk788: shows [Ad 6s] (two pair, Tens and Sixes)
lapo1987: shows [7h 7d] (two pair, Tens and Sevens)
lapo1987 collected €0.18 from pot
*** SUMMARY ***
Total pot €0.19 | Rake €0.01 
Board [Jd 6h 4s Th Tc]
Seat 1: lapo1987 (button) showed [7h 7d] and won (€0.18) with two pair, Tens and Sevens
Seat 2: AntonioKrakka (small blind) folded before Flop
Seat 3: muhozhuk788 (big blind) showed [Ad 6s] and lost with two pair, Tens and Sixes
Seat 4: bravo1270 folded before Flop (didn't bet)
Seat 5: caduceus369 folded before Flop (didn't bet)
Seat 6: TonyPir97 folded before Flop (didn't bet)



PokerStars Zoom Hand #257975287629:  Hold'em No Limit (€0.01/€0.02) [ADM ID: M62BA304494E32ST] - 2025/10/02 23:09:51 CET [2025/10/02 17:09:51 ET]
Table 'Sirio' 6-max Seat #1 is the button
Seat 1: Warterror90 (€8.40 in chips) 
Seat 2: ADRIAN0_MEIS (€2.90 in chips) 
Seat 3: cap e'bomb95 (€1.93 in chips) 
Seat 4: Redraw2Flush (€0.83 in chips) 
Seat 5: muhozhuk788 (€1.39 in chips) 
Seat 6: caduceus369 (€1.59 in chips) 
ADRIAN0_MEIS: posts small blind €0.01
cap e'bomb95: posts big blind €0.02
*** HOLE CARDS ***
Dealt to caduceus369 [4c 5c]
Redraw2Flush: folds 
muhozhuk788: raises €0.04 to €0.06
caduceus369: folds 
Warterror90: calls €0.06
ADRIAN0_MEIS: folds 
cap e'bomb95: folds 
*** FLOP *** [8s 4d Ac]
muhozhuk788: bets €0.08
Warterror90: raises €0.12 to €0.20
muhozhuk788: calls €0.12
*** TURN *** [8s 4d Ac] [8d]
muhozhuk788: checks 
Warterror90: checks 
*** RIVER *** [8s 4d Ac 8d] [9h]
muhozhuk788: bets €0.52
Warterror90: raises €7.62 to €8.14 and is all-in
muhozhuk788: calls €0.61 and is all-in
Uncalled bet (€7.01) returned to Warterror90
*** SHOW DOWN ***
Warterror90: shows [9d 9c] (a full house, Nines full of Eights)
muhozhuk788: shows [Kh Ah] (two pair, Aces and Eights)
Warterror90 collected €2.66 from pot
*** SUMMARY ***
Total pot €2.81 | Rake €0.15 
Board [8s 4d Ac 8d 9h]
Seat 1: Warterror90 (button) showed [9d 9c] and won (€2.66) with a full house, Nines full of Eights
Seat 2: ADRIAN0_MEIS (small blind) folded before Flop
Seat 3: cap e'bomb95 (big blind) folded before Flop
Seat 4: Redraw2Flush folded before Flop (didn't bet)
Seat 5: muhozhuk788 showed [Kh Ah] and lost with two pair, Aces and Eights
Seat 6: caduceus369 folded before Flop (didn't bet)



PokerStars Zoom Hand #257975290287:  Hold'em No Limit (€0.01/€0.02) [ADM ID: M62BA304494E32ST] - 2025/10/02 23:10:02 CET [2025/10/02 17:10:02 ET]
Table 'Sirio' 6-max Seat #1 is the button
Seat 1: caduceus369 (€1.59 in chips) 
Seat 2: cap e'bomb95 (€1.91 in chips) 
Seat 3: Kingo690 (€3.32 in chips) 
Seat 4: ADRIAN0_MEIS (€2.89 in chips) 
Seat 5: Warterror90 (€3.70 in chips) 
Seat 6: stfuplzudonk (€1.53 in chips) 
cap e'bomb95: posts small blind €0.01
Kingo690: posts big blind €0.02
*** HOLE CARDS ***
Dealt to caduceus369 [Js 5h]
ADRIAN0_MEIS: folds 
Warterror90: raises €0.04 to €0.06
stfuplzudonk: folds 
caduceus369: folds 
cap e'bomb95: calls €0.05
Kingo690: folds 
*** FLOP *** [4s 2h Td]
cap e'bomb95: checks 
Warterror90: bets €0.05
cap e'bomb95: folds 
Uncalled bet (€0.05) returned to Warterror90
Warterror90 collected €0.14 from pot
Warterror90: doesn't show hand 
*** SUMMARY ***
Total pot €0.14 | Rake €0 
Board [4s 2h Td]
Seat 1: caduceus369 (button) folded before Flop (didn't bet)
Seat 2: cap e'bomb95 (small blind) folded on the Flop
Seat 3: Kingo690 (big blind) folded before Flop
Seat 4: ADRIAN0_MEIS folded before Flop (didn't bet)
Seat 5: Warterror90 collected (€0.14)
Seat 6: stfuplzudonk folded before Flop (didn't bet)



PokerStars Zoom Hand #257975291450:  Hold'em No Limit (€0.01/€0.02) [ADM ID: M62BA304494E32ST] - 2025/10/02 23:10:06 CET [2025/10/02 17:10:06 ET]
Table 'Sirio' 6-max Seat #1 is the button
Seat 1: ADRIAN0_MEIS (€2.89 in chips) 
Seat 2: luchetto1990 (€3.94 in chips) 
Seat 3: Nicoirca2004 (€1.39 in chips) 
Seat 4: caduceus369 (€1.59 in chips) 
Seat 5: father2008 (€4.50 in chips) 
Seat 6: wilsson1974 (€0.65 in chips) 
luchetto1990: posts small blind €0.01
Nicoirca2004: posts big blind €0.02
*** HOLE CARDS ***
Dealt to caduceus369 [4c 5c]
caduceus369: folds 
father2008: folds 
wilsson1974: raises €0.02 to €0.04
ADRIAN0_MEIS: folds 
luchetto1990: folds 
Nicoirca2004: raises €0.04 to €0.08
wilsson1974: calls €0.04
*** FLOP *** [4d As 6c]
Nicoirca2004: bets €0.04
wilsson1974: raises €0.04 to €0.08
Nicoirca2004: calls €0.04
*** TURN *** [4d As 6c] [Ad]
Nicoirca2004: checks 
wilsson1974: bets €0.08
Nicoirca2004: calls €0.08
*** RIVER *** [4d As 6c Ad] [8s]
Nicoirca2004: checks 
wilsson1974: checks 
*** SHOW DOWN ***
Nicoirca2004: shows [Kc Kh] (two pair, Aces and Kings)
wilsson1974: mucks hand 
Nicoirca2004 collected €0.47 from pot
*** SUMMARY ***
Total pot €0.49 | Rake €0.02 
Board [4d As 6c Ad 8s]
Seat 1: ADRIAN0_MEIS (button) folded before Flop (didn't bet)
Seat 2: luchetto1990 (small blind) folded before Flop
Seat 3: Nicoirca2004 (big blind) showed [Kc Kh] and won (€0.47) with two pair, Aces and Kings
Seat 4: caduceus369 folded before Flop (didn't bet)
Seat 5: father2008 folded before Flop (didn't bet)
Seat 6: wilsson1974 mucked [Td Tc]



PokerStars Zoom Hand #257975299973:  Hold'em No Limit (€0.01/€0.02) [ADM ID: M62BA304494E32ST] - 2025/10/02 23:10:42 CET [2025/10/02 17:10:42 ET]
Table 'Sirio' 6-max Seat #1 is the button
Seat 1: RRgalp (€7.46 in chips) 
Seat 2: AntonioKrakka (€2.93 in chips) 
Seat 3: lapo1987 (€2.44 in chips) 
Seat 4: caduceus369 (€1.56 in chips) 
Seat 5: stfuplzudonk (€1.70 in chips) 
Seat 6: cap e'bomb95 (€1.85 in chips) 
AntonioKrakka: posts small blind €0.01
lapo1987: posts big blind €0.02
*** HOLE CARDS ***
Dealt to caduceus369 [2c 5s]
caduceus369: folds 
stfuplzudonk: folds 
cap e'bomb95: folds 
RRgalp: folds 
AntonioKrakka: raises €0.04 to €0.06
lapo1987: folds 
Uncalled bet (€0.04) returned to AntonioKrakka
AntonioKrakka collected €0.04 from pot
AntonioKrakka: doesn't show hand 
*** SUMMARY ***
Total pot €0.04 | Rake €0 
Seat 1: RRgalp (button) folded before Flop (didn't bet)
Seat 2: AntonioKrakka (small blind) collected (€0.04)
Seat 3: lapo1987 (big blind) folded before Flop
Seat 4: caduceus369 folded before Flop (didn't bet)
Seat 5: stfuplzudonk folded before Flop (didn't bet)
Seat 6: cap e'bomb95 folded before Flop (didn't bet)



PokerStars Zoom Hand #257975295297:  Hold'em No Limit (€0.01/€0.02) [ADM ID: M62BA304494E32ST] - 2025/10/02 23:10:22 CET [2025/10/02 17:10:22 ET]
Table 'Sirio' 6-max Seat #1 is the button
Seat 1: gigiruk91 (€4.27 in chips) 
Seat 2: caduceus369 (€1.57 in chips) 
Seat 3: stfuplzudonk (€1.53 in chips) 
Seat 4: jackkk03 (€2.09 in chips) 
Seat 5: ADRIAN0_MEIS (€6.82 in chips) 
Seat 6: VagALiss (€2.09 in chips) 
caduceus369: posts small blind €0.01
stfuplzudonk: posts big blind €0.02
*** HOLE CARDS ***
Dealt to caduceus369 [Ac 5s]
jackkk03: folds 
ADRIAN0_MEIS: raises €0.05 to €0.07
VagALiss: folds 
gigiruk91: folds 
caduceus369: folds 
stfuplzudonk: calls €0.05
*** FLOP *** [Js Td 8s]
stfuplzudonk: checks 
ADRIAN0_MEIS: bets €0.11
stfuplzudonk: folds 
Uncalled bet (€0.11) returned to ADRIAN0_MEIS
ADRIAN0_MEIS collected €0.15 from pot
ADRIAN0_MEIS: doesn't show hand 
*** SUMMARY ***
Total pot €0.15 | Rake €0 
Board [Js Td 8s]
Seat 1: gigiruk91 (button) folded before Flop (didn't bet)
Seat 2: caduceus369 (small blind) folded before Flop
Seat 3: stfuplzudonk (big blind) folded on the Flop
Seat 4: jackkk03 folded before Flop (didn't bet)
Seat 5: ADRIAN0_MEIS collected (€0.15)
Seat 6: VagALiss folded before Flop (didn't bet)



PokerStars Zoom Hand #257975300961:  Hold'em No Limit (€0.01/€0.02) [ADM ID: M62BA304494E32ST] - 2025/10/02 23:10:46 CET [2025/10/02 17:10:46 ET]
Table 'Sirio' 6-max Seat #1 is the button
Seat 1: caduceus369 (€1.56 in chips) 
Seat 2: stfuplzudonk (€1.70 in chips) 
Seat 3: fantaasso (€2.40 in chips) 
Seat 4: gigiruk91 (€4.27 in chips) 
Seat 5: RRgalp (€7.46 in chips) 
Seat 6: gttaktchem'l (€1.52 in chips) 
stfuplzudonk: posts small blind €0.01
fantaasso: posts big blind €0.02
*** HOLE CARDS ***
Dealt to caduceus369 [3s 6c]
gigiruk91: folds 
RRgalp: folds 
gttaktchem'l: folds 
caduceus369: folds 
stfuplzudonk: folds 
Uncalled bet (€0.01) returned to fantaasso
fantaasso collected €0.02 from pot
fantaasso: doesn't show hand 
*** SUMMARY ***
Total pot €0.02 | Rake €0 
Seat 1: caduceus369 (button) folded before Flop (didn't bet)
Seat 2: stfuplzudonk (small blind) folded before Flop
Seat 3: fantaasso (big blind) collected (€0.02)
Seat 4: gigiruk91 folded before Flop (didn't bet)
Seat 5: RRgalp folded before Flop (didn't bet)
Seat 6: gttaktchem'l folded before Flop (didn't bet)



PokerStars Zoom Hand #257975299003:  Hold'em No Limit (€0.01/€0.02) [ADM ID: M62BA304494E32ST] - 2025/10/02 23:10:38 CET [2025/10/02 17:10:38 ET]
Table 'Sirio' 6-max Seat #1 is the button
Seat 1: lapo1987 (€2.44 in chips) 
Seat 2: Alex83l310 (€1.75 in chips) 
Seat 3: bravo1270 (€0.79 in chips) 
Seat 4: gigiruk91 (€4.27 in chips) 
Seat 5: caduceus369 (€1.56 in chips) 
Seat 6: MVGOO (€0.93 in chips) 
Alex83l310: posts small blind €0.01
bravo1270: posts big blind €0.02
*** HOLE CARDS ***
Dealt to caduceus369 [2c Th]
gigiruk91: folds 
caduceus369: folds 
MVGOO: folds 
lapo1987: folds 
Alex83l310: calls €0.01
bravo1270: checks 
*** FLOP *** [8d 9c Ad]
Alex83l310: checks 
bravo1270: checks 
*** TURN *** [8d 9c Ad] [Kd]
Alex83l310: checks 
bravo1270: bets €0.02
Alex83l310: folds 
Uncalled bet (€0.02) returned to bravo1270
bravo1270 collected €0.04 from pot
bravo1270: doesn't show hand 
*** SUMMARY ***
Total pot €0.04 | Rake €0 
Board [8d 9c Ad Kd]
Seat 1: lapo1987 (button) folded before Flop (didn't bet)
Seat 2: Alex83l310 (small blind) folded on the Turn
Seat 3: bravo1270 (big blind) collected (€0.04)
Seat 4: gigiruk91 folded before Flop (didn't bet)
Seat 5: caduceus369 folded before Flop (didn't bet)
Seat 6: MVGOO folded before Flop (didn't bet)



PokerStars Zoom Hand #257975303856:  Hold'em No Limit (€0.01/€0.02) [ADM ID: M62BA304494E32ST] - 2025/10/02 23:10:58 CET [2025/10/02 17:10:58 ET]
Table 'Sirio' 6-max Seat #1 is the button
Seat 1: stfuplzudonk (€1.90 in chips) 
Seat 2: caduceus369 (€1.56 in chips) 
Seat 3: father2008 (€3.24 in chips) 
Seat 4: fantaasso (€2.41 in chips) 
Seat 5: ADRIAN0_MEIS (€2.87 in chips) 
Seat 6: gigiruk91 (€10.32 in chips) 
caduceus369: posts small blind €0.01
father2008: posts big blind €0.02
*** HOLE CARDS ***
Dealt to caduceus369 [Jh Td]
fantaasso: folds 
ADRIAN0_MEIS: folds 
gigiruk91: folds 
stfuplzudonk: raises €0.02 to €0.04
caduceus369: folds 
father2008: folds 
Uncalled bet (€0.02) returned to stfuplzudonk
stfuplzudonk collected €0.05 from pot
stfuplzudonk: doesn't show hand 
*** SUMMARY ***
Total pot €0.05 | Rake €0 
Seat 1: stfuplzudonk (button) collected (€0.05)
Seat 2: caduceus369 (small blind) folded before Flop
Seat 3: father2008 (big blind) folded before Flop
Seat 4: fantaasso folded before Flop (didn't bet)
Seat 5: ADRIAN0_MEIS folded before Flop (didn't bet)
Seat 6: gigiruk91 folded before Flop (didn't bet)



PokerStars Zoom Hand #257975309136:  Hold'em No Limit (€0.01/€0.02) [ADM ID: M62BA304494E32ST] - 2025/10/02 23:11:20 CET [2025/10/02 17:11:20 ET]
Table 'Sirio' 6-max Seat #1 is the button
Seat 1: TripInter (€1.45 in chips) 
Seat 2: Andsara21 (€0.81 in chips) 
Seat 3: caduceus369 (€1.55 in chips) 
Seat 4: irenuccia33 (€3.85 in chips) 
Seat 5: Warterror90 (€3.76 in chips) 
Seat 6: AntonioKrakka (€3.12 in chips) 
Andsara21: posts small blind €0.01
caduceus369: posts big blind €0.02
*** HOLE CARDS ***
Dealt to caduceus369 [3d 7h]
irenuccia33: folds 
Warterror90: folds 
AntonioKrakka: folds 
TripInter: folds 
Andsara21: folds 
Uncalled bet (€0.01) returned to caduceus369
caduceus369 collected €0.02 from pot
caduceus369: doesn't show hand 
*** SUMMARY ***
Total pot €0.02 | Rake €0 
Seat 1: TripInter (button) folded before Flop (didn't bet)
Seat 2: Andsara21 (small blind) folded before Flop
Seat 3: caduceus369 (big blind) collected (€0.02)
Seat 4: irenuccia33 folded before Flop (didn't bet)
Seat 5: Warterror90 folded before Flop (didn't bet)
Seat 6: AntonioKrakka folded before Flop (didn't bet)



PokerStars Zoom Hand #257975307601:  Hold'em No Limit (€0.01/€0.02) [ADM ID: M62BA304494E32ST] - 2025/10/02 23:11:13 CET [2025/10/02 17:11:13 ET]
Table 'Sirio' 6-max Seat #1 is the button
Seat 1: stfuplzudonk (€1.72 in chips) 
Seat 2: ADRIAN0_MEIS (€2.87 in chips) 
Seat 3: Catania838 (€1.80 in chips) 
Seat 4: wilsson1974 (€0.37 in chips) 
Seat 5: AntonioKrakka (€1.83 in chips) 
Seat 6: caduceus369 (€1.55 in chips) 
ADRIAN0_MEIS: posts small blind €0.01
Catania838: posts big blind €0.02
*** HOLE CARDS ***
Dealt to caduceus369 [Kd 6d]
wilsson1974: folds 
AntonioKrakka: folds 
caduceus369: folds 
stfuplzudonk: folds 
ADRIAN0_MEIS: folds 
Uncalled bet (€0.01) returned to Catania838
Catania838 collected €0.02 from pot
Catania838: doesn't show hand 
*** SUMMARY ***
Total pot €0.02 | Rake €0 
Seat 1: stfuplzudonk (button) folded before Flop (didn't bet)
Seat 2: ADRIAN0_MEIS (small blind) folded before Flop
Seat 3: Catania838 (big blind) collected (€0.02)
Seat 4: wilsson1974 folded before Flop (didn't bet)
Seat 5: AntonioKrakka folded before Flop (didn't bet)
Seat 6: caduceus369 folded before Flop (didn't bet)



PokerStars Zoom Hand #257975313240:  Hold'em No Limit (€0.01/€0.02) [ADM ID: M62BA304494E32ST] - 2025/10/02 23:11:37 CET [2025/10/02 17:11:37 ET]
Table 'Sirio' 6-max Seat #1 is the button
Seat 1: Catania838 (€1.81 in chips) 
Seat 2: meteco79 (€1.14 in chips) 
Seat 3: gigiruk91 (€5.95 in chips) 
Seat 4: VagALiss (€2.07 in chips) 
Seat 5: caduceus369 (€1.56 in chips) 
Seat 6: AntonioKrakka (€3.12 in chips) 
meteco79: posts small blind €0.01
gigiruk91: posts big blind €0.02
*** HOLE CARDS ***
Dealt to caduceus369 [4h 6c]
VagALiss: folds 
caduceus369: folds 
AntonioKrakka: raises €0.05 to €0.07
Catania838: folds 
meteco79: folds 
gigiruk91: folds 
Uncalled bet (€0.05) returned to AntonioKrakka
AntonioKrakka collected €0.05 from pot
AntonioKrakka: doesn't show hand 
*** SUMMARY ***
Total pot €0.05 | Rake €0 
Seat 1: Catania838 (button) folded before Flop (didn't bet)
Seat 2: meteco79 (small blind) folded before Flop
Seat 3: gigiruk91 (big blind) folded before Flop
Seat 4: VagALiss folded before Flop (didn't bet)
Seat 5: caduceus369 folded before Flop (didn't bet)
Seat 6: AntonioKrakka collected (€0.05)



PokerStars Zoom Hand #257975302942:  Hold'em No Limit (€0.01/€0.02) [ADM ID: M62BA304494E32ST] - 2025/10/02 23:10:54 CET [2025/10/02 17:10:54 ET]
Table 'Sirio' 6-max Seat #1 is the button
Seat 1: Gabrielefante (€5.20 in chips) 
Seat 2: pistaKKio23 (€1.76 in chips) 
Seat 3: raffo2712 (€0.90 in chips) 
Seat 4: Oiad (€2.07 in chips) 
Seat 5: stfuplzudonk (€1.50 in chips) 
Seat 6: caduceus369 (€1.56 in chips) 
pistaKKio23: posts small blind €0.01
raffo2712: posts big blind €0.02
*** HOLE CARDS ***
Dealt to caduceus369 [Kc 5h]
Oiad: folds 
stfuplzudonk: folds 
caduceus369: folds 
Gabrielefante: raises €0.06 to €0.08
pistaKKio23: folds 
raffo2712: calls €0.06
*** FLOP *** [6h 2s 9s]
raffo2712: checks 
Gabrielefante: bets €0.08
raffo2712: calls €0.08
*** TURN *** [6h 2s 9s] [2d]
raffo2712: checks 
Gabrielefante: bets €0.14
raffo2712: raises €0.14 to €0.28
Gabrielefante: calls €0.14
*** RIVER *** [6h 2s 9s 2d] [8d]
raffo2712: bets €0.02
Gabrielefante: raises €0.31 to €0.33
raffo2712: calls €0.31
*** SHOW DOWN ***
Gabrielefante: shows [2h 2c] (four of a kind, Deuces)
raffo2712: mucks hand 
Gabrielefante collected €1.47 from pot
*** SUMMARY ***
Total pot €1.55 | Rake €0.08 
Board [6h 2s 9s 2d 8d]
Seat 1: Gabrielefante (button) showed [2h 2c] and won (€1.47) with four of a kind, Deuces
Seat 2: pistaKKio23 (small blind) folded before Flop
Seat 3: raffo2712 (big blind) mucked [7c 9c]
Seat 4: Oiad folded before Flop (didn't bet)
Seat 5: stfuplzudonk folded before Flop (didn't bet)
Seat 6: caduceus369 folded before Flop (didn't bet)



PokerStars Zoom Hand #257975314322:  Hold'em No Limit (€0.01/€0.02) [ADM ID: M62BA304494E32ST] - 2025/10/02 23:11:41 CET [2025/10/02 17:11:41 ET]
Table 'Sirio' 6-max Seat #1 is the button
Seat 1: caduceus369 (€1.56 in chips) 
Seat 2: Alex83l310 (€2.02 in chips) 
Seat 3: AntonioKrakka (€1.82 in chips) 
Seat 4: gigiruk91 (€2 in chips) 
Seat 5: fantaasso (€2.37 in chips) 
Seat 6: kAllSeMPRE73 (€1.27 in chips) 
Alex83l310: posts small blind €0.01
AntonioKrakka: posts big blind €0.02
*** HOLE CARDS ***
Dealt to caduceus369 [Ks 9s]
gigiruk91: folds 
fantaasso: folds 
kAllSeMPRE73: folds 
caduceus369: raises €0.02 to €0.04
Alex83l310: folds 
AntonioKrakka: calls €0.02
*** FLOP *** [4h 7d 4d]
AntonioKrakka: checks 
caduceus369: checks 
*** TURN *** [4h 7d 4d] [5h]
AntonioKrakka: checks 
caduceus369: bets €0.02
AntonioKrakka: folds 
Uncalled bet (€0.02) returned to caduceus369
caduceus369 collected €0.09 from pot
caduceus369: doesn't show hand 
*** SUMMARY ***
Total pot €0.09 | Rake €0 
Board [4h 7d 4d 5h]
Seat 1: caduceus369 (button) collected (€0.09)
Seat 2: Alex83l310 (small blind) folded before Flop
Seat 3: AntonioKrakka (big blind) folded on the Turn
Seat 4: gigiruk91 folded before Flop (didn't bet)
Seat 5: fantaasso folded before Flop (didn't bet)
Seat 6: kAllSeMPRE73 folded before Flop (didn't bet)



PokerStars Zoom Hand #257975311705:  Hold'em No Limit (€0.01/€0.02) [ADM ID: M62BA304494E32ST] - 2025/10/02 23:11:30 CET [2025/10/02 17:11:30 ET]
Table 'Sirio' 6-max Seat #1 is the button
Seat 1: Anna2141 (€1.63 in chips) 
Seat 2: cap e'bomb95 (€2.05 in chips) 
Seat 3: irenuccia33 (€3.85 in chips) 
Seat 4: caduceus369 (€1.56 in chips) 
Seat 5: diesel197474 (€2.02 in chips) 
Seat 6: Oiad (€2.09 in chips) 
cap e'bomb95: posts small blind €0.01
irenuccia33: posts big blind €0.02
*** HOLE CARDS ***
Dealt to caduceus369 [8c 9s]
caduceus369: folds 
diesel197474: calls €0.02
Oiad: folds 
Anna2141: calls €0.02
cap e'bomb95: calls €0.01
irenuccia33: checks 
*** FLOP *** [3h 3c 4d]
cap e'bomb95: checks 
irenuccia33: checks 
diesel197474: checks 
Anna2141: bets €0.02
cap e'bomb95: folds 
irenuccia33: folds 
diesel197474: folds 
Uncalled bet (€0.02) returned to Anna2141
Anna2141 collected €0.08 from pot
Anna2141: doesn't show hand 
*** SUMMARY ***
Total pot €0.08 | Rake €0 
Board [3h 3c 4d]
Seat 1: Anna2141 (button) collected (€0.08)
Seat 2: cap e'bomb95 (small blind) folded on the Flop
Seat 3: irenuccia33 (big blind) folded on the Flop
Seat 4: caduceus369 folded before Flop (didn't bet)
Seat 5: diesel197474 folded on the Flop
Seat 6: Oiad folded before Flop (didn't bet)



PokerStars Zoom Hand #257975322590:  Hold'em No Limit (€0.01/€0.02) [ADM ID: M62BA304494E32ST] - 2025/10/02 23:12:16 CET [2025/10/02 17:12:16 ET]
Table 'Sirio' 6-max Seat #1 is the button
Seat 1: Warterror90 (€3.18 in chips) 
Seat 2: lapo1987 (€2.20 in chips) 
Seat 3: caduceus369 (€1.60 in chips) 
Seat 4: Kingo690 (€3.32 in chips) 
Seat 5: Oiad (€2.10 in chips) 
Seat 6: bravo1270 (€0.73 in chips) 
lapo1987: posts small blind €0.01
caduceus369: posts big blind €0.02
*** HOLE CARDS ***
Dealt to caduceus369 [9c 6h]
Kingo690: folds 
Oiad: folds 
bravo1270: calls €0.02
Warterror90: raises €0.04 to €0.06
lapo1987: folds 
caduceus369: folds 
bravo1270: raises €0.67 to €0.73 and is all-in
Warterror90: folds 
Uncalled bet (€0.67) returned to bravo1270
bravo1270 collected €0.15 from pot
bravo1270: doesn't show hand 
*** SUMMARY ***
Total pot €0.15 | Rake €0 
Seat 1: Warterror90 (button) folded before Flop
Seat 2: lapo1987 (small blind) folded before Flop
Seat 3: caduceus369 (big blind) folded before Flop
Seat 4: Kingo690 folded before Flop (didn't bet)
Seat 5: Oiad folded before Flop (didn't bet)
Seat 6: bravo1270 collected (€0.15)



PokerStars Zoom Hand #257975321884:  Hold'em No Limit (€0.01/€0.02) [ADM ID: M62BA304494E32ST] - 2025/10/02 23:12:13 CET [2025/10/02 17:12:13 ET]
Table 'Sirio' 6-max Seat #1 is the button
Seat 1: meteco79 (€1.13 in chips) 
Seat 2: caduceus369 (€1.61 in chips) 
Seat 3: Alex83l310 (€2.01 in chips) 
Seat 4: diesel197474 (€2 in chips) 
Seat 5: Catania838 (€1.45 in chips) 
Seat 6: jackkk03 (€2.56 in chips) 
caduceus369: posts small blind €0.01
Alex83l310: posts big blind €0.02
*** HOLE CARDS ***
Dealt to caduceus369 [2d 7s]
diesel197474: calls €0.02
Catania838: calls €0.02
jackkk03: calls €0.02
meteco79 has timed out
meteco79: folds 
caduceus369: folds 
Alex83l310: checks 
*** FLOP *** [9d 3s 8d]
Alex83l310: checks 
diesel197474: bets €0.02
Catania838: folds 
jackkk03: calls €0.02
Alex83l310: folds 
*** TURN *** [9d 3s 8d] [Jc]
diesel197474: bets €0.02
jackkk03: calls €0.02
*** RIVER *** [9d 3s 8d Jc] [4h]
diesel197474: checks 
jackkk03: checks 
*** SHOW DOWN ***
diesel197474: shows [Td Ad] (high card Ace)
jackkk03: shows [8h Qh] (a pair of Eights)
jackkk03 collected €0.17 from pot
*** SUMMARY ***
Total pot €0.17 | Rake €0 
Board [9d 3s 8d Jc 4h]
Seat 1: meteco79 (button) folded before Flop (didn't bet)
Seat 2: caduceus369 (small blind) folded before Flop
Seat 3: Alex83l310 (big blind) folded on the Flop
Seat 4: diesel197474 showed [Td Ad] and lost with high card Ace
Seat 5: Catania838 folded on the Flop
Seat 6: jackkk03 showed [8h Qh] and won (€0.17) with a pair of Eights



PokerStars Zoom Hand #257975327517:  Hold'em No Limit (€0.01/€0.02) [ADM ID: M62BA304494E32ST] - 2025/10/02 23:12:36 CET [2025/10/02 17:12:36 ET]
Table 'Sirio' 6-max Seat #1 is the button
Seat 1: eleonora50 (€1.41 in chips) 
Seat 2: Andsara21 (€0.81 in chips) 
Seat 3: Warterror90 (€2 in chips) 
Seat 4: gigiruk91 (€4.24 in chips) 
Seat 5: caduceus369 (€1.58 in chips) 
Seat 6: wilsson1974 (€0.66 in chips) 
Andsara21: posts small blind €0.01
Warterror90: posts big blind €0.02
*** HOLE CARDS ***
Dealt to caduceus369 [8d 9c]
gigiruk91: folds 
caduceus369: folds 
wilsson1974: calls €0.02
eleonora50: folds 
Andsara21: folds 
Warterror90: checks 
*** FLOP *** [7s Kh 5d]
Warterror90: bets €0.02
wilsson1974: calls €0.02
*** TURN *** [7s Kh 5d] [6c]
Warterror90: checks 
wilsson1974: bets €0.02
Warterror90: calls €0.02
*** RIVER *** [7s Kh 5d 6c] [Js]
Warterror90: checks 
wilsson1974: checks 
*** SHOW DOWN ***
Warterror90: shows [5s Th] (a pair of Fives)
wilsson1974: shows [6d 4d] (a pair of Sixes)
wilsson1974 collected €0.13 from pot
*** SUMMARY ***
Total pot €0.13 | Rake €0 
Board [7s Kh 5d 6c Js]
Seat 1: eleonora50 (button) folded before Flop (didn't bet)
Seat 2: Andsara21 (small blind) folded before Flop
Seat 3: Warterror90 (big blind) showed [5s Th] and lost with a pair of Fives
Seat 4: gigiruk91 folded before Flop (didn't bet)
Seat 5: caduceus369 folded before Flop (didn't bet)
Seat 6: wilsson1974 showed [6d 4d] and won (€0.13) with a pair of Sixes



PokerStars Zoom Hand #257975328933:  Hold'em No Limit (€0.01/€0.02) [ADM ID: M62BA304494E32ST] - 2025/10/02 23:12:42 CET [2025/10/02 17:12:42 ET]
Table 'Sirio' 6-max Seat #1 is the button
Seat 1: luchetto1990 (€3.96 in chips) 
Seat 2: muhozhuk788 (€2.04 in chips) 
Seat 3: Andsara21 (€0.80 in chips) 
Seat 4: Oiad (€2.85 in chips) 
Seat 5: gigiruk91 (€5.91 in chips) 
Seat 6: caduceus369 (€1.58 in chips) 
muhozhuk788: posts small blind €0.01
Andsara21: posts big blind €0.02
*** HOLE CARDS ***
Dealt to caduceus369 [Js Ah]
Oiad: raises €0.08 to €0.10
gigiruk91: folds 
caduceus369: folds 
luchetto1990: folds 
muhozhuk788: folds 
Andsara21: folds 
Uncalled bet (€0.08) returned to Oiad
Oiad collected €0.05 from pot
Oiad: doesn't show hand 
*** SUMMARY ***
Total pot €0.05 | Rake €0 
Seat 1: luchetto1990 (button) folded before Flop (didn't bet)
Seat 2: muhozhuk788 (small blind) folded before Flop
Seat 3: Andsara21 (big blind) folded before Flop
Seat 4: Oiad collected (€0.05)
Seat 5: gigiruk91 folded before Flop (didn't bet)
Seat 6: caduceus369 folded before Flop (didn't bet)



PokerStars Zoom Hand #257975321143:  Hold'em No Limit (€0.01/€0.02) [ADM ID: M62BA304494E32ST] - 2025/10/02 23:12:09 CET [2025/10/02 17:12:09 ET]
Table 'Sirio' 6-max Seat #1 is the button
Seat 1: Andsara21 (€0.83 in chips) 
Seat 2: campiraudii (€1.21 in chips) 
Seat 3: bravo1270 (€0.75 in chips) 
Seat 4: caduceus369 (€1.61 in chips) 
Seat 5: AlfredP80 (€3.62 in chips) 
Seat 6: pistaKKio23 (€1.86 in chips) 
campiraudii: posts small blind €0.01
bravo1270: posts big blind €0.02
*** HOLE CARDS ***
Dealt to caduceus369 [8h 3c]
caduceus369: folds 
AlfredP80: raises €0.04 to €0.06
pistaKKio23: folds 
Andsara21: folds 
campiraudii: calls €0.05
bravo1270: folds 
*** FLOP *** [5d 9d Js]
campiraudii: checks 
AlfredP80: bets €0.06
campiraudii: calls €0.06
*** TURN *** [5d 9d Js] [Td]
campiraudii: checks 
AlfredP80: checks 
*** RIVER *** [5d 9d Js Td] [8s]
campiraudii: bets €0.25
AlfredP80: calls €0.25
*** SHOW DOWN ***
campiraudii: shows [Kh 4h] (high card King)
AlfredP80: shows [Qh Ac] (a straight, Eight to Queen)
AlfredP80 collected €0.72 from pot
*** SUMMARY ***
Total pot €0.76 | Rake €0.04 
Board [5d 9d Js Td 8s]
Seat 1: Andsara21 (button) folded before Flop (didn't bet)
Seat 2: campiraudii (small blind) showed [Kh 4h] and lost with high card King
Seat 3: bravo1270 (big blind) folded before Flop
Seat 4: caduceus369 folded before Flop (didn't bet)
Seat 5: AlfredP80 showed [Qh Ac] and won (€0.72) with a straight, Eight to Queen
Seat 6: pistaKKio23 folded before Flop (didn't bet)



PokerStars Zoom Hand #257975333019:  Hold'em No Limit (€0.01/€0.02) [ADM ID: M62BA304494E32ST] - 2025/10/02 23:12:59 CET [2025/10/02 17:12:59 ET]
Table 'Sirio' 6-max Seat #1 is the button
Seat 1: caduceus369 (€1.58 in chips) 
Seat 2: montemeru (€1.58 in chips) 
Seat 3: Redraw2Flush (€0.77 in chips) 
Seat 4: diesel197474 (€1.94 in chips) 
Seat 5: ADRIAN0_MEIS (€2 in chips) 
Seat 6: gigiruk91 (€5.91 in chips) 
montemeru: posts small blind €0.01
Redraw2Flush: posts big blind €0.02
*** HOLE CARDS ***
Dealt to caduceus369 [3h 3d]
diesel197474: folds 
ADRIAN0_MEIS: folds 
gigiruk91: raises €0.02 to €0.04
caduceus369: folds 
montemeru: folds 
Redraw2Flush: folds 
Uncalled bet (€0.02) returned to gigiruk91
gigiruk91 collected €0.05 from pot
gigiruk91: doesn't show hand 
*** SUMMARY ***
Total pot €0.05 | Rake €0 
Seat 1: caduceus369 (button) folded before Flop (didn't bet)
Seat 2: montemeru (small blind) folded before Flop
Seat 3: Redraw2Flush (big blind) folded before Flop
Seat 4: diesel197474 folded before Flop (didn't bet)
Seat 5: ADRIAN0_MEIS folded before Flop (didn't bet)
Seat 6: gigiruk91 collected (€0.05)



PokerStars Zoom Hand #257975335320:  Hold'em No Limit (€0.01/€0.02) [ADM ID: M62BA304494E32ST] - 2025/10/02 23:13:08 CET [2025/10/02 17:13:08 ET]
Table 'Sirio' 6-max Seat #1 is the button
Seat 1: Oiad (€2.88 in chips) 
Seat 2: caduceus369 (€1.58 in chips) 
Seat 3: Anna2141 (€4.67 in chips) 
Seat 4: fantaasso (€0.68 in chips) 
Seat 5: lapo1987 (€2.14 in chips) 
Seat 6: pistaKKio23 (€2.11 in chips) 
caduceus369: posts small blind €0.01
Anna2141: posts big blind €0.02
*** HOLE CARDS ***
Dealt to caduceus369 [2d Kc]
fantaasso: folds 
lapo1987: folds 
pistaKKio23: folds 
Oiad: folds 
caduceus369: folds 
Uncalled bet (€0.01) returned to Anna2141
Anna2141 collected €0.02 from pot
Anna2141: doesn't show hand 
*** SUMMARY ***
Total pot €0.02 | Rake €0 
Seat 1: Oiad (button) folded before Flop (didn't bet)
Seat 2: caduceus369 (small blind) folded before Flop
Seat 3: Anna2141 (big blind) collected (€0.02)
Seat 4: fantaasso folded before Flop (didn't bet)
Seat 5: lapo1987 folded before Flop (didn't bet)
Seat 6: pistaKKio23 folded before Flop (didn't bet)



PokerStars Zoom Hand #257975338077:  Hold'em No Limit (€0.01/€0.02) [ADM ID: M62BA304494E32ST] - 2025/10/02 23:13:20 CET [2025/10/02 17:13:20 ET]
Table 'Sirio' 6-max Seat #1 is the button
Seat 1: stfuplzudonk (€1.46 in chips) 
Seat 2: Oiad (€2.88 in chips) 
Seat 3: caduceus369 (€1.57 in chips) 
Seat 4: VagALiss (€2.02 in chips) 
Seat 5: sancarlo18 (€2.48 in chips) 
Seat 6: AntonioKrakka (€3.05 in chips) 
Oiad: posts small blind €0.01
caduceus369: posts big blind €0.02
*** HOLE CARDS ***
Dealt to caduceus369 [6h 7s]
VagALiss: folds 
sancarlo18: folds 
AntonioKrakka: folds 
stfuplzudonk: folds 
Oiad: folds 
Uncalled bet (€0.01) returned to caduceus369
caduceus369 collected €0.02 from pot
caduceus369: doesn't show hand 
*** SUMMARY ***
Total pot €0.02 | Rake €0 
Seat 1: stfuplzudonk (button) folded before Flop (didn't bet)
Seat 2: Oiad (small blind) folded before Flop
Seat 3: caduceus369 (big blind) collected (€0.02)
Seat 4: VagALiss folded before Flop (didn't bet)
Seat 5: sancarlo18 folded before Flop (didn't bet)
Seat 6: AntonioKrakka folded before Flop (didn't bet)



PokerStars Zoom Hand #257975336317:  Hold'em No Limit (€0.01/€0.02) [ADM ID: M62BA304494E32ST] - 2025/10/02 23:13:12 CET [2025/10/02 17:13:12 ET]
Table 'Sirio' 6-max Seat #1 is the button
Seat 1: bravo1270 (€0.76 in chips) 
Seat 2: cap e'bomb95 (€2.39 in chips) 
Seat 3: Sorosuno (€2 in chips) 
Seat 4: rush572 (€0.88 in chips) 
Seat 5: caduceus369 (€1.57 in chips) 
Seat 6: Warterror90 (€1.93 in chips) 
cap e'bomb95: posts small blind €0.01
Sorosuno: posts big blind €0.02
*** HOLE CARDS ***
Dealt to caduceus369 [3h Td]
rush572: calls €0.02
caduceus369: folds 
Warterror90: folds 
bravo1270: folds 
cap e'bomb95: folds 
Sorosuno: checks 
*** FLOP *** [Ah Qc 7h]
Sorosuno: checks 
rush572: bets €0.05
Sorosuno: folds 
Uncalled bet (€0.05) returned to rush572
rush572 collected €0.05 from pot
rush572: doesn't show hand 
*** SUMMARY ***
Total pot €0.05 | Rake €0 
Board [Ah Qc 7h]
Seat 1: bravo1270 (button) folded before Flop (didn't bet)
Seat 2: cap e'bomb95 (small blind) folded before Flop
Seat 3: Sorosuno (big blind) folded on the Flop
Seat 4: rush572 collected (€0.05)
Seat 5: caduceus369 folded before Flop (didn't bet)
Seat 6: Warterror90 folded before Flop (didn't bet)



PokerStars Zoom Hand #257975336900:  Hold'em No Limit (€0.01/€0.02) [ADM ID: M62BA304494E32ST] - 2025/10/02 23:13:15 CET [2025/10/02 17:13:15 ET]
Table 'Sirio' 6-max Seat #1 is the button
Seat 1: campiraudii (€0.84 in chips) 
Seat 2: Maur2507 (€0.73 in chips) 
Seat 3: luchetto1990 (€3.95 in chips) 
Seat 4: father2008 (€3.18 in chips) 
Seat 5: AlfredP80 (€3.97 in chips) 
Seat 6: caduceus369 (€1.57 in chips) 
Maur2507: posts small blind €0.01
luchetto1990: posts big blind €0.02
*** HOLE CARDS ***
Dealt to caduceus369 [5s 8s]
father2008: raises €0.05 to €0.07
AlfredP80: calls €0.07
caduceus369: folds 
campiraudii: calls €0.07
Maur2507: folds 
luchetto1990: folds 
*** FLOP *** [3s 3h 8d]
father2008: bets €0.16
AlfredP80: folds 
campiraudii: folds 
Uncalled bet (€0.16) returned to father2008
father2008 collected €0.23 from pot
father2008: doesn't show hand 
*** SUMMARY ***
Total pot €0.24 | Rake €0.01 
Board [3s 3h 8d]
Seat 1: campiraudii (button) folded on the Flop
Seat 2: Maur2507 (small blind) folded before Flop
Seat 3: luchetto1990 (big blind) folded before Flop
Seat 4: father2008 collected (€0.23)
Seat 5: AlfredP80 folded on the Flop
Seat 6: caduceus369 folded before Flop (didn't bet)



PokerStars Zoom Hand #257975343102:  Hold'em No Limit (€0.01/€0.02) [ADM ID: M62BA304494E32ST] - 2025/10/02 23:13:40 CET [2025/10/02 17:13:40 ET]
Table 'Sirio' 6-max Seat #1 is the button
Seat 1: VagALiss (€2.01 in chips) 
Seat 2: pistaKKio23 (€4.77 in chips) 
Seat 3: father2008 (€3.34 in chips) 
Seat 4: caduceus369 (€1.58 in chips) 
Seat 5: alex96125 (€2.21 in chips) 
Seat 6: diesel197474 (€1.89 in chips) 
pistaKKio23: posts small blind €0.01
father2008: posts big blind €0.02
*** HOLE CARDS ***
Dealt to caduceus369 [Kc 6c]
caduceus369: folds 
alex96125: folds 
diesel197474: folds 
VagALiss: folds 
pistaKKio23: raises €0.04 to €0.06
father2008: folds 
Uncalled bet (€0.04) returned to pistaKKio23
pistaKKio23 collected €0.04 from pot
pistaKKio23: doesn't show hand 
*** SUMMARY ***
Total pot €0.04 | Rake €0 
Seat 1: VagALiss (button) folded before Flop (didn't bet)
Seat 2: pistaKKio23 (small blind) collected (€0.04)
Seat 3: father2008 (big blind) folded before Flop
Seat 4: caduceus369 folded before Flop (didn't bet)
Seat 5: alex96125 folded before Flop (didn't bet)
Seat 6: diesel197474 folded before Flop (didn't bet)



PokerStars Zoom Hand #257975344080:  Hold'em No Limit (€0.01/€0.02) [ADM ID: M62BA304494E32ST] - 2025/10/02 23:13:44 CET [2025/10/02 17:13:44 ET]
Table 'Sirio' 6-max Seat #1 is the button
Seat 1: irenuccia33 (€3.71 in chips) 
Seat 2: caduceus369 (€1.58 in chips) 
Seat 3: alex96125 (€2.21 in chips) 
Seat 4: VagALiss (€2.01 in chips) 
Seat 5: AntonioKrakka (€3.02 in chips) 
Seat 6: ADRIAN0_MEIS (€2.82 in chips) 
caduceus369: posts small blind €0.01
alex96125: posts big blind €0.02
*** HOLE CARDS ***
Dealt to caduceus369 [Js Jc]
VagALiss: folds 
AntonioKrakka: folds 
ADRIAN0_MEIS: raises €0.05 to €0.07
irenuccia33: folds 
caduceus369: raises €0.21 to €0.28
alex96125: folds 
ADRIAN0_MEIS: calls €0.21
*** FLOP *** [2d 5d 4h]
caduceus369: checks 
ADRIAN0_MEIS: bets €0.41
caduceus369: raises €0.89 to €1.30 and is all-in
ADRIAN0_MEIS: calls €0.89
*** TURN *** [2d 5d 4h] [Th]
*** RIVER *** [2d 5d 4h Th] [6c]
*** SHOW DOWN ***
caduceus369: shows [Js Jc] (a pair of Jacks)
ADRIAN0_MEIS: shows [7c 7h] (a pair of Sevens)
caduceus369 collected €3.01 from pot
*** SUMMARY ***
Total pot €3.18 | Rake €0.17 
Board [2d 5d 4h Th 6c]
Seat 1: irenuccia33 (button) folded before Flop (didn't bet)
Seat 2: caduceus369 (small blind) showed [Js Jc] and won (€3.01) with a pair of Jacks
Seat 3: alex96125 (big blind) folded before Flop
Seat 4: VagALiss folded before Flop (didn't bet)
Seat 5: AntonioKrakka folded before Flop (didn't bet)
Seat 6: ADRIAN0_MEIS showed [7c 7h] and lost with a pair of Sevens



PokerStars Zoom Hand #257975354220:  Hold'em No Limit (€0.01/€0.02) [ADM ID: M62BA304494E32ST] - 2025/10/02 23:14:26 CET [2025/10/02 17:14:26 ET]
Table 'Sirio' 6-max Seat #1 is the button
Seat 1: caduceus369 (€3.01 in chips) 
Seat 2: AntonioKrakka (€2.92 in chips) 
Seat 3: TonyPir97 (€0.85 in chips) 
Seat 4: RRgalp (€7.82 in chips) 
Seat 5: ADRIAN0_MEIS (€7.28 in chips) 
Seat 6: pistaKKio23 (€1.71 in chips) 
AntonioKrakka: posts small blind €0.01
TonyPir97: posts big blind €0.02
*** HOLE CARDS ***
Dealt to caduceus369 [8d Js]
RRgalp: folds 
ADRIAN0_MEIS: raises €0.05 to €0.07
pistaKKio23: folds 
caduceus369: folds 
AntonioKrakka: folds 
TonyPir97: calls €0.05
*** FLOP *** [7c Qh 3d]
TonyPir97: checks 
ADRIAN0_MEIS: checks 
*** TURN *** [7c Qh 3d] [Jh]
TonyPir97: checks 
ADRIAN0_MEIS: checks 
*** RIVER *** [7c Qh 3d Jh] [2h]
TonyPir97: checks 
ADRIAN0_MEIS: checks 
*** SHOW DOWN ***
TonyPir97: shows [7s 6h] (a pair of Sevens)
ADRIAN0_MEIS: mucks hand 
TonyPir97 collected €0.15 from pot
*** SUMMARY ***
Total pot €0.15 | Rake €0 
Board [7c Qh 3d Jh 2h]
Seat 1: caduceus369 (button) folded before Flop (didn't bet)
Seat 2: AntonioKrakka (small blind) folded before Flop
Seat 3: TonyPir97 (big blind) showed [7s 6h] and won (€0.15) with a pair of Sevens
Seat 4: RRgalp folded before Flop (didn't bet)
Seat 5: ADRIAN0_MEIS mucked [Tc Ad]
Seat 6: pistaKKio23 folded before Flop (didn't bet)



PokerStars Zoom Hand #257975355632:  Hold'em No Limit (€0.01/€0.02) [ADM ID: M62BA304494E32ST] - 2025/10/02 23:14:32 CET [2025/10/02 17:14:32 ET]
Table 'Sirio' 6-max Seat #1 is the button
Seat 1: Sorosuno (€2 in chips) 
Seat 2: campiraudii (€0.95 in chips) 
Seat 3: caduceus369 (€3.01 in chips) 
Seat 4: father2008 (€4.07 in chips) 
Seat 5: tomaok415 (€1.38 in chips) 
Seat 6: fantaasso (€1.93 in chips) 
campiraudii: posts small blind €0.01
caduceus369: posts big blind €0.02
*** HOLE CARDS ***
Dealt to caduceus369 [6s Qh]
father2008: folds 
tomaok415: folds 
fantaasso: folds 
Sorosuno: raises €0.03 to €0.05
campiraudii: calls €0.04
caduceus369: folds 
*** FLOP *** [Kd 2h Th]
campiraudii: bets €0.12
Sorosuno: calls €0.12
*** TURN *** [Kd 2h Th] [7s]
campiraudii: bets €0.18
Sorosuno: raises €0.85 to €1.03
campiraudii: calls €0.60 and is all-in
Uncalled bet (€0.25) returned to Sorosuno
*** RIVER *** [Kd 2h Th 7s] [4d]
*** SHOW DOWN ***
campiraudii: shows [9h 8h] (high card King)
Sorosuno: shows [Ks Jh] (a pair of Kings)
Sorosuno collected €1.82 from pot
*** SUMMARY ***
Total pot €1.92 | Rake €0.10 
Board [Kd 2h Th 7s 4d]
Seat 1: Sorosuno (button) showed [Ks Jh] and won (€1.82) with a pair of Kings
Seat 2: campiraudii (small blind) showed [9h 8h] and lost with high card King
Seat 3: caduceus369 (big blind) folded before Flop
Seat 4: father2008 folded before Flop (didn't bet)
Seat 5: tomaok415 folded before Flop (didn't bet)
Seat 6: fantaasso folded before Flop (didn't bet)



PokerStars Zoom Hand #257975360072:  Hold'em No Limit (€0.01/€0.02) [ADM ID: M62BA304494E32ST] - 2025/10/02 23:14:50 CET [2025/10/02 17:14:50 ET]
Table 'Sirio' 6-max Seat #1 is the button
Seat 1: Catania838 (€1.87 in chips) 
Seat 2: alex96125 (€1.31 in chips) 
Seat 3: fantaasso (€0.70 in chips) 
Seat 4: diesel197474 (€1.14 in chips) 
Seat 5: pistaKKio23 (€4.77 in chips) 
Seat 6: caduceus369 (€2.99 in chips) 
alex96125: posts small blind €0.01
fantaasso: posts big blind €0.02
*** HOLE CARDS ***
Dealt to caduceus369 [Qc Ad]
diesel197474: folds 
pistaKKio23: raises €0.02 to €0.04
caduceus369: calls €0.04
Catania838: folds 
alex96125: folds 
fantaasso: calls €0.02
*** FLOP *** [Ts Qs 2d]
fantaasso: checks 
pistaKKio23: bets €0.02
caduceus369: calls €0.02
fantaasso: folds 
*** TURN *** [Ts Qs 2d] [8d]
pistaKKio23: bets €0.09
caduceus369: calls €0.09
*** RIVER *** [Ts Qs 2d 8d] [7h]
pistaKKio23: checks 
caduceus369: bets €0.13
pistaKKio23: folds 
Uncalled bet (€0.13) returned to caduceus369
caduceus369 collected €0.34 from pot
caduceus369: doesn't show hand 
*** SUMMARY ***
Total pot €0.35 | Rake €0.01 
Board [Ts Qs 2d 8d 7h]
Seat 1: Catania838 (button) folded before Flop (didn't bet)
Seat 2: alex96125 (small blind) folded before Flop
Seat 3: fantaasso (big blind) folded on the Flop
Seat 4: diesel197474 folded before Flop (didn't bet)
Seat 5: pistaKKio23 folded on the River
Seat 6: caduceus369 collected (€0.34)



PokerStars Zoom Hand #257975379520:  Hold'em No Limit (€0.01/€0.02) [ADM ID: M62BA304494E32ST] - 2025/10/02 23:16:10 CET [2025/10/02 17:16:10 ET]
Table 'Sirio' 6-max Seat #1 is the button
Seat 1: VagALiss (€1.81 in chips) 
Seat 2: Alex83l310 (€2.17 in chips) 
Seat 3: lapo1987 (€3.77 in chips) 
Seat 4: Kingo690 (€3.29 in chips) 
Seat 5: caduceus369 (€3.18 in chips) 
Seat 6: diesel197474 (€1.11 in chips) 
Alex83l310: posts small blind €0.01
lapo1987: posts big blind €0.02
*** HOLE CARDS ***
Dealt to caduceus369 [Qs Qh]
Kingo690: folds 
caduceus369: raises €0.02 to €0.04
diesel197474: folds 
VagALiss: folds 
Alex83l310: calls €0.03
lapo1987: calls €0.02
*** FLOP *** [Tc Ks 9h]
Alex83l310: checks 
lapo1987: checks 
caduceus369: bets €0.04
Alex83l310: folds 
lapo1987: folds 
Uncalled bet (€0.04) returned to caduceus369
caduceus369 collected €0.12 from pot
caduceus369: doesn't show hand 
*** SUMMARY ***
Total pot €0.12 | Rake €0 
Board [Tc Ks 9h]
Seat 1: VagALiss (button) folded before Flop (didn't bet)
Seat 2: Alex83l310 (small blind) folded on the Flop
Seat 3: lapo1987 (big blind) folded on the Flop
Seat 4: Kingo690 folded before Flop (didn't bet)
Seat 5: caduceus369 collected (€0.12)
Seat 6: diesel197474 folded before Flop (didn't bet)



PokerStars Zoom Hand #257975385055:  Hold'em No Limit (€0.01/€0.02) [ADM ID: M62BA304494E32ST] - 2025/10/02 23:16:34 CET [2025/10/02 17:16:34 ET]
Table 'Sirio' 6-max Seat #1 is the button
Seat 1: Andsara21 (€0.64 in chips) 
Seat 2: Kingo690 (€3.30 in chips) 
Seat 3: cap e'bomb95 (€2.49 in chips) 
Seat 4: Nicoirca2004 (€1.65 in chips) 
Seat 5: Alex83l310 (€2.13 in chips) 
Seat 6: caduceus369 (€3.26 in chips) 
Kingo690: posts small blind €0.01
cap e'bomb95: posts big blind €0.02
*** HOLE CARDS ***
Dealt to caduceus369 [4h Jh]
Nicoirca2004: folds 
Alex83l310: folds 
caduceus369: folds 
Andsara21: folds 
Kingo690: calls €0.01
cap e'bomb95: checks 
*** FLOP *** [As Qh 5c]
Kingo690: checks 
cap e'bomb95: checks 
*** TURN *** [As Qh 5c] [6s]
Kingo690: bets €0.02
cap e'bomb95: folds 
Uncalled bet (€0.02) returned to Kingo690
Kingo690 collected €0.04 from pot
Kingo690: doesn't show hand 
*** SUMMARY ***
Total pot €0.04 | Rake €0 
Board [As Qh 5c 6s]
Seat 1: Andsara21 (button) folded before Flop (didn't bet)
Seat 2: Kingo690 (small blind) collected (€0.04)
Seat 3: cap e'bomb95 (big blind) folded on the Turn
Seat 4: Nicoirca2004 folded before Flop (didn't bet)
Seat 5: Alex83l310 folded before Flop (didn't bet)
Seat 6: caduceus369 folded before Flop (didn't bet)



PokerStars Zoom Hand #257975386367:  Hold'em No Limit (€0.01/€0.02) [ADM ID: M62BA304494E32ST] - 2025/10/02 23:16:39 CET [2025/10/02 17:16:39 ET]
Table 'Sirio' 6-max Seat #1 is the button
Seat 1: Nicoirca2004 (€1.65 in chips) 
Seat 2: caduceus369 (€3.26 in chips) 
Seat 3: kAllSeMPRE73 (€2.24 in chips) 
Seat 4: ADRIAN0_MEIS (€7.24 in chips) 
Seat 5: meteco79 (€1.37 in chips) 
Seat 6: wilsson1974 (€0.42 in chips) 
caduceus369: posts small blind €0.01
kAllSeMPRE73: posts big blind €0.02
*** HOLE CARDS ***
Dealt to caduceus369 [5h 9h]
ADRIAN0_MEIS: folds 
meteco79: folds 
wilsson1974: folds 
Nicoirca2004: folds 
caduceus369: folds 
Uncalled bet (€0.01) returned to kAllSeMPRE73
kAllSeMPRE73 collected €0.02 from pot
kAllSeMPRE73: doesn't show hand 
*** SUMMARY ***
Total pot €0.02 | Rake €0 
Seat 1: Nicoirca2004 (button) folded before Flop (didn't bet)
Seat 2: caduceus369 (small blind) folded before Flop
Seat 3: kAllSeMPRE73 (big blind) collected (€0.02)
Seat 4: ADRIAN0_MEIS folded before Flop (didn't bet)
Seat 5: meteco79 folded before Flop (didn't bet)
Seat 6: wilsson1974 folded before Flop (didn't bet)



PokerStars Zoom Hand #257975393320:  Hold'em No Limit (€0.01/€0.02) [ADM ID: M62BA304494E32ST] - 2025/10/02 23:17:08 CET [2025/10/02 17:17:08 ET]
Table 'Sirio' 6-max Seat #1 is the button
Seat 1: fantaasso (€1.88 in chips) 
Seat 2: pistaKKio23 (€1.79 in chips) 
Seat 3: caduceus369 (€3.25 in chips) 
Seat 4: VagALiss (€1.85 in chips) 
Seat 5: diesel197474 (€1.08 in chips) 
Seat 6: Nicoirca2004 (€1.63 in chips) 
pistaKKio23: posts small blind €0.01
caduceus369: posts big blind €0.02
*** HOLE CARDS ***
Dealt to caduceus369 [Qc 6d]
VagALiss: folds 
diesel197474: folds 
Nicoirca2004: folds 
fantaasso: folds 
pistaKKio23: folds 
Uncalled bet (€0.01) returned to caduceus369
caduceus369 collected €0.02 from pot
caduceus369: doesn't show hand 
*** SUMMARY ***
Total pot €0.02 | Rake €0 
Seat 1: fantaasso (button) folded before Flop (didn't bet)
Seat 2: pistaKKio23 (small blind) folded before Flop
Seat 3: caduceus369 (big blind) collected (€0.02)
Seat 4: VagALiss folded before Flop (didn't bet)
Seat 5: diesel197474 folded before Flop (didn't bet)
Seat 6: Nicoirca2004 folded before Flop (didn't bet)



PokerStars Zoom Hand #257975391861:  Hold'em No Limit (€0.01/€0.02) [ADM ID: M62BA304494E32ST] - 2025/10/02 23:17:01 CET [2025/10/02 17:17:01 ET]
Table 'Sirio' 6-max Seat #1 is the button
Seat 1: caduceus369 (€3.25 in chips) 
Seat 2: gigiruk91 (€6.24 in chips) 
Seat 3: lapo1987 (€3.72 in chips) 
Seat 4: VagALiss (€1.85 in chips) 
Seat 5: Nicoirca2004 (€1.63 in chips) 
Seat 6: campiraudii (€2.18 in chips) 
gigiruk91: posts small blind €0.01
lapo1987: posts big blind €0.02
*** HOLE CARDS ***
Dealt to caduceus369 [5h Qs]
VagALiss: folds 
Nicoirca2004: folds 
campiraudii: raises €0.05 to €0.07
caduceus369: folds 
gigiruk91: folds 
lapo1987: folds 
Uncalled bet (€0.05) returned to campiraudii
campiraudii collected €0.05 from pot
campiraudii: doesn't show hand 
*** SUMMARY ***
Total pot €0.05 | Rake €0 
Seat 1: caduceus369 (button) folded before Flop (didn't bet)
Seat 2: gigiruk91 (small blind) folded before Flop
Seat 3: lapo1987 (big blind) folded before Flop
Seat 4: VagALiss folded before Flop (didn't bet)
Seat 5: Nicoirca2004 folded before Flop (didn't bet)
Seat 6: campiraudii collected (€0.05)



PokerStars Zoom Hand #257975395978:  Hold'em No Limit (€0.01/€0.02) [ADM ID: M62BA304494E32ST] - 2025/10/02 23:17:19 CET [2025/10/02 17:17:19 ET]
Table 'Sirio' 6-max Seat #1 is the button
Seat 1: lapo1987 (€3.70 in chips) 
Seat 2: alex96125 (€1.20 in chips) 
Seat 3: stfuplzudonk (€3.57 in chips) 
Seat 4: Nicoirca2004 (€1.62 in chips) 
Seat 5: caduceus369 (€3.26 in chips) 
Seat 6: gigiruk91 (€2.29 in chips) 
alex96125: posts small blind €0.01
stfuplzudonk: posts big blind €0.02
*** HOLE CARDS ***
Dealt to caduceus369 [5h 4s]
Nicoirca2004: folds 
caduceus369: folds 
gigiruk91: folds 
lapo1987: folds 
alex96125 is disconnected 
alex96125 has timed out while disconnected
alex96125: folds 
Uncalled bet (€0.01) returned to stfuplzudonk
stfuplzudonk collected €0.02 from pot
stfuplzudonk: doesn't show hand 
*** SUMMARY ***
Total pot €0.02 | Rake €0 
Seat 1: lapo1987 (button) folded before Flop (didn't bet)
Seat 2: alex96125 (small blind) folded before Flop
Seat 3: stfuplzudonk (big blind) collected (€0.02)
Seat 4: Nicoirca2004 folded before Flop (didn't bet)
Seat 5: caduceus369 folded before Flop (didn't bet)
Seat 6: gigiruk91 folded before Flop (didn't bet)



PokerStars Zoom Hand #257975397214:  Hold'em No Limit (€0.01/€0.02) [ADM ID: M62BA304494E32ST] - 2025/10/02 23:17:24 CET [2025/10/02 17:17:24 ET]
Table 'Sirio' 6-max Seat #1 is the button
Seat 1: Nicoirca2004 (€1.62 in chips) 
Seat 2: stfuplzudonk (€2.15 in chips) 
Seat 3: father2008 (€4.03 in chips) 
Seat 4: Sium12302 (€2.01 in chips) 
Seat 5: VagALiss (€1.84 in chips) 
Seat 6: caduceus369 (€3.26 in chips) 
stfuplzudonk: posts small blind €0.01
father2008: posts big blind €0.02
*** HOLE CARDS ***
Dealt to caduceus369 [Ks 8s]
Sium12302: folds 
VagALiss: folds 
caduceus369 has timed out
caduceus369: folds 
Nicoirca2004: raises €0.04 to €0.06
stfuplzudonk: calls €0.05
father2008: folds 
*** FLOP *** [Qd Th Qc]
stfuplzudonk: checks 
Nicoirca2004: bets €0.06
stfuplzudonk: folds 
Uncalled bet (€0.06) returned to Nicoirca2004
Nicoirca2004 collected €0.14 from pot
Nicoirca2004: doesn't show hand 
*** SUMMARY ***
Total pot €0.14 | Rake €0 
Board [Qd Th Qc]
Seat 1: Nicoirca2004 (button) collected (€0.14)
Seat 2: stfuplzudonk (small blind) folded on the Flop
Seat 3: father2008 (big blind) folded before Flop
Seat 4: Sium12302 folded before Flop (didn't bet)
Seat 5: VagALiss folded before Flop (didn't bet)
Seat 6: caduceus369 folded before Flop (didn't bet)



PokerStars Zoom Hand #257975402172:  Hold'em No Limit (€0.01/€0.02) [ADM ID: M62BA304494E32ST] - 2025/10/02 23:17:45 CET [2025/10/02 17:17:45 ET]
Table 'Sirio' 6-max Seat #1 is the button
Seat 1: caduceus369 (€3.26 in chips) 
Seat 2: irenuccia33 (€3.74 in chips) 
Seat 3: AntonioKrakka (€1.37 in chips) 
Seat 4: Alex83l310 (€2.07 in chips) 
Seat 5: TripInter (€0.77 in chips) 
Seat 6: Warterror90 (€1.82 in chips) 
irenuccia33: posts small blind €0.01
AntonioKrakka: posts big blind €0.02
*** HOLE CARDS ***
Dealt to caduceus369 [8h 9h]
Alex83l310: folds 
TripInter: folds 
Warterror90: folds 
caduceus369: raises €0.02 to €0.04
irenuccia33: calls €0.03
AntonioKrakka: folds 
*** FLOP *** [6d 2h 3s]
irenuccia33: checks 
caduceus369: checks 
*** TURN *** [6d 2h 3s] [Jc]
irenuccia33: checks 
caduceus369: bets €0.04
irenuccia33: calls €0.04
*** RIVER *** [6d 2h 3s Jc] [Qs]
irenuccia33: checks 
caduceus369: bets €0.06
irenuccia33: calls €0.06
*** SHOW DOWN ***
caduceus369: shows [8h 9h] (high card Queen)
irenuccia33: shows [8c Js] (a pair of Jacks)
irenuccia33 collected €0.29 from pot
*** SUMMARY ***
Total pot €0.30 | Rake €0.01 
Board [6d 2h 3s Jc Qs]
Seat 1: caduceus369 (button) showed [8h 9h] and lost with high card Queen
Seat 2: irenuccia33 (small blind) showed [8c Js] and won (€0.29) with a pair of Jacks
Seat 3: AntonioKrakka (big blind) folded before Flop
Seat 4: Alex83l310 folded before Flop (didn't bet)
Seat 5: TripInter folded before Flop (didn't bet)
Seat 6: Warterror90 folded before Flop (didn't bet)



PokerStars Zoom Hand #257975420152:  Hold'em No Limit (€0.01/€0.02) [ADM ID: M62BA304494E32ST] - 2025/10/02 23:19:00 CET [2025/10/02 17:19:00 ET]
Table 'Sirio' 6-max Seat #1 is the button
Seat 1: father2008 (€3.36 in chips) 
Seat 2: Catania838 (€1.93 in chips) 
Seat 3: caduceus369 (€3.11 in chips) 
Seat 4: diesel197474 (€0.96 in chips) 
Seat 5: SenzaSperanza79 (€1.09 in chips) 
Seat 6: ADRIAN0_MEIS (€7.20 in chips) 
Catania838: posts small blind €0.01
caduceus369: posts big blind €0.02
*** HOLE CARDS ***
Dealt to caduceus369 [Jh 7h]
diesel197474: folds 
SenzaSperanza79: folds 
ADRIAN0_MEIS: folds 
father2008: folds 
Catania838: folds 
Uncalled bet (€0.01) returned to caduceus369
caduceus369 collected €0.02 from pot
caduceus369: doesn't show hand 
*** SUMMARY ***
Total pot €0.02 | Rake €0 
Seat 1: father2008 (button) folded before Flop (didn't bet)
Seat 2: Catania838 (small blind) folded before Flop
Seat 3: caduceus369 (big blind) collected (€0.02)
Seat 4: diesel197474 folded before Flop (didn't bet)
Seat 5: SenzaSperanza79 folded before Flop (didn't bet)
Seat 6: ADRIAN0_MEIS folded before Flop (didn't bet)



PokerStars Zoom Hand #257975426639:  Hold'em No Limit (€0.01/€0.02) [ADM ID: M62BA304494E32ST] - 2025/10/02 23:19:27 CET [2025/10/02 17:19:27 ET]
Table 'Sirio' 6-max Seat #1 is the button
Seat 1: cap e'bomb95 (€2.36 in chips) 
Seat 2: caduceus369 (€3.12 in chips) 
Seat 3: pistaKKio23 (€1.76 in chips) 
Seat 4: gigiruk91 (€6.28 in chips) 
Seat 5: Oiad (€2.80 in chips) 
Seat 6: ADRIAN0_MEIS (€2.30 in chips) 
caduceus369: posts small blind €0.01
pistaKKio23: posts big blind €0.02
*** HOLE CARDS ***
Dealt to caduceus369 [6s Td]
gigiruk91: folds 
Oiad: folds 
ADRIAN0_MEIS: folds 
cap e'bomb95: folds 
caduceus369: folds 
Uncalled bet (€0.01) returned to pistaKKio23
pistaKKio23 collected €0.02 from pot
pistaKKio23: doesn't show hand 
*** SUMMARY ***
Total pot €0.02 | Rake €0 
Seat 1: cap e'bomb95 (button) folded before Flop (didn't bet)
Seat 2: caduceus369 (small blind) folded before Flop
Seat 3: pistaKKio23 (big blind) collected (€0.02)
Seat 4: gigiruk91 folded before Flop (didn't bet)
Seat 5: Oiad folded before Flop (didn't bet)
Seat 6: ADRIAN0_MEIS folded before Flop (didn't bet)



PokerStars Zoom Hand #257975417552:  Hold'em No Limit (€0.01/€0.02) [ADM ID: M62BA304494E32ST] - 2025/10/02 23:18:49 CET [2025/10/02 17:18:49 ET]
Table 'Sirio' 6-max Seat #1 is the button
Seat 1: gigiruk91 (€2.34 in chips) 
Seat 2: caduceus369 (€3.12 in chips) 
Seat 3: AntonioKrakka (€2.84 in chips) 
Seat 4: diesel197474 (€0.97 in chips) 
Seat 5: Sorosuno (€2 in chips) 
Seat 6: stfuplzudonk (€3.06 in chips) 
caduceus369: posts small blind €0.01
AntonioKrakka: posts big blind €0.02
*** HOLE CARDS ***
Dealt to caduceus369 [Ac 5d]
diesel197474: folds 
Sorosuno: folds 
stfuplzudonk: raises €0.02 to €0.04
gigiruk91: folds 
caduceus369: folds 
AntonioKrakka: calls €0.02
*** FLOP *** [3d Qd 7h]
AntonioKrakka: checks 
stfuplzudonk: checks 
*** TURN *** [3d Qd 7h] [Qs]
AntonioKrakka: checks 
stfuplzudonk: checks 
*** RIVER *** [3d Qd 7h Qs] [6s]
AntonioKrakka: checks 
stfuplzudonk: checks 
*** SHOW DOWN ***
AntonioKrakka: shows [Ah 9h] (a pair of Queens)
stfuplzudonk: mucks hand 
AntonioKrakka collected €0.09 from pot
*** SUMMARY ***
Total pot €0.09 | Rake €0 
Board [3d Qd 7h Qs 6s]
Seat 1: gigiruk91 (button) folded before Flop (didn't bet)
Seat 2: caduceus369 (small blind) folded before Flop
Seat 3: AntonioKrakka (big blind) showed [Ah 9h] and won (€0.09) with a pair of Queens
Seat 4: diesel197474 folded before Flop (didn't bet)
Seat 5: Sorosuno folded before Flop (didn't bet)
Seat 6: stfuplzudonk mucked [8d As]



PokerStars Zoom Hand #257975416200:  Hold'em No Limit (€0.01/€0.02) [ADM ID: M62BA304494E32ST] - 2025/10/02 23:18:43 CET [2025/10/02 17:18:43 ET]
Table 'Sirio' 6-max Seat #1 is the button
Seat 1: pistaKKio23 (€1.76 in chips) 
Seat 2: Alex83l310 (€2.01 in chips) 
Seat 3: diesel197474 (€1.98 in chips) 
Seat 4: caduceus369 (€3.12 in chips) 
Seat 5: Oiad (€5 in chips) 
Seat 6: Sorosuno (€2.34 in chips) 
Alex83l310: posts small blind €0.01
diesel197474: posts big blind €0.02
*** HOLE CARDS ***
Dealt to caduceus369 [5h Qd]
caduceus369: folds 
Oiad: folds 
Sorosuno: raises €0.03 to €0.05
pistaKKio23: folds 
Alex83l310: folds 
diesel197474: raises €0.05 to €0.10
Sorosuno: calls €0.05
*** FLOP *** [9d Ac 4c]
diesel197474: checks 
Sorosuno: checks 
*** TURN *** [9d Ac 4c] [Js]
diesel197474: bets €0.02
Sorosuno: calls €0.02
*** RIVER *** [9d Ac 4c Js] [3s]
diesel197474: bets €0.12
Sorosuno: folds 
Uncalled bet (€0.12) returned to diesel197474
diesel197474 collected €0.24 from pot
diesel197474: doesn't show hand 
*** SUMMARY ***
Total pot €0.25 | Rake €0.01 
Board [9d Ac 4c Js 3s]
Seat 1: pistaKKio23 (button) folded before Flop (didn't bet)
Seat 2: Alex83l310 (small blind) folded before Flop
Seat 3: diesel197474 (big blind) collected (€0.24)
Seat 4: caduceus369 folded before Flop (didn't bet)
Seat 5: Oiad folded before Flop (didn't bet)
Seat 6: Sorosuno folded on the River



PokerStars Zoom Hand #257975425153:  Hold'em No Limit (€0.01/€0.02) [ADM ID: M62BA304494E32ST] - 2025/10/02 23:19:21 CET [2025/10/02 17:19:21 ET]
Table 'Sirio' 6-max Seat #1 is the button
Seat 1: cap e'bomb95 (€2.18 in chips) 
Seat 2: montemeru (€2.44 in chips) 
Seat 3: monsterc99 (€1.46 in chips) 
Seat 4: Catania838 (€1.92 in chips) 
Seat 5: father2008 (€4.01 in chips) 
Seat 6: caduceus369 (€3.12 in chips) 
montemeru: posts small blind €0.01
monsterc99: posts big blind €0.02
*** HOLE CARDS ***
Dealt to caduceus369 [8c 2h]
Catania838: folds 
father2008: folds 
caduceus369: folds 
cap e'bomb95: folds 
montemeru: raises €0.04 to €0.06
monsterc99: calls €0.04
*** FLOP *** [3s 4s Ac]
montemeru: checks 
monsterc99: bets €0.04
montemeru: calls €0.04
*** TURN *** [3s 4s Ac] [6d]
montemeru: checks 
monsterc99: bets €0.10
montemeru: folds 
Uncalled bet (€0.10) returned to monsterc99
monsterc99 collected €0.19 from pot
monsterc99: doesn't show hand 
*** SUMMARY ***
Total pot €0.20 | Rake €0.01 
Board [3s 4s Ac 6d]
Seat 1: cap e'bomb95 (button) folded before Flop (didn't bet)
Seat 2: montemeru (small blind) folded on the Turn
Seat 3: monsterc99 (big blind) collected (€0.19)
Seat 4: Catania838 folded before Flop (didn't bet)
Seat 5: father2008 folded before Flop (didn't bet)
Seat 6: caduceus369 folded before Flop (didn't bet)



PokerStars Zoom Hand #257975428845:  Hold'em No Limit (€0.01/€0.02) [ADM ID: M62BA304494E32ST] - 2025/10/02 23:19:36 CET [2025/10/02 17:19:36 ET]
Table 'Sirio' 6-max Seat #1 is the button
Seat 1: caduceus369 (€3.11 in chips) 
Seat 2: tomaok415 (€2.09 in chips) 
Seat 3: Buonosimafesson (€2.07 in chips) 
Seat 4: Warterror90 (€2.93 in chips) 
Seat 5: cap e'bomb95 (€2.36 in chips) 
Seat 6: Kingo690 (€3.32 in chips) 
tomaok415: posts small blind €0.01
Buonosimafesson: posts big blind €0.02
*** HOLE CARDS ***
Dealt to caduceus369 [Kh 6h]
Warterror90: raises €0.04 to €0.06
cap e'bomb95: folds 
Kingo690: folds 
caduceus369: folds 
tomaok415: folds 
Buonosimafesson: calls €0.04
*** FLOP *** [Jh 8h Jd]
Buonosimafesson: checks 
Warterror90: bets €0.06
Buonosimafesson: folds 
Uncalled bet (€0.06) returned to Warterror90
Warterror90 collected €0.13 from pot
Warterror90: doesn't show hand 
*** SUMMARY ***
Total pot €0.13 | Rake €0 
Board [Jh 8h Jd]
Seat 1: caduceus369 (button) folded before Flop (didn't bet)
Seat 2: tomaok415 (small blind) folded before Flop
Seat 3: Buonosimafesson (big blind) folded on the Flop
Seat 4: Warterror90 collected (€0.13)
Seat 5: cap e'bomb95 folded before Flop (didn't bet)
Seat 6: Kingo690 folded before Flop (didn't bet)



PokerStars Zoom Hand #257975435278:  Hold'em No Limit (€0.01/€0.02) [ADM ID: M62BA304494E32ST] - 2025/10/02 23:20:03 CET [2025/10/02 17:20:03 ET]
Table 'Sirio' 6-max Seat #1 is the button
Seat 1: montemeru (€2.63 in chips) 
Seat 2: fantaasso (€1.98 in chips) 
Seat 3: Catania838 (€0.88 in chips) 
Seat 4: caduceus369 (€3.11 in chips) 
Seat 5: ADRIAN0_MEIS (€2.28 in chips) 
Seat 6: monsterc99 (€1.55 in chips) 
fantaasso: posts small blind €0.01
Catania838: posts big blind €0.02
*** HOLE CARDS ***
Dealt to caduceus369 [9h 3h]
caduceus369: folds 
ADRIAN0_MEIS: folds 
monsterc99: folds 
montemeru: folds 
fantaasso: raises €0.02 to €0.04
Catania838: folds 
Uncalled bet (€0.02) returned to fantaasso
fantaasso collected €0.04 from pot
fantaasso: doesn't show hand 
*** SUMMARY ***
Total pot €0.04 | Rake €0 
Seat 1: montemeru (button) folded before Flop (didn't bet)
Seat 2: fantaasso (small blind) collected (€0.04)
Seat 3: Catania838 (big blind) folded before Flop
Seat 4: caduceus369 folded before Flop (didn't bet)
Seat 5: ADRIAN0_MEIS folded before Flop (didn't bet)
Seat 6: monsterc99 folded before Flop (didn't bet)



PokerStars Zoom Hand #257975431000:  Hold'em No Limit (€0.01/€0.02) [ADM ID: M62BA304494E32ST] - 2025/10/02 23:19:45 CET [2025/10/02 17:19:45 ET]
Table 'Sirio' 6-max Seat #1 is the button
Seat 1: SenzaSperanza79 (€1.03 in chips) 
Seat 2: AntonioKrakka (€4.30 in chips) 
Seat 3: sancarlo18 (€2.49 in chips) 
Seat 4: tomaok415 (€2.08 in chips) 
Seat 5: caduceus369 (€3.11 in chips) 
Seat 6: rush572 (€0.58 in chips) 
AntonioKrakka: posts small blind €0.01
sancarlo18: posts big blind €0.02
*** HOLE CARDS ***
Dealt to caduceus369 [6s Jd]
tomaok415: folds 
caduceus369 has timed out
caduceus369: folds 
rush572: calls €0.02
SenzaSperanza79: folds 
AntonioKrakka: folds 
sancarlo18: checks 
*** FLOP *** [6d Jh 2s]
sancarlo18: checks 
rush572: checks 
*** TURN *** [6d Jh 2s] [Ad]
sancarlo18: checks 
rush572: bets €0.05
sancarlo18: calls €0.05
*** RIVER *** [6d Jh 2s Ad] [6c]
sancarlo18: checks 
rush572: bets €0.08
sancarlo18: calls €0.08
*** SHOW DOWN ***
rush572: shows [3s Ah] (two pair, Aces and Sixes)
sancarlo18: mucks hand 
rush572 collected €0.30 from pot
*** SUMMARY ***
Total pot €0.31 | Rake €0.01 
Board [6d Jh 2s Ad 6c]
Seat 1: SenzaSperanza79 (button) folded before Flop (didn't bet)
Seat 2: AntonioKrakka (small blind) folded before Flop
Seat 3: sancarlo18 (big blind) mucked [8d Jc]
Seat 4: tomaok415 folded before Flop (didn't bet)
Seat 5: caduceus369 folded before Flop (didn't bet)
Seat 6: rush572 showed [3s Ah] and won (€0.30) with two pair, Aces and Sixes



PokerStars Zoom Hand #257975439479:  Hold'em No Limit (€0.01/€0.02) [ADM ID: M62BA304494E32ST] - 2025/10/02 23:20:21 CET [2025/10/02 17:20:21 ET]
Table 'Sirio' 6-max Seat #1 is the button
Seat 1: Eudy26 (€0.41 in chips) 
Seat 2: stfuplzudonk (€2.39 in chips) 
Seat 3: AntonioKrakka (€4.38 in chips) 
Seat 4: caduceus369 (€3.09 in chips) 
Seat 5: VagALiss (€2.27 in chips) 
Seat 6: Oiad (€5.03 in chips) 
stfuplzudonk: posts small blind €0.01
AntonioKrakka: posts big blind €0.02
*** HOLE CARDS ***
Dealt to caduceus369 [Jh 8d]
caduceus369: folds 
VagALiss: raises €0.03 to €0.05
Oiad: folds 
Eudy26: folds 
stfuplzudonk: folds 
AntonioKrakka: folds 
Uncalled bet (€0.03) returned to VagALiss
VagALiss collected €0.05 from pot
VagALiss: doesn't show hand 
*** SUMMARY ***
Total pot €0.05 | Rake €0 
Seat 1: Eudy26 (button) folded before Flop (didn't bet)
Seat 2: stfuplzudonk (small blind) folded before Flop
Seat 3: AntonioKrakka (big blind) folded before Flop
Seat 4: caduceus369 folded before Flop (didn't bet)
Seat 5: VagALiss collected (€0.05)
Seat 6: Oiad folded before Flop (didn't bet)



PokerStars Zoom Hand #257975436532:  Hold'em No Limit (€0.01/€0.02) [ADM ID: M62BA304494E32ST] - 2025/10/02 23:20:08 CET [2025/10/02 17:20:08 ET]
Table 'Sirio' 6-max Seat #1 is the button
Seat 1: VagALiss (€2.27 in chips) 
Seat 2: montemeru (€2.63 in chips) 
Seat 3: caduceus369 (€3.11 in chips) 
Seat 4: Sium12302 (€2 in chips) 
Seat 5: KnaveFlush (€2 in chips) 
Seat 6: Sorosuno (€2.26 in chips) 
montemeru: posts small blind €0.01
caduceus369: posts big blind €0.02
*** HOLE CARDS ***
Dealt to caduceus369 [9d 5h]
Sium12302: folds 
KnaveFlush: folds 
Sorosuno: raises €0.03 to €0.05
VagALiss: folds 
montemeru: calls €0.04
caduceus369: folds 
*** FLOP *** [Tc 2h 2d]
montemeru: checks 
Sorosuno: checks 
*** TURN *** [Tc 2h 2d] [9h]
montemeru: checks 
Sorosuno: bets €0.09
montemeru: folds 
Uncalled bet (€0.09) returned to Sorosuno
Sorosuno collected €0.12 from pot
Sorosuno: doesn't show hand 
*** SUMMARY ***
Total pot €0.12 | Rake €0 
Board [Tc 2h 2d 9h]
Seat 1: VagALiss (button) folded before Flop (didn't bet)
Seat 2: montemeru (small blind) folded on the Turn
Seat 3: caduceus369 (big blind) folded before Flop
Seat 4: Sium12302 folded before Flop (didn't bet)
Seat 5: KnaveFlush folded before Flop (didn't bet)
Seat 6: Sorosuno collected (€0.12)



PokerStars Zoom Hand #257975440367:  Hold'em No Limit (€0.01/€0.02) [ADM ID: M62BA304494E32ST] - 2025/10/02 23:20:25 CET [2025/10/02 17:20:25 ET]
Table 'Sirio' 6-max Seat #1 is the button
Seat 1: Warterror90 (€2.17 in chips) 
Seat 2: Catania838 (€0.86 in chips) 
Seat 3: diesel197474 (€0.87 in chips) 
Seat 4: Kingo690 (€3.47 in chips) 
Seat 5: caduceus369 (€3.09 in chips) 
Seat 6: Nicoirca2004 (€1.91 in chips) 
Catania838: posts small blind €0.01
diesel197474: posts big blind €0.02
*** HOLE CARDS ***
Dealt to caduceus369 [2d 4s]
Kingo690: folds 
caduceus369: folds 
Nicoirca2004: raises €0.02 to €0.04
Warterror90: calls €0.04
Catania838: folds 
diesel197474: calls €0.02
*** FLOP *** [5c Ts Td]
diesel197474: checks 
Nicoirca2004: bets €0.04
Warterror90: raises €0.08 to €0.12
diesel197474: folds 
Nicoirca2004: raises €0.08 to €0.20
Warterror90: folds 
Uncalled bet (€0.08) returned to Nicoirca2004
Nicoirca2004 collected €0.35 from pot
Nicoirca2004: doesn't show hand 
*** SUMMARY ***
Total pot €0.37 | Rake €0.02 
Board [5c Ts Td]
Seat 1: Warterror90 (button) folded on the Flop
Seat 2: Catania838 (small blind) folded before Flop
Seat 3: diesel197474 (big blind) folded on the Flop
Seat 4: Kingo690 folded before Flop (didn't bet)
Seat 5: caduceus369 folded before Flop (didn't bet)
Seat 6: Nicoirca2004 collected (€0.35)



PokerStars Zoom Hand #257975446746:  Hold'em No Limit (€0.01/€0.02) [ADM ID: M62BA304494E32ST] - 2025/10/02 23:20:52 CET [2025/10/02 17:20:52 ET]
Table 'Sirio' 6-max Seat #1 is the button
Seat 1: SenzaSperanza79 (€0.95 in chips) 
Seat 2: father2008 (€4.10 in chips) 
Seat 3: caduceus369 (€3.08 in chips) 
Seat 4: luchetto1990 (€2.60 in chips) 
Seat 5: cap e'bomb95 (€2.28 in chips) 
Seat 6: ADRIAN0_MEIS (€2.28 in chips) 
father2008: posts small blind €0.01
caduceus369: posts big blind €0.02
*** HOLE CARDS ***
Dealt to caduceus369 [7d 4h]
luchetto1990: folds 
cap e'bomb95: folds 
ADRIAN0_MEIS: folds 
SenzaSperanza79: folds 
father2008: folds 
Uncalled bet (€0.01) returned to caduceus369
caduceus369 collected €0.02 from pot
caduceus369: doesn't show hand 
*** SUMMARY ***
Total pot €0.02 | Rake €0 
Seat 1: SenzaSperanza79 (button) folded before Flop (didn't bet)
Seat 2: father2008 (small blind) folded before Flop
Seat 3: caduceus369 (big blind) collected (€0.02)
Seat 4: luchetto1990 folded before Flop (didn't bet)
Seat 5: cap e'bomb95 folded before Flop (didn't bet)
Seat 6: ADRIAN0_MEIS folded before Flop (didn't bet)



PokerStars Zoom Hand #257975443011:  Hold'em No Limit (€0.01/€0.02) [ADM ID: M62BA304494E32ST] - 2025/10/02 23:20:36 CET [2025/10/02 17:20:36 ET]
Table 'Sirio' 6-max Seat #1 is the button
Seat 1: pistaKKio23 (€4.70 in chips) 
Seat 2: caduceus369 (€3.09 in chips) 
Seat 3: AntonioKrakka (€2.95 in chips) 
Seat 4: Oiad (€2.94 in chips) 
Seat 5: Catania838 (€0.85 in chips) 
Seat 6: stfuplzudonk (€1.43 in chips) 
caduceus369: posts small blind €0.01
AntonioKrakka: posts big blind €0.02
*** HOLE CARDS ***
Dealt to caduceus369 [8d 3c]
Oiad: raises €0.03 to €0.05
Catania838: folds 
stfuplzudonk: calls €0.05
pistaKKio23: folds 
caduceus369: folds 
AntonioKrakka: folds 
*** FLOP *** [4c 6h Qc]
Oiad: bets €0.04
stfuplzudonk: folds 
Uncalled bet (€0.04) returned to Oiad
Oiad collected €0.13 from pot
Oiad: doesn't show hand 
*** SUMMARY ***
Total pot €0.13 | Rake €0 
Board [4c 6h Qc]
Seat 1: pistaKKio23 (button) folded before Flop (didn't bet)
Seat 2: caduceus369 (small blind) folded before Flop
Seat 3: AntonioKrakka (big blind) folded before Flop
Seat 4: Oiad collected (€0.13)
Seat 5: Catania838 folded before Flop (didn't bet)
Seat 6: stfuplzudonk folded on the Flop



PokerStars Zoom Hand #257975451509:  Hold'em No Limit (€0.01/€0.02) [ADM ID: M62BA304494E32ST] - 2025/10/02 23:21:12 CET [2025/10/02 17:21:12 ET]
Table 'Sirio' 6-max Seat #1 is the button
Seat 1: father2008 (€3.32 in chips) 
Seat 2: ADRIAN0_MEIS (€2.28 in chips) 
Seat 3: VagALiss (€2.29 in chips) 
Seat 4: cap e'bomb95 (€4.17 in chips) 
Seat 5: Sorosuno (€2.09 in chips) 
Seat 6: caduceus369 (€3.09 in chips) 
ADRIAN0_MEIS: posts small blind €0.01
VagALiss: posts big blind €0.02
*** HOLE CARDS ***
Dealt to caduceus369 [4h Jc]
cap e'bomb95: folds 
Sorosuno: folds 
caduceus369: folds 
father2008: raises €0.04 to €0.06
ADRIAN0_MEIS: folds 
VagALiss: raises €0.18 to €0.24
father2008: folds 
Uncalled bet (€0.18) returned to VagALiss
VagALiss collected €0.13 from pot
VagALiss: doesn't show hand 
*** SUMMARY ***
Total pot €0.13 | Rake €0 
Seat 1: father2008 (button) folded before Flop
Seat 2: ADRIAN0_MEIS (small blind) folded before Flop
Seat 3: VagALiss (big blind) collected (€0.13)
Seat 4: cap e'bomb95 folded before Flop (didn't bet)
Seat 5: Sorosuno folded before Flop (didn't bet)
Seat 6: caduceus369 folded before Flop (didn't bet)



PokerStars Zoom Hand #257975441826:  Hold'em No Limit (€0.01/€0.02) [ADM ID: M62BA304494E32ST] - 2025/10/02 23:20:31 CET [2025/10/02 17:20:31 ET]
Table 'Sirio' 6-max Seat #1 is the button
Seat 1: ADRIAN0_MEIS (€4.37 in chips) 
Seat 2: cap e'bomb95 (€2.13 in chips) 
Seat 3: Oiad (€5.03 in chips) 
Seat 4: caduceus369 (€3.09 in chips) 
Seat 5: Auspice67 (€1.16 in chips) 
Seat 6: Sorosuno (€2 in chips) 
cap e'bomb95: posts small blind €0.01
Oiad: posts big blind €0.02
*** HOLE CARDS ***
Dealt to caduceus369 [Th 6d]
caduceus369: folds 
Auspice67: raises €0.02 to €0.04
Sorosuno: folds 
ADRIAN0_MEIS: folds 
cap e'bomb95: folds 
Oiad: calls €0.02
*** FLOP *** [Ad 9d 9s]
Oiad: checks 
Auspice67: bets €0.07
Oiad: calls €0.07
*** TURN *** [Ad 9d 9s] [4c]
Oiad: checks 
Auspice67: bets €0.17
Oiad: calls €0.17
*** RIVER *** [Ad 9d 9s 4c] [5s]
Oiad: checks 
Auspice67: checks 
*** SHOW DOWN ***
Oiad: shows [8d Qd] (a pair of Nines)
Auspice67: shows [8s Ac] (two pair, Aces and Nines)
Auspice67 collected €0.54 from pot
*** SUMMARY ***
Total pot €0.57 | Rake €0.03 
Board [Ad 9d 9s 4c 5s]
Seat 1: ADRIAN0_MEIS (button) folded before Flop (didn't bet)
Seat 2: cap e'bomb95 (small blind) folded before Flop
Seat 3: Oiad (big blind) showed [8d Qd] and lost with a pair of Nines
Seat 4: caduceus369 folded before Flop (didn't bet)
Seat 5: Auspice67 showed [8s Ac] and won (€0.54) with two pair, Aces and Nines
Seat 6: Sorosuno folded before Flop (didn't bet)



PokerStars Zoom Hand #257975452466:  Hold'em No Limit (€0.01/€0.02) [ADM ID: M62BA304494E32ST] - 2025/10/02 23:21:16 CET [2025/10/02 17:21:16 ET]
Table 'Sirio' 6-max Seat #1 is the button
Seat 1: fantaasso (€1.91 in chips) 
Seat 2: cap e'bomb95 (€2.28 in chips) 
Seat 3: muhozhuk788 (€1.84 in chips) 
Seat 4: AntonioKrakka (€2.92 in chips) 
Seat 5: caduceus369 (€3.09 in chips) 
Seat 6: gigiruk91 (€6.23 in chips) 
cap e'bomb95: posts small blind €0.01
muhozhuk788: posts big blind €0.02
*** HOLE CARDS ***
Dealt to caduceus369 [Js Ad]
AntonioKrakka: calls €0.02
caduceus369: calls €0.02
gigiruk91: folds 
fantaasso: calls €0.02
cap e'bomb95: folds 
muhozhuk788: checks 
*** FLOP *** [Ts Qs 4h]
muhozhuk788: checks 
AntonioKrakka: checks 
caduceus369: bets €0.04
fantaasso: folds 
muhozhuk788: calls €0.04
AntonioKrakka: folds 
*** TURN *** [Ts Qs 4h] [7s]
muhozhuk788: checks 
caduceus369: bets €0.06
muhozhuk788: folds 
Uncalled bet (€0.06) returned to caduceus369
caduceus369 collected €0.17 from pot
caduceus369: doesn't show hand 
*** SUMMARY ***
Total pot €0.17 | Rake €0 
Board [Ts Qs 4h 7s]
Seat 1: fantaasso (button) folded on the Flop
Seat 2: cap e'bomb95 (small blind) folded before Flop
Seat 3: muhozhuk788 (big blind) folded on the Turn
Seat 4: AntonioKrakka folded on the Flop
Seat 5: caduceus369 collected (€0.17)
Seat 6: gigiruk91 folded before Flop (didn't bet)



PokerStars Zoom Hand #257975443810:  Hold'em No Limit (€0.01/€0.02) [ADM ID: M62BA304494E32ST] - 2025/10/02 23:20:39 CET [2025/10/02 17:20:39 ET]
Table 'Sirio' 6-max Seat #1 is the button
Seat 1: caduceus369 (€3.08 in chips) 
Seat 2: tomaok415 (€0.95 in chips) 
Seat 3: gigiruk91 (€3.06 in chips) 
Seat 4: TripInter (€0.66 in chips) 
Seat 5: sancarlo18 (€2.34 in chips) 
Seat 6: monsterc99 (€1.52 in chips) 
tomaok415: posts small blind €0.01
gigiruk91: posts big blind €0.02
*** HOLE CARDS ***
Dealt to caduceus369 [2c 9s]
TripInter: folds 
sancarlo18: raises €0.04 to €0.06
monsterc99: folds 
caduceus369: folds 
tomaok415: calls €0.05
gigiruk91: calls €0.04
*** FLOP *** [6c 2h Jc]
tomaok415: checks 
gigiruk91: bets €0.09
sancarlo18: calls €0.09
tomaok415: calls €0.09
*** TURN *** [6c 2h Jc] [Kh]
tomaok415: checks 
gigiruk91: checks 
sancarlo18: checks 
*** RIVER *** [6c 2h Jc Kh] [Ac]
tomaok415: checks 
gigiruk91: bets €0.10
sancarlo18 is disconnected 
sancarlo18 has timed out while disconnected
sancarlo18: folds 
tomaok415: calls €0.10
*** SHOW DOWN ***
gigiruk91: shows [Ad Jd] (two pair, Aces and Jacks)
tomaok415: mucks hand 
gigiruk91 collected €0.62 from pot
*** SUMMARY ***
Total pot €0.65 | Rake €0.03 
Board [6c 2h Jc Kh Ac]
Seat 1: caduceus369 (button) folded before Flop (didn't bet)
Seat 2: tomaok415 (small blind) mucked [Kc Th]
Seat 3: gigiruk91 (big blind) showed [Ad Jd] and won (€0.62) with two pair, Aces and Jacks
Seat 4: TripInter folded before Flop (didn't bet)
Seat 5: sancarlo18 folded on the River
Seat 6: monsterc99 folded before Flop (didn't bet)



PokerStars Zoom Hand #257975462989:  Hold'em No Limit (€0.01/€0.02) [ADM ID: M62BA304494E32ST] - 2025/10/02 23:22:00 CET [2025/10/02 17:22:00 ET]
Table 'Sirio' 6-max Seat #1 is the button
Seat 1: Sorosuno (€2.06 in chips) 
Seat 2: caduceus369 (€3.20 in chips) 
Seat 3: ADRIAN0_MEIS (€7.27 in chips) 
Seat 4: AntonioKrakka (€4.15 in chips) 
Seat 5: diesel197474 (€0.77 in chips) 
Seat 6: Sim_sala_bin (€0.77 in chips) 
caduceus369: posts small blind €0.01
ADRIAN0_MEIS: posts big blind €0.02
*** HOLE CARDS ***
Dealt to caduceus369 [Td Tc]
AntonioKrakka: folds 
diesel197474: folds 
Sim_sala_bin: folds 
Sorosuno: raises €0.03 to €0.05
caduceus369: calls €0.04
ADRIAN0_MEIS: folds 
*** FLOP *** [2d Jc 3s]
caduceus369: checks 
Sorosuno: bets €0.04
caduceus369: calls €0.04
*** TURN *** [2d Jc 3s] [Jd]
caduceus369: checks 
Sorosuno: bets €0.10
caduceus369: calls €0.10
*** RIVER *** [2d Jc 3s Jd] [9h]
caduceus369: checks 
Sorosuno: bets €0.32
caduceus369: calls €0.32
*** SHOW DOWN ***
Sorosuno: shows [Jh Th] (three of a kind, Jacks)
caduceus369: mucks hand 
Sorosuno collected €0.99 from pot
*** SUMMARY ***
Total pot €1.04 | Rake €0.05 
Board [2d Jc 3s Jd 9h]
Seat 1: Sorosuno (button) showed [Jh Th] and won (€0.99) with three of a kind, Jacks
Seat 2: caduceus369 (small blind) mucked [Td Tc]
Seat 3: ADRIAN0_MEIS (big blind) folded before Flop
Seat 4: AntonioKrakka folded before Flop (didn't bet)
Seat 5: diesel197474 folded before Flop (didn't bet)
Seat 6: Sim_sala_bin folded before Flop (didn't bet)



PokerStars Zoom Hand #257975480902:  Hold'em No Limit (€0.01/€0.02) [ADM ID: M62BA304494E32ST] - 2025/10/02 23:23:16 CET [2025/10/02 17:23:16 ET]
Table 'Sirio' 6-max Seat #1 is the button
Seat 1: caduceus369 (€2.69 in chips) 
Seat 2: kAllSeMPRE73 (€4.61 in chips) 
Seat 3: Catania838 (€1.67 in chips) 
Seat 4: stfuplzudonk (€2.36 in chips) 
Seat 5: luchetto1990 (€2.28 in chips) 
Seat 6: montemeru (€1.62 in chips) 
kAllSeMPRE73: posts small blind €0.01
Catania838: posts big blind €0.02
*** HOLE CARDS ***
Dealt to caduceus369 [6d 7s]
stfuplzudonk: raises €0.04 to €0.06
luchetto1990: folds 
montemeru: calls €0.06
caduceus369: folds 
kAllSeMPRE73: raises €0.20 to €0.26
Catania838: folds 
stfuplzudonk: calls €0.20
montemeru: folds 
*** FLOP *** [5s 4s Ts]
kAllSeMPRE73: checks 
stfuplzudonk: checks 
*** TURN *** [5s 4s Ts] [7d]
kAllSeMPRE73: checks 
stfuplzudonk: checks 
*** RIVER *** [5s 4s Ts 7d] [Kd]
kAllSeMPRE73: checks 
stfuplzudonk: checks 
*** SHOW DOWN ***
kAllSeMPRE73: shows [Ad 8d] (high card Ace)
stfuplzudonk: shows [7h 6h] (a pair of Sevens)
stfuplzudonk collected €0.57 from pot
*** SUMMARY ***
Total pot €0.60 | Rake €0.03 
Board [5s 4s Ts 7d Kd]
Seat 1: caduceus369 (button) folded before Flop (didn't bet)
Seat 2: kAllSeMPRE73 (small blind) showed [Ad 8d] and lost with high card Ace
Seat 3: Catania838 (big blind) folded before Flop
Seat 4: stfuplzudonk showed [7h 6h] and won (€0.57) with a pair of Sevens
Seat 5: luchetto1990 folded before Flop (didn't bet)
Seat 6: montemeru folded before Flop



PokerStars Zoom Hand #257975486153:  Hold'em No Limit (€0.01/€0.02) [ADM ID: M62BA304494E32ST] - 2025/10/02 23:23:38 CET [2025/10/02 17:23:38 ET]
Table 'Sirio' 6-max Seat #1 is the button
Seat 1: father2008 (€4.17 in chips) 
Seat 2: fantaasso (€1.82 in chips) 
Seat 3: lollo70113 (€2 in chips) 
Seat 4: montemeru (€1.94 in chips) 
Seat 5: Catania838 (€1.64 in chips) 
Seat 6: caduceus369 (€2.67 in chips) 
fantaasso: posts small blind €0.01
lollo70113: posts big blind €0.02
*** HOLE CARDS ***
Dealt to caduceus369 [8h 3d]
montemeru: folds 
Catania838: calls €0.02
caduceus369: folds 
father2008: folds 
fantaasso: raises €0.06 to €0.08
lollo70113: folds 
Catania838: folds 
Uncalled bet (€0.06) returned to fantaasso
fantaasso collected €0.06 from pot
fantaasso: doesn't show hand 
*** SUMMARY ***
Total pot €0.06 | Rake €0 
Seat 1: father2008 (button) folded before Flop (didn't bet)
Seat 2: fantaasso (small blind) collected (€0.06)
Seat 3: lollo70113 (big blind) folded before Flop
Seat 4: montemeru folded before Flop (didn't bet)
Seat 5: Catania838 folded before Flop
Seat 6: caduceus369 folded before Flop (didn't bet)



PokerStars Zoom Hand #257975481812:  Hold'em No Limit (€0.01/€0.02) [ADM ID: M62BA304494E32ST] - 2025/10/02 23:23:20 CET [2025/10/02 17:23:20 ET]
Table 'Sirio' 6-max Seat #1 is the button
Seat 1: KnaveFlush (€2.06 in chips) 
Seat 2: monsterc99 (€1.64 in chips) 
Seat 3: caduceus369 (€2.69 in chips) 
Seat 4: father2008 (€4.19 in chips) 
Seat 5: ADRIAN0_MEIS (€2.44 in chips) 
Seat 6: luchetto1990 (€2.28 in chips) 
monsterc99: posts small blind €0.01
caduceus369: posts big blind €0.02
*** HOLE CARDS ***
Dealt to caduceus369 [6d 4h]
father2008: folds 
ADRIAN0_MEIS: folds 
luchetto1990: folds 
KnaveFlush: raises €0.03 to €0.05
monsterc99: calls €0.04
caduceus369: folds 
*** FLOP *** [8s 9d 7h]
monsterc99: checks 
KnaveFlush: checks 
*** TURN *** [8s 9d 7h] [9s]
monsterc99: checks 
KnaveFlush: checks 
*** RIVER *** [8s 9d 7h 9s] [9h]
monsterc99: checks 
KnaveFlush: bets €0.54
monsterc99: folds 
Uncalled bet (€0.54) returned to KnaveFlush
KnaveFlush collected €0.12 from pot
KnaveFlush: doesn't show hand 
*** SUMMARY ***
Total pot €0.12 | Rake €0 
Board [8s 9d 7h 9s 9h]
Seat 1: KnaveFlush (button) collected (€0.12)
Seat 2: monsterc99 (small blind) folded on the River
Seat 3: caduceus369 (big blind) folded before Flop
Seat 4: father2008 folded before Flop (didn't bet)
Seat 5: ADRIAN0_MEIS folded before Flop (didn't bet)
Seat 6: luchetto1990 folded before Flop (didn't bet)



PokerStars Zoom Hand #257975490203:  Hold'em No Limit (€0.01/€0.02) [ADM ID: M62BA304494E32ST] - 2025/10/02 23:23:55 CET [2025/10/02 17:23:55 ET]
Table 'Sirio' 6-max Seat #1 is the button
Seat 1: luchetto1990 (€2.25 in chips) 
Seat 2: Redraw2Flush (€1.71 in chips) 
Seat 3: Sorosuno (€2.27 in chips) 
Seat 4: diesel197474 (€0.68 in chips) 
Seat 5: caduceus369 (€2.66 in chips) 
Seat 6: Warterror90 (€2.82 in chips) 
Redraw2Flush: posts small blind €0.01
Sorosuno: posts big blind €0.02
*** HOLE CARDS ***
Dealt to caduceus369 [Jh 8d]
diesel197474: folds 
caduceus369: folds 
Warterror90: folds 
luchetto1990: raises €0.04 to €0.06
Redraw2Flush: folds 
Sorosuno: folds 
Uncalled bet (€0.04) returned to luchetto1990
luchetto1990 collected €0.05 from pot
luchetto1990: doesn't show hand 
*** SUMMARY ***
Total pot €0.05 | Rake €0 
Seat 1: luchetto1990 (button) collected (€0.05)
Seat 2: Redraw2Flush (small blind) folded before Flop
Seat 3: Sorosuno (big blind) folded before Flop
Seat 4: diesel197474 folded before Flop (didn't bet)
Seat 5: caduceus369 folded before Flop (didn't bet)
Seat 6: Warterror90 folded before Flop (didn't bet)



PokerStars Zoom Hand #257975491128:  Hold'em No Limit (€0.01/€0.02) [ADM ID: M62BA304494E32ST] - 2025/10/02 23:24:00 CET [2025/10/02 17:24:00 ET]
Table 'Sirio' 6-max Seat #1 is the button
Seat 1: pistaKKio23 (€4.60 in chips) 
Seat 2: Auspice67 (€2 in chips) 
Seat 3: caduceus369 (€2.66 in chips) 
Seat 4: Redraw2Flush (€1.70 in chips) 
Seat 5: AntonioKrakka (€5.51 in chips) 
Seat 6: gigiruk91 (€3.43 in chips) 
Auspice67: posts small blind €0.01
caduceus369: posts big blind €0.02
*** HOLE CARDS ***
Dealt to caduceus369 [Ac 2s]
Redraw2Flush: folds 
AntonioKrakka: folds 
gigiruk91: folds 
pistaKKio23: folds 
Auspice67: raises €0.04 to €0.06
caduceus369: folds 
Uncalled bet (€0.04) returned to Auspice67
Auspice67 collected €0.04 from pot
Auspice67: doesn't show hand 
*** SUMMARY ***
Total pot €0.04 | Rake €0 
Seat 1: pistaKKio23 (button) folded before Flop (didn't bet)
Seat 2: Auspice67 (small blind) collected (€0.04)
Seat 3: caduceus369 (big blind) folded before Flop
Seat 4: Redraw2Flush folded before Flop (didn't bet)
Seat 5: AntonioKrakka folded before Flop (didn't bet)
Seat 6: gigiruk91 folded before Flop (didn't bet)



PokerStars Zoom Hand #257975489525:  Hold'em No Limit (€0.01/€0.02) [ADM ID: M62BA304494E32ST] - 2025/10/02 23:23:53 CET [2025/10/02 17:23:53 ET]
Table 'Sirio' 6-max Seat #1 is the button
Seat 1: kAllSeMPRE73 (€4.35 in chips) 
Seat 2: caduceus369 (€2.67 in chips) 
Seat 3: montemeru (€2.39 in chips) 
Seat 4: stfuplzudonk (€2.67 in chips) 
Seat 5: Redraw2Flush (€1.71 in chips) 
Seat 6: AntonioKrakka (€2.69 in chips) 
caduceus369: posts small blind €0.01
montemeru: posts big blind €0.02
*** HOLE CARDS ***
Dealt to caduceus369 [5h 4c]
stfuplzudonk: folds 
Redraw2Flush: folds 
AntonioKrakka: folds 
kAllSeMPRE73: raises €4.33 to €4.35 and is all-in
caduceus369: folds 
montemeru: folds 
Uncalled bet (€4.33) returned to kAllSeMPRE73
kAllSeMPRE73 collected €0.05 from pot
kAllSeMPRE73: doesn't show hand 
*** SUMMARY ***
Total pot €0.05 | Rake €0 
Seat 1: kAllSeMPRE73 (button) collected (€0.05)
Seat 2: caduceus369 (small blind) folded before Flop
Seat 3: montemeru (big blind) folded before Flop
Seat 4: stfuplzudonk folded before Flop (didn't bet)
Seat 5: Redraw2Flush folded before Flop (didn't bet)
Seat 6: AntonioKrakka folded before Flop (didn't bet)



PokerStars Zoom Hand #257975485192:  Hold'em No Limit (€0.01/€0.02) [ADM ID: M62BA304494E32ST] - 2025/10/02 23:23:34 CET [2025/10/02 17:23:34 ET]
Table 'Sirio' 6-max Seat #1 is the button
Seat 1: kklaudio1 (€1.99 in chips) 
Seat 2: ADRIAN0_MEIS (€2.44 in chips) 
Seat 3: muhozhuk788 (€0.37 in chips) 
Seat 4: Sorosuno (€2.52 in chips) 
Seat 5: fantaasso (€1.82 in chips) 
Seat 6: caduceus369 (€2.67 in chips) 
ADRIAN0_MEIS: posts small blind €0.01
muhozhuk788: posts big blind €0.02
*** HOLE CARDS ***
Dealt to caduceus369 [2d 3d]
Sorosuno: folds 
fantaasso: folds 
caduceus369: folds 
kklaudio1: folds 
ADRIAN0_MEIS: raises €0.05 to €0.07
muhozhuk788: calls €0.05
*** FLOP *** [8d Ts Qh]
ADRIAN0_MEIS: bets €0.08
muhozhuk788: calls €0.08
*** TURN *** [8d Ts Qh] [Ac]
ADRIAN0_MEIS: bets €0.29
muhozhuk788: calls €0.22 and is all-in
Uncalled bet (€0.07) returned to ADRIAN0_MEIS
*** RIVER *** [8d Ts Qh Ac] [6s]
*** SHOW DOWN ***
ADRIAN0_MEIS: shows [Ah 8h] (two pair, Aces and Eights)
muhozhuk788: shows [9c Qc] (a pair of Queens)
ADRIAN0_MEIS collected €0.70 from pot
*** SUMMARY ***
Total pot €0.74 | Rake €0.04 
Board [8d Ts Qh Ac 6s]
Seat 1: kklaudio1 (button) folded before Flop (didn't bet)
Seat 2: ADRIAN0_MEIS (small blind) showed [Ah 8h] and won (€0.70) with two pair, Aces and Eights
Seat 3: muhozhuk788 (big blind) showed [9c Qc] and lost with a pair of Queens
Seat 4: Sorosuno folded before Flop (didn't bet)
Seat 5: fantaasso folded before Flop (didn't bet)
Seat 6: caduceus369 folded before Flop (didn't bet)



PokerStars Zoom Hand #257975488276:  Hold'em No Limit (€0.01/€0.02) [ADM ID: M62BA304494E32ST] - 2025/10/02 23:23:47 CET [2025/10/02 17:23:47 ET]
Table 'Sirio' 6-max Seat #1 is the button
Seat 1: caduceus369 (€2.67 in chips) 
Seat 2: pistaKKio23 (€1.76 in chips) 
Seat 3: TonyPir97 (€0.61 in chips) 
Seat 4: ADRIAN0_MEIS (€5.39 in chips) 
Seat 5: SenzaSperanza79 (€0.96 in chips) 
Seat 6: alff85 (€2.07 in chips) 
pistaKKio23: posts small blind €0.01
TonyPir97: posts big blind €0.02
*** HOLE CARDS ***
Dealt to caduceus369 [2c As]
ADRIAN0_MEIS: folds 
SenzaSperanza79: folds 
alff85: calls €0.02
caduceus369: folds 
pistaKKio23: calls €0.01
TonyPir97: checks 
*** FLOP *** [4h Kc 7c]
pistaKKio23: checks 
TonyPir97: checks 
alff85: checks 
*** TURN *** [4h Kc 7c] [Th]
pistaKKio23: checks 
TonyPir97: checks 
alff85: checks 
*** RIVER *** [4h Kc 7c Th] [Ac]
pistaKKio23: checks 
TonyPir97: checks 
alff85: checks 
*** SHOW DOWN ***
pistaKKio23: shows [6h 8s] (high card Ace)
TonyPir97: shows [6d Jd] (high card Ace - King+Jack kicker)
alff85: shows [8d Ad] (a pair of Aces)
alff85 collected €0.06 from pot
*** SUMMARY ***
Total pot €0.06 | Rake €0 
Board [4h Kc 7c Th Ac]
Seat 1: caduceus369 (button) folded before Flop (didn't bet)
Seat 2: pistaKKio23 (small blind) showed [6h 8s] and lost with high card Ace
Seat 3: TonyPir97 (big blind) showed [6d Jd] and lost with high card Ace
Seat 4: ADRIAN0_MEIS folded before Flop (didn't bet)
Seat 5: SenzaSperanza79 folded before Flop (didn't bet)
Seat 6: alff85 showed [8d Ad] and won (€0.06) with a pair of Aces



PokerStars Zoom Hand #257975495883:  Hold'em No Limit (€0.01/€0.02) [ADM ID: M62BA304494E32ST] - 2025/10/02 23:24:20 CET [2025/10/02 17:24:20 ET]
Table 'Sirio' 6-max Seat #1 is the button
Seat 1: gigiruk91 (€3.42 in chips) 
Seat 2: diesel197474 (€0.66 in chips) 
Seat 3: cap e'bomb95 (€1.88 in chips) 
Seat 4: kAllSeMPRE73 (€4.38 in chips) 
Seat 5: father2008 (€4.16 in chips) 
Seat 6: caduceus369 (€2.64 in chips) 
diesel197474: posts small blind €0.01
cap e'bomb95: posts big blind €0.02
*** HOLE CARDS ***
Dealt to caduceus369 [8h Tc]
kAllSeMPRE73: raises €4.36 to €4.38 and is all-in
father2008: folds 
caduceus369: folds 
gigiruk91: folds 
diesel197474: folds 
cap e'bomb95: folds 
Uncalled bet (€4.36) returned to kAllSeMPRE73
kAllSeMPRE73 collected €0.05 from pot
kAllSeMPRE73: doesn't show hand 
*** SUMMARY ***
Total pot €0.05 | Rake €0 
Seat 1: gigiruk91 (button) folded before Flop (didn't bet)
Seat 2: diesel197474 (small blind) folded before Flop
Seat 3: cap e'bomb95 (big blind) folded before Flop
Seat 4: kAllSeMPRE73 collected (€0.05)
Seat 5: father2008 folded before Flop (didn't bet)
Seat 6: caduceus369 folded before Flop (didn't bet)



PokerStars Zoom Hand #257975494744:  Hold'em No Limit (€0.01/€0.02) [ADM ID: M62BA304494E32ST] - 2025/10/02 23:24:15 CET [2025/10/02 17:24:15 ET]
Table 'Sirio' 6-max Seat #1 is the button
Seat 1: Sorosuno (€2.24 in chips) 
Seat 2: cap e'bomb95 (€1.89 in chips) 
Seat 3: JoyLeoIce (€1.74 in chips) 
Seat 4: montemeru (€1.92 in chips) 
Seat 5: caduceus369 (€2.64 in chips) 
Seat 6: Oiad (€4.75 in chips) 
cap e'bomb95: posts small blind €0.01
JoyLeoIce: posts big blind €0.02
*** HOLE CARDS ***
Dealt to caduceus369 [5h Jc]
montemeru: raises €0.04 to €0.06
caduceus369: folds 
Oiad: calls €0.06
Sorosuno: folds 
cap e'bomb95: folds 
JoyLeoIce: folds 
*** FLOP *** [Ah Ad Jd]
montemeru: bets €0.08
Oiad: folds 
Uncalled bet (€0.08) returned to montemeru
montemeru collected €0.15 from pot
montemeru: doesn't show hand 
*** SUMMARY ***
Total pot €0.15 | Rake €0 
Board [Ah Ad Jd]
Seat 1: Sorosuno (button) folded before Flop (didn't bet)
Seat 2: cap e'bomb95 (small blind) folded before Flop
Seat 3: JoyLeoIce (big blind) folded before Flop
Seat 4: montemeru collected (€0.15)
Seat 5: caduceus369 folded before Flop (didn't bet)
Seat 6: Oiad folded on the Flop



PokerStars Zoom Hand #257975487124:  Hold'em No Limit (€0.01/€0.02) [ADM ID: M62BA304494E32ST] - 2025/10/02 23:23:42 CET [2025/10/02 17:23:42 ET]
Table 'Sirio' 6-max Seat #1 is the button
Seat 1: rush572 (€0.75 in chips) 
Seat 2: gigiruk91 (€6.40 in chips) 
Seat 3: cap e'bomb95 (€4.10 in chips) 
Seat 4: caduceus369 (€2.67 in chips) 
Seat 5: alff85 (€2.07 in chips) 
Seat 6: kklaudio1 (€1.99 in chips) 
gigiruk91: posts small blind €0.01
cap e'bomb95: posts big blind €0.02
*** HOLE CARDS ***
Dealt to caduceus369 [Th 3h]
caduceus369: folds 
alff85: folds 
kklaudio1: raises €0.02 to €0.04
rush572: folds 
gigiruk91: folds 
cap e'bomb95: calls €0.02
*** FLOP *** [Ad 6c Qh]
cap e'bomb95: checks 
kklaudio1: checks 
*** TURN *** [Ad 6c Qh] [Qc]
cap e'bomb95: checks 
kklaudio1: checks 
*** RIVER *** [Ad 6c Qh Qc] [Kd]
cap e'bomb95: checks 
kklaudio1: checks 
*** SHOW DOWN ***
cap e'bomb95: shows [9h Kh] (two pair, Kings and Queens)
kklaudio1: mucks hand 
cap e'bomb95 collected €0.09 from pot
*** SUMMARY ***
Total pot €0.09 | Rake €0 
Board [Ad 6c Qh Qc Kd]
Seat 1: rush572 (button) folded before Flop (didn't bet)
Seat 2: gigiruk91 (small blind) folded before Flop
Seat 3: cap e'bomb95 (big blind) showed [9h Kh] and won (€0.09) with two pair, Kings and Queens
Seat 4: caduceus369 folded before Flop (didn't bet)
Seat 5: alff85 folded before Flop (didn't bet)
Seat 6: kklaudio1 mucked [6h 5d]



PokerStars Zoom Hand #257975496782:  Hold'em No Limit (€0.01/€0.02) [ADM ID: M62BA304494E32ST] - 2025/10/02 23:24:24 CET [2025/10/02 17:24:24 ET]
Table 'Sirio' 6-max Seat #1 is the button
Seat 1: Sim_sala_bin (€0.67 in chips) 
Seat 2: KnaveFlush (€2.18 in chips) 
Seat 3: Auspice67 (€2.02 in chips) 
Seat 4: caduceus369 (€2.64 in chips) 
Seat 5: montemeru (€2.93 in chips) 
Seat 6: diesel197474 (€0.65 in chips) 
KnaveFlush: posts small blind €0.01
Auspice67: posts big blind €0.02
*** HOLE CARDS ***
Dealt to caduceus369 [Qd 9s]
caduceus369: folds 
montemeru: folds 
diesel197474: calls €0.02
Sim_sala_bin: calls €0.02
KnaveFlush: folds 
Auspice67: checks 
*** FLOP *** [3h 5s 6d]
Auspice67: checks 
diesel197474: bets €0.02
Sim_sala_bin: calls €0.02
Auspice67: folds 
*** TURN *** [3h 5s 6d] [7d]
diesel197474: checks 
Sim_sala_bin: checks 
*** RIVER *** [3h 5s 6d 7d] [Kc]
diesel197474: checks 
Sim_sala_bin: bets €0.02
diesel197474: folds 
Uncalled bet (€0.02) returned to Sim_sala_bin
Sim_sala_bin collected €0.11 from pot
Sim_sala_bin: doesn't show hand 
*** SUMMARY ***
Total pot €0.11 | Rake €0 
Board [3h 5s 6d 7d Kc]
Seat 1: Sim_sala_bin (button) collected (€0.11)
Seat 2: KnaveFlush (small blind) folded before Flop
Seat 3: Auspice67 (big blind) folded on the Flop
Seat 4: caduceus369 folded before Flop (didn't bet)
Seat 5: montemeru folded before Flop (didn't bet)
Seat 6: diesel197474 folded on the River



PokerStars Zoom Hand #257975497943:  Hold'em No Limit (€0.01/€0.02) [ADM ID: M62BA304494E32ST] - 2025/10/02 23:24:29 CET [2025/10/02 17:24:29 ET]
Table 'Sirio' 6-max Seat #1 is the button
Seat 1: VagALiss (€2.48 in chips) 
Seat 2: muhozhuk788 (€2 in chips) 
Seat 3: ADRIAN0_MEIS (€2.77 in chips) 
Seat 4: Warterror90 (€2.56 in chips) 
Seat 5: caduceus369 (€2.64 in chips) 
Seat 6: tomaok415 (€0.52 in chips) 
muhozhuk788: posts small blind €0.01
ADRIAN0_MEIS: posts big blind €0.02
*** HOLE CARDS ***
Dealt to caduceus369 [Ah Kd]
Warterror90: folds 
caduceus369: raises €0.02 to €0.04
tomaok415: folds 
VagALiss: calls €0.04
muhozhuk788: folds 
ADRIAN0_MEIS: folds 
*** FLOP *** [6h Qc Kh]
caduceus369: checks 
VagALiss: checks 
*** TURN *** [6h Qc Kh] [6d]
caduceus369: checks 
VagALiss: checks 
*** RIVER *** [6h Qc Kh 6d] [Jc]
caduceus369: bets €0.11
VagALiss: folds 
Uncalled bet (€0.11) returned to caduceus369
caduceus369 collected €0.11 from pot
caduceus369: doesn't show hand 
*** SUMMARY ***
Total pot €0.11 | Rake €0 
Board [6h Qc Kh 6d Jc]
Seat 1: VagALiss (button) folded on the River
Seat 2: muhozhuk788 (small blind) folded before Flop
Seat 3: ADRIAN0_MEIS (big blind) folded before Flop
Seat 4: Warterror90 folded before Flop (didn't bet)
Seat 5: caduceus369 collected (€0.11)
Seat 6: tomaok415 folded before Flop (didn't bet)



PokerStars Zoom Hand #257975508000:  Hold'em No Limit (€0.01/€0.02) [ADM ID: M62BA304494E32ST] - 2025/10/02 23:25:11 CET [2025/10/02 17:25:11 ET]
Table 'Sirio' 6-max Seat #1 is the button
Seat 1: lollo70113 (€2.02 in chips) 
Seat 2: Baroneroxxo (€2.95 in chips) 
Seat 3: caduceus369 (€2.70 in chips) 
Seat 4: TonyPir97 (€0.57 in chips) 
Seat 5: Warterror90 (€2.32 in chips) 
Seat 6: Max2720 (€1.03 in chips) 
Baroneroxxo: posts small blind €0.01
caduceus369: posts big blind €0.02
*** HOLE CARDS ***
Dealt to caduceus369 [3h Qs]
TonyPir97: raises €0.05 to €0.07
Warterror90: folds 
Max2720: folds 
lollo70113: folds 
Baroneroxxo: folds 
caduceus369: folds 
Uncalled bet (€0.05) returned to TonyPir97
TonyPir97 collected €0.05 from pot
TonyPir97: doesn't show hand 
*** SUMMARY ***
Total pot €0.05 | Rake €0 
Seat 1: lollo70113 (button) folded before Flop (didn't bet)
Seat 2: Baroneroxxo (small blind) folded before Flop
Seat 3: caduceus369 (big blind) folded before Flop
Seat 4: TonyPir97 collected (€0.05)
Seat 5: Warterror90 folded before Flop (didn't bet)
Seat 6: Max2720 folded before Flop (didn't bet)



PokerStars Zoom Hand #257975507157:  Hold'em No Limit (€0.01/€0.02) [ADM ID: M62BA304494E32ST] - 2025/10/02 23:25:08 CET [2025/10/02 17:25:08 ET]
Table 'Sirio' 6-max Seat #1 is the button
Seat 1: gigiruk91 (€10.21 in chips) 
Seat 2: caduceus369 (€2.71 in chips) 
Seat 3: ADRIAN0_MEIS (€2.45 in chips) 
Seat 4: Catania838 (€2.36 in chips) 
Seat 5: kklaudio1 (€1.52 in chips) 
Seat 6: meteco79 (€1.29 in chips) 
caduceus369: posts small blind €0.01
ADRIAN0_MEIS: posts big blind €0.02
*** HOLE CARDS ***
Dealt to caduceus369 [5s Kc]
Catania838: folds 
kklaudio1: folds 
meteco79: calls €0.02
gigiruk91: folds 
caduceus369: folds 
ADRIAN0_MEIS: checks 
*** FLOP *** [3h Jh Jc]
ADRIAN0_MEIS: checks 
meteco79: checks 
*** TURN *** [3h Jh Jc] [6h]
ADRIAN0_MEIS: checks 
meteco79: checks 
*** RIVER *** [3h Jh Jc 6h] [Tc]
ADRIAN0_MEIS: checks 
meteco79: checks 
*** SHOW DOWN ***
ADRIAN0_MEIS: shows [6d 8h] (two pair, Jacks and Sixes)
meteco79: shows [6c 9c] (two pair, Jacks and Sixes)
ADRIAN0_MEIS collected €0.03 from pot
meteco79 collected €0.02 from pot
*** SUMMARY ***
Total pot €0.05 | Rake €0 
Board [3h Jh Jc 6h Tc]
Seat 1: gigiruk91 (button) folded before Flop (didn't bet)
Seat 2: caduceus369 (small blind) folded before Flop
Seat 3: ADRIAN0_MEIS (big blind) showed [6d 8h] and won (€0.03) with two pair, Jacks and Sixes
Seat 4: Catania838 folded before Flop (didn't bet)
Seat 5: kklaudio1 folded before Flop (didn't bet)
Seat 6: meteco79 showed [6c 9c] and won (€0.02) with two pair, Jacks and Sixes



PokerStars Zoom Hand #257975510028:  Hold'em No Limit (€0.01/€0.02) [ADM ID: M62BA304494E32ST] - 2025/10/02 23:25:20 CET [2025/10/02 17:25:20 ET]
Table 'Sirio' 6-max Seat #1 is the button
Seat 1: caduceus369 (€2.68 in chips) 
Seat 2: campiraudii (€2.31 in chips) 
Seat 3: stfuplzudonk (€3.09 in chips) 
Seat 4: kklaudio1 (€1.52 in chips) 
Seat 5: Nicoirca2004 (€1.80 in chips) 
Seat 6: Redraw2Flush (€1.65 in chips) 
campiraudii: posts small blind €0.01
stfuplzudonk: posts big blind €0.02
*** HOLE CARDS ***
Dealt to caduceus369 [4s Qs]
kklaudio1: folds 
Nicoirca2004: folds 
Redraw2Flush: folds 
caduceus369: folds 
campiraudii: raises €0.04 to €0.06
stfuplzudonk: folds 
Uncalled bet (€0.04) returned to campiraudii
campiraudii collected €0.04 from pot
campiraudii: doesn't show hand 
*** SUMMARY ***
Total pot €0.04 | Rake €0 
Seat 1: caduceus369 (button) folded before Flop (didn't bet)
Seat 2: campiraudii (small blind) collected (€0.04)
Seat 3: stfuplzudonk (big blind) folded before Flop
Seat 4: kklaudio1 folded before Flop (didn't bet)
Seat 5: Nicoirca2004 folded before Flop (didn't bet)
Seat 6: Redraw2Flush folded before Flop (didn't bet)



PokerStars Zoom Hand #257975513726:  Hold'em No Limit (€0.01/€0.02) [ADM ID: M62BA304494E32ST] - 2025/10/02 23:25:36 CET [2025/10/02 17:25:36 ET]
Table 'Sirio' 6-max Seat #1 is the button
Seat 1: kklaudio1 (€1.93 in chips) 
Seat 2: ADRIAN0_MEIS (€5.53 in chips) 
Seat 3: AntonioKrakka (€3.06 in chips) 
Seat 4: rush572 (€0.58 in chips) 
Seat 5: KnaveFlush (€2 in chips) 
Seat 6: caduceus369 (€2.68 in chips) 
ADRIAN0_MEIS: posts small blind €0.01
AntonioKrakka: posts big blind €0.02
*** HOLE CARDS ***
Dealt to caduceus369 [Qd 7c]
rush572: raises €0.02 to €0.04
KnaveFlush: folds 
caduceus369: folds 
kklaudio1: folds 
ADRIAN0_MEIS: folds 
AntonioKrakka: folds 
Uncalled bet (€0.02) returned to rush572
rush572 collected €0.05 from pot
rush572: doesn't show hand 
*** SUMMARY ***
Total pot €0.05 | Rake €0 
Seat 1: kklaudio1 (button) folded before Flop (didn't bet)
Seat 2: ADRIAN0_MEIS (small blind) folded before Flop
Seat 3: AntonioKrakka (big blind) folded before Flop
Seat 4: rush572 collected (€0.05)
Seat 5: KnaveFlush folded before Flop (didn't bet)
Seat 6: caduceus369 folded before Flop (didn't bet)



PokerStars Zoom Hand #257975511302:  Hold'em No Limit (€0.01/€0.02) [ADM ID: M62BA304494E32ST] - 2025/10/02 23:25:26 CET [2025/10/02 17:25:26 ET]
Table 'Sirio' 6-max Seat #1 is the button
Seat 1: montemeru (€2.23 in chips) 
Seat 2: Oiad (€3.04 in chips) 
Seat 3: muhozhuk788 (€1.75 in chips) 
Seat 4: caduceus369 (€2.68 in chips) 
Seat 5: Redraw2Flush (€1.65 in chips) 
Seat 6: KnaveFlush (€2.26 in chips) 
Oiad: posts small blind €0.01
muhozhuk788: posts big blind €0.02
*** HOLE CARDS ***
Dealt to caduceus369 [Tc 6c]
caduceus369: folds 
Redraw2Flush: folds 
KnaveFlush: raises €0.03 to €0.05
montemeru: folds 
Oiad: folds 
muhozhuk788: raises €0.03 to €0.08
KnaveFlush: calls €0.03
*** FLOP *** [Qs 9c 2s]
muhozhuk788: checks 
KnaveFlush: bets €0.07
muhozhuk788: calls €0.07
*** TURN *** [Qs 9c 2s] [Kh]
muhozhuk788: checks 
KnaveFlush: bets €0.21
muhozhuk788: calls €0.21
*** RIVER *** [Qs 9c 2s Kh] [Qd]
muhozhuk788: checks 
KnaveFlush: checks 
*** SHOW DOWN ***
muhozhuk788: shows [Ks Ac] (two pair, Kings and Queens)
KnaveFlush: mucks hand 
muhozhuk788 collected €0.69 from pot
*** SUMMARY ***
Total pot €0.73 | Rake €0.04 
Board [Qs 9c 2s Kh Qd]
Seat 1: montemeru (button) folded before Flop (didn't bet)
Seat 2: Oiad (small blind) folded before Flop
Seat 3: muhozhuk788 (big blind) showed [Ks Ac] and won (€0.69) with two pair, Kings and Queens
Seat 4: caduceus369 folded before Flop (didn't bet)
Seat 5: Redraw2Flush folded before Flop (didn't bet)
Seat 6: KnaveFlush mucked [Ad 9h]



PokerStars Zoom Hand #257975512266:  Hold'em No Limit (€0.01/€0.02) [ADM ID: M62BA304494E32ST] - 2025/10/02 23:25:30 CET [2025/10/02 17:25:30 ET]
Table 'Sirio' 6-max Seat #1 is the button
Seat 1: lapo1987 (€2.10 in chips) 
Seat 2: montemeru (€3.03 in chips) 
Seat 3: TonyPir97 (€0.60 in chips) 
Seat 4: Sorosuno (€2.61 in chips) 
Seat 5: caduceus369 (€2.68 in chips) 
Seat 6: kklaudio1 (€1.52 in chips) 
montemeru: posts small blind €0.01
TonyPir97: posts big blind €0.02
*** HOLE CARDS ***
Dealt to caduceus369 [8s 6s]
Sorosuno: folds 
caduceus369: folds 
kklaudio1: raises €0.02 to €0.04
lapo1987: folds 
montemeru: calls €0.03
TonyPir97: calls €0.02
*** FLOP *** [Tc Ts 2s]
montemeru: checks 
TonyPir97: bets €0.04
kklaudio1: calls €0.04
montemeru: folds 
*** TURN *** [Tc Ts 2s] [Ad]
TonyPir97: checks 
kklaudio1: bets €0.06
TonyPir97: folds 
Uncalled bet (€0.06) returned to kklaudio1
kklaudio1 collected €0.19 from pot
kklaudio1: doesn't show hand 
*** SUMMARY ***
Total pot €0.20 | Rake €0.01 
Board [Tc Ts 2s Ad]
Seat 1: lapo1987 (button) folded before Flop (didn't bet)
Seat 2: montemeru (small blind) folded on the Flop
Seat 3: TonyPir97 (big blind) folded on the Turn
Seat 4: Sorosuno folded before Flop (didn't bet)
Seat 5: caduceus369 folded before Flop (didn't bet)
Seat 6: kklaudio1 collected (€0.19)



PokerStars Zoom Hand #257975515387:  Hold'em No Limit (€0.01/€0.02) [ADM ID: M62BA304494E32ST] - 2025/10/02 23:25:43 CET [2025/10/02 17:25:43 ET]
Table 'Sirio' 6-max Seat #1 is the button
Seat 1: caduceus369 (€2.67 in chips) 
Seat 2: Sorosuno (€2.47 in chips) 
Seat 3: Ptrcam (€0.83 in chips) 
Seat 4: Kingo690 (€3.55 in chips) 
Seat 5: stfuplzudonk (€1.70 in chips) 
Seat 6: kklaudio1 (€1.93 in chips) 
Sorosuno: posts small blind €0.01
Ptrcam: posts big blind €0.02
*** HOLE CARDS ***
Dealt to caduceus369 [Tc Qd]
Kingo690: folds 
stfuplzudonk: folds 
kklaudio1: folds 
caduceus369: raises €0.02 to €0.04
Sorosuno: folds 
Ptrcam: calls €0.02
*** FLOP *** [Ks 3s 9c]
Ptrcam: checks 
caduceus369: bets €0.04
Ptrcam: calls €0.04
*** TURN *** [Ks 3s 9c] [4d]
Ptrcam: checks 
caduceus369: bets €0.07
Ptrcam: folds 
Uncalled bet (€0.07) returned to caduceus369
caduceus369 collected €0.17 from pot
caduceus369: doesn't show hand 
*** SUMMARY ***
Total pot €0.17 | Rake €0 
Board [Ks 3s 9c 4d]
Seat 1: caduceus369 (button) collected (€0.17)
Seat 2: Sorosuno (small blind) folded before Flop
Seat 3: Ptrcam (big blind) folded on the Turn
Seat 4: Kingo690 folded before Flop (didn't bet)
Seat 5: stfuplzudonk folded before Flop (didn't bet)
Seat 6: kklaudio1 folded before Flop (didn't bet)



PokerStars Zoom Hand #257975514682:  Hold'em No Limit (€0.01/€0.02) [ADM ID: M62BA304494E32ST] - 2025/10/02 23:25:40 CET [2025/10/02 17:25:40 ET]
Table 'Sirio' 6-max Seat #1 is the button
Seat 1: AlfredP80 (€3.38 in chips) 
Seat 2: caduceus369 (€2.68 in chips) 
Seat 3: Max2720 (€1.02 in chips) 
Seat 4: diesel197474 (€0.39 in chips) 
Seat 5: kklaudio1 (€1.93 in chips) 
Seat 6: Catania838 (€2.33 in chips) 
caduceus369: posts small blind €0.01
Max2720: posts big blind €0.02
*** HOLE CARDS ***
Dealt to caduceus369 [3c 7d]
diesel197474: calls €0.02
kklaudio1: folds 
Catania838: folds 
AlfredP80: raises €0.04 to €0.06
caduceus369: folds 
Max2720: calls €0.04
diesel197474: calls €0.04
*** FLOP *** [2s Td Jd]
Max2720: bets €0.02
diesel197474: calls €0.02
AlfredP80: raises €0.06 to €0.08
Max2720: calls €0.06
diesel197474: folds 
*** TURN *** [2s Td Jd] [2h]
Max2720: checks 
AlfredP80: checks 
*** RIVER *** [2s Td Jd 2h] [Qc]
Max2720: checks 
AlfredP80: checks 
*** SHOW DOWN ***
Max2720: shows [Ts Ks] (two pair, Tens and Deuces)
AlfredP80: shows [Kh Th] (two pair, Tens and Deuces)
Max2720 collected €0.18 from pot
AlfredP80 collected €0.17 from pot
*** SUMMARY ***
Total pot €0.37 | Rake €0.02 
Board [2s Td Jd 2h Qc]
Seat 1: AlfredP80 (button) showed [Kh Th] and won (€0.17) with two pair, Tens and Deuces
Seat 2: caduceus369 (small blind) folded before Flop
Seat 3: Max2720 (big blind) showed [Ts Ks] and won (€0.18) with two pair, Tens and Deuces
Seat 4: diesel197474 folded on the Flop
Seat 5: kklaudio1 folded before Flop (didn't bet)
Seat 6: Catania838 folded before Flop (didn't bet)



PokerStars Zoom Hand #257975528551:  Hold'em No Limit (€0.01/€0.02) [ADM ID: M62BA304494E32ST] - 2025/10/02 23:26:39 CET [2025/10/02 17:26:39 ET]
Table 'Sirio' 6-max Seat #1 is the button
Seat 1: Catania838 (€1.48 in chips) 
Seat 2: stfuplzudonk (€2.90 in chips) 
Seat 3: caduceus369 (€2.76 in chips) 
Seat 4: Maur2507 (€0.67 in chips) 
Seat 5: kklaudio1 (€3.35 in chips) 
Seat 6: montemeru (€2.95 in chips) 
stfuplzudonk: posts small blind €0.01
caduceus369: posts big blind €0.02
*** HOLE CARDS ***
Dealt to caduceus369 [Th 9d]
Maur2507: folds 
kklaudio1: folds 
montemeru: folds 
Catania838: folds 
stfuplzudonk: folds 
Uncalled bet (€0.01) returned to caduceus369
caduceus369 collected €0.02 from pot
caduceus369: doesn't show hand 
*** SUMMARY ***
Total pot €0.02 | Rake €0 
Seat 1: Catania838 (button) folded before Flop (didn't bet)
Seat 2: stfuplzudonk (small blind) folded before Flop
Seat 3: caduceus369 (big blind) collected (€0.02)
Seat 4: Maur2507 folded before Flop (didn't bet)
Seat 5: kklaudio1 folded before Flop (didn't bet)
Seat 6: montemeru folded before Flop (didn't bet)



PokerStars Zoom Hand #257975532814:  Hold'em No Limit (€0.01/€0.02) [ADM ID: M62BA304494E32ST] - 2025/10/02 23:26:57 CET [2025/10/02 17:26:57 ET]
Table 'Sirio' 6-max Seat #1 is the button
Seat 1: Warterror90 (€2.77 in chips) 
Seat 2: cap e'bomb95 (€2.89 in chips) 
Seat 3: Sorosuno (€2.43 in chips) 
Seat 4: caduceus369 (€2.77 in chips) 
Seat 5: pistaKKio23 (€1.75 in chips) 
Seat 6: AlfredP80 (€3.41 in chips) 
cap e'bomb95: posts small blind €0.01
Sorosuno: posts big blind €0.02
*** HOLE CARDS ***
Dealt to caduceus369 [Qh Kd]
caduceus369: calls €0.02
pistaKKio23: folds 
AlfredP80: folds 
Warterror90: folds 
cap e'bomb95: folds 
Sorosuno: checks 
*** FLOP *** [3s 7s 6c]
Sorosuno: checks 
caduceus369: bets €0.02
Sorosuno: folds 
Uncalled bet (€0.02) returned to caduceus369
caduceus369 collected €0.05 from pot
caduceus369: doesn't show hand 
*** SUMMARY ***
Total pot €0.05 | Rake €0 
Board [3s 7s 6c]
Seat 1: Warterror90 (button) folded before Flop (didn't bet)
Seat 2: cap e'bomb95 (small blind) folded before Flop
Seat 3: Sorosuno (big blind) folded on the Flop
Seat 4: caduceus369 collected (€0.05)
Seat 5: pistaKKio23 folded before Flop (didn't bet)
Seat 6: AlfredP80 folded before Flop (didn't bet)



PokerStars Zoom Hand #257975539652:  Hold'em No Limit (€0.01/€0.02) [ADM ID: M62BA304494E32ST] - 2025/10/02 23:27:26 CET [2025/10/02 17:27:26 ET]
Table 'Sirio' 6-max Seat #1 is the button
Seat 1: caduceus369 (€2.80 in chips) 
Seat 2: muhozhuk788 (€2.03 in chips) 
Seat 3: rush572 (€0.90 in chips) 
Seat 4: pistaKKio23 (€1.58 in chips) 
Seat 5: Oiad (€3.51 in chips) 
Seat 6: Redraw2Flush (€1.56 in chips) 
muhozhuk788: posts small blind €0.01
rush572: posts big blind €0.02
*** HOLE CARDS ***
Dealt to caduceus369 [2s 2c]
pistaKKio23: folds 
Oiad: folds 
Redraw2Flush: folds 
caduceus369: calls €0.02
muhozhuk788: raises €0.06 to €0.08
rush572: folds 
caduceus369: calls €0.06
*** FLOP *** [6c 6h 5s]
muhozhuk788: checks 
caduceus369: bets €0.08
muhozhuk788: calls €0.08
*** TURN *** [6c 6h 5s] [Kh]
muhozhuk788: checks 
caduceus369: checks 
*** RIVER *** [6c 6h 5s Kh] [7s]
muhozhuk788: checks 
caduceus369: checks 
*** SHOW DOWN ***
muhozhuk788: shows [Qh Ac] (a pair of Sixes)
caduceus369: shows [2s 2c] (two pair, Sixes and Deuces)
caduceus369 collected €0.33 from pot
*** SUMMARY ***
Total pot €0.34 | Rake €0.01 
Board [6c 6h 5s Kh 7s]
Seat 1: caduceus369 (button) showed [2s 2c] and won (€0.33) with two pair, Sixes and Deuces
Seat 2: muhozhuk788 (small blind) showed [Qh Ac] and lost with a pair of Sixes
Seat 3: rush572 (big blind) folded before Flop
Seat 4: pistaKKio23 folded before Flop (didn't bet)
Seat 5: Oiad folded before Flop (didn't bet)
Seat 6: Redraw2Flush folded before Flop (didn't bet)



PokerStars Zoom Hand #257975555127:  Hold'em No Limit (€0.01/€0.02) [ADM ID: M62BA304494E32ST] - 2025/10/02 23:28:31 CET [2025/10/02 17:28:31 ET]
Table 'Sirio' 6-max Seat #1 is the button
Seat 1: jackkk03 (€2.80 in chips) 
Seat 2: caduceus369 (€2.97 in chips) 
Seat 3: gigiruk91 (€10.23 in chips) 
Seat 4: 999rizla (€0.65 in chips) 
Seat 5: muhozhuk788 (€1.87 in chips) 
Seat 6: AntonioKrakka (€2.76 in chips) 
caduceus369: posts small blind €0.01
gigiruk91: posts big blind €0.02
*** HOLE CARDS ***
Dealt to caduceus369 [7s 6s]
999rizla: folds 
muhozhuk788: raises €0.02 to €0.04
AntonioKrakka: folds 
jackkk03: folds 
caduceus369: folds 
gigiruk91: folds 
Uncalled bet (€0.02) returned to muhozhuk788
muhozhuk788 collected €0.05 from pot
muhozhuk788: doesn't show hand 
*** SUMMARY ***
Total pot €0.05 | Rake €0 
Seat 1: jackkk03 (button) folded before Flop (didn't bet)
Seat 2: caduceus369 (small blind) folded before Flop
Seat 3: gigiruk91 (big blind) folded before Flop
Seat 4: 999rizla folded before Flop (didn't bet)
Seat 5: muhozhuk788 collected (€0.05)
Seat 6: AntonioKrakka folded before Flop (didn't bet)



PokerStars Zoom Hand #257975561696:  Hold'em No Limit (€0.01/€0.02) [ADM ID: M62BA304494E32ST] - 2025/10/02 23:28:59 CET [2025/10/02 17:28:59 ET]
Table 'Sirio' 6-max Seat #1 is the button
Seat 1: AntonioKrakka (€5.32 in chips) 
Seat 2: father2008 (€4.03 in chips) 
Seat 3: caduceus369 (€2.96 in chips) 
Seat 4: Catania838 (€1.72 in chips) 
Seat 5: cap e'bomb95 (€1.81 in chips) 
Seat 6: AlfredP80 (€3.30 in chips) 
father2008: posts small blind €0.01
caduceus369: posts big blind €0.02
*** HOLE CARDS ***
Dealt to caduceus369 [Qd 2s]
Catania838: folds 
cap e'bomb95: raises €0.03 to €0.05
AlfredP80: folds 
AntonioKrakka: folds 
father2008: folds 
caduceus369: folds 
Uncalled bet (€0.03) returned to cap e'bomb95
cap e'bomb95 collected €0.05 from pot
cap e'bomb95: doesn't show hand 
*** SUMMARY ***
Total pot €0.05 | Rake €0 
Seat 1: AntonioKrakka (button) folded before Flop (didn't bet)
Seat 2: father2008 (small blind) folded before Flop
Seat 3: caduceus369 (big blind) folded before Flop
Seat 4: Catania838 folded before Flop (didn't bet)
Seat 5: cap e'bomb95 collected (€0.05)
Seat 6: AlfredP80 folded before Flop (didn't bet)



PokerStars Zoom Hand #257975557504:  Hold'em No Limit (€0.01/€0.02) [ADM ID: M62BA304494E32ST] - 2025/10/02 23:28:41 CET [2025/10/02 17:28:41 ET]
Table 'Sirio' 6-max Seat #1 is the button
Seat 1: VagALiss (€2.36 in chips) 
Seat 2: Sorosuno (€2.23 in chips) 
Seat 3: 999rizla (€0.64 in chips) 
Seat 4: cap e'bomb95 (€4.38 in chips) 
Seat 5: jackkk03 (€2.80 in chips) 
Seat 6: caduceus369 (€2.96 in chips) 
Sorosuno: posts small blind €0.01
999rizla: posts big blind €0.02
*** HOLE CARDS ***
Dealt to caduceus369 [4h Ks]
cap e'bomb95: folds 
jackkk03: folds 
caduceus369: folds 
VagALiss: raises €0.03 to €0.05
Sorosuno: raises €0.18 to €0.23
999rizla: calls €0.21
VagALiss: folds 
*** FLOP *** [Kc 2h 8h]
Sorosuno: bets €0.25
999rizla: raises €0.16 to €0.41 and is all-in
Sorosuno: calls €0.16
*** TURN *** [Kc 2h 8h] [8d]
*** RIVER *** [Kc 2h 8h 8d] [7d]
*** SHOW DOWN ***
Sorosuno: shows [As Kh] (two pair, Kings and Eights)
999rizla: shows [Qh Qc] (two pair, Queens and Eights)
Sorosuno collected €1.26 from pot
*** SUMMARY ***
Total pot €1.33 | Rake €0.07 
Board [Kc 2h 8h 8d 7d]
Seat 1: VagALiss (button) folded before Flop
Seat 2: Sorosuno (small blind) showed [As Kh] and won (€1.26) with two pair, Kings and Eights
Seat 3: 999rizla (big blind) showed [Qh Qc] and lost with two pair, Queens and Eights
Seat 4: cap e'bomb95 folded before Flop (didn't bet)
Seat 5: jackkk03 folded before Flop (didn't bet)
Seat 6: caduceus369 folded before Flop (didn't bet)



PokerStars Zoom Hand #257975565540:  Hold'em No Limit (€0.01/€0.02) [ADM ID: M62BA304494E32ST] - 2025/10/02 23:29:15 CET [2025/10/02 17:29:15 ET]
Table 'Sirio' 6-max Seat #1 is the button
Seat 1: Sorosuno (€3.19 in chips) 
Seat 2: AntonioKrakka (€2.74 in chips) 
Seat 3: father2008 (€4.02 in chips) 
Seat 4: diesel197474 (€1.45 in chips) 
Seat 5: caduceus369 (€2.94 in chips) 
Seat 6: muhozhuk788 (€1.63 in chips) 
AntonioKrakka: posts small blind €0.01
father2008: posts big blind €0.02
*** HOLE CARDS ***
Dealt to caduceus369 [7d 5h]
diesel197474: folds 
caduceus369: folds 
muhozhuk788: folds 
Sorosuno: folds 
AntonioKrakka: folds 
Uncalled bet (€0.01) returned to father2008
father2008 collected €0.02 from pot
father2008: doesn't show hand 
*** SUMMARY ***
Total pot €0.02 | Rake €0 
Seat 1: Sorosuno (button) folded before Flop (didn't bet)
Seat 2: AntonioKrakka (small blind) folded before Flop
Seat 3: father2008 (big blind) collected (€0.02)
Seat 4: diesel197474 folded before Flop (didn't bet)
Seat 5: caduceus369 folded before Flop (didn't bet)
Seat 6: muhozhuk788 folded before Flop (didn't bet)



PokerStars Zoom Hand #257975568424:  Hold'em No Limit (€0.01/€0.02) [ADM ID: M62BA304494E32ST] - 2025/10/02 23:29:27 CET [2025/10/02 17:29:27 ET]
Table 'Sirio' 6-max Seat #1 is the button
Seat 1: AntonioKrakka (€2.73 in chips) 
Seat 2: Warterror90 (€4.98 in chips) 
Seat 3: gigiruk91 (€3.39 in chips) 
Seat 4: caduceus369 (€2.93 in chips) 
Seat 5: fantaasso (€0.95 in chips) 
Seat 6: Redraw2Flush (€1.56 in chips) 
Warterror90: posts small blind €0.01
gigiruk91: posts big blind €0.02
*** HOLE CARDS ***
Dealt to caduceus369 [7d Qh]
caduceus369: folds 
fantaasso: folds 
Redraw2Flush: folds 
AntonioKrakka: folds 
Warterror90: folds 
Uncalled bet (€0.01) returned to gigiruk91
gigiruk91 collected €0.02 from pot
gigiruk91: doesn't show hand 
*** SUMMARY ***
Total pot €0.02 | Rake €0 
Seat 1: AntonioKrakka (button) folded before Flop (didn't bet)
Seat 2: Warterror90 (small blind) folded before Flop
Seat 3: gigiruk91 (big blind) collected (€0.02)
Seat 4: caduceus369 folded before Flop (didn't bet)
Seat 5: fantaasso folded before Flop (didn't bet)
Seat 6: Redraw2Flush folded before Flop (didn't bet)



PokerStars Zoom Hand #257975560058:  Hold'em No Limit (€0.01/€0.02) [ADM ID: M62BA304494E32ST] - 2025/10/02 23:28:52 CET [2025/10/02 17:28:52 ET]
Table 'Sirio' 6-max Seat #1 is the button
Seat 1: AlfredP80 (€3.30 in chips) 
Seat 2: Catania838 (€1.61 in chips) 
Seat 3: jackkk03 (€2.80 in chips) 
Seat 4: kklaudio1 (€2.84 in chips) 
Seat 5: cap e'bomb95 (€2.92 in chips) 
Seat 6: caduceus369 (€2.96 in chips) 
Catania838: posts small blind €0.01
jackkk03: posts big blind €0.02
*** HOLE CARDS ***
Dealt to caduceus369 [5c 4c]
kklaudio1: folds 
cap e'bomb95: raises €0.03 to €0.05
caduceus369: folds 
AlfredP80: folds 
Catania838: folds 
jackkk03: calls €0.03
*** FLOP *** [7c 2s 9s]
jackkk03: checks 
cap e'bomb95: checks 
*** TURN *** [7c 2s 9s] [7d]
jackkk03: checks 
cap e'bomb95: checks 
*** RIVER *** [7c 2s 9s 7d] [Qd]
jackkk03: bets €0.11
cap e'bomb95: calls €0.11
*** SHOW DOWN ***
jackkk03: shows [7s 6d] (three of a kind, Sevens)
cap e'bomb95: mucks hand 
jackkk03 collected €0.32 from pot
*** SUMMARY ***
Total pot €0.33 | Rake €0.01 
Board [7c 2s 9s 7d Qd]
Seat 1: AlfredP80 (button) folded before Flop (didn't bet)
Seat 2: Catania838 (small blind) folded before Flop
Seat 3: jackkk03 (big blind) showed [7s 6d] and won (€0.32) with three of a kind, Sevens
Seat 4: kklaudio1 folded before Flop (didn't bet)
Seat 5: cap e'bomb95 mucked [Qc Jc]
Seat 6: caduceus369 folded before Flop (didn't bet)



PokerStars Zoom Hand #257975566563:  Hold'em No Limit (€0.01/€0.02) [ADM ID: M62BA304494E32ST] - 2025/10/02 23:29:19 CET [2025/10/02 17:29:19 ET]
Table 'Sirio' 6-max Seat #1 is the button
Seat 1: meteco79 (€1.22 in chips) 
Seat 2: caduceus369 (€2.94 in chips) 
Seat 3: Baroneroxxo (€2.54 in chips) 
Seat 4: cap e'bomb95 (€1.84 in chips) 
Seat 5: AntonioKrakka (€2.73 in chips) 
Seat 6: pistaKKio23 (€2 in chips) 
caduceus369: posts small blind €0.01
Baroneroxxo: posts big blind €0.02
*** HOLE CARDS ***
Dealt to caduceus369 [2h 9d]
cap e'bomb95: raises €0.03 to €0.05
AntonioKrakka: folds 
pistaKKio23: raises €0.23 to €0.28
meteco79: folds 
caduceus369: folds 
Baroneroxxo: folds 
cap e'bomb95: folds 
Uncalled bet (€0.23) returned to pistaKKio23
pistaKKio23 collected €0.13 from pot
pistaKKio23: doesn't show hand 
*** SUMMARY ***
Total pot €0.13 | Rake €0 
Seat 1: meteco79 (button) folded before Flop (didn't bet)
Seat 2: caduceus369 (small blind) folded before Flop
Seat 3: Baroneroxxo (big blind) folded before Flop
Seat 4: cap e'bomb95 folded before Flop
Seat 5: AntonioKrakka folded before Flop (didn't bet)
Seat 6: pistaKKio23 collected (€0.13)



PokerStars Zoom Hand #257975558904:  Hold'em No Limit (€0.01/€0.02) [ADM ID: M62BA304494E32ST] - 2025/10/02 23:28:47 CET [2025/10/02 17:28:47 ET]
Table 'Sirio' 6-max Seat #1 is the button
Seat 1: rush572 (€0.81 in chips) 
Seat 2: Redraw2Flush (€1.79 in chips) 
Seat 3: Warterror90 (€2.19 in chips) 
Seat 4: caduceus369 (€2.96 in chips) 
Seat 5: father2008 (€4.03 in chips) 
Seat 6: cap e'bomb95 (€4.38 in chips) 
Redraw2Flush: posts small blind €0.01
Warterror90: posts big blind €0.02
*** HOLE CARDS ***
Dealt to caduceus369 [Kh 9d]
caduceus369: folds 
father2008: folds 
cap e'bomb95: raises €0.03 to €0.05
rush572: folds 
Redraw2Flush: calls €0.04
Warterror90: folds 
*** FLOP *** [Ah 8h Qh]
Redraw2Flush: checks 
cap e'bomb95: checks 
*** TURN *** [Ah 8h Qh] [6d]
Redraw2Flush: checks 
cap e'bomb95: checks 
*** RIVER *** [Ah 8h Qh 6d] [7h]
Redraw2Flush: checks 
cap e'bomb95: checks 
*** SHOW DOWN ***
Redraw2Flush: shows [Kd Td] (high card Ace)
cap e'bomb95: shows [2c 2d] (a pair of Deuces)
cap e'bomb95 collected €0.12 from pot
*** SUMMARY ***
Total pot €0.12 | Rake €0 
Board [Ah 8h Qh 6d 7h]
Seat 1: rush572 (button) folded before Flop (didn't bet)
Seat 2: Redraw2Flush (small blind) showed [Kd Td] and lost with high card Ace
Seat 3: Warterror90 (big blind) folded before Flop
Seat 4: caduceus369 folded before Flop (didn't bet)
Seat 5: father2008 folded before Flop (didn't bet)
Seat 6: cap e'bomb95 showed [2c 2d] and won (€0.12) with a pair of Deuces



PokerStars Zoom Hand #257975569419:  Hold'em No Limit (€0.01/€0.02) [ADM ID: M62BA304494E32ST] - 2025/10/02 23:29:31 CET [2025/10/02 17:29:31 ET]
Table 'Sirio' 6-max Seat #1 is the button
Seat 1: caduceus369 (€2.93 in chips) 
Seat 2: Auspice67 (€2.46 in chips) 
Seat 3: KnaveFlush (€2.54 in chips) 
Seat 4: AntonioKrakka (€2.73 in chips) 
Seat 5: pistaKKio23 (€1.95 in chips) 
Seat 6: Warterror90 (€4.97 in chips) 
Auspice67: posts small blind €0.01
KnaveFlush: posts big blind €0.02
*** HOLE CARDS ***
Dealt to caduceus369 [Ks 2h]
AntonioKrakka: folds 
pistaKKio23: folds 
Warterror90: raises €0.04 to €0.06
caduceus369: folds 
Auspice67: folds 
KnaveFlush: folds 
Uncalled bet (€0.04) returned to Warterror90
Warterror90 collected €0.05 from pot
Warterror90: doesn't show hand 
*** SUMMARY ***
Total pot €0.05 | Rake €0 
Seat 1: caduceus369 (button) folded before Flop (didn't bet)
Seat 2: Auspice67 (small blind) folded before Flop
Seat 3: KnaveFlush (big blind) folded before Flop
Seat 4: AntonioKrakka folded before Flop (didn't bet)
Seat 5: pistaKKio23 folded before Flop (didn't bet)
Seat 6: Warterror90 collected (€0.05)



PokerStars Zoom Hand #257975570069:  Hold'em No Limit (€0.01/€0.02) [ADM ID: M62BA304494E32ST] - 2025/10/02 23:29:34 CET [2025/10/02 17:29:34 ET]
Table 'Sirio' 6-max Seat #1 is the button
Seat 1: lapo1987 (€3.87 in chips) 
Seat 2: ADRIAN0_MEIS (€2.21 in chips) 
Seat 3: caduceus369 (€2.93 in chips) 
Seat 4: fantaasso (€0.95 in chips) 
Seat 5: Sorosuno (€2.85 in chips) 
Seat 6: diesel197474 (€1.44 in chips) 
ADRIAN0_MEIS: posts small blind €0.01
caduceus369: posts big blind €0.02
*** HOLE CARDS ***
Dealt to caduceus369 [Jd Ts]
fantaasso: folds 
Sorosuno: raises €0.03 to €0.05
diesel197474: folds 
lapo1987: folds 
ADRIAN0_MEIS: folds 
caduceus369: calls €0.03
*** FLOP *** [7c 6c 4s]
caduceus369: bets €0.04
Sorosuno: calls €0.04
*** TURN *** [7c 6c 4s] [7h]
caduceus369: bets €0.08
Sorosuno: calls €0.08
*** RIVER *** [7c 6c 4s 7h] [8h]
caduceus369: bets €0.36
Sorosuno: folds 
Uncalled bet (€0.36) returned to caduceus369
caduceus369 collected €0.34 from pot
caduceus369: doesn't show hand 
*** SUMMARY ***
Total pot €0.35 | Rake €0.01 
Board [7c 6c 4s 7h 8h]
Seat 1: lapo1987 (button) folded before Flop (didn't bet)
Seat 2: ADRIAN0_MEIS (small blind) folded before Flop
Seat 3: caduceus369 (big blind) collected (€0.34)
Seat 4: fantaasso folded before Flop (didn't bet)
Seat 5: Sorosuno folded on the River
Seat 6: diesel197474 folded before Flop (didn't bet)



PokerStars Zoom Hand #257975596038:  Hold'em No Limit (€0.01/€0.02) [ADM ID: M62BA304494E32ST] - 2025/10/02 23:31:23 CET [2025/10/02 17:31:23 ET]
Table 'Sirio' 6-max Seat #1 is the button
Seat 1: Redraw2Flush (€1.50 in chips) 
Seat 2: caduceus369 (€3.10 in chips) 
Seat 3: fantaasso (€1.88 in chips) 
Seat 4: pistaKKio23 (€1.90 in chips) 
Seat 5: KnaveFlush (€2.57 in chips) 
Seat 6: stfuplzudonk (€2.74 in chips) 
caduceus369: posts small blind €0.01
fantaasso: posts big blind €0.02
*** HOLE CARDS ***
Dealt to caduceus369 [8c 6s]
pistaKKio23: folds 
KnaveFlush: folds 
stfuplzudonk: raises €0.02 to €0.04
Redraw2Flush: folds 
caduceus369: folds 
fantaasso: calls €0.02
*** FLOP *** [3c 3d Jc]
fantaasso: checks 
stfuplzudonk: checks 
*** TURN *** [3c 3d Jc] [Js]
fantaasso: bets €0.05
stfuplzudonk: folds 
Uncalled bet (€0.05) returned to fantaasso
fantaasso collected €0.09 from pot
fantaasso: doesn't show hand 
*** SUMMARY ***
Total pot €0.09 | Rake €0 
Board [3c 3d Jc Js]
Seat 1: Redraw2Flush (button) folded before Flop (didn't bet)
Seat 2: caduceus369 (small blind) folded before Flop
Seat 3: fantaasso (big blind) collected (€0.09)
Seat 4: pistaKKio23 folded before Flop (didn't bet)
Seat 5: KnaveFlush folded before Flop (didn't bet)
Seat 6: stfuplzudonk folded on the Turn



PokerStars Zoom Hand #257975591780:  Hold'em No Limit (€0.01/€0.02) [ADM ID: M62BA304494E32ST] - 2025/10/02 23:31:05 CET [2025/10/02 17:31:05 ET]
Table 'Sirio' 6-max Seat #1 is the button
Seat 1: cap e'bomb95 (€1.76 in chips) 
Seat 2: kklaudio1 (€1.88 in chips) 
Seat 3: Oiad (€4.05 in chips) 
Seat 4: AntonioKrakka (€5.19 in chips) 
Seat 5: caduceus369 (€3.10 in chips) 
Seat 6: KnaveFlush (€2.24 in chips) 
kklaudio1: posts small blind €0.01
Oiad: posts big blind €0.02
*** HOLE CARDS ***
Dealt to caduceus369 [Kc 5d]
AntonioKrakka: raises €0.05 to €0.07
caduceus369: folds 
KnaveFlush: folds 
cap e'bomb95: folds 
kklaudio1: folds 
Oiad: calls €0.05
*** FLOP *** [4h 9s Jh]
Oiad: checks 
AntonioKrakka: checks 
*** TURN *** [4h 9s Jh] [As]
Oiad: checks 
AntonioKrakka: bets €0.15
Oiad: folds 
Uncalled bet (€0.15) returned to AntonioKrakka
AntonioKrakka collected €0.15 from pot
AntonioKrakka: doesn't show hand 
AntonioKrakka is disconnected 
*** SUMMARY ***
Total pot €0.15 | Rake €0 
Board [4h 9s Jh As]
Seat 1: cap e'bomb95 (button) folded before Flop (didn't bet)
Seat 2: kklaudio1 (small blind) folded before Flop
Seat 3: Oiad (big blind) folded on the Turn
Seat 4: AntonioKrakka collected (€0.15)
Seat 5: caduceus369 folded before Flop (didn't bet)
Seat 6: KnaveFlush folded before Flop (didn't bet)



PokerStars Zoom Hand #257975593214:  Hold'em No Limit (€0.01/€0.02) [ADM ID: M62BA304494E32ST] - 2025/10/02 23:31:11 CET [2025/10/02 17:31:11 ET]
Table 'Sirio' 6-max Seat #1 is the button
Seat 1: pistaKKio23 (€2.04 in chips) 
Seat 2: lapo1987 (€3.82 in chips) 
Seat 3: Catania838 (€1.74 in chips) 
Seat 4: Alex83l310 (€2.11 in chips) 
Seat 5: Auspice67 (€2.41 in chips) 
Seat 6: caduceus369 (€3.10 in chips) 
lapo1987: posts small blind €0.01
Catania838: posts big blind €0.02
*** HOLE CARDS ***
Dealt to caduceus369 [3d 6s]
Alex83l310: folds 
Auspice67: raises €0.03 to €0.05
caduceus369: folds 
pistaKKio23: folds 
lapo1987: folds 
Catania838: calls €0.03
*** FLOP *** [Kh Jh 3c]
Catania838: checks 
Auspice67: checks 
*** TURN *** [Kh Jh 3c] [Qd]
Catania838: checks 
Auspice67: bets €0.08
Catania838: calls €0.08
*** RIVER *** [Kh Jh 3c Qd] [Qc]
Catania838: checks 
Auspice67: bets €0.34
Catania838: calls €0.34
*** SHOW DOWN ***
Auspice67: shows [As Ts] (a straight, Ten to Ace)
Catania838: mucks hand 
Auspice67 collected €0.90 from pot
*** SUMMARY ***
Total pot €0.95 | Rake €0.05 
Board [Kh Jh 3c Qd Qc]
Seat 1: pistaKKio23 (button) folded before Flop (didn't bet)
Seat 2: lapo1987 (small blind) folded before Flop
Seat 3: Catania838 (big blind) mucked [6c Jc]
Seat 4: Alex83l310 folded before Flop (didn't bet)
Seat 5: Auspice67 showed [As Ts] and won (€0.90) with a straight, Ten to Ace
Seat 6: caduceus369 folded before Flop (didn't bet)



PokerStars Zoom Hand #257975599620:  Hold'em No Limit (€0.01/€0.02) [ADM ID: M62BA304494E32ST] - 2025/10/02 23:31:38 CET [2025/10/02 17:31:38 ET]
Table 'Sirio' 6-max Seat #1 is the button
Seat 1: caduceus369 (€3.09 in chips) 
Seat 2: montemeru (€1.76 in chips) 
Seat 3: fantaasso (€0.84 in chips) 
Seat 4: lapo1987 (€3.81 in chips) 
Seat 5: ADRIAN0_MEIS (€2.28 in chips) 
Seat 6: stfuplzudonk (€2.15 in chips) 
montemeru: posts small blind €0.01
fantaasso: posts big blind €0.02
*** HOLE CARDS ***
Dealt to caduceus369 [Kd Jh]
lapo1987: folds 
ADRIAN0_MEIS: folds 
stfuplzudonk: raises €0.02 to €0.04
caduceus369: calls €0.04
montemeru: folds 
fantaasso: folds 
*** FLOP *** [7h 4c 2h]
stfuplzudonk: bets €0.06
caduceus369: calls €0.06
*** TURN *** [7h 4c 2h] [2c]
stfuplzudonk: bets €0.11
caduceus369: folds 
Uncalled bet (€0.11) returned to stfuplzudonk
stfuplzudonk collected €0.22 from pot
stfuplzudonk: doesn't show hand 
*** SUMMARY ***
Total pot €0.23 | Rake €0.01 
Board [7h 4c 2h 2c]
Seat 1: caduceus369 (button) folded on the Turn
Seat 2: montemeru (small blind) folded before Flop
Seat 3: fantaasso (big blind) folded before Flop
Seat 4: lapo1987 folded before Flop (didn't bet)
Seat 5: ADRIAN0_MEIS folded before Flop (didn't bet)
Seat 6: stfuplzudonk collected (€0.22)



PokerStars Zoom Hand #257975612334:  Hold'em No Limit (€0.01/€0.02) [ADM ID: M62BA304494E32ST] - 2025/10/02 23:32:32 CET [2025/10/02 17:32:32 ET]
Table 'Sirio' 6-max Seat #1 is the button
Seat 1: KnaveFlush (€2 in chips) 
Seat 2: Sorosuno (€2.59 in chips) 
Seat 3: kAllSeMPRE73 (€0.82 in chips) 
Seat 4: caduceus369 (€2.99 in chips) 
Seat 5: stfuplzudonk (€2.85 in chips) 
Seat 6: pistaKKio23 (€1.81 in chips) 
Sorosuno: posts small blind €0.01
kAllSeMPRE73: posts big blind €0.02
*** HOLE CARDS ***
Dealt to caduceus369 [8d 4h]
caduceus369: folds 
stfuplzudonk: folds 
pistaKKio23: folds 
KnaveFlush: folds 
Sorosuno: folds 
Uncalled bet (€0.01) returned to kAllSeMPRE73
kAllSeMPRE73 collected €0.02 from pot
kAllSeMPRE73: doesn't show hand 
*** SUMMARY ***
Total pot €0.02 | Rake €0 
Seat 1: KnaveFlush (button) folded before Flop (didn't bet)
Seat 2: Sorosuno (small blind) folded before Flop
Seat 3: kAllSeMPRE73 (big blind) collected (€0.02)
Seat 4: caduceus369 folded before Flop (didn't bet)
Seat 5: stfuplzudonk folded before Flop (didn't bet)
Seat 6: pistaKKio23 folded before Flop (didn't bet)



PokerStars Zoom Hand #257975610086:  Hold'em No Limit (€0.01/€0.02) [ADM ID: M62BA304494E32ST] - 2025/10/02 23:32:23 CET [2025/10/02 17:32:23 ET]
Table 'Sirio' 6-max Seat #1 is the button
Seat 1: pistaKKio23 (€4.61 in chips) 
Seat 2: Auspice67 (€2.84 in chips) 
Seat 3: muhozhuk788 (€1.19 in chips) 
Seat 4: caduceus369 (€2.99 in chips) 
Seat 5: Redraw2Flush (€1.90 in chips) 
Seat 6: lapo1987 (€3.78 in chips) 
Auspice67: posts small blind €0.01
muhozhuk788: posts big blind €0.02
*** HOLE CARDS ***
Dealt to caduceus369 [8s Td]
caduceus369: folds 
Redraw2Flush: folds 
lapo1987: raises €0.02 to €0.04
pistaKKio23: folds 
Auspice67: folds 
muhozhuk788: raises €0.02 to €0.06
lapo1987: calls €0.02
*** FLOP *** [Kh 2h 7d]
muhozhuk788: bets €0.04
lapo1987: folds 
Uncalled bet (€0.04) returned to muhozhuk788
muhozhuk788 collected €0.13 from pot
muhozhuk788: doesn't show hand 
*** SUMMARY ***
Total pot €0.13 | Rake €0 
Board [Kh 2h 7d]
Seat 1: pistaKKio23 (button) folded before Flop (didn't bet)
Seat 2: Auspice67 (small blind) folded before Flop
Seat 3: muhozhuk788 (big blind) collected (€0.13)
Seat 4: caduceus369 folded before Flop (didn't bet)
Seat 5: Redraw2Flush folded before Flop (didn't bet)
Seat 6: lapo1987 folded on the Flop



PokerStars Zoom Hand #257975611315:  Hold'em No Limit (€0.01/€0.02) [ADM ID: M62BA304494E32ST] - 2025/10/02 23:32:28 CET [2025/10/02 17:32:28 ET]
Table 'Sirio' 6-max Seat #1 is the button
Seat 1: montemeru (€2 in chips) 
Seat 2: Redraw2Flush (€1.90 in chips) 
Seat 3: fantaasso (€0.81 in chips) 
Seat 4: stfuplzudonk (€2.69 in chips) 
Seat 5: caduceus369 (€2.99 in chips) 
Seat 6: Sorosuno (€2.12 in chips) 
Redraw2Flush: posts small blind €0.01
fantaasso: posts big blind €0.02
*** HOLE CARDS ***
Dealt to caduceus369 [6h Th]
stfuplzudonk: folds 
caduceus369: folds 
Sorosuno: folds 
montemeru: raises €0.04 to €0.06
Redraw2Flush: folds 
fantaasso: raises €0.13 to €0.19
montemeru: calls €0.13
*** FLOP *** [Qs 4s 3s]
fantaasso: checks 
montemeru: checks 
*** TURN *** [Qs 4s 3s] [5h]
fantaasso: bets €0.19
montemeru: folds 
Uncalled bet (€0.19) returned to fantaasso
fantaasso collected €0.37 from pot
fantaasso: doesn't show hand 
*** SUMMARY ***
Total pot €0.39 | Rake €0.02 
Board [Qs 4s 3s 5h]
Seat 1: montemeru (button) folded on the Turn
Seat 2: Redraw2Flush (small blind) folded before Flop
Seat 3: fantaasso (big blind) collected (€0.37)
Seat 4: stfuplzudonk folded before Flop (didn't bet)
Seat 5: caduceus369 folded before Flop (didn't bet)
Seat 6: Sorosuno folded before Flop (didn't bet)



PokerStars Zoom Hand #257975614676:  Hold'em No Limit (€0.01/€0.02) [ADM ID: M62BA304494E32ST] - 2025/10/02 23:32:42 CET [2025/10/02 17:32:42 ET]
Table 'Sirio' 6-max Seat #1 is the button
Seat 1: Sorosuno (€2.58 in chips) 
Seat 2: stfuplzudonk (€2.25 in chips) 
Seat 3: caduceus369 (€2.99 in chips) 
Seat 4: cap e'bomb95 (€4.43 in chips) 
Seat 5: Baroneroxxo (€2.55 in chips) 
Seat 6: KnaveFlush (€2 in chips) 
stfuplzudonk: posts small blind €0.01
caduceus369: posts big blind €0.02
*** HOLE CARDS ***
Dealt to caduceus369 [6c 9c]
cap e'bomb95: folds 
Baroneroxxo: calls €0.02
KnaveFlush: folds 
Sorosuno: folds 
stfuplzudonk: calls €0.01
caduceus369: checks 
*** FLOP *** [3s Qs Ad]
stfuplzudonk: checks 
caduceus369: checks 
Baroneroxxo: checks 
*** TURN *** [3s Qs Ad] [6d]
stfuplzudonk: checks 
caduceus369: checks 
Baroneroxxo: checks 
*** RIVER *** [3s Qs Ad 6d] [9d]
stfuplzudonk: checks 
caduceus369: bets €0.02
Baroneroxxo: folds 
stfuplzudonk: folds 
Uncalled bet (€0.02) returned to caduceus369
caduceus369 collected €0.06 from pot
caduceus369: doesn't show hand 
*** SUMMARY ***
Total pot €0.06 | Rake €0 
Board [3s Qs Ad 6d 9d]
Seat 1: Sorosuno (button) folded before Flop (didn't bet)
Seat 2: stfuplzudonk (small blind) folded on the River
Seat 3: caduceus369 (big blind) collected (€0.06)
Seat 4: cap e'bomb95 folded before Flop (didn't bet)
Seat 5: Baroneroxxo folded on the River
Seat 6: KnaveFlush folded before Flop (didn't bet)



PokerStars Zoom Hand #257975627953:  Hold'em No Limit (€0.01/€0.02) [ADM ID: M62BA304494E32ST] - 2025/10/02 23:33:38 CET [2025/10/02 17:33:38 ET]
Table 'Sirio' 6-max Seat #1 is the button
Seat 1: caduceus369 (€3.02 in chips) 
Seat 2: Redraw2Flush (€1.69 in chips) 
Seat 3: montemeru (€1.96 in chips) 
Seat 4: lapo1987 (€2.72 in chips) 
Seat 5: fantaasso (€0.99 in chips) 
Seat 6: cap e'bomb95 (€1.86 in chips) 
Redraw2Flush: posts small blind €0.01
montemeru: posts big blind €0.02
*** HOLE CARDS ***
Dealt to caduceus369 [2s Kc]
lapo1987: folds 
fantaasso: raises €0.04 to €0.06
cap e'bomb95: folds 
caduceus369: folds 
Redraw2Flush: folds 
montemeru: calls €0.04
*** FLOP *** [5h Qh 9s]
montemeru: checks 
fantaasso: checks 
*** TURN *** [5h Qh 9s] [Jh]
montemeru: bets €0.07
fantaasso: calls €0.07
*** RIVER *** [5h Qh 9s Jh] [5c]
montemeru: bets €0.13
fantaasso: calls €0.13
*** SHOW DOWN ***
montemeru: shows [6h Jc] (two pair, Jacks and Fives)
fantaasso: shows [Kd Kh] (two pair, Kings and Fives)
fantaasso collected €0.51 from pot
*** SUMMARY ***
Total pot €0.53 | Rake €0.02 
Board [5h Qh 9s Jh 5c]
Seat 1: caduceus369 (button) folded before Flop (didn't bet)
Seat 2: Redraw2Flush (small blind) folded before Flop
Seat 3: montemeru (big blind) showed [6h Jc] and lost with two pair, Jacks and Fives
Seat 4: lapo1987 folded before Flop (didn't bet)
Seat 5: fantaasso showed [Kd Kh] and won (€0.51) with two pair, Kings and Fives
Seat 6: cap e'bomb95 folded before Flop (didn't bet)



PokerStars Zoom Hand #257975626935:  Hold'em No Limit (€0.01/€0.02) [ADM ID: M62BA304494E32ST] - 2025/10/02 23:33:34 CET [2025/10/02 17:33:34 ET]
Table 'Sirio' 6-max Seat #1 is the button
Seat 1: father2008 (€2.68 in chips) 
Seat 2: caduceus369 (€3.03 in chips) 
Seat 3: ADRIAN0_MEIS (€5.77 in chips) 
Seat 4: Redraw2Flush (€1.69 in chips) 
Seat 5: stfuplzudonk (€2.23 in chips) 
Seat 6: Ptrcam (€0.64 in chips) 
caduceus369: posts small blind €0.01
ADRIAN0_MEIS: posts big blind €0.02
*** HOLE CARDS ***
Dealt to caduceus369 [5h 2d]
Redraw2Flush: folds 
stfuplzudonk: folds 
Ptrcam: calls €0.02
father2008: folds 
caduceus369: folds 
ADRIAN0_MEIS: checks 
*** FLOP *** [Ks Ah 5s]
ADRIAN0_MEIS: checks 
Ptrcam: checks 
*** TURN *** [Ks Ah 5s] [Ad]
ADRIAN0_MEIS: checks 
Ptrcam: bets €0.02
ADRIAN0_MEIS: folds 
Uncalled bet (€0.02) returned to Ptrcam
Ptrcam collected €0.05 from pot
Ptrcam: doesn't show hand 
*** SUMMARY ***
Total pot €0.05 | Rake €0 
Board [Ks Ah 5s Ad]
Seat 1: father2008 (button) folded before Flop (didn't bet)
Seat 2: caduceus369 (small blind) folded before Flop
Seat 3: ADRIAN0_MEIS (big blind) folded on the Turn
Seat 4: Redraw2Flush folded before Flop (didn't bet)
Seat 5: stfuplzudonk folded before Flop (didn't bet)
Seat 6: Ptrcam collected (€0.05)



PokerStars Zoom Hand #257975629376:  Hold'em No Limit (€0.01/€0.02) [ADM ID: M62BA304494E32ST] - 2025/10/02 23:33:44 CET [2025/10/02 17:33:44 ET]
Table 'Sirio' 6-max Seat #1 is the button
Seat 1: campiraudii (€5.10 in chips) 
Seat 2: Catania838 (€2.61 in chips) 
Seat 3: meteco79 (€1.04 in chips) 
Seat 4: cap e'bomb95 (€3.06 in chips) 
Seat 5: Redraw2Flush (€1.85 in chips) 
Seat 6: caduceus369 (€3.02 in chips) 
Catania838: posts small blind €0.01
meteco79: posts big blind €0.02
*** HOLE CARDS ***
Dealt to caduceus369 [As Ah]
cap e'bomb95: folds 
Redraw2Flush: folds 
caduceus369: raises €0.02 to €0.04
campiraudii: calls €0.04
Catania838: folds 
meteco79: calls €0.02
*** FLOP *** [Tc 8c 6d]
meteco79: checks 
caduceus369: bets €0.02
campiraudii: calls €0.02
meteco79: calls €0.02
*** TURN *** [Tc 8c 6d] [6s]
meteco79: checks 
caduceus369: bets €0.05
campiraudii: calls €0.05
meteco79: folds 
*** RIVER *** [Tc 8c 6d 6s] [8s]
caduceus369: bets €0.28
campiraudii: folds 
Uncalled bet (€0.28) returned to caduceus369
caduceus369 collected €0.28 from pot
caduceus369: doesn't show hand 
*** SUMMARY ***
Total pot €0.29 | Rake €0.01 
Board [Tc 8c 6d 6s 8s]
Seat 1: campiraudii (button) folded on the River
Seat 2: Catania838 (small blind) folded before Flop
Seat 3: meteco79 (big blind) folded on the Turn
Seat 4: cap e'bomb95 folded before Flop (didn't bet)
Seat 5: Redraw2Flush folded before Flop (didn't bet)
Seat 6: caduceus369 collected (€0.28)



PokerStars Zoom Hand #257975642177:  Hold'em No Limit (€0.01/€0.02) [ADM ID: M62BA304494E32ST] - 2025/10/02 23:34:39 CET [2025/10/02 17:34:39 ET]
Table 'Sirio' 6-max Seat #1 is the button
Seat 1: Auspice67 (€2.56 in chips) 
Seat 2: cap e'bomb95 (€3.04 in chips) 
Seat 3: caduceus369 (€3.19 in chips) 
Seat 4: fantaasso (€1.78 in chips) 
Seat 5: diesel197474 (€1.31 in chips) 
Seat 6: lapo1987 (€3.60 in chips) 
cap e'bomb95: posts small blind €0.01
caduceus369: posts big blind €0.02
*** HOLE CARDS ***
Dealt to caduceus369 [Jh Js]
fantaasso: folds 
diesel197474: folds 
lapo1987: folds 
Auspice67: folds 
cap e'bomb95: folds 
Uncalled bet (€0.01) returned to caduceus369
caduceus369 collected €0.02 from pot
caduceus369: doesn't show hand 
*** SUMMARY ***
Total pot €0.02 | Rake €0 
Seat 1: Auspice67 (button) folded before Flop (didn't bet)
Seat 2: cap e'bomb95 (small blind) folded before Flop
Seat 3: caduceus369 (big blind) collected (€0.02)
Seat 4: fantaasso folded before Flop (didn't bet)
Seat 5: diesel197474 folded before Flop (didn't bet)
Seat 6: lapo1987 folded before Flop (didn't bet)



PokerStars Zoom Hand #257975640747:  Hold'em No Limit (€0.01/€0.02) [ADM ID: M62BA304494E32ST] - 2025/10/02 23:34:33 CET [2025/10/02 17:34:33 ET]
Table 'Sirio' 6-max Seat #1 is the button
Seat 1: tomaok415 (€1.31 in chips) 
Seat 2: fantaasso (€1.22 in chips) 
Seat 3: Alex83l310 (€1.97 in chips) 
Seat 4: cap e'bomb95 (€3.04 in chips) 
Seat 5: caduceus369 (€3.19 in chips) 
Seat 6: diesel197474 (€1.31 in chips) 
fantaasso: posts small blind €0.01
Alex83l310: posts big blind €0.02
*** HOLE CARDS ***
Dealt to caduceus369 [Jd 9h]
cap e'bomb95: folds 
caduceus369: folds 
diesel197474: folds 
tomaok415: raises €0.05 to €0.07
fantaasso: folds 
Alex83l310: calls €0.05
*** FLOP *** [Kh 6s Kc]
Alex83l310: checks 
tomaok415: bets €0.15
Alex83l310: calls €0.15
*** TURN *** [Kh 6s Kc] [8s]
Alex83l310: checks 
tomaok415: bets €0.43
Alex83l310: folds 
Uncalled bet (€0.43) returned to tomaok415
tomaok415 collected €0.43 from pot
tomaok415: doesn't show hand 
*** SUMMARY ***
Total pot €0.45 | Rake €0.02 
Board [Kh 6s Kc 8s]
Seat 1: tomaok415 (button) collected (€0.43)
Seat 2: fantaasso (small blind) folded before Flop
Seat 3: Alex83l310 (big blind) folded on the Turn
Seat 4: cap e'bomb95 folded before Flop (didn't bet)
Seat 5: caduceus369 folded before Flop (didn't bet)
Seat 6: diesel197474 folded before Flop (didn't bet)



PokerStars Zoom Hand #257975644668:  Hold'em No Limit (€0.01/€0.02) [ADM ID: M62BA304494E32ST] - 2025/10/02 23:34:50 CET [2025/10/02 17:34:50 ET]
Table 'Sirio' 6-max Seat #1 is the button
Seat 1: meteco79 (€1 in chips) 
Seat 2: caduceus369 (€3.20 in chips) 
Seat 3: montemeru (€2.45 in chips) 
Seat 4: muhozhuk788 (€2.79 in chips) 
Seat 5: Warterror90 (€5.06 in chips) 
Seat 6: lollo70113 (€1.49 in chips) 
caduceus369: posts small blind €0.01
montemeru: posts big blind €0.02
*** HOLE CARDS ***
Dealt to caduceus369 [As 2d]
muhozhuk788: folds 
Warterror90: folds 
lollo70113: folds 
meteco79: folds 
caduceus369: calls €0.01
montemeru: raises €0.04 to €0.06
caduceus369: folds 
Uncalled bet (€0.04) returned to montemeru
montemeru collected €0.04 from pot
montemeru: doesn't show hand 
*** SUMMARY ***
Total pot €0.04 | Rake €0 
Seat 1: meteco79 (button) folded before Flop (didn't bet)
Seat 2: caduceus369 (small blind) folded before Flop
Seat 3: montemeru (big blind) collected (€0.04)
Seat 4: muhozhuk788 folded before Flop (didn't bet)
Seat 5: Warterror90 folded before Flop (didn't bet)
Seat 6: lollo70113 folded before Flop (didn't bet)



PokerStars Zoom Hand #257975648879:  Hold'em No Limit (€0.01/€0.02) [ADM ID: M62BA304494E32ST] - 2025/10/02 23:35:08 CET [2025/10/02 17:35:08 ET]
Table 'Sirio' 6-max Seat #1 is the button
Seat 1: montemeru (€2.47 in chips) 
Seat 2: Redraw2Flush (€2.31 in chips) 
Seat 3: fantaasso (€1.20 in chips) 
Seat 4: stfuplzudonk (€2.81 in chips) 
Seat 5: ADRIAN0_MEIS (€4.47 in chips) 
Seat 6: caduceus369 (€3.18 in chips) 
Redraw2Flush: posts small blind €0.01
fantaasso: posts big blind €0.02
*** HOLE CARDS ***
Dealt to caduceus369 [6d 4h]
stfuplzudonk: raises €0.02 to €0.04
ADRIAN0_MEIS: folds 
caduceus369: folds 
montemeru: raises €0.11 to €0.15
Redraw2Flush: folds 
fantaasso: folds 
stfuplzudonk: calls €0.11
*** FLOP *** [4d 6s 8h]
stfuplzudonk: checks 
montemeru: bets €0.20
stfuplzudonk: folds 
Uncalled bet (€0.20) returned to montemeru
montemeru collected €0.32 from pot
montemeru: doesn't show hand 
*** SUMMARY ***
Total pot €0.33 | Rake €0.01 
Board [4d 6s 8h]
Seat 1: montemeru (button) collected (€0.32)
Seat 2: Redraw2Flush (small blind) folded before Flop
Seat 3: fantaasso (big blind) folded before Flop
Seat 4: stfuplzudonk folded on the Flop
Seat 5: ADRIAN0_MEIS folded before Flop (didn't bet)
Seat 6: caduceus369 folded before Flop (didn't bet)



PokerStars Zoom Hand #257975651091:  Hold'em No Limit (€0.01/€0.02) [ADM ID: M62BA304494E32ST] - 2025/10/02 23:35:18 CET [2025/10/02 17:35:18 ET]
Table 'Sirio' 6-max Seat #1 is the button
Seat 1: kklaudio1 (€2.38 in chips) 
Seat 2: Baroneroxxo (€0.22 in chips) 
Seat 3: ADRIAN0_MEIS (€5.74 in chips) 
Seat 4: Oiad (€3.88 in chips) 
Seat 5: caduceus369 (€3.18 in chips) 
Seat 6: KnaveFlush (€3.01 in chips) 
Baroneroxxo: posts small blind €0.01
ADRIAN0_MEIS: posts big blind €0.02
*** HOLE CARDS ***
Dealt to caduceus369 [7c 2h]
Oiad: folds 
caduceus369: folds 
KnaveFlush: folds 
kklaudio1: raises €0.02 to €0.04
Baroneroxxo: raises €0.18 to €0.22 and is all-in
ADRIAN0_MEIS: folds 
kklaudio1: calls €0.18
*** FLOP *** [5d Jd 6s]
*** TURN *** [5d Jd 6s] [5h]
*** RIVER *** [5d Jd 6s 5h] [4c]
*** SHOW DOWN ***
Baroneroxxo: shows [Qc Ac] (a pair of Fives)
kklaudio1: shows [Ah Th] (a pair of Fives - lower kicker)
Baroneroxxo collected €0.44 from pot
*** SUMMARY ***
Total pot €0.46 | Rake €0.02 
Board [5d Jd 6s 5h 4c]
Seat 1: kklaudio1 (button) showed [Ah Th] and lost with a pair of Fives
Seat 2: Baroneroxxo (small blind) showed [Qc Ac] and won (€0.44) with a pair of Fives
Seat 3: ADRIAN0_MEIS (big blind) folded before Flop
Seat 4: Oiad folded before Flop (didn't bet)
Seat 5: caduceus369 folded before Flop (didn't bet)
Seat 6: KnaveFlush folded before Flop (didn't bet)



PokerStars Zoom Hand #257975649796:  Hold'em No Limit (€0.01/€0.02) [ADM ID: M62BA304494E32ST] - 2025/10/02 23:35:13 CET [2025/10/02 17:35:13 ET]
Table 'Sirio' 6-max Seat #1 is the button
Seat 1: Redraw2Flush (€2.30 in chips) 
Seat 2: Oiad (€3.89 in chips) 
Seat 3: cap e'bomb95 (€4.51 in chips) 
Seat 4: caduceus369 (€3.18 in chips) 
Seat 5: diesel197474 (€1.28 in chips) 
Seat 6: RRgalp (€8.21 in chips) 
Oiad: posts small blind €0.01
cap e'bomb95: posts big blind €0.02
*** HOLE CARDS ***
Dealt to caduceus369 [5d Qd]
caduceus369: folds 
diesel197474: folds 
RRgalp: raises €0.04 to €0.06
Redraw2Flush: calls €0.06
Oiad: folds 
cap e'bomb95: folds 
*** FLOP *** [7s 6d Tc]
RRgalp: checks 
Redraw2Flush: checks 
*** TURN *** [7s 6d Tc] [8s]
RRgalp: checks 
Redraw2Flush: bets €0.10
RRgalp: folds 
Uncalled bet (€0.10) returned to Redraw2Flush
Redraw2Flush collected €0.15 from pot
Redraw2Flush: doesn't show hand 
*** SUMMARY ***
Total pot €0.15 | Rake €0 
Board [7s 6d Tc 8s]
Seat 1: Redraw2Flush (button) collected (€0.15)
Seat 2: Oiad (small blind) folded before Flop
Seat 3: cap e'bomb95 (big blind) folded before Flop
Seat 4: caduceus369 folded before Flop (didn't bet)
Seat 5: diesel197474 folded before Flop (didn't bet)
Seat 6: RRgalp folded on the Turn



PokerStars Zoom Hand #257975652298:  Hold'em No Limit (€0.01/€0.02) [ADM ID: M62BA304494E32ST] - 2025/10/02 23:35:23 CET [2025/10/02 17:35:23 ET]
Table 'Sirio' 6-max Seat #1 is the button
Seat 1: lapo1987 (€2.62 in chips) 
Seat 2: Pasdum57 (€1.56 in chips) 
Seat 3: caduceus369 (€3.18 in chips) 
Seat 4: Oiad (€3.88 in chips) 
Seat 5: Robycastel89 (€1.02 in chips) 
Seat 6: ADRIAN0_MEIS (€5.72 in chips) 
Pasdum57: posts small blind €0.01
caduceus369: posts big blind €0.02
*** HOLE CARDS ***
Dealt to caduceus369 [7c 3h]
Oiad: folds 
Robycastel89: folds 
ADRIAN0_MEIS: folds 
lapo1987: folds 
Pasdum57: calls €0.01
caduceus369: checks 
*** FLOP *** [As 4h 9h]
Pasdum57: checks 
caduceus369: bets €0.02
Pasdum57: calls €0.02
*** TURN *** [As 4h 9h] [4s]
Pasdum57: checks 
caduceus369: checks 
*** RIVER *** [As 4h 9h 4s] [4c]
Pasdum57: checks 
caduceus369: bets €0.02
Pasdum57: calls €0.02
*** SHOW DOWN ***
caduceus369: shows [7c 3h] (three of a kind, Fours)
Pasdum57: shows [Qh Th] (three of a kind, Fours - Ace+Queen kicker)
Pasdum57 collected €0.12 from pot
*** SUMMARY ***
Total pot €0.12 | Rake €0 
Board [As 4h 9h 4s 4c]
Seat 1: lapo1987 (button) folded before Flop (didn't bet)
Seat 2: Pasdum57 (small blind) showed [Qh Th] and won (€0.12) with three of a kind, Fours
Seat 3: caduceus369 (big blind) showed [7c 3h] and lost with three of a kind, Fours
Seat 4: Oiad folded before Flop (didn't bet)
Seat 5: Robycastel89 folded before Flop (didn't bet)
Seat 6: ADRIAN0_MEIS folded before Flop (didn't bet)



PokerStars Zoom Hand #257975662114:  Hold'em No Limit (€0.01/€0.02) [ADM ID: M62BA304494E32ST] - 2025/10/02 23:36:06 CET [2025/10/02 17:36:06 ET]
Table 'Sirio' 6-max Seat #1 is the button
Seat 1: caduceus369 (€3.12 in chips) 
Seat 2: muhozhuk788 (€1.26 in chips) 
Seat 3: meteco79 (€0.98 in chips) 
Seat 4: rush572 (€0.53 in chips) 
Seat 5: cap e'bomb95 (€3.07 in chips) 
Seat 6: pistaKKio23 (€1.84 in chips) 
muhozhuk788: posts small blind €0.01
meteco79: posts big blind €0.02
*** HOLE CARDS ***
Dealt to caduceus369 [Ac 2h]
rush572: folds 
cap e'bomb95: folds 
pistaKKio23: folds 
caduceus369: raises €0.02 to €0.04
muhozhuk788: folds 
meteco79: calls €0.02
*** FLOP *** [9d 4s Qs]
meteco79: checks 
caduceus369: bets €0.03
meteco79: folds 
Uncalled bet (€0.03) returned to caduceus369
caduceus369 collected €0.09 from pot
caduceus369: doesn't show hand 
*** SUMMARY ***
Total pot €0.09 | Rake €0 
Board [9d 4s Qs]
Seat 1: caduceus369 (button) collected (€0.09)
Seat 2: muhozhuk788 (small blind) folded before Flop
Seat 3: meteco79 (big blind) folded on the Flop
Seat 4: rush572 folded before Flop (didn't bet)
Seat 5: cap e'bomb95 folded before Flop (didn't bet)
Seat 6: pistaKKio23 folded before Flop (didn't bet)



PokerStars Zoom Hand #257975667729:  Hold'em No Limit (€0.01/€0.02) [ADM ID: M62BA304494E32ST] - 2025/10/02 23:36:30 CET [2025/10/02 17:36:30 ET]
Table 'Sirio' 6-max Seat #1 is the button
Seat 1: Catania838 (€2.72 in chips) 
Seat 2: caduceus369 (€3.17 in chips) 
Seat 3: Oiad (€5.11 in chips) 
Seat 4: Auspice67 (€2.41 in chips) 
Seat 5: kklaudio1 (€2.05 in chips) 
Seat 6: diesel197474 (€1.20 in chips) 
caduceus369: posts small blind €0.01
Oiad: posts big blind €0.02
*** HOLE CARDS ***
Dealt to caduceus369 [8h 8s]
Auspice67: folds 
kklaudio1: folds 
diesel197474: folds 
Catania838: folds 
caduceus369: calls €0.01
Oiad: checks 
*** FLOP *** [Qs Ad Jh]
caduceus369: checks 
Oiad: bets €0.04
caduceus369: calls €0.04
*** TURN *** [Qs Ad Jh] [Kd]
caduceus369: bets €0.04
Oiad: raises €0.06 to €0.10
caduceus369: folds 
Uncalled bet (€0.06) returned to Oiad
Oiad collected €0.19 from pot
Oiad: doesn't show hand 
*** SUMMARY ***
Total pot €0.20 | Rake €0.01 
Board [Qs Ad Jh Kd]
Seat 1: Catania838 (button) folded before Flop (didn't bet)
Seat 2: caduceus369 (small blind) folded on the Turn
Seat 3: Oiad (big blind) collected (€0.19)
Seat 4: Auspice67 folded before Flop (didn't bet)
Seat 5: kklaudio1 folded before Flop (didn't bet)
Seat 6: diesel197474 folded before Flop (didn't bet)



PokerStars Zoom Hand #257975689722:  Hold'em No Limit (€0.01/€0.02) [ADM ID: M62BA304494E32ST] - 2025/10/02 23:38:05 CET [2025/10/02 17:38:05 ET]
Table 'Sirio' 6-max Seat #1 is the button
Seat 1: campiraudii (€4.46 in chips) 
Seat 2: Warterror90 (€5.09 in chips) 
Seat 3: Sium12302 (€2.24 in chips) 
Seat 4: kAllSeMPRE73 (€0.80 in chips) 
Seat 5: Oiad (€5.20 in chips) 
Seat 6: caduceus369 (€3.07 in chips) 
Warterror90: posts small blind €0.01
Sium12302: posts big blind €0.02
*** HOLE CARDS ***
Dealt to caduceus369 [Qd 7h]
kAllSeMPRE73: folds 
Oiad: folds 
caduceus369: folds 
campiraudii: calls €0.02
Warterror90: folds 
Sium12302: raises €0.07 to €0.09
campiraudii: calls €0.07
*** FLOP *** [3c 6c 2h]
Sium12302: bets €0.09
campiraudii: folds 
Uncalled bet (€0.09) returned to Sium12302
Sium12302 collected €0.18 from pot
Sium12302: doesn't show hand 
*** SUMMARY ***
Total pot €0.19 | Rake €0.01 
Board [3c 6c 2h]
Seat 1: campiraudii (button) folded on the Flop
Seat 2: Warterror90 (small blind) folded before Flop
Seat 3: Sium12302 (big blind) collected (€0.18)
Seat 4: kAllSeMPRE73 folded before Flop (didn't bet)
Seat 5: Oiad folded before Flop (didn't bet)
Seat 6: caduceus369 folded before Flop (didn't bet)



PokerStars Zoom Hand #257975691224:  Hold'em No Limit (€0.01/€0.02) [ADM ID: M62BA304494E32ST] - 2025/10/02 23:38:12 CET [2025/10/02 17:38:12 ET]
Table 'Sirio' 6-max Seat #1 is the button
Seat 1: caduceus369 (€3.07 in chips) 
Seat 2: pistaKKio23 (€4.54 in chips) 
Seat 3: stfuplzudonk (€2.43 in chips) 
Seat 4: Robycastel89 (€1.32 in chips) 
Seat 5: Warterror90 (€5.08 in chips) 
Seat 6: meteco79 (€0.94 in chips) 
pistaKKio23: posts small blind €0.01
stfuplzudonk: posts big blind €0.02
*** HOLE CARDS ***
Dealt to caduceus369 [8h 8s]
Robycastel89: folds 
Warterror90: folds 
meteco79: calls €0.02
caduceus369: raises €0.06 to €0.08
pistaKKio23: folds 
stfuplzudonk: calls €0.06
meteco79: folds 
*** FLOP *** [9d 2s 7d]
stfuplzudonk: checks 
caduceus369: bets €0.09
stfuplzudonk: folds 
Uncalled bet (€0.09) returned to caduceus369
caduceus369 collected €0.18 from pot
caduceus369: doesn't show hand 
*** SUMMARY ***
Total pot €0.19 | Rake €0.01 
Board [9d 2s 7d]
Seat 1: caduceus369 (button) collected (€0.18)
Seat 2: pistaKKio23 (small blind) folded before Flop
Seat 3: stfuplzudonk (big blind) folded on the Flop
Seat 4: Robycastel89 folded before Flop (didn't bet)
Seat 5: Warterror90 folded before Flop (didn't bet)
Seat 6: meteco79 folded before Flop



PokerStars Zoom Hand #257975687999:  Hold'em No Limit (€0.01/€0.02) [ADM ID: M62BA304494E32ST] - 2025/10/02 23:37:58 CET [2025/10/02 17:37:58 ET]
Table 'Sirio' 6-max Seat #1 is the button
Seat 1: Pasdum57 (€0.21 in chips) 
Seat 2: Auspice67 (€2.38 in chips) 
Seat 3: Tiaka0105 (€0.55 in chips) 
Seat 4: caduceus369 (€3.07 in chips) 
Seat 5: Warterror90 (€5.09 in chips) 
Seat 6: Sium12302 (€2.24 in chips) 
Auspice67: posts small blind €0.01
Tiaka0105: posts big blind €0.02
*** HOLE CARDS ***
Dealt to caduceus369 [7s 2d]
caduceus369: folds 
Warterror90: folds 
Sium12302: folds 
Pasdum57: folds 
Auspice67: raises €0.04 to €0.06
Tiaka0105: folds 
Uncalled bet (€0.04) returned to Auspice67
Auspice67 collected €0.04 from pot
Auspice67: doesn't show hand 
*** SUMMARY ***
Total pot €0.04 | Rake €0 
Seat 1: Pasdum57 (button) folded before Flop (didn't bet)
Seat 2: Auspice67 (small blind) collected (€0.04)
Seat 3: Tiaka0105 (big blind) folded before Flop
Seat 4: caduceus369 folded before Flop (didn't bet)
Seat 5: Warterror90 folded before Flop (didn't bet)
Seat 6: Sium12302 folded before Flop (didn't bet)



PokerStars Zoom Hand #257975698607:  Hold'em No Limit (€0.01/€0.02) [ADM ID: M62BA304494E32ST] - 2025/10/02 23:38:44 CET [2025/10/02 17:38:44 ET]
Table 'Sirio' 6-max Seat #1 is the button
Seat 1: muhozhuk788 (€1.51 in chips) 
Seat 2: stfuplzudonk (€4.85 in chips) 
Seat 3: Warterror90 (€1.69 in chips) 
Seat 4: pistaKKio23 (€1.92 in chips) 
Seat 5: Auspice67 (€2.40 in chips) 
Seat 6: caduceus369 (€3.17 in chips) 
stfuplzudonk: posts small blind €0.01
Warterror90: posts big blind €0.02
*** HOLE CARDS ***
Dealt to caduceus369 [Qh 5h]
pistaKKio23: folds 
Auspice67: folds 
caduceus369: folds 
muhozhuk788: folds 
stfuplzudonk: calls €0.01
Warterror90: raises €0.04 to €0.06
stfuplzudonk: folds 
Uncalled bet (€0.04) returned to Warterror90
Warterror90 collected €0.04 from pot
Warterror90: doesn't show hand 
*** SUMMARY ***
Total pot €0.04 | Rake €0 
Seat 1: muhozhuk788 (button) folded before Flop (didn't bet)
Seat 2: stfuplzudonk (small blind) folded before Flop
Seat 3: Warterror90 (big blind) collected (€0.04)
Seat 4: pistaKKio23 folded before Flop (didn't bet)
Seat 5: Auspice67 folded before Flop (didn't bet)
Seat 6: caduceus369 folded before Flop (didn't bet)



PokerStars Zoom Hand #257975700673:  Hold'em No Limit (€0.01/€0.02) [ADM ID: M62BA304494E32ST] - 2025/10/02 23:38:53 CET [2025/10/02 17:38:53 ET]
Table 'Sirio' 6-max Seat #1 is the button
Seat 1: fantaasso (€0.92 in chips) 
Seat 2: Catania838 (€1.89 in chips) 
Seat 3: caduceus369 (€3.17 in chips) 
Seat 4: diesel197474 (€1.09 in chips) 
Seat 5: lollo70113 (€2.55 in chips) 
Seat 6: MacScrat (€2 in chips) 
Catania838: posts small blind €0.01
caduceus369: posts big blind €0.02
*** HOLE CARDS ***
Dealt to caduceus369 [Qd 7c]
diesel197474: folds 
lollo70113: raises €0.04 to €0.06
MacScrat: folds 
fantaasso: folds 
Catania838: folds 
caduceus369: folds 
Uncalled bet (€0.04) returned to lollo70113
lollo70113 collected €0.05 from pot
lollo70113: doesn't show hand 
*** SUMMARY ***
Total pot €0.05 | Rake €0 
Seat 1: fantaasso (button) folded before Flop (didn't bet)
Seat 2: Catania838 (small blind) folded before Flop
Seat 3: caduceus369 (big blind) folded before Flop
Seat 4: diesel197474 folded before Flop (didn't bet)
Seat 5: lollo70113 collected (€0.05)
Seat 6: MacScrat folded before Flop (didn't bet)



PokerStars Zoom Hand #257975699616:  Hold'em No Limit (€0.01/€0.02) [ADM ID: M62BA304494E32ST] - 2025/10/02 23:38:48 CET [2025/10/02 17:38:48 ET]
Table 'Sirio' 6-max Seat #1 is the button
Seat 1: Auspice67 (€2.40 in chips) 
Seat 2: lapo1987 (€2.90 in chips) 
Seat 3: kAllSeMPRE73 (€0.89 in chips) 
Seat 4: muhozhuk788 (€1.51 in chips) 
Seat 5: caduceus369 (€3.17 in chips) 
Seat 6: diesel197474 (€1.09 in chips) 
lapo1987: posts small blind €0.01
kAllSeMPRE73: posts big blind €0.02
*** HOLE CARDS ***
Dealt to caduceus369 [Qc 2s]
muhozhuk788: raises €0.02 to €0.04
caduceus369: folds 
diesel197474: folds 
Auspice67: calls €0.04
lapo1987: folds 
kAllSeMPRE73: folds 
*** FLOP *** [7c 9d 4h]
muhozhuk788: bets €0.11
Auspice67: folds 
Uncalled bet (€0.11) returned to muhozhuk788
muhozhuk788 collected €0.11 from pot
muhozhuk788: doesn't show hand 
*** SUMMARY ***
Total pot €0.11 | Rake €0 
Board [7c 9d 4h]
Seat 1: Auspice67 (button) folded on the Flop
Seat 2: lapo1987 (small blind) folded before Flop
Seat 3: kAllSeMPRE73 (big blind) folded before Flop
Seat 4: muhozhuk788 collected (€0.11)
Seat 5: caduceus369 folded before Flop (didn't bet)
Seat 6: diesel197474 folded before Flop (didn't bet)



PokerStars Zoom Hand #257975707686:  Hold'em No Limit (€0.01/€0.02) [ADM ID: M62BA304494E32ST] - 2025/10/02 23:39:24 CET [2025/10/02 17:39:24 ET]
Table 'Sirio' 6-max Seat #1 is the button
Seat 1: MacScrat (€2 in chips) 
Seat 2: caduceus369 (€3.14 in chips) 
Seat 3: father2008 (€3.85 in chips) 
Seat 4: fantaasso (€1.79 in chips) 
Seat 5: mondie73100 (€2.01 in chips) 
Seat 6: montemeru (€2 in chips) 
caduceus369: posts small blind €0.01
father2008: posts big blind €0.02
*** HOLE CARDS ***
Dealt to caduceus369 [Th 8h]
fantaasso: folds 
mondie73100: folds 
montemeru: raises €0.04 to €0.06
MacScrat: folds 
caduceus369: folds 
father2008: folds 
Uncalled bet (€0.04) returned to montemeru
montemeru collected €0.05 from pot
montemeru: doesn't show hand 
*** SUMMARY ***
Total pot €0.05 | Rake €0 
Seat 1: MacScrat (button) folded before Flop (didn't bet)
Seat 2: caduceus369 (small blind) folded before Flop
Seat 3: father2008 (big blind) folded before Flop
Seat 4: fantaasso folded before Flop (didn't bet)
Seat 5: mondie73100 folded before Flop (didn't bet)
Seat 6: montemeru collected (€0.05)



PokerStars Zoom Hand #257975706392:  Hold'em No Limit (€0.01/€0.02) [ADM ID: M62BA304494E32ST] - 2025/10/02 23:39:18 CET [2025/10/02 17:39:18 ET]
Table 'Sirio' 6-max Seat #1 is the button
Seat 1: jackkk03 (€2.80 in chips) 
Seat 2: PolyMangasJK (€1.10 in chips) 
Seat 3: lollo70113 (€2.58 in chips) 
Seat 4: lapo1987 (€2.46 in chips) 
Seat 5: caduceus369 (€3.14 in chips) 
Seat 6: Warterror90 (€1.70 in chips) 
PolyMangasJK: posts small blind €0.01
lollo70113: posts big blind €0.02
*** HOLE CARDS ***
Dealt to caduceus369 [5c 9h]
lapo1987: raises €0.02 to €0.04
caduceus369: folds 
Warterror90: calls €0.04
jackkk03: calls €0.04
PolyMangasJK: folds 
lollo70113: calls €0.02
*** FLOP *** [Qc Kc 3d]
lollo70113: checks 
lapo1987: bets €0.08
Warterror90: folds 
jackkk03: folds 
lollo70113: folds 
Uncalled bet (€0.08) returned to lapo1987
lapo1987 collected €0.17 from pot
lapo1987: doesn't show hand 
*** SUMMARY ***
Total pot €0.17 | Rake €0 
Board [Qc Kc 3d]
Seat 1: jackkk03 (button) folded on the Flop
Seat 2: PolyMangasJK (small blind) folded before Flop
Seat 3: lollo70113 (big blind) folded on the Flop
Seat 4: lapo1987 collected (€0.17)
Seat 5: caduceus369 folded before Flop (didn't bet)
Seat 6: Warterror90 folded on the Flop



PokerStars Zoom Hand #257975703629:  Hold'em No Limit (€0.01/€0.02) [ADM ID: M62BA304494E32ST] - 2025/10/02 23:39:06 CET [2025/10/02 17:39:06 ET]
Table 'Sirio' 6-max Seat #1 is the button
Seat 1: father2008 (€3.85 in chips) 
Seat 2: caduceus369 (€3.15 in chips) 
Seat 3: AlfredP80 (€3.19 in chips) 
Seat 4: Catania838 (€1.88 in chips) 
Seat 5: PolyMangasJK (€1.10 in chips) 
Seat 6: stfuplzudonk (€3.93 in chips) 
caduceus369: posts small blind €0.01
AlfredP80: posts big blind €0.02
*** HOLE CARDS ***
Dealt to caduceus369 [8c 6s]
Catania838: raises €0.04 to €0.06
PolyMangasJK: folds 
stfuplzudonk: folds 
father2008: folds 
caduceus369: folds 
AlfredP80: calls €0.04
*** FLOP *** [Th Qs Qh]
AlfredP80: checks 
Catania838: bets €0.08
AlfredP80: calls €0.08
*** TURN *** [Th Qs Qh] [6d]
AlfredP80: checks 
Catania838: bets €0.08
AlfredP80: calls €0.08
*** RIVER *** [Th Qs Qh 6d] [Qd]
AlfredP80: checks 
Catania838: bets €0.43
AlfredP80: calls €0.43
*** SHOW DOWN ***
Catania838: shows [As Ah] (a full house, Queens full of Aces)
AlfredP80: mucks hand 
Catania838 collected €1.24 from pot
*** SUMMARY ***
Total pot €1.31 | Rake €0.07 
Board [Th Qs Qh 6d Qd]
Seat 1: father2008 (button) folded before Flop (didn't bet)
Seat 2: caduceus369 (small blind) folded before Flop
Seat 3: AlfredP80 (big blind) mucked [Jc Ts]
Seat 4: Catania838 showed [As Ah] and won (€1.24) with a full house, Queens full of Aces
Seat 5: PolyMangasJK folded before Flop (didn't bet)
Seat 6: stfuplzudonk folded before Flop (didn't bet)



PokerStars Zoom Hand #257975705699:  Hold'em No Limit (€0.01/€0.02) [ADM ID: M62BA304494E32ST] - 2025/10/02 23:39:15 CET [2025/10/02 17:39:15 ET]
Table 'Sirio' 6-max Seat #1 is the button
Seat 1: caduceus369 (€3.14 in chips) 
Seat 2: montemeru (€3.35 in chips) 
Seat 3: muhozhuk788 (€3.39 in chips) 
Seat 4: rush572 (€0.60 in chips) 
Seat 5: father2008 (€3.85 in chips) 
Seat 6: pistaKKio23 (€2.18 in chips) 
montemeru: posts small blind €0.01
muhozhuk788: posts big blind €0.02
*** HOLE CARDS ***
Dealt to caduceus369 [2d 4d]
rush572: calls €0.02
father2008: folds 
pistaKKio23: raises €0.07 to €0.09
caduceus369: folds 
montemeru: folds 
muhozhuk788: folds 
rush572: calls €0.07
*** FLOP *** [Ts 3c 7h]
rush572: checks 
pistaKKio23: checks 
*** TURN *** [Ts 3c 7h] [Kd]
rush572: bets €0.10
pistaKKio23: folds 
Uncalled bet (€0.10) returned to rush572
rush572 collected €0.20 from pot
rush572: doesn't show hand 
*** SUMMARY ***
Total pot €0.21 | Rake €0.01 
Board [Ts 3c 7h Kd]
Seat 1: caduceus369 (button) folded before Flop (didn't bet)
Seat 2: montemeru (small blind) folded before Flop
Seat 3: muhozhuk788 (big blind) folded before Flop
Seat 4: rush572 collected (€0.20)
Seat 5: father2008 folded before Flop (didn't bet)
Seat 6: pistaKKio23 folded on the Turn



PokerStars Zoom Hand #257975710814:  Hold'em No Limit (€0.01/€0.02) [ADM ID: M62BA304494E32ST] - 2025/10/02 23:39:38 CET [2025/10/02 17:39:38 ET]
Table 'Sirio' 6-max Seat #1 is the button
Seat 1: montemeru (€3.34 in chips) 
Seat 2: muhozhuk788 (€1.50 in chips) 
Seat 3: caduceus369 (€3.13 in chips) 
Seat 4: kklaudio1 (€2.29 in chips) 
Seat 5: TonyPir97 (€0.52 in chips) 
Seat 6: stfuplzudonk (€3.06 in chips) 
muhozhuk788: posts small blind €0.01
caduceus369: posts big blind €0.02
*** HOLE CARDS ***
Dealt to caduceus369 [6c 7s]
kklaudio1: raises €0.02 to €0.04
TonyPir97: folds 
stfuplzudonk: folds 
montemeru: folds 
muhozhuk788: calls €0.03
caduceus369: folds 
*** FLOP *** [Ks 6s 3c]
muhozhuk788: checks 
kklaudio1: bets €0.06
muhozhuk788: folds 
Uncalled bet (€0.06) returned to kklaudio1
kklaudio1 collected €0.10 from pot
kklaudio1: doesn't show hand 
*** SUMMARY ***
Total pot €0.10 | Rake €0 
Board [Ks 6s 3c]
Seat 1: montemeru (button) folded before Flop (didn't bet)
Seat 2: muhozhuk788 (small blind) folded on the Flop
Seat 3: caduceus369 (big blind) folded before Flop
Seat 4: kklaudio1 collected (€0.10)
Seat 5: TonyPir97 folded before Flop (didn't bet)
Seat 6: stfuplzudonk folded before Flop (didn't bet)



PokerStars Zoom Hand #257975713617:  Hold'em No Limit (€0.01/€0.02) [ADM ID: M62BA304494E32ST] - 2025/10/02 23:39:50 CET [2025/10/02 17:39:50 ET]
Table 'Sirio' 6-max Seat #1 is the button
Seat 1: RRgalp (€8.85 in chips) 
Seat 2: kAllSeMPRE73 (€0.85 in chips) 
Seat 3: lapo1987 (€2.59 in chips) 
Seat 4: Tiaka0105 (€0.51 in chips) 
Seat 5: AlfredP80 (€2.54 in chips) 
Seat 6: caduceus369 (€3.11 in chips) 
kAllSeMPRE73: posts small blind €0.01
lapo1987: posts big blind €0.02
*** HOLE CARDS ***
Dealt to caduceus369 [9h 3h]
Tiaka0105: calls €0.02
AlfredP80: folds 
caduceus369: folds 
RRgalp: folds 
kAllSeMPRE73: raises €0.79 to €0.81
lapo1987: folds 
Tiaka0105: folds 
Uncalled bet (€0.79) returned to kAllSeMPRE73
kAllSeMPRE73 collected €0.06 from pot
kAllSeMPRE73: doesn't show hand 
*** SUMMARY ***
Total pot €0.06 | Rake €0 
Seat 1: RRgalp (button) folded before Flop (didn't bet)
Seat 2: kAllSeMPRE73 (small blind) collected (€0.06)
Seat 3: lapo1987 (big blind) folded before Flop
Seat 4: Tiaka0105 folded before Flop
Seat 5: AlfredP80 folded before Flop (didn't bet)
Seat 6: caduceus369 folded before Flop (didn't bet)



PokerStars Zoom Hand #257975716077:  Hold'em No Limit (€0.01/€0.02) [ADM ID: M62BA304494E32ST] - 2025/10/02 23:40:00 CET [2025/10/02 17:40:00 ET]
Table 'Sirio' 6-max Seat #1 is the button
Seat 1: caduceus369 (€3.11 in chips) 
Seat 2: AlfredP80 (€2.54 in chips) 
Seat 3: fantaasso (€1.86 in chips) 
Seat 4: Auspice67 (€4.47 in chips) 
Seat 5: Oiad (€6.39 in chips) 
Seat 6: pistaKKio23 (€3.19 in chips) 
AlfredP80: posts small blind €0.01
fantaasso: posts big blind €0.02
*** HOLE CARDS ***
Dealt to caduceus369 [Jc 5c]
Auspice67: folds 
Oiad: folds 
pistaKKio23: folds 
caduceus369: folds 
AlfredP80: folds 
Uncalled bet (€0.01) returned to fantaasso
fantaasso collected €0.02 from pot
fantaasso: doesn't show hand 
*** SUMMARY ***
Total pot €0.02 | Rake €0 
Seat 1: caduceus369 (button) folded before Flop (didn't bet)
Seat 2: AlfredP80 (small blind) folded before Flop
Seat 3: fantaasso (big blind) collected (€0.02)
Seat 4: Auspice67 folded before Flop (didn't bet)
Seat 5: Oiad folded before Flop (didn't bet)
Seat 6: pistaKKio23 folded before Flop (didn't bet)



PokerStars Zoom Hand #257975719007:  Hold'em No Limit (€0.01/€0.02) [ADM ID: M62BA304494E32ST] - 2025/10/02 23:40:13 CET [2025/10/02 17:40:13 ET]
Table 'Sirio' 6-max Seat #1 is the button
Seat 1: fantaasso (€1.87 in chips) 
Seat 2: Alex83l310 (€2 in chips) 
Seat 3: caduceus369 (€3.11 in chips) 
Seat 4: stfuplzudonk (€3.91 in chips) 
Seat 5: PolyMangasJK (€1.14 in chips) 
Seat 6: RRgalp (€8.84 in chips) 
Alex83l310: posts small blind €0.01
caduceus369: posts big blind €0.02
*** HOLE CARDS ***
Dealt to caduceus369 [4h Js]
stfuplzudonk: folds 
PolyMangasJK: folds 
RRgalp: folds 
fantaasso: folds 
Alex83l310: calls €0.01
caduceus369: checks 
*** FLOP *** [Qc Qh 5s]
Alex83l310: checks 
caduceus369: checks 
*** TURN *** [Qc Qh 5s] [Ah]
Alex83l310: bets €0.02
caduceus369: folds 
Uncalled bet (€0.02) returned to Alex83l310
Alex83l310 collected €0.04 from pot
Alex83l310: doesn't show hand 
*** SUMMARY ***
Total pot €0.04 | Rake €0 
Board [Qc Qh 5s Ah]
Seat 1: fantaasso (button) folded before Flop (didn't bet)
Seat 2: Alex83l310 (small blind) collected (€0.04)
Seat 3: caduceus369 (big blind) folded on the Turn
Seat 4: stfuplzudonk folded before Flop (didn't bet)
Seat 5: PolyMangasJK folded before Flop (didn't bet)
Seat 6: RRgalp folded before Flop (didn't bet)



PokerStars Zoom Hand #257975716992:  Hold'em No Limit (€0.01/€0.02) [ADM ID: M62BA304494E32ST] - 2025/10/02 23:40:05 CET [2025/10/02 17:40:05 ET]
Table 'Sirio' 6-max Seat #1 is the button
Seat 1: AlfredP80 (€2.53 in chips) 
Seat 2: Auspice67 (€4.47 in chips) 
Seat 3: kklaudio1 (€2.35 in chips) 
Seat 4: caduceus369 (€3.11 in chips) 
Seat 5: Robycastel89 (€1.98 in chips) 
Seat 6: muhozhuk788 (€3.40 in chips) 
Auspice67: posts small blind €0.01
kklaudio1: posts big blind €0.02
*** HOLE CARDS ***
Dealt to caduceus369 [Tc 6d]
caduceus369: folds 
Robycastel89: folds 
muhozhuk788: raises €0.02 to €0.04
AlfredP80: folds 
Auspice67: folds 
kklaudio1: calls €0.02
*** FLOP *** [Kh Jc 9h]
kklaudio1: checks 
muhozhuk788: bets €0.03
kklaudio1: folds 
Uncalled bet (€0.03) returned to muhozhuk788
muhozhuk788 collected €0.09 from pot
muhozhuk788: doesn't show hand 
*** SUMMARY ***
Total pot €0.09 | Rake €0 
Board [Kh Jc 9h]
Seat 1: AlfredP80 (button) folded before Flop (didn't bet)
Seat 2: Auspice67 (small blind) folded before Flop
Seat 3: kklaudio1 (big blind) folded on the Flop
Seat 4: caduceus369 folded before Flop (didn't bet)
Seat 5: Robycastel89 folded before Flop (didn't bet)
Seat 6: muhozhuk788 collected (€0.09)



PokerStars Zoom Hand #257975717734:  Hold'em No Limit (€0.01/€0.02) [ADM ID: M62BA304494E32ST] - 2025/10/02 23:40:08 CET [2025/10/02 17:40:08 ET]
Table 'Sirio' 6-max Seat #1 is the button
Seat 1: mondie73100 (€2.01 in chips) 
Seat 2: lapo1987 (€2.57 in chips) 
Seat 3: Tiaka0105 (€0.49 in chips) 
Seat 4: caduceus369 (€3.11 in chips) 
Seat 5: pistaKKio23 (€3.19 in chips) 
Seat 6: stfuplzudonk (€4.86 in chips) 
lapo1987: posts small blind €0.01
Tiaka0105: posts big blind €0.02
*** HOLE CARDS ***
Dealt to caduceus369 [Ts Qc]
caduceus369: folds 
pistaKKio23: folds 
stfuplzudonk: folds 
mondie73100: folds 
lapo1987: raises €0.02 to €0.04
Tiaka0105: calls €0.02
*** FLOP *** [Js 8s Kh]
lapo1987: checks 
Tiaka0105: checks 
*** TURN *** [Js 8s Kh] [3h]
lapo1987: checks 
Tiaka0105: checks 
*** RIVER *** [Js 8s Kh 3h] [Ah]
lapo1987: bets €0.08
Tiaka0105: calls €0.08
*** SHOW DOWN ***
lapo1987: shows [3c Tc] (a pair of Threes)
Tiaka0105: shows [7d Jd] (a pair of Jacks)
Tiaka0105 collected €0.23 from pot
*** SUMMARY ***
Total pot €0.24 | Rake €0.01 
Board [Js 8s Kh 3h Ah]
Seat 1: mondie73100 (button) folded before Flop (didn't bet)
Seat 2: lapo1987 (small blind) showed [3c Tc] and lost with a pair of Threes
Seat 3: Tiaka0105 (big blind) showed [7d Jd] and won (€0.23) with a pair of Jacks
Seat 4: caduceus369 folded before Flop (didn't bet)
Seat 5: pistaKKio23 folded before Flop (didn't bet)
Seat 6: stfuplzudonk folded before Flop (didn't bet)



PokerStars Zoom Hand #257975718396:  Hold'em No Limit (€0.01/€0.02) [ADM ID: M62BA304494E32ST] - 2025/10/02 23:40:11 CET [2025/10/02 17:40:11 ET]
Table 'Sirio' 6-max Seat #1 is the button
Seat 1: mondie73100 (€2.54 in chips) 
Seat 2: Cinghi11 (€1.12 in chips) 
Seat 3: Robycastel89 (€1.98 in chips) 
Seat 4: Auspice67 (€4.46 in chips) 
Seat 5: caduceus369 (€3.11 in chips) 
Seat 6: lollo70113 (€2.53 in chips) 
Cinghi11: posts small blind €0.01
Robycastel89: posts big blind €0.02
*** HOLE CARDS ***
Dealt to caduceus369 [4s Td]
Auspice67: folds 
caduceus369: folds 
lollo70113: raises €0.02 to €0.04
mondie73100: folds 
Cinghi11: calls €0.03
Robycastel89: raises €0.12 to €0.16
lollo70113: calls €0.12
Cinghi11: calls €0.12
*** FLOP *** [2c 3s 5c]
Cinghi11: checks 
Robycastel89: bets €0.46
lollo70113: calls €0.46
Cinghi11: folds 
*** TURN *** [2c 3s 5c] [5d]
Robycastel89: bets €0.67
lollo70113: raises €0.67 to €1.34
Robycastel89: calls €0.67
*** RIVER *** [2c 3s 5c 5d] [Th]
Robycastel89: bets €0.02 and is all-in
lollo70113: calls €0.02
*** SHOW DOWN ***
Robycastel89: shows [Kd Kc] (two pair, Kings and Fives)
lollo70113: shows [As 5s] (three of a kind, Fives)
lollo70113 collected €3.90 from pot
*** SUMMARY ***
Total pot €4.12 | Rake €0.22 
Board [2c 3s 5c 5d Th]
Seat 1: mondie73100 (button) folded before Flop (didn't bet)
Seat 2: Cinghi11 (small blind) folded on the Flop
Seat 3: Robycastel89 (big blind) showed [Kd Kc] and lost with two pair, Kings and Fives
Seat 4: Auspice67 folded before Flop (didn't bet)
Seat 5: caduceus369 folded before Flop (didn't bet)
Seat 6: lollo70113 showed [As 5s] and won (€3.90) with three of a kind, Fives



PokerStars Zoom Hand #257975725615:  Hold'em No Limit (€0.01/€0.02) [ADM ID: M62BA304494E32ST] - 2025/10/02 23:40:41 CET [2025/10/02 17:40:41 ET]
Table 'Sirio' 6-max Seat #1 is the button
Seat 1: stfuplzudonk (€4.87 in chips) 
Seat 2: MacScrat (€3.45 in chips) 
Seat 3: pistaKKio23 (€3.53 in chips) 
Seat 4: ADRIAN0_MEIS (€6.15 in chips) 
Seat 5: muhozhuk788 (€1.49 in chips) 
Seat 6: caduceus369 (€3.09 in chips) 
MacScrat: posts small blind €0.01
pistaKKio23: posts big blind €0.02
*** HOLE CARDS ***
Dealt to caduceus369 [9s As]
ADRIAN0_MEIS: folds 
muhozhuk788: folds 
caduceus369: raises €0.02 to €0.04
stfuplzudonk: calls €0.04
MacScrat: folds 
pistaKKio23: folds 
*** FLOP *** [5s 2c 7d]
caduceus369: checks 
stfuplzudonk: checks 
*** TURN *** [5s 2c 7d] [6s]
caduceus369: bets €0.06
stfuplzudonk: calls €0.06
*** RIVER *** [5s 2c 7d 6s] [Ah]
caduceus369: bets €0.26
stfuplzudonk: folds 
Uncalled bet (€0.26) returned to caduceus369
caduceus369 collected €0.22 from pot
caduceus369: doesn't show hand 
*** SUMMARY ***
Total pot €0.23 | Rake €0.01 
Board [5s 2c 7d 6s Ah]
Seat 1: stfuplzudonk (button) folded on the River
Seat 2: MacScrat (small blind) folded before Flop
Seat 3: pistaKKio23 (big blind) folded before Flop
Seat 4: ADRIAN0_MEIS folded before Flop (didn't bet)
Seat 5: muhozhuk788 folded before Flop (didn't bet)
Seat 6: caduceus369 collected (€0.22)



PokerStars Zoom Hand #257975734674:  Hold'em No Limit (€0.01/€0.02) [ADM ID: M62BA304494E32ST] - 2025/10/02 23:41:21 CET [2025/10/02 17:41:21 ET]
Table 'Sirio' 6-max Seat #1 is the button
Seat 1: ADRIAN0_MEIS (€4.46 in chips) 
Seat 2: caduceus369 (€3.21 in chips) 
Seat 3: lollo70113 (€4.45 in chips) 
Seat 4: mondie73100 (€2 in chips) 
Seat 5: Auspice67 (€4.49 in chips) 
Seat 6: MacScrat (€3.41 in chips) 
caduceus369: posts small blind €0.01
lollo70113: posts big blind €0.02
*** HOLE CARDS ***
Dealt to caduceus369 [3s 8c]
mondie73100: folds 
Auspice67: folds 
MacScrat: raises €0.04 to €0.06
ADRIAN0_MEIS: folds 
caduceus369: folds 
lollo70113: folds 
Uncalled bet (€0.04) returned to MacScrat
MacScrat collected €0.05 from pot
MacScrat: doesn't show hand 
*** SUMMARY ***
Total pot €0.05 | Rake €0 
Seat 1: ADRIAN0_MEIS (button) folded before Flop (didn't bet)
Seat 2: caduceus369 (small blind) folded before Flop
Seat 3: lollo70113 (big blind) folded before Flop
Seat 4: mondie73100 folded before Flop (didn't bet)
Seat 5: Auspice67 folded before Flop (didn't bet)
Seat 6: MacScrat collected (€0.05)



PokerStars Zoom Hand #257975735399:  Hold'em No Limit (€0.01/€0.02) [ADM ID: M62BA304494E32ST] - 2025/10/02 23:41:24 CET [2025/10/02 17:41:24 ET]
Table 'Sirio' 6-max Seat #1 is the button
Seat 1: caduceus369 (€3.20 in chips) 
Seat 2: muhozhuk788 (€3.54 in chips) 
Seat 3: stfuplzudonk (€3.09 in chips) 
Seat 4: Tiaka0105 (€0.56 in chips) 
Seat 5: campiraudii (€5.16 in chips) 
Seat 6: Alex83l310 (€2.03 in chips) 
muhozhuk788: posts small blind €0.01
stfuplzudonk: posts big blind €0.02
*** HOLE CARDS ***
Dealt to caduceus369 [4s Kc]
Tiaka0105: calls €0.02
campiraudii: raises €0.07 to €0.09
Alex83l310: folds 
caduceus369: folds 
muhozhuk788: folds 
stfuplzudonk: folds 
Tiaka0105: calls €0.07
*** FLOP *** [9h Ts Qh]
Tiaka0105: bets €0.47 and is all-in
campiraudii: calls €0.47
*** TURN *** [9h Ts Qh] [3s]
*** RIVER *** [9h Ts Qh 3s] [6h]
*** SHOW DOWN ***
Tiaka0105: shows [As 9c] (a pair of Nines)
campiraudii: shows [7h Ah] (a flush, Ace high)
campiraudii collected €1.09 from pot
*** SUMMARY ***
Total pot €1.15 | Rake €0.06 
Board [9h Ts Qh 3s 6h]
Seat 1: caduceus369 (button) folded before Flop (didn't bet)
Seat 2: muhozhuk788 (small blind) folded before Flop
Seat 3: stfuplzudonk (big blind) folded before Flop
Seat 4: Tiaka0105 showed [As 9c] and lost with a pair of Nines
Seat 5: campiraudii showed [7h Ah] and won (€1.09) with a flush, Ace high
Seat 6: Alex83l310 folded before Flop (didn't bet)



PokerStars Zoom Hand #257975738393:  Hold'em No Limit (€0.01/€0.02) [ADM ID: M62BA304494E32ST] - 2025/10/02 23:41:37 CET [2025/10/02 17:41:37 ET]
Table 'Sirio' 6-max Seat #1 is the button
Seat 1: MacScrat (€2 in chips) 
Seat 2: Catania838 (€2.76 in chips) 
Seat 3: lapo1987 (€2.59 in chips) 
Seat 4: caduceus369 (€3.20 in chips) 
Seat 5: Sium12302 (€2.35 in chips) 
Seat 6: stfuplzudonk (€2.07 in chips) 
Catania838: posts small blind €0.01
lapo1987: posts big blind €0.02
*** HOLE CARDS ***
Dealt to caduceus369 [7s 8d]
caduceus369: folds 
Sium12302: folds 
stfuplzudonk: folds 
MacScrat: raises €0.05 to €0.07
Catania838: folds 
lapo1987: folds 
Uncalled bet (€0.05) returned to MacScrat
MacScrat collected €0.05 from pot
MacScrat: doesn't show hand 
*** SUMMARY ***
Total pot €0.05 | Rake €0 
Seat 1: MacScrat (button) collected (€0.05)
Seat 2: Catania838 (small blind) folded before Flop
Seat 3: lapo1987 (big blind) folded before Flop
Seat 4: caduceus369 folded before Flop (didn't bet)
Seat 5: Sium12302 folded before Flop (didn't bet)
Seat 6: stfuplzudonk folded before Flop (didn't bet)



PokerStars Zoom Hand #257975740896:  Hold'em No Limit (€0.01/€0.02) [ADM ID: M62BA304494E32ST] - 2025/10/02 23:41:48 CET [2025/10/02 17:41:48 ET]
Table 'Sirio' 6-max Seat #1 is the button
Seat 1: mondie73100 (€2.44 in chips) 
Seat 2: lapo1987 (€2.43 in chips) 
Seat 3: caduceus369 (€3.20 in chips) 
Seat 4: Alex83l310 (€2 in chips) 
Seat 5: MacScrat (€3.44 in chips) 
Seat 6: muhozhuk788 (€1.49 in chips) 
lapo1987: posts small blind €0.01
caduceus369: posts big blind €0.02
*** HOLE CARDS ***
Dealt to caduceus369 [Qs 4h]
Alex83l310: folds 
MacScrat: raises €0.04 to €0.06
muhozhuk788: folds 
mondie73100: folds 
lapo1987: folds 
caduceus369: folds 
Uncalled bet (€0.04) returned to MacScrat
MacScrat collected €0.05 from pot
MacScrat: doesn't show hand 
*** SUMMARY ***
Total pot €0.05 | Rake €0 
Seat 1: mondie73100 (button) folded before Flop (didn't bet)
Seat 2: lapo1987 (small blind) folded before Flop
Seat 3: caduceus369 (big blind) folded before Flop
Seat 4: Alex83l310 folded before Flop (didn't bet)
Seat 5: MacScrat collected (€0.05)
Seat 6: muhozhuk788 folded before Flop (didn't bet)



PokerStars Zoom Hand #257975743246:  Hold'em No Limit (€0.01/€0.02) [ADM ID: M62BA304494E32ST] - 2025/10/02 23:41:58 CET [2025/10/02 17:41:58 ET]
Table 'Sirio' 6-max Seat #1 is the button
Seat 1: Warterror90 (€5.33 in chips) 
Seat 2: RRgalp (€8.82 in chips) 
Seat 3: Catania838 (€2.75 in chips) 
Seat 4: Cinghi11 (€1.04 in chips) 
Seat 5: lapo1987 (€2.42 in chips) 
Seat 6: caduceus369 (€3.18 in chips) 
RRgalp: posts small blind €0.01
Catania838: posts big blind €0.02
*** HOLE CARDS ***
Dealt to caduceus369 [Ad 6s]
Cinghi11: folds 
lapo1987: folds 
caduceus369: folds 
Warterror90: folds 
RRgalp: folds 
Uncalled bet (€0.01) returned to Catania838
Catania838 collected €0.02 from pot
Catania838: doesn't show hand 
*** SUMMARY ***
Total pot €0.02 | Rake €0 
Seat 1: Warterror90 (button) folded before Flop (didn't bet)
Seat 2: RRgalp (small blind) folded before Flop
Seat 3: Catania838 (big blind) collected (€0.02)
Seat 4: Cinghi11 folded before Flop (didn't bet)
Seat 5: lapo1987 folded before Flop (didn't bet)
Seat 6: caduceus369 folded before Flop (didn't bet)



PokerStars Zoom Hand #257975745094:  Hold'em No Limit (€0.01/€0.02) [ADM ID: M62BA304494E32ST] - 2025/10/02 23:42:06 CET [2025/10/02 17:42:06 ET]
Table 'Sirio' 6-max Seat #1 is the button
Seat 1: caduceus369 (€3.17 in chips) 
Seat 2: Catania838 (€2.76 in chips) 
Seat 3: Warterror90 (€5.33 in chips) 
Seat 4: Auspice67 (€4.46 in chips) 
Seat 5: RRgalp (€8.81 in chips) 
Seat 6: fantaasso (€1.89 in chips) 
Catania838: posts small blind €0.01
Warterror90: posts big blind €0.02
*** HOLE CARDS ***
Dealt to caduceus369 [4d Qh]
Auspice67: folds 
RRgalp: folds 
fantaasso: folds 
caduceus369: folds 
Catania838: raises €0.02 to €0.04
Warterror90: folds 
Uncalled bet (€0.02) returned to Catania838
Catania838 collected €0.04 from pot
Catania838: doesn't show hand 
*** SUMMARY ***
Total pot €0.04 | Rake €0 
Seat 1: caduceus369 (button) folded before Flop (didn't bet)
Seat 2: Catania838 (small blind) collected (€0.04)
Seat 3: Warterror90 (big blind) folded before Flop
Seat 4: Auspice67 folded before Flop (didn't bet)
Seat 5: RRgalp folded before Flop (didn't bet)
Seat 6: fantaasso folded before Flop (didn't bet)



PokerStars Zoom Hand #257975744333:  Hold'em No Limit (€0.01/€0.02) [ADM ID: M62BA304494E32ST] - 2025/10/02 23:42:03 CET [2025/10/02 17:42:03 ET]
Table 'Sirio' 6-max Seat #1 is the button
Seat 1: pistaKKio23 (€2.05 in chips) 
Seat 2: caduceus369 (€3.18 in chips) 
Seat 3: mondie73100 (€2.44 in chips) 
Seat 4: stfuplzudonk (€4.70 in chips) 
Seat 5: Auspice67 (€4.46 in chips) 
Seat 6: lapo1987 (€2.56 in chips) 
caduceus369: posts small blind €0.01
mondie73100: posts big blind €0.02
*** HOLE CARDS ***
Dealt to caduceus369 [6s Kc]
stfuplzudonk: raises €0.02 to €0.04
Auspice67: folds 
lapo1987: folds 
pistaKKio23 has timed out
pistaKKio23: folds 
caduceus369: folds 
mondie73100: folds 
Uncalled bet (€0.02) returned to stfuplzudonk
stfuplzudonk collected €0.05 from pot
stfuplzudonk: doesn't show hand 
*** SUMMARY ***
Total pot €0.05 | Rake €0 
Seat 1: pistaKKio23 (button) folded before Flop (didn't bet)
Seat 2: caduceus369 (small blind) folded before Flop
Seat 3: mondie73100 (big blind) folded before Flop
Seat 4: stfuplzudonk collected (€0.05)
Seat 5: Auspice67 folded before Flop (didn't bet)
Seat 6: lapo1987 folded before Flop (didn't bet)



PokerStars Zoom Hand #257975746206:  Hold'em No Limit (€0.01/€0.02) [ADM ID: M62BA304494E32ST] - 2025/10/02 23:42:11 CET [2025/10/02 17:42:11 ET]
Table 'Sirio' 6-max Seat #1 is the button
Seat 1: PolyMangasJK (€1.18 in chips) 
Seat 2: Alex83l310 (€2.03 in chips) 
Seat 3: Auspice67 (€4.46 in chips) 
Seat 4: lollo70113 (€4.45 in chips) 
Seat 5: fantaasso (€1.89 in chips) 
Seat 6: caduceus369 (€3.17 in chips) 
Alex83l310: posts small blind €0.01
Auspice67: posts big blind €0.02
*** HOLE CARDS ***
Dealt to caduceus369 [Qc Tc]
lollo70113: raises €0.02 to €0.04
fantaasso: folds 
caduceus369: calls €0.04
PolyMangasJK: calls €0.04
Alex83l310: folds 
Auspice67: folds 
*** FLOP *** [5s 3h 7s]
lollo70113: checks 
caduceus369: checks 
PolyMangasJK: checks 
*** TURN *** [5s 3h 7s] [Ah]
lollo70113: bets €0.06
caduceus369: folds 
PolyMangasJK: folds 
Uncalled bet (€0.06) returned to lollo70113
lollo70113 collected €0.15 from pot
lollo70113: doesn't show hand 
*** SUMMARY ***
Total pot €0.15 | Rake €0 
Board [5s 3h 7s Ah]
Seat 1: PolyMangasJK (button) folded on the Turn
Seat 2: Alex83l310 (small blind) folded before Flop
Seat 3: Auspice67 (big blind) folded before Flop
Seat 4: lollo70113 collected (€0.15)
Seat 5: fantaasso folded before Flop (didn't bet)
Seat 6: caduceus369 folded on the Turn



PokerStars Zoom Hand #257975737478:  Hold'em No Limit (€0.01/€0.02) [ADM ID: M62BA304494E32ST] - 2025/10/02 23:41:33 CET [2025/10/02 17:41:33 ET]
Table 'Sirio' 6-max Seat #1 is the button
Seat 1: Sium12302 (€2.35 in chips) 
Seat 2: fantaasso (€1.90 in chips) 
Seat 3: AlfredP80 (€2.53 in chips) 
Seat 4: muhozhuk788 (€3.53 in chips) 
Seat 5: caduceus369 (€3.20 in chips) 
Seat 6: Oiad (€6.36 in chips) 
fantaasso: posts small blind €0.01
AlfredP80: posts big blind €0.02
*** HOLE CARDS ***
Dealt to caduceus369 [3s 7c]
muhozhuk788: folds 
caduceus369: folds 
Oiad: raises €0.08 to €0.10
Sium12302: folds 
fantaasso: folds 
AlfredP80: calls €0.08
*** FLOP *** [Ad 6s 5h]
AlfredP80: checks 
Oiad: bets €0.06
AlfredP80: calls €0.06
*** TURN *** [Ad 6s 5h] [9c]
AlfredP80: checks 
Oiad: bets €0.32
AlfredP80: folds 
Uncalled bet (€0.32) returned to Oiad
Oiad collected €0.32 from pot
Oiad: doesn't show hand 
*** SUMMARY ***
Total pot €0.33 | Rake €0.01 
Board [Ad 6s 5h 9c]
Seat 1: Sium12302 (button) folded before Flop (didn't bet)
Seat 2: fantaasso (small blind) folded before Flop
Seat 3: AlfredP80 (big blind) folded on the Turn
Seat 4: muhozhuk788 folded before Flop (didn't bet)
Seat 5: caduceus369 folded before Flop (didn't bet)
Seat 6: Oiad collected (€0.32)



PokerStars Zoom Hand #257975752206:  Hold'em No Limit (€0.01/€0.02) [ADM ID: M62BA304494E32ST] - 2025/10/02 23:42:37 CET [2025/10/02 17:42:37 ET]
Table 'Sirio' 6-max Seat #1 is the button
Seat 1: lapo1987 (€2.52 in chips) 
Seat 2: muhozhuk788 (€3.43 in chips) 
Seat 3: PolyMangasJK (€1.14 in chips) 
Seat 4: stfuplzudonk (€4.73 in chips) 
Seat 5: caduceus369 (€3.13 in chips) 
Seat 6: ADRIAN0_MEIS (€3.92 in chips) 
muhozhuk788: posts small blind €0.01
PolyMangasJK: posts big blind €0.02
*** HOLE CARDS ***
Dealt to caduceus369 [6c Ks]
stfuplzudonk: folds 
caduceus369: folds 
ADRIAN0_MEIS: folds 
lapo1987: raises €0.02 to €0.04
muhozhuk788: folds 
PolyMangasJK: folds 
Uncalled bet (€0.02) returned to lapo1987
lapo1987 collected €0.05 from pot
lapo1987: doesn't show hand 
*** SUMMARY ***
Total pot €0.05 | Rake €0 
Seat 1: lapo1987 (button) collected (€0.05)
Seat 2: muhozhuk788 (small blind) folded before Flop
Seat 3: PolyMangasJK (big blind) folded before Flop
Seat 4: stfuplzudonk folded before Flop (didn't bet)
Seat 5: caduceus369 folded before Flop (didn't bet)
Seat 6: ADRIAN0_MEIS folded before Flop (didn't bet)



PokerStars Zoom Hand #257975753607:  Hold'em No Limit (€0.01/€0.02) [ADM ID: M62BA304494E32ST] - 2025/10/02 23:42:43 CET [2025/10/02 17:42:43 ET]
Table 'Sirio' 6-max Seat #1 is the button
Seat 1: muhozhuk788 (€3.42 in chips) 
Seat 2: meteco79 (€0.79 in chips) 
Seat 3: caduceus369 (€3.13 in chips) 
Seat 4: pistaKKio23 (€1.82 in chips) 
Seat 5: lollo70113 (€4.56 in chips) 
Seat 6: MacScrat (€2 in chips) 
meteco79: posts small blind €0.01
caduceus369: posts big blind €0.02
*** HOLE CARDS ***
Dealt to caduceus369 [5s 7s]
pistaKKio23: folds 
lollo70113: folds 
MacScrat: folds 
muhozhuk788: raises €0.02 to €0.04
meteco79: folds 
caduceus369: calls €0.02
*** FLOP *** [Js Kc Qd]
caduceus369: checks 
muhozhuk788: bets €0.09
caduceus369: folds 
Uncalled bet (€0.09) returned to muhozhuk788
muhozhuk788 collected €0.09 from pot
muhozhuk788: doesn't show hand 
*** SUMMARY ***
Total pot €0.09 | Rake €0 
Board [Js Kc Qd]
Seat 1: muhozhuk788 (button) collected (€0.09)
Seat 2: meteco79 (small blind) folded before Flop
Seat 3: caduceus369 (big blind) folded on the Flop
Seat 4: pistaKKio23 folded before Flop (didn't bet)
Seat 5: lollo70113 folded before Flop (didn't bet)
Seat 6: MacScrat folded before Flop (didn't bet)



PokerStars Zoom Hand #257975757275:  Hold'em No Limit (€0.01/€0.02) [ADM ID: M62BA304494E32ST] - 2025/10/02 23:42:59 CET [2025/10/02 17:42:59 ET]
Table 'Sirio' 6-max Seat #1 is the button
Seat 1: ADRIAN0_MEIS (€4.73 in chips) 
Seat 2: caduceus369 (€3.09 in chips) 
Seat 3: Warterror90 (€5.30 in chips) 
Seat 4: robertoH2O (€2 in chips) 
Seat 5: Alex83l310 (€2 in chips) 
Seat 6: Robycastel89 (€2.05 in chips) 
caduceus369: posts small blind €0.01
Warterror90: posts big blind €0.02
*** HOLE CARDS ***
Dealt to caduceus369 [2c 9d]
robertoH2O: folds 
Alex83l310: folds 
Robycastel89: folds 
ADRIAN0_MEIS: folds 
caduceus369: folds 
Uncalled bet (€0.01) returned to Warterror90
Warterror90 collected €0.02 from pot
Warterror90: doesn't show hand 
*** SUMMARY ***
Total pot €0.02 | Rake €0 
Seat 1: ADRIAN0_MEIS (button) folded before Flop (didn't bet)
Seat 2: caduceus369 (small blind) folded before Flop
Seat 3: Warterror90 (big blind) collected (€0.02)
Seat 4: robertoH2O folded before Flop (didn't bet)
Seat 5: Alex83l310 folded before Flop (didn't bet)
Seat 6: Robycastel89 folded before Flop (didn't bet)



PokerStars Zoom Hand #257975758626:  Hold'em No Limit (€0.01/€0.02) [ADM ID: M62BA304494E32ST] - 2025/10/02 23:43:05 CET [2025/10/02 17:43:05 ET]
Table 'Sirio' 6-max Seat #1 is the button
Seat 1: AlfredP80 (€2.39 in chips) 
Seat 2: PolyMangasJK (€1.12 in chips) 
Seat 3: muhozhuk788 (€3.47 in chips) 
Seat 4: caduceus369 (€3.08 in chips) 
Seat 5: ADRIAN0_MEIS (€4.73 in chips) 
Seat 6: mondie73100 (€2.01 in chips) 
PolyMangasJK: posts small blind €0.01
muhozhuk788: posts big blind €0.02
*** HOLE CARDS ***
Dealt to caduceus369 [9c 5h]
caduceus369: folds 
ADRIAN0_MEIS: folds 
mondie73100: folds 
AlfredP80: folds 
PolyMangasJK: calls €0.01
muhozhuk788: checks 
*** FLOP *** [Kc 7h 8h]
PolyMangasJK: bets €0.02
muhozhuk788: calls €0.02
*** TURN *** [Kc 7h 8h] [2c]
PolyMangasJK: bets €0.04
muhozhuk788: folds 
Uncalled bet (€0.04) returned to PolyMangasJK
PolyMangasJK collected €0.08 from pot
PolyMangasJK: doesn't show hand 
*** SUMMARY ***
Total pot €0.08 | Rake €0 
Board [Kc 7h 8h 2c]
Seat 1: AlfredP80 (button) folded before Flop (didn't bet)
Seat 2: PolyMangasJK (small blind) collected (€0.08)
Seat 3: muhozhuk788 (big blind) folded on the Turn
Seat 4: caduceus369 folded before Flop (didn't bet)
Seat 5: ADRIAN0_MEIS folded before Flop (didn't bet)
Seat 6: mondie73100 folded before Flop (didn't bet)



PokerStars Zoom Hand #257975759718:  Hold'em No Limit (€0.01/€0.02) [ADM ID: M62BA304494E32ST] - 2025/10/02 23:43:10 CET [2025/10/02 17:43:10 ET]
Table 'Sirio' 6-max Seat #1 is the button
Seat 1: caduceus369 (€3.08 in chips) 
Seat 2: jackkk03 (€2.41 in chips) 
Seat 3: ADRIAN0_MEIS (€4.73 in chips) 
Seat 4: Warterror90 (€5.31 in chips) 
Seat 5: AlfredP80 (€2.39 in chips) 
Seat 6: kAllSeMPRE73 (€1.34 in chips) 
jackkk03: posts small blind €0.01
ADRIAN0_MEIS: posts big blind €0.02
*** HOLE CARDS ***
Dealt to caduceus369 [4s 9c]
Warterror90: folds 
AlfredP80: folds 
kAllSeMPRE73: folds 
caduceus369: folds 
jackkk03: calls €0.01
ADRIAN0_MEIS: checks 
*** FLOP *** [5h 3s Jc]
jackkk03: checks 
ADRIAN0_MEIS: checks 
*** TURN *** [5h 3s Jc] [7d]
jackkk03: bets €0.04
ADRIAN0_MEIS: raises €0.09 to €0.13
jackkk03: calls €0.09
*** RIVER *** [5h 3s Jc 7d] [4c]
jackkk03: checks 
ADRIAN0_MEIS: checks 
*** SHOW DOWN ***
jackkk03: shows [Ts Jd] (a pair of Jacks)
ADRIAN0_MEIS: mucks hand 
jackkk03 collected €0.29 from pot
*** SUMMARY ***
Total pot €0.30 | Rake €0.01 
Board [5h 3s Jc 7d 4c]
Seat 1: caduceus369 (button) folded before Flop (didn't bet)
Seat 2: jackkk03 (small blind) showed [Ts Jd] and won (€0.29) with a pair of Jacks
Seat 3: ADRIAN0_MEIS (big blind) mucked [7s Th]
Seat 4: Warterror90 folded before Flop (didn't bet)
Seat 5: AlfredP80 folded before Flop (didn't bet)
Seat 6: kAllSeMPRE73 folded before Flop (didn't bet)



PokerStars Zoom Hand #257975760655:  Hold'em No Limit (€0.01/€0.02) [ADM ID: M62BA304494E32ST] - 2025/10/02 23:43:14 CET [2025/10/02 17:43:14 ET]
Table 'Sirio' 6-max Seat #1 is the button
Seat 1: AlfredP80 (€2.39 in chips) 
Seat 2: Catania838 (€1.95 in chips) 
Seat 3: Robycastel89 (€2.05 in chips) 
Seat 4: stfuplzudonk (€2.98 in chips) 
Seat 5: mondie73100 (€2.41 in chips) 
Seat 6: caduceus369 (€3.08 in chips) 
Catania838: posts small blind €0.01
Robycastel89: posts big blind €0.02
*** HOLE CARDS ***
Dealt to caduceus369 [2c 3h]
stfuplzudonk: folds 
mondie73100: folds 
caduceus369: folds 
AlfredP80: folds 
Catania838: raises €0.02 to €0.04
Robycastel89: folds 
Uncalled bet (€0.02) returned to Catania838
Catania838 collected €0.04 from pot
Catania838: doesn't show hand 
*** SUMMARY ***
Total pot €0.04 | Rake €0 
Seat 1: AlfredP80 (button) folded before Flop (didn't bet)
Seat 2: Catania838 (small blind) collected (€0.04)
Seat 3: Robycastel89 (big blind) folded before Flop
Seat 4: stfuplzudonk folded before Flop (didn't bet)
Seat 5: mondie73100 folded before Flop (didn't bet)
Seat 6: caduceus369 folded before Flop (didn't bet)



PokerStars Zoom Hand #257975762047:  Hold'em No Limit (€0.01/€0.02) [ADM ID: M62BA304494E32ST] - 2025/10/02 23:43:20 CET [2025/10/02 17:43:20 ET]
Table 'Sirio' 6-max Seat #1 is the button
Seat 1: kAllSeMPRE73 (€1.34 in chips) 
Seat 2: fantaasso (€2.08 in chips) 
Seat 3: stfuplzudonk (€2.98 in chips) 
Seat 4: DannyO985 (€2.10 in chips) 
Seat 5: caduceus369 (€3.08 in chips) 
Seat 6: AlfredP80 (€2.39 in chips) 
fantaasso: posts small blind €0.01
stfuplzudonk: posts big blind €0.02
*** HOLE CARDS ***
Dealt to caduceus369 [3d Ad]
DannyO985: folds 
caduceus369: folds 
AlfredP80: calls €0.02
kAllSeMPRE73: folds 
fantaasso: folds 
stfuplzudonk: checks 
*** FLOP *** [As 6s Js]
stfuplzudonk: checks 
AlfredP80: checks 
*** TURN *** [As 6s Js] [Tc]
stfuplzudonk: checks 
AlfredP80: bets €0.06
stfuplzudonk: folds 
Uncalled bet (€0.06) returned to AlfredP80
AlfredP80 collected €0.05 from pot
AlfredP80: doesn't show hand 
*** SUMMARY ***
Total pot €0.05 | Rake €0 
Board [As 6s Js Tc]
Seat 1: kAllSeMPRE73 (button) folded before Flop (didn't bet)
Seat 2: fantaasso (small blind) folded before Flop
Seat 3: stfuplzudonk (big blind) folded on the Turn
Seat 4: DannyO985 folded before Flop (didn't bet)
Seat 5: caduceus369 folded before Flop (didn't bet)
Seat 6: AlfredP80 collected (€0.05)



PokerStars Zoom Hand #257975764339:  Hold'em No Limit (€0.01/€0.02) [ADM ID: M62BA304494E32ST] - 2025/10/02 23:43:30 CET [2025/10/02 17:43:30 ET]
Table 'Sirio' 6-max Seat #1 is the button
Seat 1: Auspice67 (€4.16 in chips) 
Seat 2: RRgalp (€8.79 in chips) 
Seat 3: caduceus369 (€3.08 in chips) 
Seat 4: muhozhuk788 (€1.48 in chips) 
Seat 5: tomaok415 (€1.08 in chips) 
Seat 6: montemeru (€1.96 in chips) 
RRgalp: posts small blind €0.01
caduceus369: posts big blind €0.02
*** HOLE CARDS ***
Dealt to caduceus369 [8d 4h]
muhozhuk788: calls €0.02
tomaok415: folds 
montemeru: raises €0.07 to €0.09
Auspice67: calls €0.09
RRgalp: folds 
caduceus369: folds 
muhozhuk788: folds 
*** FLOP *** [7d Td 3c]
montemeru: bets €0.11
Auspice67: calls €0.11
*** TURN *** [7d Td 3c] [Qs]
montemeru: checks 
Auspice67: checks 
*** RIVER *** [7d Td 3c Qs] [6s]
montemeru: checks 
Auspice67: checks 
*** SHOW DOWN ***
montemeru: shows [Kh 8h] (high card King)
Auspice67: shows [9s 9d] (a pair of Nines)
Auspice67 collected €0.43 from pot
*** SUMMARY ***
Total pot €0.45 | Rake €0.02 
Board [7d Td 3c Qs 6s]
Seat 1: Auspice67 (button) showed [9s 9d] and won (€0.43) with a pair of Nines
Seat 2: RRgalp (small blind) folded before Flop
Seat 3: caduceus369 (big blind) folded before Flop
Seat 4: muhozhuk788 folded before Flop
Seat 5: tomaok415 folded before Flop (didn't bet)
Seat 6: montemeru showed [Kh 8h] and lost with high card King



PokerStars Zoom Hand #257975766826:  Hold'em No Limit (€0.01/€0.02) [ADM ID: M62BA304494E32ST] - 2025/10/02 23:43:41 CET [2025/10/02 17:43:41 ET]
Table 'Sirio' 6-max Seat #1 is the button
Seat 1: meteco79 (€0.74 in chips) 
Seat 2: lapo1987 (€2.48 in chips) 
Seat 3: pistaKKio23 (€3.48 in chips) 
Seat 4: ADRIAN0_MEIS (€4.58 in chips) 
Seat 5: caduceus369 (€3.06 in chips) 
Seat 6: stfuplzudonk (€2.23 in chips) 
lapo1987: posts small blind €0.01
pistaKKio23: posts big blind €0.02
*** HOLE CARDS ***
Dealt to caduceus369 [Qc 4s]
ADRIAN0_MEIS: raises €0.05 to €0.07
caduceus369: folds 
stfuplzudonk: calls €0.07
meteco79: folds 
lapo1987: folds 
pistaKKio23: folds 
*** FLOP *** [Kh 3s 7d]
ADRIAN0_MEIS: bets €0.09
stfuplzudonk: folds 
Uncalled bet (€0.09) returned to ADRIAN0_MEIS
ADRIAN0_MEIS collected €0.17 from pot
ADRIAN0_MEIS: doesn't show hand 
*** SUMMARY ***
Total pot €0.17 | Rake €0 
Board [Kh 3s 7d]
Seat 1: meteco79 (button) folded before Flop (didn't bet)
Seat 2: lapo1987 (small blind) folded before Flop
Seat 3: pistaKKio23 (big blind) folded before Flop
Seat 4: ADRIAN0_MEIS collected (€0.17)
Seat 5: caduceus369 folded before Flop (didn't bet)
Seat 6: stfuplzudonk folded on the Flop



PokerStars Zoom Hand #257975769910:  Hold'em No Limit (€0.01/€0.02) [ADM ID: M62BA304494E32ST] - 2025/10/02 23:43:54 CET [2025/10/02 17:43:54 ET]
Table 'Sirio' 6-max Seat #1 is the button
Seat 1: Oiad (€6.53 in chips) 
Seat 2: caduceus369 (€3.06 in chips) 
Seat 3: RRgalp (€8.78 in chips) 
Seat 4: mondie73100 (€2.42 in chips) 
Seat 5: robertoH2O (€2 in chips) 
Seat 6: stfuplzudonk (€5.46 in chips) 
caduceus369: posts small blind €0.01
RRgalp: posts big blind €0.02
*** HOLE CARDS ***
Dealt to caduceus369 [8s Qs]
mondie73100: folds 
robertoH2O: raises €0.03 to €0.05
stfuplzudonk: raises €0.13 to €0.18
Oiad: folds 
caduceus369: folds 
RRgalp: folds 
robertoH2O: folds 
Uncalled bet (€0.13) returned to stfuplzudonk
stfuplzudonk collected €0.13 from pot
stfuplzudonk: doesn't show hand 
*** SUMMARY ***
Total pot €0.13 | Rake €0 
Seat 1: Oiad (button) folded before Flop (didn't bet)
Seat 2: caduceus369 (small blind) folded before Flop
Seat 3: RRgalp (big blind) folded before Flop
Seat 4: mondie73100 folded before Flop (didn't bet)
Seat 5: robertoH2O folded before Flop
Seat 6: stfuplzudonk collected (€0.13)



PokerStars Zoom Hand #257975768113:  Hold'em No Limit (€0.01/€0.02) [ADM ID: M62BA304494E32ST] - 2025/10/02 23:43:46 CET [2025/10/02 17:43:46 ET]
Table 'Sirio' 6-max Seat #1 is the button
Seat 1: caduceus369 (€3.06 in chips) 
Seat 2: Sium12302 (€2.21 in chips) 
Seat 3: mondie73100 (€2.01 in chips) 
Seat 4: meteco79 (€0.74 in chips) 
Seat 5: Catania838 (€1.97 in chips) 
Seat 6: lapo1987 (€2.47 in chips) 
Sium12302: posts small blind €0.01
mondie73100: posts big blind €0.02
*** HOLE CARDS ***
Dealt to caduceus369 [Jd 6d]
meteco79: calls €0.02
Catania838: folds 
lapo1987: folds 
caduceus369: folds 
Sium12302: folds 
mondie73100: checks 
*** FLOP *** [Qc 5d 2s]
mondie73100: checks 
meteco79: checks 
*** TURN *** [Qc 5d 2s] [4h]
mondie73100: bets €0.02
meteco79: folds 
Uncalled bet (€0.02) returned to mondie73100
mondie73100 collected €0.05 from pot
mondie73100: doesn't show hand 
*** SUMMARY ***
Total pot €0.05 | Rake €0 
Board [Qc 5d 2s 4h]
Seat 1: caduceus369 (button) folded before Flop (didn't bet)
Seat 2: Sium12302 (small blind) folded before Flop
Seat 3: mondie73100 (big blind) collected (€0.05)
Seat 4: meteco79 folded on the Turn
Seat 5: Catania838 folded before Flop (didn't bet)
Seat 6: lapo1987 folded before Flop (didn't bet)



PokerStars Zoom Hand #257975774247:  Hold'em No Limit (€0.01/€0.02) [ADM ID: M62BA304494E32ST] - 2025/10/02 23:44:13 CET [2025/10/02 17:44:13 ET]
Table 'Sirio' 6-max Seat #1 is the button
Seat 1: PolyMangasJK (€1.19 in chips) 
Seat 2: muhozhuk788 (€3.45 in chips) 
Seat 3: Alex83l310 (€2.01 in chips) 
Seat 4: caduceus369 (€3.05 in chips) 
Seat 5: montemeru (€1.76 in chips) 
Seat 6: RRgalp (€8.76 in chips) 
muhozhuk788: posts small blind €0.01
Alex83l310: posts big blind €0.02
*** HOLE CARDS ***
Dealt to caduceus369 [5d 9d]
caduceus369: folds 
montemeru: raises €0.04 to €0.06
RRgalp: raises €0.12 to €0.18
PolyMangasJK: folds 
muhozhuk788: folds 
Alex83l310: folds 
montemeru: folds 
Uncalled bet (€0.12) returned to RRgalp
RRgalp collected €0.15 from pot
RRgalp: doesn't show hand 
*** SUMMARY ***
Total pot €0.15 | Rake €0 
Seat 1: PolyMangasJK (button) folded before Flop (didn't bet)
Seat 2: muhozhuk788 (small blind) folded before Flop
Seat 3: Alex83l310 (big blind) folded before Flop
Seat 4: caduceus369 folded before Flop (didn't bet)
Seat 5: montemeru folded before Flop
Seat 6: RRgalp collected (€0.15)



PokerStars Zoom Hand #257975777479:  Hold'em No Limit (€0.01/€0.02) [ADM ID: M62BA304494E32ST] - 2025/10/02 23:44:27 CET [2025/10/02 17:44:27 ET]
Table 'Sirio' 6-max Seat #1 is the button
Seat 1: Alex83l310 (€1.99 in chips) 
Seat 2: robertoH2O (€2 in chips) 
Seat 3: caduceus369 (€3.05 in chips) 
Seat 4: MacScrat (€2 in chips) 
Seat 5: PolyMangasJK (€1.19 in chips) 
Seat 6: ADRIAN0_MEIS (€6.01 in chips) 
robertoH2O: posts small blind €0.01
caduceus369: posts big blind €0.02
*** HOLE CARDS ***
Dealt to caduceus369 [Js 6c]
MacScrat: folds 
PolyMangasJK: folds 
ADRIAN0_MEIS: folds 
Alex83l310: folds 
robertoH2O: raises €0.04 to €0.06
caduceus369: folds 
Uncalled bet (€0.04) returned to robertoH2O
robertoH2O collected €0.04 from pot
robertoH2O: doesn't show hand 
*** SUMMARY ***
Total pot €0.04 | Rake €0 
Seat 1: Alex83l310 (button) folded before Flop (didn't bet)
Seat 2: robertoH2O (small blind) collected (€0.04)
Seat 3: caduceus369 (big blind) folded before Flop
Seat 4: MacScrat folded before Flop (didn't bet)
Seat 5: PolyMangasJK folded before Flop (didn't bet)
Seat 6: ADRIAN0_MEIS folded before Flop (didn't bet)



PokerStars Zoom Hand #257975776296:  Hold'em No Limit (€0.01/€0.02) [ADM ID: M62BA304494E32ST] - 2025/10/02 23:44:22 CET [2025/10/02 17:44:22 ET]
Table 'Sirio' 6-max Seat #1 is the button
Seat 1: stfuplzudonk (€2.95 in chips) 
Seat 2: MacScrat (€2 in chips) 
Seat 3: fantaasso (€1.88 in chips) 
Seat 4: caduceus369 (€3.05 in chips) 
Seat 5: Auspice67 (€4.37 in chips) 
Seat 6: campiraudii (€5.48 in chips) 
MacScrat: posts small blind €0.01
fantaasso: posts big blind €0.02
*** HOLE CARDS ***
Dealt to caduceus369 [Ts 9d]
caduceus369: folds 
Auspice67: raises €0.03 to €0.05
campiraudii: folds 
stfuplzudonk: folds 
MacScrat: folds 
fantaasso: calls €0.03
*** FLOP *** [5s 5h 3h]
fantaasso: checks 
Auspice67: checks 
*** TURN *** [5s 5h 3h] [6s]
fantaasso: bets €0.06
Auspice67: folds 
Uncalled bet (€0.06) returned to fantaasso
fantaasso collected €0.11 from pot
fantaasso: doesn't show hand 
*** SUMMARY ***
Total pot €0.11 | Rake €0 
Board [5s 5h 3h 6s]
Seat 1: stfuplzudonk (button) folded before Flop (didn't bet)
Seat 2: MacScrat (small blind) folded before Flop
Seat 3: fantaasso (big blind) collected (€0.11)
Seat 4: caduceus369 folded before Flop (didn't bet)
Seat 5: Auspice67 folded on the Turn
Seat 6: campiraudii folded before Flop (didn't bet)



PokerStars Zoom Hand #257975780309:  Hold'em No Limit (€0.01/€0.02) [ADM ID: M62BA304494E32ST] - 2025/10/02 23:44:39 CET [2025/10/02 17:44:39 ET]
Table 'Sirio' 6-max Seat #1 is the button
Seat 1: jackkk03 (€2.73 in chips) 
Seat 2: RRgalp (€8.85 in chips) 
Seat 3: MacScrat (€2 in chips) 
Seat 4: stfuplzudonk (€5.54 in chips) 
Seat 5: caduceus369 (€3.03 in chips) 
Seat 6: meteco79 (€0.70 in chips) 
RRgalp: posts small blind €0.01
MacScrat: posts big blind €0.02
*** HOLE CARDS ***
Dealt to caduceus369 [6h Jd]
stfuplzudonk: folds 
caduceus369: folds 
meteco79: calls €0.02
jackkk03: calls €0.02
RRgalp: folds 
MacScrat: checks 
*** FLOP *** [Kh 5s 6d]
MacScrat: bets €0.02
meteco79: calls €0.02
jackkk03: folds 
*** TURN *** [Kh 5s 6d] [As]
MacScrat: checks 
meteco79: checks 
*** RIVER *** [Kh 5s 6d As] [Kc]
MacScrat: bets €0.11
meteco79: folds 
Uncalled bet (€0.11) returned to MacScrat
MacScrat collected €0.11 from pot
MacScrat: doesn't show hand 
*** SUMMARY ***
Total pot €0.11 | Rake €0 
Board [Kh 5s 6d As Kc]
Seat 1: jackkk03 (button) folded on the Flop
Seat 2: RRgalp (small blind) folded before Flop
Seat 3: MacScrat (big blind) collected (€0.11)
Seat 4: stfuplzudonk folded before Flop (didn't bet)
Seat 5: caduceus369 folded before Flop (didn't bet)
Seat 6: meteco79 folded on the River



PokerStars Zoom Hand #257975781319:  Hold'em No Limit (€0.01/€0.02) [ADM ID: M62BA304494E32ST] - 2025/10/02 23:44:43 CET [2025/10/02 17:44:43 ET]
Table 'Sirio' 6-max Seat #1 is the button
Seat 1: ADRIAN0_MEIS (€4.67 in chips) 
Seat 2: caduceus369 (€3.03 in chips) 
Seat 3: stfuplzudonk (€2.95 in chips) 
Seat 4: Cinghi11 (€0.39 in chips) 
Seat 5: pistaKKio23 (€3.45 in chips) 
Seat 6: mondie73100 (€2.03 in chips) 
caduceus369: posts small blind €0.01
stfuplzudonk: posts big blind €0.02
*** HOLE CARDS ***
Dealt to caduceus369 [7d 8s]
Cinghi11: folds 
pistaKKio23: folds 
mondie73100: raises €0.04 to €0.06
ADRIAN0_MEIS: folds 
caduceus369: folds 
stfuplzudonk: folds 
Uncalled bet (€0.04) returned to mondie73100
mondie73100 collected €0.05 from pot
mondie73100: doesn't show hand 
*** SUMMARY ***
Total pot €0.05 | Rake €0 
Seat 1: ADRIAN0_MEIS (button) folded before Flop (didn't bet)
Seat 2: caduceus369 (small blind) folded before Flop
Seat 3: stfuplzudonk (big blind) folded before Flop
Seat 4: Cinghi11 folded before Flop (didn't bet)
Seat 5: pistaKKio23 folded before Flop (didn't bet)
Seat 6: mondie73100 collected (€0.05)



PokerStars Zoom Hand #257975783859:  Hold'em No Limit (€0.01/€0.02) [ADM ID: M62BA304494E32ST] - 2025/10/02 23:44:55 CET [2025/10/02 17:44:55 ET]
Table 'Sirio' 6-max Seat #1 is the button
Seat 1: PolyMangasJK (€1.16 in chips) 
Seat 2: fantaasso (€1.94 in chips) 
Seat 3: caduceus369 (€3.02 in chips) 
Seat 4: Auspice67 (€4.31 in chips) 
Seat 5: Warterror90 (€1.97 in chips) 
Seat 6: MacScrat (€3.50 in chips) 
fantaasso: posts small blind €0.01
caduceus369: posts big blind €0.02
*** HOLE CARDS ***
Dealt to caduceus369 [7c 6s]
Auspice67: folds 
Warterror90: folds 
MacScrat: raises €0.04 to €0.06
PolyMangasJK: calls €0.06
fantaasso: folds 
caduceus369: folds 
*** FLOP *** [Jc 6c 8h]
MacScrat: checks 
PolyMangasJK: checks 
*** TURN *** [Jc 6c 8h] [Qh]
MacScrat: checks 
PolyMangasJK: checks 
*** RIVER *** [Jc 6c 8h Qh] [4d]
MacScrat: checks 
PolyMangasJK: checks 
*** SHOW DOWN ***
MacScrat: shows [5c 5h] (a pair of Fives)
PolyMangasJK: shows [9h 9s] (a pair of Nines)
PolyMangasJK collected €0.15 from pot
*** SUMMARY ***
Total pot €0.15 | Rake €0 
Board [Jc 6c 8h Qh 4d]
Seat 1: PolyMangasJK (button) showed [9h 9s] and won (€0.15) with a pair of Nines
Seat 2: fantaasso (small blind) folded before Flop
Seat 3: caduceus369 (big blind) folded before Flop
Seat 4: Auspice67 folded before Flop (didn't bet)
Seat 5: Warterror90 folded before Flop (didn't bet)
Seat 6: MacScrat showed [5c 5h] and lost with a pair of Fives



PokerStars Zoom Hand #257975782796:  Hold'em No Limit (€0.01/€0.02) [ADM ID: M62BA304494E32ST] - 2025/10/02 23:44:50 CET [2025/10/02 17:44:50 ET]
Table 'Sirio' 6-max Seat #1 is the button
Seat 1: caduceus369 (€3.02 in chips) 
Seat 2: Warterror90 (€1.98 in chips) 
Seat 3: RRgalp (€8.84 in chips) 
Seat 4: cap e'bomb95 (€2.88 in chips) 
Seat 5: fantaasso (€1.94 in chips) 
Seat 6: jackkk03 (€2.71 in chips) 
Warterror90: posts small blind €0.01
RRgalp: posts big blind €0.02
*** HOLE CARDS ***
Dealt to caduceus369 [7c 5s]
cap e'bomb95: folds 
fantaasso: folds 
jackkk03: calls €0.02
caduceus369: folds 
Warterror90: folds 
RRgalp: checks 
*** FLOP *** [4d 6c Kc]
RRgalp: checks 
jackkk03: checks 
*** TURN *** [4d 6c Kc] [Jc]
RRgalp: checks 
jackkk03: checks 
*** RIVER *** [4d 6c Kc Jc] [3h]
RRgalp: bets €0.02
jackkk03: calls €0.02
*** SHOW DOWN ***
RRgalp: shows [7d Js] (a pair of Jacks)
jackkk03: mucks hand 
RRgalp collected €0.09 from pot
*** SUMMARY ***
Total pot €0.09 | Rake €0 
Board [4d 6c Kc Jc 3h]
Seat 1: caduceus369 (button) folded before Flop (didn't bet)
Seat 2: Warterror90 (small blind) folded before Flop
Seat 3: RRgalp (big blind) showed [7d Js] and won (€0.09) with a pair of Jacks
Seat 4: cap e'bomb95 folded before Flop (didn't bet)
Seat 5: fantaasso folded before Flop (didn't bet)
Seat 6: jackkk03 mucked [Ts 6s]



PokerStars Zoom Hand #257975786753:  Hold'em No Limit (€0.01/€0.02) [ADM ID: M62BA304494E32ST] - 2025/10/02 23:45:08 CET [2025/10/02 17:45:08 ET]
Table 'Sirio' 6-max Seat #1 is the button
Seat 1: cap e'bomb95 (€2.87 in chips) 
Seat 2: caduceus369 (€3 in chips) 
Seat 3: Robycastel89 (€1.98 in chips) 
Seat 4: stfuplzudonk (€5.07 in chips) 
Seat 5: mondie73100 (€2.06 in chips) 
Seat 6: TonyPir97 (€1.79 in chips) 
caduceus369: posts small blind €0.01
Robycastel89: posts big blind €0.02
*** HOLE CARDS ***
Dealt to caduceus369 [5c 3c]
stfuplzudonk: folds 
mondie73100: folds 
TonyPir97: raises €0.05 to €0.07
cap e'bomb95: folds 
caduceus369: folds 
Robycastel89: folds 
Uncalled bet (€0.05) returned to TonyPir97
TonyPir97 collected €0.05 from pot
TonyPir97: doesn't show hand 
*** SUMMARY ***
Total pot €0.05 | Rake €0 
Seat 1: cap e'bomb95 (button) folded before Flop (didn't bet)
Seat 2: caduceus369 (small blind) folded before Flop
Seat 3: Robycastel89 (big blind) folded before Flop
Seat 4: stfuplzudonk folded before Flop (didn't bet)
Seat 5: mondie73100 folded before Flop (didn't bet)
Seat 6: TonyPir97 collected (€0.05)



PokerStars Zoom Hand #257975790058:  Hold'em No Limit (€0.01/€0.02) [ADM ID: M62BA304494E32ST] - 2025/10/02 23:45:23 CET [2025/10/02 17:45:23 ET]
Table 'Sirio' 6-max Seat #1 is the button
Seat 1: RRgalp (€8.89 in chips) 
Seat 2: jackkk03 (€2.67 in chips) 
Seat 3: mondie73100 (€2.06 in chips) 
Seat 4: caduceus369 (€2.99 in chips) 
Seat 5: DannyO985 (€2.35 in chips) 
Seat 6: PolyMangasJK (€1.25 in chips) 
jackkk03: posts small blind €0.01
mondie73100: posts big blind €0.02
*** HOLE CARDS ***
Dealt to caduceus369 [3h Ts]
caduceus369: folds 
DannyO985: folds 
PolyMangasJK: folds 
RRgalp: folds 
jackkk03: folds 
Uncalled bet (€0.01) returned to mondie73100
mondie73100 collected €0.02 from pot
mondie73100: doesn't show hand 
*** SUMMARY ***
Total pot €0.02 | Rake €0 
Seat 1: RRgalp (button) folded before Flop (didn't bet)
Seat 2: jackkk03 (small blind) folded before Flop
Seat 3: mondie73100 (big blind) collected (€0.02)
Seat 4: caduceus369 folded before Flop (didn't bet)
Seat 5: DannyO985 folded before Flop (didn't bet)
Seat 6: PolyMangasJK folded before Flop (didn't bet)



PokerStars Zoom Hand #257975787844:  Hold'em No Limit (€0.01/€0.02) [ADM ID: M62BA304494E32ST] - 2025/10/02 23:45:13 CET [2025/10/02 17:45:13 ET]
Table 'Sirio' 6-max Seat #1 is the button
Seat 1: cap e'bomb95 (€4.61 in chips) 
Seat 2: robertoH2O (€2.02 in chips) 
Seat 3: kAllSeMPRE73 (€1.21 in chips) 
Seat 4: fantaasso (€1.82 in chips) 
Seat 5: muhozhuk788 (€1.22 in chips) 
Seat 6: caduceus369 (€2.99 in chips) 
robertoH2O: posts small blind €0.01
kAllSeMPRE73: posts big blind €0.02
*** HOLE CARDS ***
Dealt to caduceus369 [Ks 4c]
fantaasso: folds 
muhozhuk788: folds 
caduceus369: folds 
cap e'bomb95: folds 
robertoH2O: raises €0.04 to €0.06
kAllSeMPRE73: calls €0.04
*** FLOP *** [6c 9s 5c]
robertoH2O: bets €0.06
kAllSeMPRE73: calls €0.06
*** TURN *** [6c 9s 5c] [3d]
robertoH2O: bets €0.16
kAllSeMPRE73: calls €0.16
*** RIVER *** [6c 9s 5c 3d] [3h]
robertoH2O: bets €0.28
kAllSeMPRE73: folds 
Uncalled bet (€0.28) returned to robertoH2O
robertoH2O collected €0.53 from pot
robertoH2O: doesn't show hand 
*** SUMMARY ***
Total pot €0.56 | Rake €0.03 
Board [6c 9s 5c 3d 3h]
Seat 1: cap e'bomb95 (button) folded before Flop (didn't bet)
Seat 2: robertoH2O (small blind) collected (€0.53)
Seat 3: kAllSeMPRE73 (big blind) folded on the River
Seat 4: fantaasso folded before Flop (didn't bet)
Seat 5: muhozhuk788 folded before Flop (didn't bet)
Seat 6: caduceus369 folded before Flop (didn't bet)



PokerStars Zoom Hand #257975785698:  Hold'em No Limit (€0.01/€0.02) [ADM ID: M62BA304494E32ST] - 2025/10/02 23:45:03 CET [2025/10/02 17:45:03 ET]
Table 'Sirio' 6-max Seat #1 is the button
Seat 1: Oiad (€6.10 in chips) 
Seat 2: cap e'bomb95 (€2.88 in chips) 
Seat 3: Buonosimafesson (€0.94 in chips) 
Seat 4: caduceus369 (€3 in chips) 
Seat 5: Robycastel89 (€1.98 in chips) 
Seat 6: ADRIAN0_MEIS (€4.67 in chips) 
cap e'bomb95: posts small blind €0.01
Buonosimafesson: posts big blind €0.02
*** HOLE CARDS ***
Dealt to caduceus369 [3c 7d]
caduceus369: folds 
Robycastel89: folds 
ADRIAN0_MEIS: raises €0.04 to €0.06
Oiad: folds 
cap e'bomb95: folds 
Buonosimafesson: calls €0.04
*** FLOP *** [As Qh 9s]
Buonosimafesson: checks 
ADRIAN0_MEIS: bets €0.07
Buonosimafesson: folds 
Uncalled bet (€0.07) returned to ADRIAN0_MEIS
ADRIAN0_MEIS collected €0.13 from pot
ADRIAN0_MEIS: doesn't show hand 
*** SUMMARY ***
Total pot €0.13 | Rake €0 
Board [As Qh 9s]
Seat 1: Oiad (button) folded before Flop (didn't bet)
Seat 2: cap e'bomb95 (small blind) folded before Flop
Seat 3: Buonosimafesson (big blind) folded on the Flop
Seat 4: caduceus369 folded before Flop (didn't bet)
Seat 5: Robycastel89 folded before Flop (didn't bet)
Seat 6: ADRIAN0_MEIS collected (€0.13)



PokerStars Zoom Hand #257975788776:  Hold'em No Limit (€0.01/€0.02) [ADM ID: M62BA304494E32ST] - 2025/10/02 23:45:17 CET [2025/10/02 17:45:17 ET]
Table 'Sirio' 6-max Seat #1 is the button
Seat 1: caduceus369 (€2.99 in chips) 
Seat 2: cap e'bomb95 (€1.89 in chips) 
Seat 3: Oiad (€6.10 in chips) 
Seat 4: ADRIAN0_MEIS (€6.09 in chips) 
Seat 5: muhozhuk788 (€3.65 in chips) 
Seat 6: stfuplzudonk (€5.54 in chips) 
cap e'bomb95: posts small blind €0.01
Oiad: posts big blind €0.02
*** HOLE CARDS ***
Dealt to caduceus369 [4d 2c]
ADRIAN0_MEIS: folds 
muhozhuk788: folds 
stfuplzudonk: raises €0.04 to €0.06
caduceus369: folds 
cap e'bomb95: folds 
Oiad: raises €0.18 to €0.24
stfuplzudonk: folds 
Uncalled bet (€0.18) returned to Oiad
Oiad collected €0.13 from pot
Oiad: doesn't show hand 
*** SUMMARY ***
Total pot €0.13 | Rake €0 
Seat 1: caduceus369 (button) folded before Flop (didn't bet)
Seat 2: cap e'bomb95 (small blind) folded before Flop
Seat 3: Oiad (big blind) collected (€0.13)
Seat 4: ADRIAN0_MEIS folded before Flop (didn't bet)
Seat 5: muhozhuk788 folded before Flop (didn't bet)
Seat 6: stfuplzudonk folded before Flop



PokerStars Zoom Hand #257975791474:  Hold'em No Limit (€0.01/€0.02) [ADM ID: M62BA304494E32ST] - 2025/10/02 23:45:29 CET [2025/10/02 17:45:29 ET]
Table 'Sirio' 6-max Seat #1 is the button
Seat 1: Alex83l310 (€1.92 in chips) 
Seat 2: PolyMangasJK (€1.25 in chips) 
Seat 3: TonyPir97 (€1.82 in chips) 
Seat 4: cap e'bomb95 (€1.88 in chips) 
Seat 5: MacScrat (€3.44 in chips) 
Seat 6: caduceus369 (€2.99 in chips) 
PolyMangasJK: posts small blind €0.01
TonyPir97: posts big blind €0.02
*** HOLE CARDS ***
Dealt to caduceus369 [Ts 2s]
cap e'bomb95: folds 
MacScrat: folds 
caduceus369: folds 
Alex83l310: raises €0.02 to €0.04
PolyMangasJK: folds 
TonyPir97: calls €0.02
*** FLOP *** [Td 5s Ah]
TonyPir97: checks 
Alex83l310: bets €0.04
TonyPir97: folds 
Uncalled bet (€0.04) returned to Alex83l310
Alex83l310 collected €0.09 from pot
Alex83l310: doesn't show hand 
*** SUMMARY ***
Total pot €0.09 | Rake €0 
Board [Td 5s Ah]
Seat 1: Alex83l310 (button) collected (€0.09)
Seat 2: PolyMangasJK (small blind) folded before Flop
Seat 3: TonyPir97 (big blind) folded on the Flop
Seat 4: cap e'bomb95 folded before Flop (didn't bet)
Seat 5: MacScrat folded before Flop (didn't bet)
Seat 6: caduceus369 folded before Flop (didn't bet)



PokerStars Zoom Hand #257975775238:  Hold'em No Limit (€0.01/€0.02) [ADM ID: M62BA304494E32ST] - 2025/10/02 23:44:17 CET [2025/10/02 17:44:17 ET]
Table 'Sirio' 6-max Seat #1 is the button
Seat 1: fantaasso (€1.88 in chips) 
Seat 2: Anna2141 (€2.20 in chips) 
Seat 3: ADRIAN0_MEIS (€3.94 in chips) 
Seat 4: Oiad (€6.52 in chips) 
Seat 5: stfuplzudonk (€2.95 in chips) 
Seat 6: caduceus369 (€3.05 in chips) 
Anna2141: posts small blind €0.01
ADRIAN0_MEIS: posts big blind €0.02
*** HOLE CARDS ***
Dealt to caduceus369 [7d Kh]
Oiad: raises €0.08 to €0.10
stfuplzudonk: folds 
caduceus369: folds 
fantaasso: folds 
Anna2141: calls €0.09
ADRIAN0_MEIS: calls €0.08
*** FLOP *** [9d Qs 5c]
Anna2141: checks 
ADRIAN0_MEIS: checks 
Oiad: checks 
*** TURN *** [9d Qs 5c] [7c]
Anna2141: checks 
ADRIAN0_MEIS: checks 
Oiad: bets €0.09
Anna2141: calls €0.09
ADRIAN0_MEIS: folds 
*** RIVER *** [9d Qs 5c 7c] [5s]
Anna2141: checks 
Oiad: bets €1.38
Anna2141: folds 
Uncalled bet (€1.38) returned to Oiad
Oiad collected €0.46 from pot
Oiad: doesn't show hand 
*** SUMMARY ***
Total pot €0.48 | Rake €0.02 
Board [9d Qs 5c 7c 5s]
Seat 1: fantaasso (button) folded before Flop (didn't bet)
Seat 2: Anna2141 (small blind) folded on the River
Seat 3: ADRIAN0_MEIS (big blind) folded on the Turn
Seat 4: Oiad collected (€0.46)
Seat 5: stfuplzudonk folded before Flop (didn't bet)
Seat 6: caduceus369 folded before Flop (didn't bet)



PokerStars Zoom Hand #257975792501:  Hold'em No Limit (€0.01/€0.02) [ADM ID: M62BA304494E32ST] - 2025/10/02 23:45:34 CET [2025/10/02 17:45:34 ET]
Table 'Sirio' 6-max Seat #1 is the button
Seat 1: mondie73100 (€2.07 in chips) 
Seat 2: cap e'bomb95 (€4.59 in chips) 
Seat 3: caduceus369 (€2.99 in chips) 
Seat 4: ADRIAN0_MEIS (€6.09 in chips) 
Seat 5: AlfredP80 (€2.49 in chips) 
Seat 6: pistaKKio23 (€1.82 in chips) 
cap e'bomb95: posts small blind €0.01
caduceus369: posts big blind €0.02
*** HOLE CARDS ***
Dealt to caduceus369 [7c Kd]
ADRIAN0_MEIS: folds 
AlfredP80: calls €0.02
pistaKKio23 has timed out
pistaKKio23: folds 
mondie73100: calls €0.02
cap e'bomb95: folds 
caduceus369: checks 
*** FLOP *** [Td 2h 2d]
caduceus369: checks 
AlfredP80: checks 
mondie73100: checks 
*** TURN *** [Td 2h 2d] [Qs]
caduceus369: checks 
AlfredP80: checks 
mondie73100: checks 
*** RIVER *** [Td 2h 2d Qs] [5h]
caduceus369: bets €0.02
AlfredP80: folds 
mondie73100: folds 
Uncalled bet (€0.02) returned to caduceus369
caduceus369 collected €0.07 from pot
caduceus369: doesn't show hand 
*** SUMMARY ***
Total pot €0.07 | Rake €0 
Board [Td 2h 2d Qs 5h]
Seat 1: mondie73100 (button) folded on the River
Seat 2: cap e'bomb95 (small blind) folded before Flop
Seat 3: caduceus369 (big blind) collected (€0.07)
Seat 4: ADRIAN0_MEIS folded before Flop (didn't bet)
Seat 5: AlfredP80 folded on the River
Seat 6: pistaKKio23 folded before Flop (didn't bet)



PokerStars Zoom Hand #257975806182:  Hold'em No Limit (€0.01/€0.02) [ADM ID: M62BA304494E32ST] - 2025/10/02 23:46:34 CET [2025/10/02 17:46:34 ET]
Table 'Sirio' 6-max Seat #1 is the button
Seat 1: MacScrat (€2.03 in chips) 
Seat 2: caduceus369 (€3.04 in chips) 
Seat 3: PolyMangasJK (€1.28 in chips) 
Seat 4: Oiad (€5.98 in chips) 
Seat 5: cap e'bomb95 (€1.73 in chips) 
Seat 6: Auspice67 (€4.34 in chips) 
caduceus369: posts small blind €0.01
PolyMangasJK: posts big blind €0.02
*** HOLE CARDS ***
Dealt to caduceus369 [4h Kc]
Oiad: folds 
cap e'bomb95: folds 
Auspice67: folds 
MacScrat: raises €0.05 to €0.07
caduceus369: folds 
PolyMangasJK: folds 
Uncalled bet (€0.05) returned to MacScrat
MacScrat collected €0.05 from pot
MacScrat: doesn't show hand 
*** SUMMARY ***
Total pot €0.05 | Rake €0 
Seat 1: MacScrat (button) collected (€0.05)
Seat 2: caduceus369 (small blind) folded before Flop
Seat 3: PolyMangasJK (big blind) folded before Flop
Seat 4: Oiad folded before Flop (didn't bet)
Seat 5: cap e'bomb95 folded before Flop (didn't bet)
Seat 6: Auspice67 folded before Flop (didn't bet)



PokerStars Zoom Hand #257975805252:  Hold'em No Limit (€0.01/€0.02) [ADM ID: M62BA304494E32ST] - 2025/10/02 23:46:30 CET [2025/10/02 17:46:30 ET]
Table 'Sirio' 6-max Seat #1 is the button
Seat 1: AlfredP80 (€2.47 in chips) 
Seat 2: MacScrat (€2.04 in chips) 
Seat 3: lapo1987 (€2.53 in chips) 
Seat 4: stfuplzudonk (€5.47 in chips) 
Seat 5: caduceus369 (€3.04 in chips) 
Seat 6: PolyMangasJK (€1.28 in chips) 
MacScrat: posts small blind €0.01
lapo1987: posts big blind €0.02
*** HOLE CARDS ***
Dealt to caduceus369 [7h 9d]
stfuplzudonk: raises €0.04 to €0.06
caduceus369: folds 
PolyMangasJK: folds 
AlfredP80: calls €0.06
MacScrat: folds 
lapo1987: folds 
*** FLOP *** [Jh 6s 2d]
stfuplzudonk: checks 
AlfredP80: checks 
*** TURN *** [Jh 6s 2d] [Tc]
stfuplzudonk: checks 
AlfredP80: checks 
*** RIVER *** [Jh 6s 2d Tc] [Ac]
stfuplzudonk: checks 
AlfredP80: checks 
*** SHOW DOWN ***
stfuplzudonk: shows [Th Kh] (a pair of Tens)
AlfredP80: mucks hand 
stfuplzudonk collected €0.15 from pot
*** SUMMARY ***
Total pot €0.15 | Rake €0 
Board [Jh 6s 2d Tc Ac]
Seat 1: AlfredP80 (button) mucked [8d 7d]
Seat 2: MacScrat (small blind) folded before Flop
Seat 3: lapo1987 (big blind) folded before Flop
Seat 4: stfuplzudonk showed [Th Kh] and won (€0.15) with a pair of Tens
Seat 5: caduceus369 folded before Flop (didn't bet)
Seat 6: PolyMangasJK folded before Flop (didn't bet)



PokerStars Zoom Hand #257975806839:  Hold'em No Limit (€0.01/€0.02) [ADM ID: M62BA304494E32ST] - 2025/10/02 23:46:37 CET [2025/10/02 17:46:37 ET]
Table 'Sirio' 6-max Seat #1 is the button
Seat 1: caduceus369 (€3.03 in chips) 
Seat 2: jackkk03 (€2.15 in chips) 
Seat 3: DannyO985 (€2.31 in chips) 
Seat 4: Buonosimafesson (€1.08 in chips) 
Seat 5: RRgalp (€8.86 in chips) 
Seat 6: cap e'bomb95 (€1.73 in chips) 
jackkk03: posts small blind €0.01
DannyO985: posts big blind €0.02
*** HOLE CARDS ***
Dealt to caduceus369 [3s Kh]
Buonosimafesson: calls €0.02
RRgalp: folds 
cap e'bomb95: folds 
caduceus369: folds 
jackkk03: calls €0.01
DannyO985: checks 
*** FLOP *** [Ad Qd Td]
jackkk03: checks 
DannyO985: checks 
Buonosimafesson: bets €0.04
jackkk03: folds 
DannyO985: folds 
Uncalled bet (€0.04) returned to Buonosimafesson
Buonosimafesson collected €0.06 from pot
Buonosimafesson: doesn't show hand 
*** SUMMARY ***
Total pot €0.06 | Rake €0 
Board [Ad Qd Td]
Seat 1: caduceus369 (button) folded before Flop (didn't bet)
Seat 2: jackkk03 (small blind) folded on the Flop
Seat 3: DannyO985 (big blind) folded on the Flop
Seat 4: Buonosimafesson collected (€0.06)
Seat 5: RRgalp folded before Flop (didn't bet)
Seat 6: cap e'bomb95 folded before Flop (didn't bet)



PokerStars Zoom Hand #257975807441:  Hold'em No Limit (€0.01/€0.02) [ADM ID: M62BA304494E32ST] - 2025/10/02 23:46:40 CET [2025/10/02 17:46:40 ET]
Table 'Sirio' 6-max Seat #1 is the button
Seat 1: Sium12302 (€2.27 in chips) 
Seat 2: fantaasso (€1.63 in chips) 
Seat 3: Auspice67 (€4.34 in chips) 
Seat 4: caduceus369 (€3.03 in chips) 
Seat 5: Oiad (€5.98 in chips) 
Seat 6: Alex83l310 (€1.97 in chips) 
fantaasso: posts small blind €0.01
Auspice67: posts big blind €0.02
*** HOLE CARDS ***
Dealt to caduceus369 [Ac 7c]
caduceus369: calls €0.02
Oiad: folds 
Alex83l310: folds 
Sium12302: folds 
fantaasso: folds 
Auspice67: checks 
*** FLOP *** [Jc 9h 2h]
Auspice67: checks 
caduceus369: bets €0.02
Auspice67: calls €0.02
*** TURN *** [Jc 9h 2h] [8h]
Auspice67: checks 
caduceus369: checks 
*** RIVER *** [Jc 9h 2h 8h] [Kd]
Auspice67: checks 
caduceus369: bets €0.03
Auspice67: folds 
Uncalled bet (€0.03) returned to caduceus369
caduceus369 collected €0.09 from pot
caduceus369: doesn't show hand 
*** SUMMARY ***
Total pot €0.09 | Rake €0 
Board [Jc 9h 2h 8h Kd]
Seat 1: Sium12302 (button) folded before Flop (didn't bet)
Seat 2: fantaasso (small blind) folded before Flop
Seat 3: Auspice67 (big blind) folded on the River
Seat 4: caduceus369 collected (€0.09)
Seat 5: Oiad folded before Flop (didn't bet)
Seat 6: Alex83l310 folded before Flop (didn't bet)



PokerStars Zoom Hand #257975818430:  Hold'em No Limit (€0.01/€0.02) [ADM ID: M62BA304494E32ST] - 2025/10/02 23:47:29 CET [2025/10/02 17:47:29 ET]
Table 'Sirio' 6-max Seat #1 is the button
Seat 1: mondie73100 (€2 in chips) 
Seat 2: fantaasso (€1.63 in chips) 
Seat 3: lapo1987 (€2.50 in chips) 
Seat 4: stfuplzudonk (€2.96 in chips) 
Seat 5: Oiad (€6.24 in chips) 
Seat 6: caduceus369 (€3.08 in chips) 
fantaasso: posts small blind €0.01
lapo1987: posts big blind €0.02
*** HOLE CARDS ***
Dealt to caduceus369 [2d 4d]
stfuplzudonk: folds 
Oiad: folds 
caduceus369: folds 
mondie73100: folds 
fantaasso: raises €0.02 to €0.04
lapo1987: folds 
Uncalled bet (€0.02) returned to fantaasso
fantaasso collected €0.04 from pot
fantaasso: doesn't show hand 
*** SUMMARY ***
Total pot €0.04 | Rake €0 
Seat 1: mondie73100 (button) folded before Flop (didn't bet)
Seat 2: fantaasso (small blind) collected (€0.04)
Seat 3: lapo1987 (big blind) folded before Flop
Seat 4: stfuplzudonk folded before Flop (didn't bet)
Seat 5: Oiad folded before Flop (didn't bet)
Seat 6: caduceus369 folded before Flop (didn't bet)



PokerStars Zoom Hand #257975825241:  Hold'em No Limit (€0.01/€0.02) [ADM ID: M62BA304494E32ST] - 2025/10/02 23:47:59 CET [2025/10/02 17:47:59 ET]
Table 'Sirio' 6-max Seat #1 is the button
Seat 1: lapo1987 (€2.48 in chips) 
Seat 2: caduceus369 (€3.06 in chips) 
Seat 3: stfuplzudonk (€2.06 in chips) 
Seat 4: cap e'bomb95 (€1.67 in chips) 
Seat 5: ADRIAN0_MEIS (€4.99 in chips) 
Seat 6: fantaasso (€1.65 in chips) 
caduceus369: posts small blind €0.01
stfuplzudonk: posts big blind €0.02
*** HOLE CARDS ***
Dealt to caduceus369 [3c 9s]
cap e'bomb95: folds 
ADRIAN0_MEIS: folds 
fantaasso: raises €0.04 to €0.06
lapo1987: folds 
caduceus369: folds 
stfuplzudonk: folds 
Uncalled bet (€0.04) returned to fantaasso
fantaasso collected €0.05 from pot
fantaasso: doesn't show hand 
*** SUMMARY ***
Total pot €0.05 | Rake €0 
Seat 1: lapo1987 (button) folded before Flop (didn't bet)
Seat 2: caduceus369 (small blind) folded before Flop
Seat 3: stfuplzudonk (big blind) folded before Flop
Seat 4: cap e'bomb95 folded before Flop (didn't bet)
Seat 5: ADRIAN0_MEIS folded before Flop (didn't bet)
Seat 6: fantaasso collected (€0.05)



PokerStars Zoom Hand #257975819948:  Hold'em No Limit (€0.01/€0.02) [ADM ID: M62BA304494E32ST] - 2025/10/02 23:47:36 CET [2025/10/02 17:47:36 ET]
Table 'Sirio' 6-max Seat #1 is the button
Seat 1: pistaKKio23 (€3.07 in chips) 
Seat 2: jackkk03 (€2.11 in chips) 
Seat 3: caduceus369 (€3.08 in chips) 
Seat 4: Anna2141 (€2.13 in chips) 
Seat 5: MacScrat (€2.03 in chips) 
Seat 6: ADRIAN0_MEIS (€4.24 in chips) 
jackkk03: posts small blind €0.01
caduceus369: posts big blind €0.02
*** HOLE CARDS ***
Dealt to caduceus369 [2c 3h]
Anna2141: calls €0.02
MacScrat: folds 
ADRIAN0_MEIS: folds 
pistaKKio23: folds 
jackkk03: calls €0.01
caduceus369: checks 
*** FLOP *** [6c Ah 4h]
jackkk03: checks 
caduceus369: checks 
Anna2141: bets €0.02
jackkk03: calls €0.02
caduceus369: folds 
*** TURN *** [6c Ah 4h] [Ad]
jackkk03: checks 
Anna2141: bets €0.02
jackkk03: calls €0.02
*** RIVER *** [6c Ah 4h Ad] [Kh]
jackkk03: bets €0.20
Anna2141: folds 
Uncalled bet (€0.20) returned to jackkk03
jackkk03 collected €0.14 from pot
jackkk03: doesn't show hand 
*** SUMMARY ***
Total pot €0.14 | Rake €0 
Board [6c Ah 4h Ad Kh]
Seat 1: pistaKKio23 (button) folded before Flop (didn't bet)
Seat 2: jackkk03 (small blind) collected (€0.14)
Seat 3: caduceus369 (big blind) folded on the Flop
Seat 4: Anna2141 folded on the River
Seat 5: MacScrat folded before Flop (didn't bet)
Seat 6: ADRIAN0_MEIS folded before Flop (didn't bet)



PokerStars Zoom Hand #257975827290:  Hold'em No Limit (€0.01/€0.02) [ADM ID: M62BA304494E32ST] - 2025/10/02 23:48:09 CET [2025/10/02 17:48:09 ET]
Table 'Sirio' 6-max Seat #1 is the button
Seat 1: caduceus369 (€3.05 in chips) 
Seat 2: cap e'bomb95 (€2.80 in chips) 
Seat 3: stfuplzudonk (€5.55 in chips) 
Seat 4: Oiad (€5.95 in chips) 
Seat 5: MacScrat (€3.43 in chips) 
Seat 6: lapo1987 (€2.48 in chips) 
cap e'bomb95: posts small blind €0.01
stfuplzudonk: posts big blind €0.02
*** HOLE CARDS ***
Dealt to caduceus369 [Ah 6h]
Oiad: folds 
MacScrat: folds 
lapo1987: folds 
caduceus369: raises €0.02 to €0.04
cap e'bomb95: raises €0.10 to €0.14
stfuplzudonk: folds 
caduceus369: folds 
Uncalled bet (€0.10) returned to cap e'bomb95
cap e'bomb95 collected €0.10 from pot
cap e'bomb95: doesn't show hand 
*** SUMMARY ***
Total pot €0.10 | Rake €0 
Seat 1: caduceus369 (button) folded before Flop
Seat 2: cap e'bomb95 (small blind) collected (€0.10)
Seat 3: stfuplzudonk (big blind) folded before Flop
Seat 4: Oiad folded before Flop (didn't bet)
Seat 5: MacScrat folded before Flop (didn't bet)
Seat 6: lapo1987 folded before Flop (didn't bet)



PokerStars Zoom Hand #257975831158:  Hold'em No Limit (€0.01/€0.02) [ADM ID: M62BA304494E32ST] - 2025/10/02 23:48:26 CET [2025/10/02 17:48:26 ET]
Table 'Sirio' 6-max Seat #1 is the button
Seat 1: PolyMangasJK (€1.35 in chips) 
Seat 2: DannyO985 (€2.81 in chips) 
Seat 3: jackkk03 (€2.19 in chips) 
Seat 4: stfuplzudonk (€2.89 in chips) 
Seat 5: caduceus369 (€3.01 in chips) 
Seat 6: pistaKKio23 (€1.79 in chips) 
DannyO985: posts small blind €0.01
jackkk03: posts big blind €0.02
*** HOLE CARDS ***
Dealt to caduceus369 [Th Jh]
stfuplzudonk: folds 
caduceus369: calls €0.02
pistaKKio23: folds 
PolyMangasJK is disconnected 
PolyMangasJK has timed out while disconnected
PolyMangasJK: folds 
DannyO985: folds 
jackkk03: checks 
*** FLOP *** [6c 9c 7s]
jackkk03: checks 
caduceus369: bets €0.02
jackkk03: folds 
Uncalled bet (€0.02) returned to caduceus369
caduceus369 collected €0.05 from pot
caduceus369: doesn't show hand 
*** SUMMARY ***
Total pot €0.05 | Rake €0 
Board [6c 9c 7s]
Seat 1: PolyMangasJK (button) folded before Flop (didn't bet)
Seat 2: DannyO985 (small blind) folded before Flop
Seat 3: jackkk03 (big blind) folded on the Flop
Seat 4: stfuplzudonk folded before Flop (didn't bet)
Seat 5: caduceus369 collected (€0.05)
Seat 6: pistaKKio23 folded before Flop (didn't bet)



PokerStars Zoom Hand #257975837513:  Hold'em No Limit (€0.01/€0.02) [ADM ID: M62BA304494E32ST] - 2025/10/02 23:48:54 CET [2025/10/02 17:48:54 ET]
Table 'Sirio' 6-max Seat #1 is the button
Seat 1: stfuplzudonk (€4.89 in chips) 
Seat 2: Hermoso9619 (€1.26 in chips) 
Seat 3: mondie73100 (€2.40 in chips) 
Seat 4: cap e'bomb95 (€2.86 in chips) 
Seat 5: caduceus369 (€3.04 in chips) 
Seat 6: jackkk03 (€2.17 in chips) 
Hermoso9619: posts small blind €0.01
mondie73100: posts big blind €0.02
*** HOLE CARDS ***
Dealt to caduceus369 [4h 5d]
cap e'bomb95: folds 
caduceus369: folds 
jackkk03: folds 
stfuplzudonk: raises €0.02 to €0.04
Hermoso9619 has timed out while disconnected
Hermoso9619: folds 
mondie73100: folds 
Uncalled bet (€0.02) returned to stfuplzudonk
stfuplzudonk collected €0.05 from pot
stfuplzudonk: doesn't show hand 
*** SUMMARY ***
Total pot €0.05 | Rake €0 
Seat 1: stfuplzudonk (button) collected (€0.05)
Seat 2: Hermoso9619 (small blind) folded before Flop
Seat 3: mondie73100 (big blind) folded before Flop
Seat 4: cap e'bomb95 folded before Flop (didn't bet)
Seat 5: caduceus369 folded before Flop (didn't bet)
Seat 6: jackkk03 folded before Flop (didn't bet)



PokerStars Zoom Hand #257975840287:  Hold'em No Limit (€0.01/€0.02) [ADM ID: M62BA304494E32ST] - 2025/10/02 23:49:07 CET [2025/10/02 17:49:07 ET]
Table 'Sirio' 6-max Seat #1 is the button
Seat 1: mondie73100 (€2 in chips) 
Seat 2: ADRIAN0_MEIS (€4.37 in chips) 
Seat 3: caduceus369 (€3.03 in chips) 
Seat 4: rush572 (€0.55 in chips) 
Seat 5: robertoH2O (€2.26 in chips) 
Seat 6: Alex83l310 (€1.91 in chips) 
ADRIAN0_MEIS: posts small blind €0.01
caduceus369: posts big blind €0.02
*** HOLE CARDS ***
Dealt to caduceus369 [As 9s]
rush572: folds 
robertoH2O: folds 
Alex83l310: folds 
mondie73100: folds 
ADRIAN0_MEIS: folds 
Uncalled bet (€0.01) returned to caduceus369
caduceus369 collected €0.02 from pot
caduceus369: doesn't show hand 
*** SUMMARY ***
Total pot €0.02 | Rake €0 
Seat 1: mondie73100 (button) folded before Flop (didn't bet)
Seat 2: ADRIAN0_MEIS (small blind) folded before Flop
Seat 3: caduceus369 (big blind) collected (€0.02)
Seat 4: rush572 folded before Flop (didn't bet)
Seat 5: robertoH2O folded before Flop (didn't bet)
Seat 6: Alex83l310 folded before Flop (didn't bet)



PokerStars Zoom Hand #257975844355:  Hold'em No Limit (€0.01/€0.02) [ADM ID: M62BA304494E32ST] - 2025/10/02 23:49:25 CET [2025/10/02 17:49:25 ET]
Table 'Sirio' 6-max Seat #1 is the button
Seat 1: Alex83l310 (€1.90 in chips) 
Seat 2: lapo1987 (€2.45 in chips) 
Seat 3: Warterror90 (€2.69 in chips) 
Seat 4: cap e'bomb95 (€1.64 in chips) 
Seat 5: RRgalp (€8.82 in chips) 
Seat 6: caduceus369 (€3.04 in chips) 
lapo1987: posts small blind €0.01
Warterror90: posts big blind €0.02
*** HOLE CARDS ***
Dealt to caduceus369 [5d Kc]
cap e'bomb95: folds 
RRgalp: folds 
caduceus369: folds 
Alex83l310: folds 
lapo1987: raises €0.02 to €0.04
Warterror90: calls €0.02
*** FLOP *** [4s 8s 5s]
lapo1987: checks 
Warterror90: bets €0.04
lapo1987: folds 
Uncalled bet (€0.04) returned to Warterror90
Warterror90 collected €0.08 from pot
Warterror90: doesn't show hand 
*** SUMMARY ***
Total pot €0.08 | Rake €0 
Board [4s 8s 5s]
Seat 1: Alex83l310 (button) folded before Flop (didn't bet)
Seat 2: lapo1987 (small blind) folded on the Flop
Seat 3: Warterror90 (big blind) collected (€0.08)
Seat 4: cap e'bomb95 folded before Flop (didn't bet)
Seat 5: RRgalp folded before Flop (didn't bet)
Seat 6: caduceus369 folded before Flop (didn't bet)



PokerStars Zoom Hand #257975839148:  Hold'em No Limit (€0.01/€0.02) [ADM ID: M62BA304494E32ST] - 2025/10/02 23:49:02 CET [2025/10/02 17:49:02 ET]
Table 'Sirio' 6-max Seat #1 is the button
Seat 1: campiraudii (€5.43 in chips) 
Seat 2: caduceus369 (€3.04 in chips) 
Seat 3: AlfredP80 (€4.71 in chips) 
Seat 4: jackkk03 (€2.17 in chips) 
Seat 5: Buonosimafesson (€0.96 in chips) 
Seat 6: pistaKKio23 (€2.32 in chips) 
caduceus369: posts small blind €0.01
AlfredP80: posts big blind €0.02
*** HOLE CARDS ***
Dealt to caduceus369 [4s Ks]
jackkk03: raises €0.04 to €0.06
Buonosimafesson: calls €0.06
pistaKKio23: folds 
campiraudii: calls €0.06
caduceus369: folds 
AlfredP80: calls €0.04
*** FLOP *** [7c Ac 2h]
AlfredP80: checks 
jackkk03: bets €0.12
Buonosimafesson: folds 
campiraudii: folds 
AlfredP80: calls €0.12
*** TURN *** [7c Ac 2h] [8s]
AlfredP80: checks 
jackkk03: bets €0.14
AlfredP80: calls €0.14
*** RIVER *** [7c Ac 2h 8s] [Tc]
AlfredP80: checks 
jackkk03: bets €0.23
AlfredP80: folds 
Uncalled bet (€0.23) returned to jackkk03
jackkk03 collected €0.73 from pot
jackkk03: doesn't show hand 
*** SUMMARY ***
Total pot €0.77 | Rake €0.04 
Board [7c Ac 2h 8s Tc]
Seat 1: campiraudii (button) folded on the Flop
Seat 2: caduceus369 (small blind) folded before Flop
Seat 3: AlfredP80 (big blind) folded on the River
Seat 4: jackkk03 collected (€0.73)
Seat 5: Buonosimafesson folded on the Flop
Seat 6: pistaKKio23 folded before Flop (didn't bet)



PokerStars Zoom Hand #257975845430:  Hold'em No Limit (€0.01/€0.02) [ADM ID: M62BA304494E32ST] - 2025/10/02 23:49:30 CET [2025/10/02 17:49:30 ET]
Table 'Sirio' 6-max Seat #1 is the button
Seat 1: caduceus369 (€3.04 in chips) 
Seat 2: cap e'bomb95 (€2.84 in chips) 
Seat 3: Alex83l310 (€1.90 in chips) 
Seat 4: lapo1987 (€2.01 in chips) 
Seat 5: stfuplzudonk (€4.92 in chips) 
Seat 6: fantaasso (€1.71 in chips) 
cap e'bomb95: posts small blind €0.01
Alex83l310: posts big blind €0.02
*** HOLE CARDS ***
Dealt to caduceus369 [Jd Jc]
lapo1987: folds 
stfuplzudonk: raises €0.04 to €0.06
fantaasso: folds 
caduceus369: raises €0.18 to €0.24
cap e'bomb95: folds 
Alex83l310: folds 
stfuplzudonk: calls €0.18
*** FLOP *** [Ad 7d 8d]
stfuplzudonk: checks 
caduceus369: bets €0.16
stfuplzudonk: folds 
Uncalled bet (€0.16) returned to caduceus369
caduceus369 collected €0.49 from pot
caduceus369: doesn't show hand 
*** SUMMARY ***
Total pot €0.51 | Rake €0.02 
Board [Ad 7d 8d]
Seat 1: caduceus369 (button) collected (€0.49)
Seat 2: cap e'bomb95 (small blind) folded before Flop
Seat 3: Alex83l310 (big blind) folded before Flop
Seat 4: lapo1987 folded before Flop (didn't bet)
Seat 5: stfuplzudonk folded on the Flop
Seat 6: fantaasso folded before Flop (didn't bet)



PokerStars Zoom Hand #257975854891:  Hold'em No Limit (€0.01/€0.02) [ADM ID: M62BA304494E32ST] - 2025/10/02 23:50:13 CET [2025/10/02 17:50:13 ET]
Table 'Sirio' 6-max Seat #1 is the button
Seat 1: lapo1987 (€2.39 in chips) 
Seat 2: Reacherbetter (€1.68 in chips) 
Seat 3: stfuplzudonk (€4.68 in chips) 
Seat 4: caduceus369 (€3.29 in chips) 
Seat 5: robertoH2O (€2.23 in chips) 
Seat 6: ADRIAN0_MEIS (€4.39 in chips) 
Reacherbetter: posts small blind €0.01
stfuplzudonk: posts big blind €0.02
*** HOLE CARDS ***
Dealt to caduceus369 [Qc 9s]
caduceus369: folds 
robertoH2O: folds 
ADRIAN0_MEIS: folds 
lapo1987: folds 
Reacherbetter: calls €0.01
stfuplzudonk: checks 
*** FLOP *** [4c 6h 3d]
Reacherbetter: bets €0.02
stfuplzudonk: calls €0.02
*** TURN *** [4c 6h 3d] [5d]
Reacherbetter: bets €0.04
stfuplzudonk: calls €0.04
*** RIVER *** [4c 6h 3d 5d] [8h]
Reacherbetter: bets €0.04
stfuplzudonk: raises €0.08 to €0.12
Reacherbetter: calls €0.08
*** SHOW DOWN ***
stfuplzudonk: shows [7c 2c] (a straight, Four to Eight)
Reacherbetter: mucks hand 
stfuplzudonk collected €0.38 from pot
*** SUMMARY ***
Total pot €0.40 | Rake €0.02 
Board [4c 6h 3d 5d 8h]
Seat 1: lapo1987 (button) folded before Flop (didn't bet)
Seat 2: Reacherbetter (small blind) mucked [4d 5h]
Seat 3: stfuplzudonk (big blind) showed [7c 2c] and won (€0.38) with a straight, Four to Eight
Seat 4: caduceus369 folded before Flop (didn't bet)
Seat 5: robertoH2O folded before Flop (didn't bet)
Seat 6: ADRIAN0_MEIS folded before Flop (didn't bet)



PokerStars Zoom Hand #257975856836:  Hold'em No Limit (€0.01/€0.02) [ADM ID: M62BA304494E32ST] - 2025/10/02 23:50:22 CET [2025/10/02 17:50:22 ET]
Table 'Sirio' 6-max Seat #1 is the button
Seat 1: Robycastel89 (€2.02 in chips) 
Seat 2: Sium12302 (€2.16 in chips) 
Seat 3: mondie73100 (€2.43 in chips) 
Seat 4: cap e'bomb95 (€1.72 in chips) 
Seat 5: stfuplzudonk (€3.23 in chips) 
Seat 6: caduceus369 (€3.29 in chips) 
Sium12302: posts small blind €0.01
mondie73100: posts big blind €0.02
*** HOLE CARDS ***
Dealt to caduceus369 [3h Ks]
cap e'bomb95: folds 
stfuplzudonk: folds 
caduceus369: folds 
Robycastel89: calls €0.02
Sium12302: folds 
mondie73100: raises €0.07 to €0.09
Robycastel89: calls €0.07
*** FLOP *** [8s Ad 3d]
mondie73100: bets €0.13
Robycastel89: folds 
Uncalled bet (€0.13) returned to mondie73100
mondie73100 collected €0.18 from pot
mondie73100: doesn't show hand 
*** SUMMARY ***
Total pot €0.19 | Rake €0.01 
Board [8s Ad 3d]
Seat 1: Robycastel89 (button) folded on the Flop
Seat 2: Sium12302 (small blind) folded before Flop
Seat 3: mondie73100 (big blind) collected (€0.18)
Seat 4: cap e'bomb95 folded before Flop (didn't bet)
Seat 5: stfuplzudonk folded before Flop (didn't bet)
Seat 6: caduceus369 folded before Flop (didn't bet)



PokerStars Zoom Hand #257975865575:  Hold'em No Limit (€0.01/€0.02) [ADM ID: M62BA304494E32ST] - 2025/10/02 23:51:01 CET [2025/10/02 17:51:01 ET]
Table 'Sirio' 6-max Seat #1 is the button
Seat 1: caduceus369 (€3.26 in chips) 
Seat 2: cap e'bomb95 (€2.91 in chips) 
Seat 3: stfuplzudonk (€3.23 in chips) 
Seat 4: Auspice67 (€4.33 in chips) 
Seat 5: lapo1987 (€2.36 in chips) 
Seat 6: Sium12302 (€2.12 in chips) 
cap e'bomb95: posts small blind €0.01
stfuplzudonk: posts big blind €0.02
*** HOLE CARDS ***
Dealt to caduceus369 [2d Qc]
Auspice67: folds 
lapo1987: folds 
Sium12302: folds 
caduceus369: folds 
cap e'bomb95: folds 
Uncalled bet (€0.01) returned to stfuplzudonk
stfuplzudonk collected €0.02 from pot
stfuplzudonk: doesn't show hand 
*** SUMMARY ***
Total pot €0.02 | Rake €0 
Seat 1: caduceus369 (button) folded before Flop (didn't bet)
Seat 2: cap e'bomb95 (small blind) folded before Flop
Seat 3: stfuplzudonk (big blind) collected (€0.02)
Seat 4: Auspice67 folded before Flop (didn't bet)
Seat 5: lapo1987 folded before Flop (didn't bet)
Seat 6: Sium12302 folded before Flop (didn't bet)



PokerStars Zoom Hand #257975858422:  Hold'em No Limit (€0.01/€0.02) [ADM ID: M62BA304494E32ST] - 2025/10/02 23:50:29 CET [2025/10/02 17:50:29 ET]
Table 'Sirio' 6-max Seat #1 is the button
Seat 1: AlfredP80 (€4.41 in chips) 
Seat 2: caduceus369 (€3.29 in chips) 
Seat 3: muhozhuk788 (€0.91 in chips) 
Seat 4: ADRIAN0_MEIS (€4.39 in chips) 
Seat 5: stfuplzudonk (€3.23 in chips) 
Seat 6: lapo1987 (€2.39 in chips) 
caduceus369: posts small blind €0.01
muhozhuk788: posts big blind €0.02
*** HOLE CARDS ***
Dealt to caduceus369 [Qh 7h]
ADRIAN0_MEIS: raises €0.05 to €0.07
stfuplzudonk: folds 
lapo1987: folds 
AlfredP80: calls €0.07
caduceus369: folds 
muhozhuk788: folds 
*** FLOP *** [9s 5h 8s]
ADRIAN0_MEIS: bets €0.17
AlfredP80: calls €0.17
*** TURN *** [9s 5h 8s] [5s]
ADRIAN0_MEIS: bets €0.27
AlfredP80: calls €0.27
*** RIVER *** [9s 5h 8s 5s] [As]
ADRIAN0_MEIS: checks 
AlfredP80: checks 
*** SHOW DOWN ***
ADRIAN0_MEIS: shows [Jh Jd] (two pair, Jacks and Fives)
AlfredP80: shows [6s Js] (a flush, Ace high)
AlfredP80 collected €1 from pot
*** SUMMARY ***
Total pot €1.05 | Rake €0.05 
Board [9s 5h 8s 5s As]
Seat 1: AlfredP80 (button) showed [6s Js] and won (€1) with a flush, Ace high
Seat 2: caduceus369 (small blind) folded before Flop
Seat 3: muhozhuk788 (big blind) folded before Flop
Seat 4: ADRIAN0_MEIS showed [Jh Jd] and lost with two pair, Jacks and Fives
Seat 5: stfuplzudonk folded before Flop (didn't bet)
Seat 6: lapo1987 folded before Flop (didn't bet)



PokerStars Zoom Hand #257975855734:  Hold'em No Limit (€0.01/€0.02) [ADM ID: M62BA304494E32ST] - 2025/10/02 23:50:17 CET [2025/10/02 17:50:17 ET]
Table 'Sirio' 6-max Seat #1 is the button
Seat 1: fantaasso (€1.58 in chips) 
Seat 2: Oiad (€7.08 in chips) 
Seat 3: Buonosimafesson (€0.85 in chips) 
Seat 4: caduceus369 (€3.29 in chips) 
Seat 5: lapo1987 (€2.39 in chips) 
Seat 6: robertoH2O (€2.23 in chips) 
Oiad: posts small blind €0.01
Buonosimafesson: posts big blind €0.02
*** HOLE CARDS ***
Dealt to caduceus369 [5d Tc]
caduceus369: folds 
lapo1987: folds 
robertoH2O: raises €0.03 to €0.05
fantaasso: folds 
Oiad: calls €0.04
Buonosimafesson: calls €0.03
*** FLOP *** [Js Td Qs]
Oiad: checks 
Buonosimafesson: checks 
robertoH2O: checks 
*** TURN *** [Js Td Qs] [Qc]
Oiad: bets €0.05
Buonosimafesson: folds 
robertoH2O: folds 
Uncalled bet (€0.05) returned to Oiad
Oiad collected €0.15 from pot
Oiad: doesn't show hand 
*** SUMMARY ***
Total pot €0.15 | Rake €0 
Board [Js Td Qs Qc]
Seat 1: fantaasso (button) folded before Flop (didn't bet)
Seat 2: Oiad (small blind) collected (€0.15)
Seat 3: Buonosimafesson (big blind) folded on the Turn
Seat 4: caduceus369 folded before Flop (didn't bet)
Seat 5: lapo1987 folded before Flop (didn't bet)
Seat 6: robertoH2O folded on the Turn



PokerStars Zoom Hand #257975857531:  Hold'em No Limit (€0.01/€0.02) [ADM ID: M62BA304494E32ST] - 2025/10/02 23:50:25 CET [2025/10/02 17:50:25 ET]
Table 'Sirio' 6-max Seat #1 is the button
Seat 1: ADRIAN0_MEIS (€3.76 in chips) 
Seat 2: lapo1987 (€2 in chips) 
Seat 3: Oiad (€6.26 in chips) 
Seat 4: muhozhuk788 (€1.72 in chips) 
Seat 5: caduceus369 (€3.29 in chips) 
Seat 6: Sium12302 (€2.15 in chips) 
lapo1987: posts small blind €0.01
Oiad: posts big blind €0.02
*** HOLE CARDS ***
Dealt to caduceus369 [As 8d]
muhozhuk788: calls €0.02
caduceus369: folds 
Sium12302: folds 
ADRIAN0_MEIS: folds 
lapo1987: folds 
Oiad: checks 
*** FLOP *** [6s Th 2c]
Oiad: checks 
muhozhuk788: bets €0.02
Oiad: folds 
Uncalled bet (€0.02) returned to muhozhuk788
muhozhuk788 collected €0.05 from pot
muhozhuk788: doesn't show hand 
*** SUMMARY ***
Total pot €0.05 | Rake €0 
Board [6s Th 2c]
Seat 1: ADRIAN0_MEIS (button) folded before Flop (didn't bet)
Seat 2: lapo1987 (small blind) folded before Flop
Seat 3: Oiad (big blind) folded on the Flop
Seat 4: muhozhuk788 collected (€0.05)
Seat 5: caduceus369 folded before Flop (didn't bet)
Seat 6: Sium12302 folded before Flop (didn't bet)



PokerStars Zoom Hand #257975867821:  Hold'em No Limit (€0.01/€0.02) [ADM ID: M62BA304494E32ST] - 2025/10/02 23:51:12 CET [2025/10/02 17:51:12 ET]
Table 'Sirio' 6-max Seat #1 is the button
Seat 1: cap e'bomb95 (€2.90 in chips) 
Seat 2: RRgalp (€8.65 in chips) 
Seat 3: ADRIAN0_MEIS (€5.60 in chips) 
Seat 4: Sium12302 (€2.12 in chips) 
Seat 5: lapo1987 (€2.36 in chips) 
Seat 6: caduceus369 (€3.26 in chips) 
RRgalp: posts small blind €0.01
ADRIAN0_MEIS: posts big blind €0.02
*** HOLE CARDS ***
Dealt to caduceus369 [Ac 7d]
Sium12302: folds 
lapo1987: folds 
caduceus369: folds 
cap e'bomb95: folds 
RRgalp: folds 
Uncalled bet (€0.01) returned to ADRIAN0_MEIS
ADRIAN0_MEIS collected €0.02 from pot
ADRIAN0_MEIS: doesn't show hand 
*** SUMMARY ***
Total pot €0.02 | Rake €0 
Seat 1: cap e'bomb95 (button) folded before Flop (didn't bet)
Seat 2: RRgalp (small blind) folded before Flop
Seat 3: ADRIAN0_MEIS (big blind) collected (€0.02)
Seat 4: Sium12302 folded before Flop (didn't bet)
Seat 5: lapo1987 folded before Flop (didn't bet)
Seat 6: caduceus369 folded before Flop (didn't bet)



PokerStars Zoom Hand #257975862024:  Hold'em No Limit (€0.01/€0.02) [ADM ID: M62BA304494E32ST] - 2025/10/02 23:50:45 CET [2025/10/02 17:50:45 ET]
Table 'Sirio' 6-max Seat #1 is the button
Seat 1: montemeru (€1.79 in chips) 
Seat 2: cap e'bomb95 (€1.70 in chips) 
Seat 3: caduceus369 (€3.28 in chips) 
Seat 4: Sium12302 (€2.15 in chips) 
Seat 5: rush572 (€0.73 in chips) 
Seat 6: stfuplzudonk (€5.42 in chips) 
cap e'bomb95: posts small blind €0.01
caduceus369: posts big blind €0.02
*** HOLE CARDS ***
Dealt to caduceus369 [4c Tc]
Sium12302: folds 
rush572: calls €0.02
stfuplzudonk: calls €0.02
montemeru: raises €0.09 to €0.11
cap e'bomb95: folds 
caduceus369: folds 
rush572: folds 
stfuplzudonk: calls €0.09
*** FLOP *** [8s Jd Kc]
stfuplzudonk: checks 
montemeru: bets €0.13
stfuplzudonk: calls €0.13
*** TURN *** [8s Jd Kc] [Jc]
stfuplzudonk: checks 
montemeru: bets €0.26
stfuplzudonk: folds 
Uncalled bet (€0.26) returned to montemeru
montemeru collected €0.51 from pot
montemeru: doesn't show hand 
*** SUMMARY ***
Total pot €0.53 | Rake €0.02 
Board [8s Jd Kc Jc]
Seat 1: montemeru (button) collected (€0.51)
Seat 2: cap e'bomb95 (small blind) folded before Flop
Seat 3: caduceus369 (big blind) folded before Flop
Seat 4: Sium12302 folded before Flop (didn't bet)
Seat 5: rush572 folded before Flop
Seat 6: stfuplzudonk folded on the Turn



PokerStars Zoom Hand #257975866767:  Hold'em No Limit (€0.01/€0.02) [ADM ID: M62BA304494E32ST] - 2025/10/02 23:51:07 CET [2025/10/02 17:51:07 ET]
Table 'Sirio' 6-max Seat #1 is the button
Seat 1: rush572 (€0.71 in chips) 
Seat 2: mondie73100 (€2 in chips) 
Seat 3: Auspice67 (€4.33 in chips) 
Seat 4: caduceus369 (€3.26 in chips) 
Seat 5: Sium12302 (€2.12 in chips) 
Seat 6: lapo1987 (€2.36 in chips) 
mondie73100: posts small blind €0.01
Auspice67: posts big blind €0.02
*** HOLE CARDS ***
Dealt to caduceus369 [4d 6c]
caduceus369: folds 
Sium12302: folds 
lapo1987: folds 
rush572: folds 
mondie73100: folds 
Uncalled bet (€0.01) returned to Auspice67
Auspice67 collected €0.02 from pot
Auspice67: doesn't show hand 
*** SUMMARY ***
Total pot €0.02 | Rake €0 
Seat 1: rush572 (button) folded before Flop (didn't bet)
Seat 2: mondie73100 (small blind) folded before Flop
Seat 3: Auspice67 (big blind) collected (€0.02)
Seat 4: caduceus369 folded before Flop (didn't bet)
Seat 5: Sium12302 folded before Flop (didn't bet)
Seat 6: lapo1987 folded before Flop (didn't bet)



PokerStars Zoom Hand #257975870450:  Hold'em No Limit (€0.01/€0.02) [ADM ID: M62BA304494E32ST] - 2025/10/02 23:51:24 CET [2025/10/02 17:51:24 ET]
Table 'Sirio' 6-max Seat #1 is the button
Seat 1: MammAnnAILovey (€2.05 in chips) 
Seat 2: MacScrat (€5.51 in chips) 
Seat 3: caduceus369 (€3.26 in chips) 
Seat 4: robertoH2O (€2.18 in chips) 
Seat 5: ADRIAN0_MEIS (€3.75 in chips) 
Seat 6: lapo1987 (€2 in chips) 
MacScrat: posts small blind €0.01
caduceus369: posts big blind €0.02
*** HOLE CARDS ***
Dealt to caduceus369 [2h Qd]
robertoH2O: folds 
ADRIAN0_MEIS: raises €0.05 to €0.07
lapo1987: folds 
MammAnnAILovey: folds 
MacScrat: folds 
caduceus369: folds 
Uncalled bet (€0.05) returned to ADRIAN0_MEIS
ADRIAN0_MEIS collected €0.05 from pot
ADRIAN0_MEIS: doesn't show hand 
*** SUMMARY ***
Total pot €0.05 | Rake €0 
Seat 1: MammAnnAILovey (button) folded before Flop (didn't bet)
Seat 2: MacScrat (small blind) folded before Flop
Seat 3: caduceus369 (big blind) folded before Flop
Seat 4: robertoH2O folded before Flop (didn't bet)
Seat 5: ADRIAN0_MEIS collected (€0.05)
Seat 6: lapo1987 folded before Flop (didn't bet)



PokerStars Zoom Hand #257975869760:  Hold'em No Limit (€0.01/€0.02) [ADM ID: M62BA304494E32ST] - 2025/10/02 23:51:20 CET [2025/10/02 17:51:20 ET]
Table 'Sirio' 6-max Seat #1 is the button
Seat 1: Oiad (€7.18 in chips) 
Seat 2: campiraudii (€5.69 in chips) 
Seat 3: ADRIAN0_MEIS (€3.88 in chips) 
Seat 4: caduceus369 (€3.26 in chips) 
Seat 5: Alex83l310 (€1.55 in chips) 
Seat 6: muhozhuk788 (€1.75 in chips) 
campiraudii: posts small blind €0.01
ADRIAN0_MEIS: posts big blind €0.02
*** HOLE CARDS ***
Dealt to caduceus369 [4h Jc]
caduceus369: folds 
Alex83l310: folds 
muhozhuk788: folds 
Oiad: folds 
campiraudii: calls €0.01
ADRIAN0_MEIS: raises €0.04 to €0.06
campiraudii: calls €0.04
*** FLOP *** [7h Kc 3d]
campiraudii: checks 
ADRIAN0_MEIS: bets €0.07
campiraudii: calls €0.07
*** TURN *** [7h Kc 3d] [4d]
campiraudii: checks 
ADRIAN0_MEIS: checks 
*** RIVER *** [7h Kc 3d 4d] [5c]
campiraudii: bets €0.25
ADRIAN0_MEIS: raises €3.50 to €3.75 and is all-in
campiraudii: folds 
Uncalled bet (€3.50) returned to ADRIAN0_MEIS
ADRIAN0_MEIS collected €0.72 from pot
ADRIAN0_MEIS: doesn't show hand 
*** SUMMARY ***
Total pot €0.76 | Rake €0.04 
Board [7h Kc 3d 4d 5c]
Seat 1: Oiad (button) folded before Flop (didn't bet)
Seat 2: campiraudii (small blind) folded on the River
Seat 3: ADRIAN0_MEIS (big blind) collected (€0.72)
Seat 4: caduceus369 folded before Flop (didn't bet)
Seat 5: Alex83l310 folded before Flop (didn't bet)
Seat 6: muhozhuk788 folded before Flop (didn't bet)



PokerStars Zoom Hand #257975874189:  Hold'em No Limit (€0.01/€0.02) [ADM ID: M62BA304494E32ST] - 2025/10/02 23:51:41 CET [2025/10/02 17:51:41 ET]
Table 'Sirio' 6-max Seat #1 is the button
Seat 1: MacScrat (€2.42 in chips) 
Seat 2: caduceus369 (€3.24 in chips) 
Seat 3: Cinghi11 (€1.03 in chips) 
Seat 4: jackkk03 (€2.52 in chips) 
Seat 5: cap e'bomb95 (€4.48 in chips) 
Seat 6: Sium12302 (€2.12 in chips) 
caduceus369: posts small blind €0.01
Cinghi11: posts big blind €0.02
*** HOLE CARDS ***
Dealt to caduceus369 [4s Ac]
jackkk03: calls €0.02
cap e'bomb95: raises €0.03 to €0.05
Sium12302: folds 
MacScrat: folds 
caduceus369: folds 
Cinghi11: calls €0.03
jackkk03: calls €0.03
*** FLOP *** [8h Td 6h]
Cinghi11: checks 
jackkk03: checks 
cap e'bomb95: checks 
*** TURN *** [8h Td 6h] [2c]
Cinghi11: bets €0.08
jackkk03: folds 
cap e'bomb95: raises €0.21 to €0.29
Cinghi11: calls €0.21
*** RIVER *** [8h Td 6h 2c] [Th]
Cinghi11: bets €0.69 and is all-in
cap e'bomb95: calls €0.69
*** SHOW DOWN ***
Cinghi11: shows [9h Ah] (a flush, Ace high)
cap e'bomb95: shows [2s 2d] (a full house, Deuces full of Tens)
cap e'bomb95 collected €2.01 from pot
*** SUMMARY ***
Total pot €2.12 | Rake €0.11 
Board [8h Td 6h 2c Th]
Seat 1: MacScrat (button) folded before Flop (didn't bet)
Seat 2: caduceus369 (small blind) folded before Flop
Seat 3: Cinghi11 (big blind) showed [9h Ah] and lost with a flush, Ace high
Seat 4: jackkk03 folded on the Turn
Seat 5: cap e'bomb95 showed [2s 2d] and won (€2.01) with a full house, Deuces full of Tens
Seat 6: Sium12302 folded before Flop (didn't bet)



PokerStars Zoom Hand #257975875337:  Hold'em No Limit (€0.01/€0.02) [ADM ID: M62BA304494E32ST] - 2025/10/02 23:51:46 CET [2025/10/02 17:51:46 ET]
Table 'Sirio' 6-max Seat #1 is the button
Seat 1: caduceus369 (€3.23 in chips) 
Seat 2: robertoH2O (€2.16 in chips) 
Seat 3: MacScrat (€2.42 in chips) 
Seat 4: stfuplzudonk (€3.27 in chips) 
Seat 5: Sium12302 (€2.12 in chips) 
Seat 6: ADRIAN0_MEIS (€5.64 in chips) 
robertoH2O: posts small blind €0.01
MacScrat: posts big blind €0.02
*** HOLE CARDS ***
Dealt to caduceus369 [2h 2s]
stfuplzudonk: raises €0.04 to €0.06
Sium12302: folds 
ADRIAN0_MEIS: folds 
caduceus369: calls €0.06
robertoH2O: folds 
MacScrat: folds 
*** FLOP *** [9d 7h Kc]
stfuplzudonk: checks 
caduceus369: checks 
*** TURN *** [9d 7h Kc] [5h]
stfuplzudonk: bets €0.08
caduceus369: calls €0.08
*** RIVER *** [9d 7h Kc 5h] [8s]
stfuplzudonk: checks 
caduceus369: bets €0.10
stfuplzudonk: folds 
Uncalled bet (€0.10) returned to caduceus369
caduceus369 collected €0.30 from pot
caduceus369: doesn't show hand 
*** SUMMARY ***
Total pot €0.31 | Rake €0.01 
Board [9d 7h Kc 5h 8s]
Seat 1: caduceus369 (button) collected (€0.30)
Seat 2: robertoH2O (small blind) folded before Flop
Seat 3: MacScrat (big blind) folded before Flop
Seat 4: stfuplzudonk folded on the River
Seat 5: Sium12302 folded before Flop (didn't bet)
Seat 6: ADRIAN0_MEIS folded before Flop (didn't bet)



PokerStars Zoom Hand #257975887512:  Hold'em No Limit (€0.01/€0.02) [ADM ID: M62BA304494E32ST] - 2025/10/02 23:52:41 CET [2025/10/02 17:52:41 ET]
Table 'Sirio' 6-max Seat #1 is the button
Seat 1: MacScrat (€2.46 in chips) 
Seat 2: Oiad (€6.38 in chips) 
Seat 3: cap e'bomb95 (€5.46 in chips) 
Seat 4: Robycastel89 (€1.95 in chips) 
Seat 5: AlfredP80 (€4.52 in chips) 
Seat 6: caduceus369 (€3.39 in chips) 
Oiad: posts small blind €0.01
cap e'bomb95: posts big blind €0.02
*** HOLE CARDS ***
Dealt to caduceus369 [5d 7c]
Robycastel89: folds 
AlfredP80: folds 
caduceus369: folds 
MacScrat: folds 
Oiad: raises €0.04 to €0.06
cap e'bomb95: folds 
Uncalled bet (€0.04) returned to Oiad
Oiad collected €0.04 from pot
Oiad: doesn't show hand 
*** SUMMARY ***
Total pot €0.04 | Rake €0 
Seat 1: MacScrat (button) folded before Flop (didn't bet)
Seat 2: Oiad (small blind) collected (€0.04)
Seat 3: cap e'bomb95 (big blind) folded before Flop
Seat 4: Robycastel89 folded before Flop (didn't bet)
Seat 5: AlfredP80 folded before Flop (didn't bet)
Seat 6: caduceus369 folded before Flop (didn't bet)



PokerStars Zoom Hand #257975889454:  Hold'em No Limit (€0.01/€0.02) [ADM ID: M62BA304494E32ST] - 2025/10/02 23:52:50 CET [2025/10/02 17:52:50 ET]
Table 'Sirio' 6-max Seat #1 is the button
Seat 1: Robycastel89 (€1.95 in chips) 
Seat 2: caduceus369 (€3.39 in chips) 
Seat 3: Oiad (€6.41 in chips) 
Seat 4: rush572 (€0.74 in chips) 
Seat 5: lapo1987 (€2.04 in chips) 
Seat 6: AlfredP80 (€4.52 in chips) 
caduceus369: posts small blind €0.01
Oiad: posts big blind €0.02
*** HOLE CARDS ***
Dealt to caduceus369 [4h 7h]
rush572: folds 
lapo1987: folds 
AlfredP80: raises €0.04 to €0.06
Robycastel89: folds 
caduceus369: folds 
Oiad: folds 
Uncalled bet (€0.04) returned to AlfredP80
AlfredP80 collected €0.05 from pot
AlfredP80: doesn't show hand 
*** SUMMARY ***
Total pot €0.05 | Rake €0 
Seat 1: Robycastel89 (button) folded before Flop (didn't bet)
Seat 2: caduceus369 (small blind) folded before Flop
Seat 3: Oiad (big blind) folded before Flop
Seat 4: rush572 folded before Flop (didn't bet)
Seat 5: lapo1987 folded before Flop (didn't bet)
Seat 6: AlfredP80 collected (€0.05)



PokerStars Zoom Hand #257975888566:  Hold'em No Limit (€0.01/€0.02) [ADM ID: M62BA304494E32ST] - 2025/10/02 23:52:46 CET [2025/10/02 17:52:46 ET]
Table 'Sirio' 6-max Seat #1 is the button
Seat 1: AlfredP80 (€4.52 in chips) 
Seat 2: stfuplzudonk (€5.23 in chips) 
Seat 3: MacScrat (€2.46 in chips) 
Seat 4: ADRIAN0_MEIS (€5.61 in chips) 
Seat 5: caduceus369 (€3.39 in chips) 
Seat 6: lapo1987 (€2.04 in chips) 
stfuplzudonk: posts small blind €0.01
MacScrat: posts big blind €0.02
*** HOLE CARDS ***
Dealt to caduceus369 [5d 2s]
ADRIAN0_MEIS: folds 
caduceus369: folds 
lapo1987: folds 
AlfredP80: folds 
stfuplzudonk: calls €0.01
MacScrat: checks 
*** FLOP *** [4h Qc Ac]
stfuplzudonk: checks 
MacScrat: checks 
*** TURN *** [4h Qc Ac] [Ad]
stfuplzudonk: checks 
MacScrat: checks 
*** RIVER *** [4h Qc Ac Ad] [9h]
stfuplzudonk: checks 
MacScrat: checks 
*** SHOW DOWN ***
stfuplzudonk: shows [2h 3h] (a pair of Aces)
MacScrat: shows [7s Jc] (a pair of Aces - Queen+Jack kicker)
MacScrat collected €0.04 from pot
*** SUMMARY ***
Total pot €0.04 | Rake €0 
Board [4h Qc Ac Ad 9h]
Seat 1: AlfredP80 (button) folded before Flop (didn't bet)
Seat 2: stfuplzudonk (small blind) showed [2h 3h] and lost with a pair of Aces
Seat 3: MacScrat (big blind) showed [7s Jc] and won (€0.04) with a pair of Aces
Seat 4: ADRIAN0_MEIS folded before Flop (didn't bet)
Seat 5: caduceus369 folded before Flop (didn't bet)
Seat 6: lapo1987 folded before Flop (didn't bet)



PokerStars Zoom Hand #257975894281:  Hold'em No Limit (€0.01/€0.02) [ADM ID: M62BA304494E32ST] - 2025/10/02 23:53:12 CET [2025/10/02 17:53:12 ET]
Table 'Sirio' 6-max Seat #1 is the button
Seat 1: Warterror90 (€2.85 in chips) 
Seat 2: Alex83l310 (€1.93 in chips) 
Seat 3: bigfr4nk (€2 in chips) 
Seat 4: mondie73100 (€2.45 in chips) 
Seat 5: caduceus369 (€3.36 in chips) 
Seat 6: Sium12302 (€2.06 in chips) 
Alex83l310: posts small blind €0.01
bigfr4nk: posts big blind €0.02
*** HOLE CARDS ***
Dealt to caduceus369 [Kd 5h]
mondie73100: folds 
caduceus369: folds 
Sium12302: folds 
Warterror90: folds 
Alex83l310: folds 
Uncalled bet (€0.01) returned to bigfr4nk
bigfr4nk collected €0.02 from pot
bigfr4nk: doesn't show hand 
*** SUMMARY ***
Total pot €0.02 | Rake €0 
Seat 1: Warterror90 (button) folded before Flop (didn't bet)
Seat 2: Alex83l310 (small blind) folded before Flop
Seat 3: bigfr4nk (big blind) collected (€0.02)
Seat 4: mondie73100 folded before Flop (didn't bet)
Seat 5: caduceus369 folded before Flop (didn't bet)
Seat 6: Sium12302 folded before Flop (didn't bet)



PokerStars Zoom Hand #257975895126:  Hold'em No Limit (€0.01/€0.02) [ADM ID: M62BA304494E32ST] - 2025/10/02 23:53:16 CET [2025/10/02 17:53:16 ET]
Table 'Sirio' 6-max Seat #1 is the button
Seat 1: caduceus369 (€3.36 in chips) 
Seat 2: Warterror90 (€2.85 in chips) 
Seat 3: ADRIAN0_MEIS (€4.11 in chips) 
Seat 4: rush572 (€0.74 in chips) 
Seat 5: muhozhuk788 (€1.23 in chips) 
Seat 6: Auspice67 (€4.41 in chips) 
Warterror90: posts small blind €0.01
ADRIAN0_MEIS: posts big blind €0.02
*** HOLE CARDS ***
Dealt to caduceus369 [4d 8h]
rush572: folds 
muhozhuk788: raises €0.02 to €0.04
Auspice67: folds 
caduceus369: folds 
Warterror90: folds 
ADRIAN0_MEIS: folds 
Uncalled bet (€0.02) returned to muhozhuk788
muhozhuk788 collected €0.05 from pot
muhozhuk788: doesn't show hand 
*** SUMMARY ***
Total pot €0.05 | Rake €0 
Seat 1: caduceus369 (button) folded before Flop (didn't bet)
Seat 2: Warterror90 (small blind) folded before Flop
Seat 3: ADRIAN0_MEIS (big blind) folded before Flop
Seat 4: rush572 folded before Flop (didn't bet)
Seat 5: muhozhuk788 collected (€0.05)
Seat 6: Auspice67 folded before Flop (didn't bet)



PokerStars Zoom Hand #257975891462:  Hold'em No Limit (€0.01/€0.02) [ADM ID: M62BA304494E32ST] - 2025/10/02 23:52:59 CET [2025/10/02 17:52:59 ET]
Table 'Sirio' 6-max Seat #1 is the button
Seat 1: cap e'bomb95 (€2.82 in chips) 
Seat 2: muhozhuk788 (€1.24 in chips) 
Seat 3: caduceus369 (€3.38 in chips) 
Seat 4: fantaasso (€1.49 in chips) 
Seat 5: stfuplzudonk (€4.75 in chips) 
Seat 6: MammAnnAILovey (€2.59 in chips) 
muhozhuk788: posts small blind €0.01
caduceus369: posts big blind €0.02
*** HOLE CARDS ***
Dealt to caduceus369 [8d 7s]
fantaasso: folds 
stfuplzudonk: raises €0.02 to €0.04
MammAnnAILovey: raises €0.10 to €0.14
cap e'bomb95: calls €0.14
muhozhuk788: folds 
caduceus369: folds 
stfuplzudonk: calls €0.10
*** FLOP *** [7h 2h 3d]
stfuplzudonk: checks 
MammAnnAILovey: bets €0.26
cap e'bomb95: calls €0.26
stfuplzudonk: folds 
*** TURN *** [7h 2h 3d] [Jd]
MammAnnAILovey: bets €0.65
cap e'bomb95: folds 
Uncalled bet (€0.65) returned to MammAnnAILovey
MammAnnAILovey collected €0.92 from pot
MammAnnAILovey: doesn't show hand 
*** SUMMARY ***
Total pot €0.97 | Rake €0.05 
Board [7h 2h 3d Jd]
Seat 1: cap e'bomb95 (button) folded on the Turn
Seat 2: muhozhuk788 (small blind) folded before Flop
Seat 3: caduceus369 (big blind) folded before Flop
Seat 4: fantaasso folded before Flop (didn't bet)
Seat 5: stfuplzudonk folded on the Flop
Seat 6: MammAnnAILovey collected (€0.92)



PokerStars Zoom Hand #257975898142:  Hold'em No Limit (€0.01/€0.02) [ADM ID: M62BA304494E32ST] - 2025/10/02 23:53:29 CET [2025/10/02 17:53:29 ET]
Table 'Sirio' 6-max Seat #1 is the button
Seat 1: RRgalp (€8.89 in chips) 
Seat 2: MacScrat (€2.48 in chips) 
Seat 3: fantaasso (€1.49 in chips) 
Seat 4: caduceus369 (€3.36 in chips) 
Seat 5: Warterror90 (€2.84 in chips) 
Seat 6: lapo1987 (€2.01 in chips) 
MacScrat: posts small blind €0.01
fantaasso: posts big blind €0.02
*** HOLE CARDS ***
Dealt to caduceus369 [Jd Qh]
caduceus369: calls €0.02
Warterror90: folds 
lapo1987: folds 
RRgalp: folds 
MacScrat: folds 
fantaasso: checks 
*** FLOP *** [Ks Qc Ac]
fantaasso: checks 
caduceus369: bets €0.02
fantaasso: folds 
Uncalled bet (€0.02) returned to caduceus369
caduceus369 collected €0.05 from pot
caduceus369: doesn't show hand 
*** SUMMARY ***
Total pot €0.05 | Rake €0 
Board [Ks Qc Ac]
Seat 1: RRgalp (button) folded before Flop (didn't bet)
Seat 2: MacScrat (small blind) folded before Flop
Seat 3: fantaasso (big blind) folded on the Flop
Seat 4: caduceus369 collected (€0.05)
Seat 5: Warterror90 folded before Flop (didn't bet)
Seat 6: lapo1987 folded before Flop (didn't bet)



PokerStars Zoom Hand #257975903170:  Hold'em No Limit (€0.01/€0.02) [ADM ID: M62BA304494E32ST] - 2025/10/02 23:53:53 CET [2025/10/02 17:53:53 ET]
Table 'Sirio' 6-max Seat #1 is the button
Seat 1: mondie73100 (€2.43 in chips) 
Seat 2: Alex83l310 (€1.93 in chips) 
Seat 3: cap e'bomb95 (€1.93 in chips) 
Seat 4: stfuplzudonk (€4.61 in chips) 
Seat 5: caduceus369 (€3.39 in chips) 
Seat 6: fantaasso (€1.56 in chips) 
Alex83l310: posts small blind €0.01
cap e'bomb95: posts big blind €0.02
*** HOLE CARDS ***
Dealt to caduceus369 [Th 4s]
stfuplzudonk: folds 
caduceus369: folds 
fantaasso: folds 
mondie73100: folds 
Alex83l310: folds 
Uncalled bet (€0.01) returned to cap e'bomb95
cap e'bomb95 collected €0.02 from pot
cap e'bomb95: doesn't show hand 
*** SUMMARY ***
Total pot €0.02 | Rake €0 
Seat 1: mondie73100 (button) folded before Flop (didn't bet)
Seat 2: Alex83l310 (small blind) folded before Flop
Seat 3: cap e'bomb95 (big blind) collected (€0.02)
Seat 4: stfuplzudonk folded before Flop (didn't bet)
Seat 5: caduceus369 folded before Flop (didn't bet)
Seat 6: fantaasso folded before Flop (didn't bet)



PokerStars Zoom Hand #257975903722:  Hold'em No Limit (€0.01/€0.02) [ADM ID: M62BA304494E32ST] - 2025/10/02 23:53:55 CET [2025/10/02 17:53:55 ET]
Table 'Sirio' 6-max Seat #1 is the button
Seat 1: bigfr4nk (€1.99 in chips) 
Seat 2: ADRIAN0_MEIS (€4.09 in chips) 
Seat 3: Fengjie82 (€1.50 in chips) 
Seat 4: MammAnnAILovey (€3.11 in chips) 
Seat 5: MacScrat (€2.50 in chips) 
Seat 6: caduceus369 (€3.39 in chips) 
ADRIAN0_MEIS: posts small blind €0.01
Fengjie82: posts big blind €0.02
*** HOLE CARDS ***
Dealt to caduceus369 [7h Ah]
MammAnnAILovey: folds 
MacScrat: folds 
caduceus369: raises €0.02 to €0.04
bigfr4nk: raises €0.06 to €0.10
ADRIAN0_MEIS: folds 
Fengjie82: folds 
caduceus369: calls €0.06
*** FLOP *** [As 4h 7d]
caduceus369: checks 
bigfr4nk: bets €0.13
caduceus369: calls €0.13
*** TURN *** [As 4h 7d] [9c]
caduceus369: checks 
bigfr4nk: bets €0.20
caduceus369: calls €0.20
*** RIVER *** [As 4h 7d 9c] [9d]
caduceus369: bets €0.18
bigfr4nk: raises €0.61 to €0.79
caduceus369: folds 
Uncalled bet (€0.61) returned to bigfr4nk
bigfr4nk collected €1.19 from pot
bigfr4nk: doesn't show hand 
*** SUMMARY ***
Total pot €1.25 | Rake €0.06 
Board [As 4h 7d 9c 9d]
Seat 1: bigfr4nk (button) collected (€1.19)
Seat 2: ADRIAN0_MEIS (small blind) folded before Flop
Seat 3: Fengjie82 (big blind) folded before Flop
Seat 4: MammAnnAILovey folded before Flop (didn't bet)
Seat 5: MacScrat folded before Flop (didn't bet)
Seat 6: caduceus369 folded on the River



PokerStars Zoom Hand #257975919223:  Hold'em No Limit (€0.01/€0.02) [ADM ID: M62BA304494E32ST] - 2025/10/02 23:55:07 CET [2025/10/02 17:55:07 ET]
Table 'Sirio' 6-max Seat #1 is the button
Seat 1: Sium12302 (€2.04 in chips) 
Seat 2: Warterror90 (€2.78 in chips) 
Seat 3: caduceus369 (€2.78 in chips) 
Seat 4: cap e'bomb95 (€2.41 in chips) 
Seat 5: Anna2141 (€0.86 in chips) 
Seat 6: jackkk03 (€2.82 in chips) 
Warterror90: posts small blind €0.01
caduceus369: posts big blind €0.02
*** HOLE CARDS ***
Dealt to caduceus369 [Th 7c]
cap e'bomb95: folds 
Anna2141: folds 
jackkk03: raises €0.02 to €0.04
Sium12302: folds 
Warterror90: raises €0.08 to €0.12
caduceus369: folds 
jackkk03: folds 
Uncalled bet (€0.08) returned to Warterror90
Warterror90 collected €0.10 from pot
Warterror90: doesn't show hand 
*** SUMMARY ***
Total pot €0.10 | Rake €0 
Seat 1: Sium12302 (button) folded before Flop (didn't bet)
Seat 2: Warterror90 (small blind) collected (€0.10)
Seat 3: caduceus369 (big blind) folded before Flop
Seat 4: cap e'bomb95 folded before Flop (didn't bet)
Seat 5: Anna2141 folded before Flop (didn't bet)
Seat 6: jackkk03 folded before Flop



PokerStars Zoom Hand #257975922266:  Hold'em No Limit (€0.01/€0.02) [ADM ID: M62BA304494E32ST] - 2025/10/02 23:55:24 CET [2025/10/02 17:55:24 ET]
Table 'Sirio' 6-max Seat #1 is the button
Seat 1: caduceus369 (€2.75 in chips) 
Seat 2: fantaasso (€1.40 in chips) 
Seat 3: Robycastel89 (€2.04 in chips) 
Seat 4: Reacherbetter (€1.55 in chips) 
Seat 5: Sium12302 (€2.03 in chips) 
Seat 6: jackkk03 (€2.78 in chips) 
fantaasso: posts small blind €0.01
Robycastel89: posts big blind €0.02
*** HOLE CARDS ***
Dealt to caduceus369 [3s Qd]
Reacherbetter: folds 
Sium12302: folds 
jackkk03: raises €0.04 to €0.06
caduceus369: folds 
fantaasso: folds 
Robycastel89: folds 
Uncalled bet (€0.04) returned to jackkk03
jackkk03 collected €0.05 from pot
jackkk03: doesn't show hand 
*** SUMMARY ***
Total pot €0.05 | Rake €0 
Seat 1: caduceus369 (button) folded before Flop (didn't bet)
Seat 2: fantaasso (small blind) folded before Flop
Seat 3: Robycastel89 (big blind) folded before Flop
Seat 4: Reacherbetter folded before Flop (didn't bet)
Seat 5: Sium12302 folded before Flop (didn't bet)
Seat 6: jackkk03 collected (€0.05)



PokerStars Zoom Hand #257975924184:  Hold'em No Limit (€0.01/€0.02) [ADM ID: M62BA304494E32ST] - 2025/10/02 23:55:37 CET [2025/10/02 17:55:37 ET]
Table 'Sirio' 6-max Seat #1 is the button
Seat 1: mondie73100 (€2.03 in chips) 
Seat 2: MacScrat (€2.48 in chips) 
Seat 3: fantaasso (€1.46 in chips) 
Seat 4: RRgalp (€8.83 in chips) 
Seat 5: cap e'bomb95 (€2.38 in chips) 
Seat 6: caduceus369 (€2.75 in chips) 
MacScrat: posts small blind €0.01
fantaasso: posts big blind €0.02
*** HOLE CARDS ***
Dealt to caduceus369 [Ks 8c]
RRgalp: folds 
cap e'bomb95: folds 
caduceus369: folds 
mondie73100: folds 
MacScrat: folds 
Uncalled bet (€0.01) returned to fantaasso
fantaasso collected €0.02 from pot
fantaasso: doesn't show hand 
*** SUMMARY ***
Total pot €0.02 | Rake €0 
Seat 1: mondie73100 (button) folded before Flop (didn't bet)
Seat 2: MacScrat (small blind) folded before Flop
Seat 3: fantaasso (big blind) collected (€0.02)
Seat 4: RRgalp folded before Flop (didn't bet)
Seat 5: cap e'bomb95 folded before Flop (didn't bet)
Seat 6: caduceus369 folded before Flop (didn't bet)



PokerStars Zoom Hand #257975921761:  Hold'em No Limit (€0.01/€0.02) [ADM ID: M62BA304494E32ST] - 2025/10/02 23:55:21 CET [2025/10/02 17:55:21 ET]
Table 'Sirio' 6-max Seat #1 is the button
Seat 1: cap e'bomb95 (€1.90 in chips) 
Seat 2: caduceus369 (€2.76 in chips) 
Seat 3: Oiad (€6.54 in chips) 
Seat 4: ADRIAN0_MEIS (€5.54 in chips) 
Seat 5: bigfr4nk (€2.57 in chips) 
Seat 6: Anna2141 (€0.85 in chips) 
caduceus369: posts small blind €0.01
Oiad: posts big blind €0.02
*** HOLE CARDS ***
Dealt to caduceus369 [3h 9d]
ADRIAN0_MEIS: raises €0.05 to €0.07
bigfr4nk: folds 
Anna2141: calls €0.07
cap e'bomb95: folds 
caduceus369: folds 
Oiad: folds 
*** FLOP *** [6d Ac 4s]
ADRIAN0_MEIS: bets €0.17
Anna2141: calls €0.17
*** TURN *** [6d Ac 4s] [2h]
ADRIAN0_MEIS: bets €0.37
Anna2141: calls €0.37
*** RIVER *** [6d Ac 4s 2h] [Qh]
ADRIAN0_MEIS: bets €1.19
Anna2141: calls €0.24 and is all-in
Uncalled bet (€0.95) returned to ADRIAN0_MEIS
*** SHOW DOWN ***
ADRIAN0_MEIS: shows [Kh Ah] (a pair of Aces)
Anna2141: shows [Td Kd] (high card Ace)
ADRIAN0_MEIS collected €1.64 from pot
*** SUMMARY ***
Total pot €1.73 | Rake €0.09 
Board [6d Ac 4s 2h Qh]
Seat 1: cap e'bomb95 (button) folded before Flop (didn't bet)
Seat 2: caduceus369 (small blind) folded before Flop
Seat 3: Oiad (big blind) folded before Flop
Seat 4: ADRIAN0_MEIS showed [Kh Ah] and won (€1.64) with a pair of Aces
Seat 5: bigfr4nk folded before Flop (didn't bet)
Seat 6: Anna2141 showed [Td Kd] and lost with high card Ace



PokerStars Zoom Hand #257975923645:  Hold'em No Limit (€0.01/€0.02) [ADM ID: M62BA304494E32ST] - 2025/10/02 23:55:33 CET [2025/10/02 17:55:33 ET]
Table 'Sirio' 6-max Seat #1 is the button
Seat 1: MacScrat (€2.48 in chips) 
Seat 2: bigfr4nk (€2.57 in chips) 
Seat 3: rush572 (€0.81 in chips) 
Seat 4: caduceus369 (€2.75 in chips) 
Seat 5: fantaasso (€1.46 in chips) 
Seat 6: MammAnnAILovey (€3.25 in chips) 
bigfr4nk: posts small blind €0.01
rush572: posts big blind €0.02
*** HOLE CARDS ***
Dealt to caduceus369 [2s 5d]
caduceus369: folds 
fantaasso: folds 
MammAnnAILovey: raises €0.03 to €0.05
MacScrat: folds 
bigfr4nk: calls €0.04
rush572: calls €0.03
*** FLOP *** [Ts 4h 6d]
bigfr4nk: checks 
rush572: checks 
MammAnnAILovey: checks 
*** TURN *** [Ts 4h 6d] [9c]
bigfr4nk: checks 
rush572: checks 
MammAnnAILovey: bets €0.08
bigfr4nk: calls €0.08
rush572: folds 
*** RIVER *** [Ts 4h 6d 9c] [Qs]
bigfr4nk: checks 
MammAnnAILovey: bets €0.23
bigfr4nk: folds 
Uncalled bet (€0.23) returned to MammAnnAILovey
MammAnnAILovey collected €0.30 from pot
MammAnnAILovey: doesn't show hand 
*** SUMMARY ***
Total pot €0.31 | Rake €0.01 
Board [Ts 4h 6d 9c Qs]
Seat 1: MacScrat (button) folded before Flop (didn't bet)
Seat 2: bigfr4nk (small blind) folded on the River
Seat 3: rush572 (big blind) folded on the Turn
Seat 4: caduceus369 folded before Flop (didn't bet)
Seat 5: fantaasso folded before Flop (didn't bet)
Seat 6: MammAnnAILovey collected (€0.30)



PokerStars Zoom Hand #257975924570:  Hold'em No Limit (€0.01/€0.02) [ADM ID: M62BA304494E32ST] - 2025/10/02 23:55:39 CET [2025/10/02 17:55:39 ET]
Table 'Sirio' 6-max Seat #1 is the button
Seat 1: Buonosimafesson (€0.66 in chips) 
Seat 2: Auspice67 (€4.50 in chips) 
Seat 3: caduceus369 (€2.75 in chips) 
Seat 4: MacScrat (€2.47 in chips) 
Seat 5: campiraudii (€5.93 in chips) 
Seat 6: Fromparis1987 (€1.38 in chips) 
Auspice67: posts small blind €0.01
caduceus369: posts big blind €0.02
*** HOLE CARDS ***
Dealt to caduceus369 [2s 9s]
MacScrat: folds 
campiraudii: calls €0.02
Fromparis1987: calls €0.02
Buonosimafesson: calls €0.02
Auspice67: folds 
caduceus369: checks 
*** FLOP *** [7c Td 2c]
caduceus369: checks 
campiraudii: bets €0.02
Fromparis1987: calls €0.02
Buonosimafesson: folds 
caduceus369: folds 
*** TURN *** [7c Td 2c] [Ac]
campiraudii: bets €0.13
Fromparis1987: calls €0.13
*** RIVER *** [7c Td 2c Ac] [6s]
campiraudii: bets €0.19
Fromparis1987: raises €1.02 to €1.21 and is all-in
campiraudii: folds 
Uncalled bet (€1.02) returned to Fromparis1987
Fromparis1987 collected €0.73 from pot
Fromparis1987: doesn't show hand 
*** SUMMARY ***
Total pot €0.77 | Rake €0.04 
Board [7c Td 2c Ac 6s]
Seat 1: Buonosimafesson (button) folded on the Flop
Seat 2: Auspice67 (small blind) folded before Flop
Seat 3: caduceus369 (big blind) folded on the Flop
Seat 4: MacScrat folded before Flop (didn't bet)
Seat 5: campiraudii folded on the River
Seat 6: Fromparis1987 collected (€0.73)



PokerStars Zoom Hand #257975928477:  Hold'em No Limit (€0.01/€0.02) [ADM ID: M62BA304494E32ST] - 2025/10/02 23:56:05 CET [2025/10/02 17:56:05 ET]
Table 'Sirio' 6-max Seat #1 is the button
Seat 1: fantaasso (€1.43 in chips) 
Seat 2: Oiad (€7.34 in chips) 
Seat 3: Fengjie82 (€1.44 in chips) 
Seat 4: Alex83l310 (€2 in chips) 
Seat 5: mondie73100 (€2 in chips) 
Seat 6: caduceus369 (€2.73 in chips) 
Oiad: posts small blind €0.01
Fengjie82: posts big blind €0.02
*** HOLE CARDS ***
Dealt to caduceus369 [Qc Qh]
Alex83l310: folds 
mondie73100: folds 
caduceus369: raises €0.02 to €0.04
fantaasso: folds 
Oiad: folds 
Fengjie82: calls €0.02
*** FLOP *** [Ad 7c 4s]
Fengjie82: checks 
caduceus369: bets €0.04
Fengjie82: calls €0.04
*** TURN *** [Ad 7c 4s] [9h]
Fengjie82: checks 
caduceus369: checks 
*** RIVER *** [Ad 7c 4s 9h] [3d]
Fengjie82: bets €0.06
caduceus369: calls €0.06
*** SHOW DOWN ***
Fengjie82: shows [Ah 6c] (a pair of Aces)
caduceus369: mucks hand 
Fengjie82 collected €0.28 from pot
*** SUMMARY ***
Total pot €0.29 | Rake €0.01 
Board [Ad 7c 4s 9h 3d]
Seat 1: fantaasso (button) folded before Flop (didn't bet)
Seat 2: Oiad (small blind) folded before Flop
Seat 3: Fengjie82 (big blind) showed [Ah 6c] and won (€0.28) with a pair of Aces
Seat 4: Alex83l310 folded before Flop (didn't bet)
Seat 5: mondie73100 folded before Flop (didn't bet)
Seat 6: caduceus369 mucked [Qc Qh]



PokerStars Zoom Hand #257975936937:  Hold'em No Limit (€0.01/€0.02) [ADM ID: M62BA304494E32ST] - 2025/10/02 23:57:00 CET [2025/10/02 17:57:00 ET]
Table 'Sirio' 6-max Seat #1 is the button
Seat 1: heitel (€2.01 in chips) 
Seat 2: caduceus369 (€2.59 in chips) 
Seat 3: cap e'bomb95 (€6.60 in chips) 
Seat 4: Warterror90 (€2.90 in chips) 
Seat 5: MacScrat (€5.45 in chips) 
Seat 6: Fengjie82 (€1.58 in chips) 
caduceus369: posts small blind €0.01
cap e'bomb95: posts big blind €0.02
*** HOLE CARDS ***
Dealt to caduceus369 [7s 9d]
Warterror90: folds 
MacScrat: raises €0.04 to €0.06
Fengjie82: folds 
heitel: folds 
caduceus369: folds 
cap e'bomb95: folds 
Uncalled bet (€0.04) returned to MacScrat
MacScrat collected €0.05 from pot
MacScrat: doesn't show hand 
*** SUMMARY ***
Total pot €0.05 | Rake €0 
Seat 1: heitel (button) folded before Flop (didn't bet)
Seat 2: caduceus369 (small blind) folded before Flop
Seat 3: cap e'bomb95 (big blind) folded before Flop
Seat 4: Warterror90 folded before Flop (didn't bet)
Seat 5: MacScrat collected (€0.05)
Seat 6: Fengjie82 folded before Flop (didn't bet)



PokerStars Zoom Hand #257975938299:  Hold'em No Limit (€0.01/€0.02) [ADM ID: M62BA304494E32ST] - 2025/10/02 23:57:09 CET [2025/10/02 17:57:09 ET]
Table 'Sirio' 6-max Seat #1 is the button
Seat 1: caduceus369 (€2.58 in chips) 
Seat 2: Fengjie82 (€1.58 in chips) 
Seat 3: rush572 (€1.50 in chips) 
Seat 4: heitel (€2.01 in chips) 
Seat 5: ADRIAN0_MEIS (€3.16 in chips) 
Seat 6: cap e'bomb95 (€6.58 in chips) 
Fengjie82: posts small blind €0.01
rush572: posts big blind €0.02
*** HOLE CARDS ***
Dealt to caduceus369 [4d Jc]
heitel: folds 
ADRIAN0_MEIS: folds 
cap e'bomb95: folds 
caduceus369: folds 
Fengjie82: raises €0.04 to €0.06
rush572: calls €0.04
*** FLOP *** [6d 7h Qh]
Fengjie82: bets €0.06
rush572: folds 
Uncalled bet (€0.06) returned to Fengjie82
Fengjie82 collected €0.12 from pot
Fengjie82: doesn't show hand 
*** SUMMARY ***
Total pot €0.12 | Rake €0 
Board [6d 7h Qh]
Seat 1: caduceus369 (button) folded before Flop (didn't bet)
Seat 2: Fengjie82 (small blind) collected (€0.12)
Seat 3: rush572 (big blind) folded on the Flop
Seat 4: heitel folded before Flop (didn't bet)
Seat 5: ADRIAN0_MEIS folded before Flop (didn't bet)
Seat 6: cap e'bomb95 folded before Flop (didn't bet)



PokerStars Zoom Hand #257975939705:  Hold'em No Limit (€0.01/€0.02) [ADM ID: M62BA304494E32ST] - 2025/10/02 23:57:18 CET [2025/10/02 17:57:18 ET]
Table 'Sirio' 6-max Seat #1 is the button
Seat 1: RRgalp (€9.03 in chips) 
Seat 2: ADRIAN0_MEIS (€3.67 in chips) 
Seat 3: MacScrat (€5.48 in chips) 
Seat 4: heitel (€2.01 in chips) 
Seat 5: caduceus369 (€2.58 in chips) 
Seat 6: cap e'bomb95 (€6.58 in chips) 
ADRIAN0_MEIS: posts small blind €0.01
MacScrat: posts big blind €0.02
*** HOLE CARDS ***
Dealt to caduceus369 [Ts As]
heitel: folds 
caduceus369: raises €0.02 to €0.04
cap e'bomb95: calls €0.04
RRgalp: folds 
ADRIAN0_MEIS: folds 
MacScrat: calls €0.02
*** FLOP *** [5s 9d 8d]
MacScrat: checks 
caduceus369: bets €0.02
cap e'bomb95: folds 
MacScrat: folds 
Uncalled bet (€0.02) returned to caduceus369
caduceus369 collected €0.13 from pot
caduceus369: doesn't show hand 
*** SUMMARY ***
Total pot €0.13 | Rake €0 
Board [5s 9d 8d]
Seat 1: RRgalp (button) folded before Flop (didn't bet)
Seat 2: ADRIAN0_MEIS (small blind) folded before Flop
Seat 3: MacScrat (big blind) folded on the Flop
Seat 4: heitel folded before Flop (didn't bet)
Seat 5: caduceus369 collected (€0.13)
Seat 6: cap e'bomb95 folded on the Flop



PokerStars Zoom Hand #257975947366:  Hold'em No Limit (€0.01/€0.02) [ADM ID: M62BA304494E32ST] - 2025/10/02 23:58:06 CET [2025/10/02 17:58:06 ET]
Table 'Sirio' 6-max Seat #1 is the button
Seat 1: fantaasso (€0.57 in chips) 
Seat 2: caduceus369 (€2.67 in chips) 
Seat 3: RRgalp (€8.90 in chips) 
Seat 4: mondie73100 (€2 in chips) 
Seat 5: MacScrat (€2.27 in chips) 
Seat 6: MammAnnAILovey (€3.53 in chips) 
caduceus369: posts small blind €0.01
RRgalp: posts big blind €0.02
*** HOLE CARDS ***
Dealt to caduceus369 [4d 5d]
mondie73100: raises €0.02 to €0.04
MacScrat: folds 
MammAnnAILovey: folds 
fantaasso: folds 
caduceus369: folds 
RRgalp: raises €0.08 to €0.12
mondie73100: calls €0.08
*** FLOP *** [9h Js 7s]
RRgalp: bets €0.24
mondie73100: folds 
Uncalled bet (€0.24) returned to RRgalp
RRgalp collected €0.24 from pot
RRgalp: doesn't show hand 
*** SUMMARY ***
Total pot €0.25 | Rake €0.01 
Board [9h Js 7s]
Seat 1: fantaasso (button) folded before Flop (didn't bet)
Seat 2: caduceus369 (small blind) folded before Flop
Seat 3: RRgalp (big blind) collected (€0.24)
Seat 4: mondie73100 folded on the Flop
Seat 5: MacScrat folded before Flop (didn't bet)
Seat 6: MammAnnAILovey folded before Flop (didn't bet)



PokerStars Zoom Hand #257975946698:  Hold'em No Limit (€0.01/€0.02) [ADM ID: M62BA304494E32ST] - 2025/10/02 23:58:02 CET [2025/10/02 17:58:02 ET]
Table 'Sirio' 6-max Seat #1 is the button
Seat 1: lapo1987 (€2 in chips) 
Seat 2: Fromparis1987 (€1.63 in chips) 
Seat 3: ADRIAN0_MEIS (€3.16 in chips) 
Seat 4: caduceus369 (€2.67 in chips) 
Seat 5: fantaasso (€1.43 in chips) 
Seat 6: Reacherbetter (€1.42 in chips) 
Fromparis1987: posts small blind €0.01
ADRIAN0_MEIS: posts big blind €0.02
*** HOLE CARDS ***
Dealt to caduceus369 [Td Qh]
caduceus369: folds 
fantaasso: folds 
Reacherbetter: folds 
lapo1987: raises €0.02 to €0.04
Fromparis1987: calls €0.03
ADRIAN0_MEIS: raises €0.12 to €0.16
lapo1987: calls €0.12
Fromparis1987: folds 
*** FLOP *** [2c Th 8h]
ADRIAN0_MEIS: checks 
lapo1987: checks 
*** TURN *** [2c Th 8h] [Qd]
ADRIAN0_MEIS: bets €0.19
lapo1987: calls €0.19
*** RIVER *** [2c Th 8h Qd] [Tc]
ADRIAN0_MEIS: checks 
lapo1987: checks 
*** SHOW DOWN ***
ADRIAN0_MEIS: shows [5c Ac] (a pair of Tens)
lapo1987: shows [Jh Jc] (two pair, Jacks and Tens)
lapo1987 collected €0.70 from pot
*** SUMMARY ***
Total pot €0.74 | Rake €0.04 
Board [2c Th 8h Qd Tc]
Seat 1: lapo1987 (button) showed [Jh Jc] and won (€0.70) with two pair, Jacks and Tens
Seat 2: Fromparis1987 (small blind) folded before Flop
Seat 3: ADRIAN0_MEIS (big blind) showed [5c Ac] and lost with a pair of Tens
Seat 4: caduceus369 folded before Flop (didn't bet)
Seat 5: fantaasso folded before Flop (didn't bet)
Seat 6: Reacherbetter folded before Flop (didn't bet)



