PokerStars Zoom Hand #257987369907:  Hold'em No Limit (€0.01/€0.02) [ADM ID: M62BA304494E32ST] - 2025/10/03 22:45:16 CET [2025/10/03 16:45:16 ET]
Table 'Sirio' 6-max Seat #1 is the button
Seat 1: pedrito271 (€2.46 in chips) 
Seat 2: Catania838 (€2.98 in chips) 
Seat 3: caduceus369 (€2 in chips) 
Seat 4: CacciatoreAA (€2.20 in chips) 
Seat 5: Sium12302 (€2 in chips) 
Seat 6: Witness85906 (€2.17 in chips) 
Catania838: posts small blind €0.01
caduceus369: posts big blind €0.02
*** HOLE CARDS ***
Dealt to caduceus369 [3s 9h]
CacciatoreAA: raises €0.06 to €0.08
Sium12302: folds 
Witness85906: folds 
pedrito271: calls €0.08
Catania838: folds 
caduceus369: folds 
*** FLOP *** [Qh Ah 4s]
CacciatoreAA: checks 
pedrito271: bets €0.04
CacciatoreAA: calls €0.04
*** TURN *** [Qh Ah 4s] [2d]
CacciatoreAA: checks 
pedrito271: checks 
*** RIVER *** [Qh Ah 4s 2d] [2s]
CacciatoreAA: checks 
pedrito271: checks 
*** SHOW DOWN ***
CacciatoreAA: shows [Qd Kc] (two pair, Queens and Deuces)
pedrito271: shows [Th As] (two pair, Aces and Deuces)
pedrito271 collected €0.26 from pot
*** SUMMARY ***
Total pot €0.27 | Rake €0.01 
Board [Qh Ah 4s 2d 2s]
Seat 1: pedrito271 (button) showed [Th As] and won (€0.26) with two pair, Aces and Deuces
Seat 2: Catania838 (small blind) folded before Flop
Seat 3: caduceus369 (big blind) folded before Flop
Seat 4: CacciatoreAA showed [Qd Kc] and lost with two pair, Queens and Deuces
Seat 5: Sium12302 folded before Flop (didn't bet)
Seat 6: Witness85906 folded before Flop (didn't bet)



PokerStars Zoom Hand #257987372613:  Hold'em No Limit (€0.01/€0.02) [ADM ID: M62BA304494E32ST] - 2025/10/03 22:45:27 CET [2025/10/03 16:45:27 ET]
Table 'Sirio' 6-max Seat #1 is the button
Seat 1: goxstars (€2 in chips) 
Seat 2: caduceus369 (€1.98 in chips) 
Seat 3: father2008 (€3.88 in chips) 
Seat 4: OMGWOLFX (€2.41 in chips) 
Seat 5: KillByte00 (€2.54 in chips) 
Seat 6: Ghost2773 (€2.98 in chips) 
caduceus369: posts small blind €0.01
father2008: posts big blind €0.02
*** HOLE CARDS ***
Dealt to caduceus369 [Ac 6h]
OMGWOLFX: folds 
KillByte00: folds 
Ghost2773: folds 
goxstars: folds 
caduceus369: calls €0.01
father2008: checks 
*** FLOP *** [Kc Kd Qh]
caduceus369: checks 
father2008: bets €0.04
caduceus369: folds 
Uncalled bet (€0.04) returned to father2008
father2008 collected €0.04 from pot
father2008: doesn't show hand 
*** SUMMARY ***
Total pot €0.04 | Rake €0 
Board [Kc Kd Qh]
Seat 1: goxstars (button) folded before Flop (didn't bet)
Seat 2: caduceus369 (small blind) folded on the Flop
Seat 3: father2008 (big blind) collected (€0.04)
Seat 4: OMGWOLFX folded before Flop (didn't bet)
Seat 5: KillByte00 folded before Flop (didn't bet)
Seat 6: Ghost2773 folded before Flop (didn't bet)



PokerStars Zoom Hand #257987378999:  Hold'em No Limit (€0.01/€0.02) [ADM ID: M62BA304494E32ST] - 2025/10/03 22:45:52 CET [2025/10/03 16:45:52 ET]
Table 'Sirio' 6-max Seat #1 is the button
Seat 1: caduceus369 (€1.96 in chips) 
Seat 2: AntonioKrakka (€2.09 in chips) 
Seat 3: SidneyPrescott (€5.86 in chips) 
Seat 4: rounders121282 (€5.16 in chips) 
Seat 5: trillycata (€0.93 in chips) 
Seat 6: father2008 (€3.90 in chips) 
AntonioKrakka: posts small blind €0.01
SidneyPrescott: posts big blind €0.02
*** HOLE CARDS ***
Dealt to caduceus369 [2h 2d]
rounders121282: folds 
trillycata: raises €0.05 to €0.07
father2008: folds 
caduceus369: folds 
AntonioKrakka: folds 
SidneyPrescott: folds 
Uncalled bet (€0.05) returned to trillycata
trillycata collected €0.05 from pot
trillycata: doesn't show hand 
*** SUMMARY ***
Total pot €0.05 | Rake €0 
Seat 1: caduceus369 (button) folded before Flop (didn't bet)
Seat 2: AntonioKrakka (small blind) folded before Flop
Seat 3: SidneyPrescott (big blind) folded before Flop
Seat 4: rounders121282 folded before Flop (didn't bet)
Seat 5: trillycata collected (€0.05)
Seat 6: father2008 folded before Flop (didn't bet)



PokerStars Zoom Hand #257987384758:  Hold'em No Limit (€0.01/€0.02) [ADM ID: M62BA304494E32ST] - 2025/10/03 22:46:15 CET [2025/10/03 16:46:15 ET]
Table 'Sirio' 6-max Seat #1 is the button
Seat 1: father2008 (€3.35 in chips) 
Seat 2: robertoH2O (€2.21 in chips) 
Seat 3: caduceus369 (€1.96 in chips) 
Seat 4: macchia1010 (€0.45 in chips) 
Seat 5: ivano747 (€4.43 in chips) 
Seat 6: stfuplzudonk (€3.05 in chips) 
robertoH2O: posts small blind €0.01
caduceus369: posts big blind €0.02
*** HOLE CARDS ***
Dealt to caduceus369 [Ah Ts]
macchia1010: calls €0.02
ivano747: folds 
stfuplzudonk: folds 
father2008: raises €0.07 to €0.09
robertoH2O: folds 
caduceus369: folds 
macchia1010: calls €0.07
*** FLOP *** [Tc Th Qc]
macchia1010: checks 
father2008: checks 
*** TURN *** [Tc Th Qc] [Kh]
macchia1010: checks 
father2008: checks 
*** RIVER *** [Tc Th Qc Kh] [8c]
macchia1010: bets €0.36 and is all-in
father2008: folds 
Uncalled bet (€0.36) returned to macchia1010
macchia1010 collected €0.20 from pot
macchia1010: doesn't show hand 
*** SUMMARY ***
Total pot €0.21 | Rake €0.01 
Board [Tc Th Qc Kh 8c]
Seat 1: father2008 (button) folded on the River
Seat 2: robertoH2O (small blind) folded before Flop
Seat 3: caduceus369 (big blind) folded before Flop
Seat 4: macchia1010 collected (€0.20)
Seat 5: ivano747 folded before Flop (didn't bet)
Seat 6: stfuplzudonk folded before Flop (didn't bet)



PokerStars Zoom Hand #257987388098:  Hold'em No Limit (€0.01/€0.02) [ADM ID: M62BA304494E32ST] - 2025/10/03 22:46:28 CET [2025/10/03 16:46:28 ET]
Table 'Sirio' 6-max Seat #1 is the button
Seat 1: stfuplzudonk (€2.71 in chips) 
Seat 2: OMGWOLFX (€12.21 in chips) 
Seat 3: EasyToRule (€2.58 in chips) 
Seat 4: H.Quinn.1987 (€1.88 in chips) 
Seat 5: caduceus369 (€1.94 in chips) 
Seat 6: ElBoro1601 (€2.81 in chips) 
OMGWOLFX: posts small blind €0.01
EasyToRule: posts big blind €0.02
*** HOLE CARDS ***
Dealt to caduceus369 [Qd Kc]
H.Quinn.1987: raises €0.04 to €0.06
caduceus369: folds 
ElBoro1601: folds 
stfuplzudonk: calls €0.06
OMGWOLFX: folds 
EasyToRule: folds 
*** FLOP *** [Ad 8d Qc]
H.Quinn.1987: checks 
stfuplzudonk: checks 
*** TURN *** [Ad 8d Qc] [4s]
H.Quinn.1987: bets €0.08
stfuplzudonk: folds 
Uncalled bet (€0.08) returned to H.Quinn.1987
H.Quinn.1987 collected €0.15 from pot
H.Quinn.1987: doesn't show hand 
*** SUMMARY ***
Total pot €0.15 | Rake €0 
Board [Ad 8d Qc 4s]
Seat 1: stfuplzudonk (button) folded on the Turn
Seat 2: OMGWOLFX (small blind) folded before Flop
Seat 3: EasyToRule (big blind) folded before Flop
Seat 4: H.Quinn.1987 collected (€0.15)
Seat 5: caduceus369 folded before Flop (didn't bet)
Seat 6: ElBoro1601 folded before Flop (didn't bet)



PokerStars Zoom Hand #257987382005:  Hold'em No Limit (€0.01/€0.02) [ADM ID: M62BA304494E32ST] - 2025/10/03 22:46:04 CET [2025/10/03 16:46:04 ET]
Table 'Sirio' 6-max Seat #1 is the button
Seat 1: robertoH2O (€2.21 in chips) 
Seat 2: CacciatoreAA (€2.06 in chips) 
Seat 3: zicky78.r (€2.51 in chips) 
Seat 4: stfuplzudonk (€3.05 in chips) 
Seat 5: Catania838 (€2.93 in chips) 
Seat 6: caduceus369 (€1.96 in chips) 
CacciatoreAA: posts small blind €0.01
zicky78.r: posts big blind €0.02
*** HOLE CARDS ***
Dealt to caduceus369 [8s Ks]
stfuplzudonk: folds 
Catania838: calls €0.02
caduceus369: folds 
robertoH2O: folds 
CacciatoreAA: folds 
zicky78.r: checks 
*** FLOP *** [5d 8c 4h]
zicky78.r: checks 
Catania838: checks 
*** TURN *** [5d 8c 4h] [8d]
zicky78.r: checks 
Catania838: checks 
*** RIVER *** [5d 8c 4h 8d] [Jd]
zicky78.r: checks 
Catania838: bets €0.03
zicky78.r: folds 
Uncalled bet (€0.03) returned to Catania838
Catania838 collected €0.05 from pot
Catania838: doesn't show hand 
*** SUMMARY ***
Total pot €0.05 | Rake €0 
Board [5d 8c 4h 8d Jd]
Seat 1: robertoH2O (button) folded before Flop (didn't bet)
Seat 2: CacciatoreAA (small blind) folded before Flop
Seat 3: zicky78.r (big blind) folded on the River
Seat 4: stfuplzudonk folded before Flop (didn't bet)
Seat 5: Catania838 collected (€0.05)
Seat 6: caduceus369 folded before Flop (didn't bet)



PokerStars Zoom Hand #257987392009:  Hold'em No Limit (€0.01/€0.02) [ADM ID: M62BA304494E32ST] - 2025/10/03 22:46:43 CET [2025/10/03 16:46:43 ET]
Table 'Sirio' 6-max Seat #1 is the button
Seat 1: CallMeYzmael (€9.48 in chips) 
Seat 2: Sium12302 (€2.08 in chips) 
Seat 3: Pasdum57 (€2 in chips) 
Seat 4: AntonioKrakka (€2.68 in chips) 
Seat 5: MOLDAVO1069 (€2.16 in chips) 
Seat 6: caduceus369 (€1.94 in chips) 
Sium12302: posts small blind €0.01
Pasdum57: posts big blind €0.02
*** HOLE CARDS ***
Dealt to caduceus369 [7c Ah]
AntonioKrakka: folds 
MOLDAVO1069: folds 
caduceus369: raises €0.02 to €0.04
CallMeYzmael: folds 
Sium12302: folds 
Pasdum57: calls €0.02
*** FLOP *** [Jc Ks 9s]
Pasdum57: bets €0.09
caduceus369: folds 
Uncalled bet (€0.09) returned to Pasdum57
Pasdum57 collected €0.09 from pot
Pasdum57: doesn't show hand 
*** SUMMARY ***
Total pot €0.09 | Rake €0 
Board [Jc Ks 9s]
Seat 1: CallMeYzmael (button) folded before Flop (didn't bet)
Seat 2: Sium12302 (small blind) folded before Flop
Seat 3: Pasdum57 (big blind) collected (€0.09)
Seat 4: AntonioKrakka folded before Flop (didn't bet)
Seat 5: MOLDAVO1069 folded before Flop (didn't bet)
Seat 6: caduceus369 folded on the Flop



PokerStars Zoom Hand #257987399864:  Hold'em No Limit (€0.01/€0.02) [ADM ID: M62BA304494E32ST] - 2025/10/03 22:47:14 CET [2025/10/03 16:47:14 ET]
Table 'Sirio' 6-max Seat #1 is the button
Seat 1: caduceus369 (€1.90 in chips) 
Seat 2: Pasdum57 (€2.05 in chips) 
Seat 3: QUATTRODAME (€1.48 in chips) 
Seat 4: goxstars (€2 in chips) 
Seat 5: zicky78.r (€2.49 in chips) 
Seat 6: SidneyPrescott (€2.88 in chips) 
Pasdum57: posts small blind €0.01
QUATTRODAME: posts big blind €0.02
*** HOLE CARDS ***
Dealt to caduceus369 [7s 6s]
goxstars: folds 
zicky78.r: folds 
SidneyPrescott: folds 
caduceus369: raises €0.02 to €0.04
Pasdum57: folds 
QUATTRODAME: calls €0.02
*** FLOP *** [9d 2s 4s]
QUATTRODAME: checks 
caduceus369: checks 
*** TURN *** [9d 2s 4s] [9h]
QUATTRODAME: checks 
caduceus369: bets €0.04
QUATTRODAME: calls €0.04
*** RIVER *** [9d 2s 4s 9h] [Ah]
QUATTRODAME: checks 
caduceus369: bets €0.06
QUATTRODAME: folds 
Uncalled bet (€0.06) returned to caduceus369
caduceus369 collected €0.17 from pot
caduceus369: doesn't show hand 
*** SUMMARY ***
Total pot €0.17 | Rake €0 
Board [9d 2s 4s 9h Ah]
Seat 1: caduceus369 (button) collected (€0.17)
Seat 2: Pasdum57 (small blind) folded before Flop
Seat 3: QUATTRODAME (big blind) folded on the River
Seat 4: goxstars folded before Flop (didn't bet)
Seat 5: zicky78.r folded before Flop (didn't bet)
Seat 6: SidneyPrescott folded before Flop (didn't bet)



PokerStars Zoom Hand #257987410166:  Hold'em No Limit (€0.01/€0.02) [ADM ID: M62BA304494E32ST] - 2025/10/03 22:47:54 CET [2025/10/03 16:47:54 ET]
Table 'Sirio' 6-max Seat #1 is the button
Seat 1: MOLDAVO1069 (€2.16 in chips) 
Seat 2: caduceus369 (€1.99 in chips) 
Seat 3: trillycata (€0.95 in chips) 
Seat 4: lucpri (€0.92 in chips) 
Seat 5: H.Quinn.1987 (€1.90 in chips) 
Seat 6: carlino65 (€1.68 in chips) 
caduceus369: posts small blind €0.01
trillycata: posts big blind €0.02
*** HOLE CARDS ***
Dealt to caduceus369 [4d 5s]
lucpri: folds 
H.Quinn.1987: folds 
carlino65: calls €0.02
MOLDAVO1069: folds 
caduceus369: folds 
trillycata: checks 
*** FLOP *** [Ts 2s 6s]
trillycata: checks 
carlino65: checks 
*** TURN *** [Ts 2s 6s] [8c]
trillycata: checks 
carlino65: checks 
*** RIVER *** [Ts 2s 6s 8c] [Qh]
trillycata: checks 
carlino65: checks 
*** SHOW DOWN ***
trillycata: shows [Qd 9d] (a pair of Queens)
carlino65: mucks hand 
trillycata collected €0.05 from pot
*** SUMMARY ***
Total pot €0.05 | Rake €0 
Board [Ts 2s 6s 8c Qh]
Seat 1: MOLDAVO1069 (button) folded before Flop (didn't bet)
Seat 2: caduceus369 (small blind) folded before Flop
Seat 3: trillycata (big blind) showed [Qd 9d] and won (€0.05) with a pair of Queens
Seat 4: lucpri folded before Flop (didn't bet)
Seat 5: H.Quinn.1987 folded before Flop (didn't bet)
Seat 6: carlino65 mucked [Jh 7d]



PokerStars Zoom Hand #257987412955:  Hold'em No Limit (€0.01/€0.02) [ADM ID: M62BA304494E32ST] - 2025/10/03 22:48:06 CET [2025/10/03 16:48:06 ET]
Table 'Sirio' 6-max Seat #1 is the button
Seat 1: IKARO_3 (€2.32 in chips) 
Seat 2: EasyToRule (€2.55 in chips) 
Seat 3: stfuplzudonk (€4.45 in chips) 
Seat 4: AntonioKrakka (€1.33 in chips) 
Seat 5: caduceus369 (€1.98 in chips) 
Seat 6: ADRIAN0_MEIS (€9.77 in chips) 
EasyToRule: posts small blind €0.01
stfuplzudonk: posts big blind €0.02
*** HOLE CARDS ***
Dealt to caduceus369 [Jd Js]
AntonioKrakka: folds 
caduceus369: raises €0.04 to €0.06
ADRIAN0_MEIS: raises €0.15 to €0.21
IKARO_3: folds 
EasyToRule: folds 
stfuplzudonk: folds 
caduceus369: raises €0.45 to €0.66
ADRIAN0_MEIS: calls €0.45
*** FLOP *** [Ah 9h 6s]
caduceus369: bets €0.38
ADRIAN0_MEIS: raises €0.67 to €1.05
caduceus369: calls €0.67
*** TURN *** [Ah 9h 6s] [9c]
caduceus369: checks 
ADRIAN0_MEIS: bets €1.80
caduceus369: calls €0.27 and is all-in
Uncalled bet (€1.53) returned to ADRIAN0_MEIS
*** RIVER *** [Ah 9h 6s 9c] [Ks]
*** SHOW DOWN ***
caduceus369: shows [Jd Js] (two pair, Jacks and Nines)
ADRIAN0_MEIS: shows [As Qs] (two pair, Aces and Nines)
ADRIAN0_MEIS collected €3.78 from pot
*** SUMMARY ***
Total pot €3.99 | Rake €0.21 
Board [Ah 9h 6s 9c Ks]
Seat 1: IKARO_3 (button) folded before Flop (didn't bet)
Seat 2: EasyToRule (small blind) folded before Flop
Seat 3: stfuplzudonk (big blind) folded before Flop
Seat 4: AntonioKrakka folded before Flop (didn't bet)
Seat 5: caduceus369 showed [Jd Js] and lost with two pair, Jacks and Nines
Seat 6: ADRIAN0_MEIS showed [As Qs] and won (€3.78) with two pair, Aces and Nines



PokerStars Zoom Hand #257987442847:  Hold'em No Limit (€0.01/€0.02) [ADM ID: M62BA304494E32ST] - 2025/10/03 22:50:05 CET [2025/10/03 16:50:05 ET]
Table 'Sirio' 6-max Seat #1 is the button
Seat 1: OMGWOLFX (€7.38 in chips) 
Seat 2: ADRIAN0_MEIS (€4.83 in chips) 
Seat 3: AntonioKrakka (€2.12 in chips) 
Seat 4: caduceus369 (€2 in chips) 
Seat 5: bullone58 (€1.03 in chips) 
Seat 6: Sium12302 (€2.11 in chips) 
ADRIAN0_MEIS: posts small blind €0.01
AntonioKrakka: posts big blind €0.02
*** HOLE CARDS ***
Dealt to caduceus369 [9d 9s]
caduceus369: calls €0.02
bullone58: folds 
Sium12302: folds 
OMGWOLFX: folds 
ADRIAN0_MEIS: folds 
AntonioKrakka: checks 
*** FLOP *** [Kd 5c 5h]
AntonioKrakka: checks 
caduceus369: checks 
*** TURN *** [Kd 5c 5h] [Jd]
AntonioKrakka: checks 
caduceus369: bets €0.02
AntonioKrakka: calls €0.02
*** RIVER *** [Kd 5c 5h Jd] [7d]
AntonioKrakka: bets €0.09
caduceus369: folds 
Uncalled bet (€0.09) returned to AntonioKrakka
AntonioKrakka collected €0.09 from pot
AntonioKrakka: doesn't show hand 
*** SUMMARY ***
Total pot €0.09 | Rake €0 
Board [Kd 5c 5h Jd 7d]
Seat 1: OMGWOLFX (button) folded before Flop (didn't bet)
Seat 2: ADRIAN0_MEIS (small blind) folded before Flop
Seat 3: AntonioKrakka (big blind) collected (€0.09)
Seat 4: caduceus369 folded on the River
Seat 5: bullone58 folded before Flop (didn't bet)
Seat 6: Sium12302 folded before Flop (didn't bet)



PokerStars Zoom Hand #257987451849:  Hold'em No Limit (€0.01/€0.02) [ADM ID: M62BA304494E32ST] - 2025/10/03 22:50:40 CET [2025/10/03 16:50:40 ET]
Table 'Sirio' 6-max Seat #1 is the button
Seat 1: stfuplzudonk (€4.43 in chips) 
Seat 2: pylonstrip (€3.68 in chips) 
Seat 3: caduceus369 (€1.96 in chips) 
Seat 4: Witness85906 (€2.01 in chips) 
Seat 5: Ivyberna (€1.91 in chips) 
Seat 6: CIKO71131 (€0.55 in chips) 
pylonstrip: posts small blind €0.01
caduceus369: posts big blind €0.02
*** HOLE CARDS ***
Dealt to caduceus369 [Tc 7h]
Witness85906: folds 
Ivyberna: raises €0.05 to €0.07
CIKO71131: folds 
stfuplzudonk: folds 
pylonstrip: folds 
caduceus369: folds 
Uncalled bet (€0.05) returned to Ivyberna
Ivyberna collected €0.05 from pot
Ivyberna: doesn't show hand 
*** SUMMARY ***
Total pot €0.05 | Rake €0 
Seat 1: stfuplzudonk (button) folded before Flop (didn't bet)
Seat 2: pylonstrip (small blind) folded before Flop
Seat 3: caduceus369 (big blind) folded before Flop
Seat 4: Witness85906 folded before Flop (didn't bet)
Seat 5: Ivyberna collected (€0.05)
Seat 6: CIKO71131 folded before Flop (didn't bet)



PokerStars Zoom Hand #257987453879:  Hold'em No Limit (€0.01/€0.02) [ADM ID: M62BA304494E32ST] - 2025/10/03 22:50:48 CET [2025/10/03 16:50:48 ET]
Table 'Sirio' 6-max Seat #1 is the button
Seat 1: caduceus369 (€1.94 in chips) 
Seat 2: Catania838 (€3.58 in chips) 
Seat 3: goxstars (€2 in chips) 
Seat 4: zicky78.r (€3.94 in chips) 
Seat 5: OMGWOLFX (€2.32 in chips) 
Seat 6: ADRIAN0_MEIS (€11.51 in chips) 
Catania838: posts small blind €0.01
goxstars: posts big blind €0.02
*** HOLE CARDS ***
Dealt to caduceus369 [Th 2h]
zicky78.r: folds 
OMGWOLFX: raises €0.04 to €0.06
ADRIAN0_MEIS: folds 
caduceus369: folds 
Catania838: folds 
goxstars: folds 
Uncalled bet (€0.04) returned to OMGWOLFX
OMGWOLFX collected €0.05 from pot
OMGWOLFX: doesn't show hand 
*** SUMMARY ***
Total pot €0.05 | Rake €0 
Seat 1: caduceus369 (button) folded before Flop (didn't bet)
Seat 2: Catania838 (small blind) folded before Flop
Seat 3: goxstars (big blind) folded before Flop
Seat 4: zicky78.r folded before Flop (didn't bet)
Seat 5: OMGWOLFX collected (€0.05)
Seat 6: ADRIAN0_MEIS folded before Flop (didn't bet)



PokerStars Zoom Hand #257987455932:  Hold'em No Limit (€0.01/€0.02) [ADM ID: M62BA304494E32ST] - 2025/10/03 22:50:56 CET [2025/10/03 16:50:56 ET]
Table 'Sirio' 6-max Seat #1 is the button
Seat 1: Ivyberna (€1.94 in chips) 
Seat 2: stfuplzudonk (€3.10 in chips) 
Seat 3: zicky78.r (€2.45 in chips) 
Seat 4: Ghost2773 (€3.22 in chips) 
Seat 5: MOLDAVO1069 (€2 in chips) 
Seat 6: caduceus369 (€1.93 in chips) 
stfuplzudonk: posts small blind €0.01
zicky78.r: posts big blind €0.02
*** HOLE CARDS ***
Dealt to caduceus369 [5d Qd]
Ghost2773: folds 
MOLDAVO1069: raises €0.03 to €0.05
caduceus369: folds 
Ivyberna: calls €0.05
stfuplzudonk: calls €0.04
zicky78.r: folds 
*** FLOP *** [Js Th Jd]
stfuplzudonk: checks 
MOLDAVO1069: bets €0.07
Ivyberna: calls €0.07
stfuplzudonk: folds 
*** TURN *** [Js Th Jd] [2d]
MOLDAVO1069: checks 
Ivyberna: bets €0.12
MOLDAVO1069: calls €0.12
*** RIVER *** [Js Th Jd 2d] [9h]
MOLDAVO1069: checks 
Ivyberna: checks 
*** SHOW DOWN ***
MOLDAVO1069: shows [Ad Kd] (a pair of Jacks)
Ivyberna: shows [Td Ac] (two pair, Jacks and Tens)
Ivyberna collected €0.52 from pot
*** SUMMARY ***
Total pot €0.55 | Rake €0.03 
Board [Js Th Jd 2d 9h]
Seat 1: Ivyberna (button) showed [Td Ac] and won (€0.52) with two pair, Jacks and Tens
Seat 2: stfuplzudonk (small blind) folded on the Flop
Seat 3: zicky78.r (big blind) folded before Flop
Seat 4: Ghost2773 folded before Flop (didn't bet)
Seat 5: MOLDAVO1069 showed [Ad Kd] and lost with a pair of Jacks
Seat 6: caduceus369 folded before Flop (didn't bet)



PokerStars Zoom Hand #257987456771:  Hold'em No Limit (€0.01/€0.02) [ADM ID: M62BA304494E32ST] - 2025/10/03 22:50:59 CET [2025/10/03 16:50:59 ET]
Table 'Sirio' 6-max Seat #1 is the button
Seat 1: Witness85906 (€2 in chips) 
Seat 2: robertoH2O (€2 in chips) 
Seat 3: caduceus369 (€1.93 in chips) 
Seat 4: Ptrcam (€1.68 in chips) 
Seat 5: ivano747 (€4.11 in chips) 
Seat 6: macchia1010 (€1.04 in chips) 
robertoH2O: posts small blind €0.01
caduceus369: posts big blind €0.02
*** HOLE CARDS ***
Dealt to caduceus369 [9s Js]
Ptrcam: folds 
ivano747: folds 
macchia1010: folds 
Witness85906: folds 
robertoH2O: raises €0.04 to €0.06
caduceus369: calls €0.04
*** FLOP *** [Jc Ks Kh]
robertoH2O: checks 
caduceus369: bets €0.04
robertoH2O: raises €0.10 to €0.14
caduceus369: folds 
Uncalled bet (€0.10) returned to robertoH2O
robertoH2O collected €0.19 from pot
robertoH2O: doesn't show hand 
*** SUMMARY ***
Total pot €0.20 | Rake €0.01 
Board [Jc Ks Kh]
Seat 1: Witness85906 (button) folded before Flop (didn't bet)
Seat 2: robertoH2O (small blind) collected (€0.19)
Seat 3: caduceus369 (big blind) folded on the Flop
Seat 4: Ptrcam folded before Flop (didn't bet)
Seat 5: ivano747 folded before Flop (didn't bet)
Seat 6: macchia1010 folded before Flop (didn't bet)



PokerStars Zoom Hand #257987454870:  Hold'em No Limit (€0.01/€0.02) [ADM ID: M62BA304494E32ST] - 2025/10/03 22:50:52 CET [2025/10/03 16:50:52 ET]
Table 'Sirio' 6-max Seat #1 is the button
Seat 1: stfuplzudonk (€3.10 in chips) 
Seat 2: caduceus369 (€1.94 in chips) 
Seat 3: father2008 (€3.93 in chips) 
Seat 4: ADRIAN0_MEIS (€11.51 in chips) 
Seat 5: zicky78.r (€3.94 in chips) 
Seat 6: SidneyPrescott (€3 in chips) 
caduceus369: posts small blind €0.01
father2008: posts big blind €0.02
*** HOLE CARDS ***
Dealt to caduceus369 [2d Tc]
ADRIAN0_MEIS: raises €0.04 to €0.06
zicky78.r: folds 
SidneyPrescott: raises €0.14 to €0.20
stfuplzudonk: folds 
caduceus369: folds 
father2008: folds 
ADRIAN0_MEIS: calls €0.14
*** FLOP *** [Ad 4s Qc]
ADRIAN0_MEIS: checks 
SidneyPrescott: bets €0.20
ADRIAN0_MEIS: folds 
Uncalled bet (€0.20) returned to SidneyPrescott
SidneyPrescott collected €0.41 from pot
SidneyPrescott: doesn't show hand 
*** SUMMARY ***
Total pot €0.43 | Rake €0.02 
Board [Ad 4s Qc]
Seat 1: stfuplzudonk (button) folded before Flop (didn't bet)
Seat 2: caduceus369 (small blind) folded before Flop
Seat 3: father2008 (big blind) folded before Flop
Seat 4: ADRIAN0_MEIS folded on the Flop
Seat 5: zicky78.r folded before Flop (didn't bet)
Seat 6: SidneyPrescott collected (€0.41)



PokerStars Zoom Hand #257987466346:  Hold'em No Limit (€0.01/€0.02) [ADM ID: M62BA304494E32ST] - 2025/10/03 22:51:37 CET [2025/10/03 16:51:37 ET]
Table 'Sirio' 6-max Seat #1 is the button
Seat 1: H.Quinn.1987 (€2.44 in chips) 
Seat 2: AntonioKrakka (€2.11 in chips) 
Seat 3: pedrito271 (€6.66 in chips) 
Seat 4: zicky78.r (€2.59 in chips) 
Seat 5: caduceus369 (€1.83 in chips) 
Seat 6: EasyToRule (€2.17 in chips) 
AntonioKrakka: posts small blind €0.01
pedrito271: posts big blind €0.02
*** HOLE CARDS ***
Dealt to caduceus369 [4c 5d]
zicky78.r: folds 
caduceus369: folds 
EasyToRule: folds 
H.Quinn.1987: folds 
AntonioKrakka: folds 
Uncalled bet (€0.01) returned to pedrito271
pedrito271 collected €0.02 from pot
pedrito271: doesn't show hand 
*** SUMMARY ***
Total pot €0.02 | Rake €0 
Seat 1: H.Quinn.1987 (button) folded before Flop (didn't bet)
Seat 2: AntonioKrakka (small blind) folded before Flop
Seat 3: pedrito271 (big blind) collected (€0.02)
Seat 4: zicky78.r folded before Flop (didn't bet)
Seat 5: caduceus369 folded before Flop (didn't bet)
Seat 6: EasyToRule folded before Flop (didn't bet)



PokerStars Zoom Hand #257987467363:  Hold'em No Limit (€0.01/€0.02) [ADM ID: M62BA304494E32ST] - 2025/10/03 22:51:41 CET [2025/10/03 16:51:41 ET]
Table 'Sirio' 6-max Seat #1 is the button
Seat 1: OMGWOLFX (€12.56 in chips) 
Seat 2: caduceus369 (€1.83 in chips) 
Seat 3: father2008 (€3.31 in chips) 
Seat 4: AntonioKrakka (€2.13 in chips) 
Seat 5: QUATTRODAME (€1.95 in chips) 
Seat 6: Ivyberna (€2.22 in chips) 
caduceus369: posts small blind €0.01
father2008: posts big blind €0.02
*** HOLE CARDS ***
Dealt to caduceus369 [7d 5h]
AntonioKrakka: folds 
QUATTRODAME: raises €0.05 to €0.07
Ivyberna: raises €0.11 to €0.18
OMGWOLFX: folds 
caduceus369: folds 
father2008: folds 
QUATTRODAME: calls €0.11
*** FLOP *** [6d 9h Qh]
QUATTRODAME: bets €0.19
Ivyberna: calls €0.19
*** TURN *** [6d 9h Qh] [3c]
QUATTRODAME: bets €0.37
Ivyberna: raises €1.48 to €1.85 and is all-in
QUATTRODAME: folds 
Uncalled bet (€1.48) returned to Ivyberna
Ivyberna collected €1.43 from pot
Ivyberna: doesn't show hand 
*** SUMMARY ***
Total pot €1.51 | Rake €0.08 
Board [6d 9h Qh 3c]
Seat 1: OMGWOLFX (button) folded before Flop (didn't bet)
Seat 2: caduceus369 (small blind) folded before Flop
Seat 3: father2008 (big blind) folded before Flop
Seat 4: AntonioKrakka folded before Flop (didn't bet)
Seat 5: QUATTRODAME folded on the Turn
Seat 6: Ivyberna collected (€1.43)



PokerStars Zoom Hand #257987468338:  Hold'em No Limit (€0.01/€0.02) [ADM ID: M62BA304494E32ST] - 2025/10/03 22:51:45 CET [2025/10/03 16:51:45 ET]
Table 'Sirio' 6-max Seat #1 is the button
Seat 1: ivano747 (€4.12 in chips) 
Seat 2: MOLDAVO1069 (€7.57 in chips) 
Seat 3: rounders121282 (€5.97 in chips) 
Seat 4: xxcash88 (€1.98 in chips) 
Seat 5: AntonioKrakka (€2.13 in chips) 
Seat 6: caduceus369 (€1.82 in chips) 
MOLDAVO1069: posts small blind €0.01
rounders121282: posts big blind €0.02
*** HOLE CARDS ***
Dealt to caduceus369 [8c 7c]
xxcash88: folds 
AntonioKrakka: folds 
caduceus369: calls €0.02
ivano747: raises €0.04 to €0.06
MOLDAVO1069: folds 
rounders121282: folds 
caduceus369: calls €0.04
*** FLOP *** [Kc Ts 3h]
caduceus369: checks 
ivano747: checks 
*** TURN *** [Kc Ts 3h] [2s]
caduceus369: checks 
ivano747: bets €0.08
caduceus369: folds 
Uncalled bet (€0.08) returned to ivano747
ivano747 collected €0.15 from pot
ivano747: doesn't show hand 
*** SUMMARY ***
Total pot €0.15 | Rake €0 
Board [Kc Ts 3h 2s]
Seat 1: ivano747 (button) collected (€0.15)
Seat 2: MOLDAVO1069 (small blind) folded before Flop
Seat 3: rounders121282 (big blind) folded before Flop
Seat 4: xxcash88 folded before Flop (didn't bet)
Seat 5: AntonioKrakka folded before Flop (didn't bet)
Seat 6: caduceus369 folded on the Turn



PokerStars Zoom Hand #257987482317:  Hold'em No Limit (€0.01/€0.02) [ADM ID: M62BA304494E32ST] - 2025/10/03 22:52:40 CET [2025/10/03 16:52:40 ET]
Table 'Sirio' 6-max Seat #1 is the button
Seat 1: CallMeYzmael (€9.79 in chips) 
Seat 2: lucpri (€0.93 in chips) 
Seat 3: zietta60 (€1.23 in chips) 
Seat 4: caduceus369 (€1.76 in chips) 
Seat 5: IKARO_3 (€1.91 in chips) 
Seat 6: H.Quinn.1987 (€2.44 in chips) 
lucpri: posts small blind €0.01
zietta60: posts big blind €0.02
*** HOLE CARDS ***
Dealt to caduceus369 [Jh 4c]
caduceus369: folds 
IKARO_3: raises €0.04 to €0.06
H.Quinn.1987: folds 
CallMeYzmael: folds 
lucpri: folds 
zietta60: folds 
Uncalled bet (€0.04) returned to IKARO_3
IKARO_3 collected €0.05 from pot
IKARO_3: doesn't show hand 
*** SUMMARY ***
Total pot €0.05 | Rake €0 
Seat 1: CallMeYzmael (button) folded before Flop (didn't bet)
Seat 2: lucpri (small blind) folded before Flop
Seat 3: zietta60 (big blind) folded before Flop
Seat 4: caduceus369 folded before Flop (didn't bet)
Seat 5: IKARO_3 collected (€0.05)
Seat 6: H.Quinn.1987 folded before Flop (didn't bet)



PokerStars Zoom Hand #257987485020:  Hold'em No Limit (€0.01/€0.02) [ADM ID: M62BA304494E32ST] - 2025/10/03 22:52:51 CET [2025/10/03 16:52:51 ET]
Table 'Sirio' 6-max Seat #1 is the button
Seat 1: Witness85906 (€2.06 in chips) 
Seat 2: caduceus369 (€1.76 in chips) 
Seat 3: QUATTRODAME (€1.09 in chips) 
Seat 4: H.Quinn.1987 (€2.44 in chips) 
Seat 5: SidneyPrescott (€3.11 in chips) 
Seat 6: bullone58 (€0.89 in chips) 
caduceus369: posts small blind €0.01
QUATTRODAME: posts big blind €0.02
*** HOLE CARDS ***
Dealt to caduceus369 [3c 9c]
H.Quinn.1987: folds 
SidneyPrescott: folds 
bullone58: folds 
Witness85906: raises €0.03 to €0.05
caduceus369: folds 
QUATTRODAME: folds 
Uncalled bet (€0.03) returned to Witness85906
Witness85906 collected €0.05 from pot
Witness85906: doesn't show hand 
*** SUMMARY ***
Total pot €0.05 | Rake €0 
Seat 1: Witness85906 (button) collected (€0.05)
Seat 2: caduceus369 (small blind) folded before Flop
Seat 3: QUATTRODAME (big blind) folded before Flop
Seat 4: H.Quinn.1987 folded before Flop (didn't bet)
Seat 5: SidneyPrescott folded before Flop (didn't bet)
Seat 6: bullone58 folded before Flop (didn't bet)



PokerStars Zoom Hand #257987483840:  Hold'em No Limit (€0.01/€0.02) [ADM ID: M62BA304494E32ST] - 2025/10/03 22:52:46 CET [2025/10/03 16:52:46 ET]
Table 'Sirio' 6-max Seat #1 is the button
Seat 1: robertoH2O (€2.06 in chips) 
Seat 2: VagALiss (€3.81 in chips) 
Seat 3: carlino65 (€1.07 in chips) 
Seat 4: caduceus369 (€1.76 in chips) 
Seat 5: H.Quinn.1987 (€2.44 in chips) 
Seat 6: ADRIAN0_MEIS (€8.31 in chips) 
VagALiss: posts small blind €0.01
carlino65: posts big blind €0.02
*** HOLE CARDS ***
Dealt to caduceus369 [5h As]
caduceus369: folds 
H.Quinn.1987: folds 
ADRIAN0_MEIS: folds 
robertoH2O: raises €0.03 to €0.05
VagALiss: folds 
carlino65: folds 
Uncalled bet (€0.03) returned to robertoH2O
robertoH2O collected €0.05 from pot
robertoH2O: doesn't show hand 
*** SUMMARY ***
Total pot €0.05 | Rake €0 
Seat 1: robertoH2O (button) collected (€0.05)
Seat 2: VagALiss (small blind) folded before Flop
Seat 3: carlino65 (big blind) folded before Flop
Seat 4: caduceus369 folded before Flop (didn't bet)
Seat 5: H.Quinn.1987 folded before Flop (didn't bet)
Seat 6: ADRIAN0_MEIS folded before Flop (didn't bet)



PokerStars Zoom Hand #257987479262:  Hold'em No Limit (€0.01/€0.02) [ADM ID: M62BA304494E32ST] - 2025/10/03 22:52:28 CET [2025/10/03 16:52:28 ET]
Table 'Sirio' 6-max Seat #1 is the button
Seat 1: caduceus369 (€1.76 in chips) 
Seat 2: AntonioKrakka (€3.96 in chips) 
Seat 3: C8n_the_sheep (€0.80 in chips) 
Seat 4: rounders121282 (€5.70 in chips) 
Seat 5: father2008 (€3.91 in chips) 
Seat 6: ADRIAN0_MEIS (€6.17 in chips) 
AntonioKrakka: posts small blind €0.01
C8n_the_sheep: posts big blind €0.02
*** HOLE CARDS ***
Dealt to caduceus369 [Th Kd]
rounders121282: calls €0.02
father2008: folds 
ADRIAN0_MEIS: folds 
caduceus369: folds 
AntonioKrakka: folds 
C8n_the_sheep: checks 
*** FLOP *** [As 9c 3c]
C8n_the_sheep: checks 
rounders121282: checks 
*** TURN *** [As 9c 3c] [9s]
C8n_the_sheep: checks 
rounders121282: checks 
*** RIVER *** [As 9c 3c 9s] [Qc]
C8n_the_sheep: checks 
rounders121282: checks 
*** SHOW DOWN ***
C8n_the_sheep: shows [6h 7h] (a pair of Nines)
rounders121282: shows [4d Ks] (a pair of Nines - Ace+King kicker)
rounders121282 collected €0.05 from pot
*** SUMMARY ***
Total pot €0.05 | Rake €0 
Board [As 9c 3c 9s Qc]
Seat 1: caduceus369 (button) folded before Flop (didn't bet)
Seat 2: AntonioKrakka (small blind) folded before Flop
Seat 3: C8n_the_sheep (big blind) showed [6h 7h] and lost with a pair of Nines
Seat 4: rounders121282 showed [4d Ks] and won (€0.05) with a pair of Nines
Seat 5: father2008 folded before Flop (didn't bet)
Seat 6: ADRIAN0_MEIS folded before Flop (didn't bet)



PokerStars Zoom Hand #257987485954:  Hold'em No Limit (€0.01/€0.02) [ADM ID: M62BA304494E32ST] - 2025/10/03 22:52:55 CET [2025/10/03 16:52:55 ET]
Table 'Sirio' 6-max Seat #1 is the button
Seat 1: Ptrcam (€1.64 in chips) 
Seat 2: EasyToRule (€2.63 in chips) 
Seat 3: caduceus369 (€1.75 in chips) 
Seat 4: trillycata (€0.98 in chips) 
Seat 5: SidneyPrescott (€3.11 in chips) 
Seat 6: zietta60 (€1.20 in chips) 
EasyToRule: posts small blind €0.01
caduceus369: posts big blind €0.02
*** HOLE CARDS ***
Dealt to caduceus369 [Kc 3h]
trillycata: folds 
SidneyPrescott: folds 
zietta60: folds 
Ptrcam: calls €0.02
EasyToRule: folds 
caduceus369: checks 
*** FLOP *** [Qs Jd Ad]
caduceus369: checks 
Ptrcam: checks 
*** TURN *** [Qs Jd Ad] [3s]
caduceus369: bets €0.02
Ptrcam: raises €0.02 to €0.04
caduceus369: calls €0.02
*** RIVER *** [Qs Jd Ad 3s] [7s]
caduceus369: bets €0.10
Ptrcam: raises €0.10 to €0.20
caduceus369: folds 
Uncalled bet (€0.10) returned to Ptrcam
Ptrcam collected €0.32 from pot
Ptrcam: doesn't show hand 
*** SUMMARY ***
Total pot €0.33 | Rake €0.01 
Board [Qs Jd Ad 3s 7s]
Seat 1: Ptrcam (button) collected (€0.32)
Seat 2: EasyToRule (small blind) folded before Flop
Seat 3: caduceus369 (big blind) folded on the River
Seat 4: trillycata folded before Flop (didn't bet)
Seat 5: SidneyPrescott folded before Flop (didn't bet)
Seat 6: zietta60 folded before Flop (didn't bet)



PokerStars Zoom Hand #257987499453:  Hold'em No Limit (€0.01/€0.02) [ADM ID: M62BA304494E32ST] - 2025/10/03 22:53:48 CET [2025/10/03 16:53:48 ET]
Table 'Sirio' 6-max Seat #1 is the button
Seat 1: zicky78.r (€8.11 in chips) 
Seat 2: pylonstrip (€3.70 in chips) 
Seat 3: potodds1979 (€2 in chips) 
Seat 4: ivano747 (€4.17 in chips) 
Seat 5: caduceus369 (€1.59 in chips) 
Seat 6: father2008 (€3.26 in chips) 
pylonstrip: posts small blind €0.01
potodds1979: posts big blind €0.02
*** HOLE CARDS ***
Dealt to caduceus369 [Ac 3s]
ivano747: folds 
caduceus369: folds 
father2008: folds 
zicky78.r: folds 
pylonstrip: folds 
Uncalled bet (€0.01) returned to potodds1979
potodds1979 collected €0.02 from pot
potodds1979: doesn't show hand 
*** SUMMARY ***
Total pot €0.02 | Rake €0 
Seat 1: zicky78.r (button) folded before Flop (didn't bet)
Seat 2: pylonstrip (small blind) folded before Flop
Seat 3: potodds1979 (big blind) collected (€0.02)
Seat 4: ivano747 folded before Flop (didn't bet)
Seat 5: caduceus369 folded before Flop (didn't bet)
Seat 6: father2008 folded before Flop (didn't bet)



PokerStars Zoom Hand #257987501761:  Hold'em No Limit (€0.01/€0.02) [ADM ID: M62BA304494E32ST] - 2025/10/03 22:53:57 CET [2025/10/03 16:53:57 ET]
Table 'Sirio' 6-max Seat #1 is the button
Seat 1: EasyToRule (€2.19 in chips) 
Seat 2: zicky78.r (€2.46 in chips) 
Seat 3: Catania838 (€1.51 in chips) 
Seat 4: MOLDAVO1069 (€7.90 in chips) 
Seat 5: ZefirDevil (€0.88 in chips) 
Seat 6: caduceus369 (€1.59 in chips) 
zicky78.r: posts small blind €0.01
Catania838: posts big blind €0.02
*** HOLE CARDS ***
Dealt to caduceus369 [6d 2s]
MOLDAVO1069: folds 
ZefirDevil: raises €0.02 to €0.04
caduceus369: folds 
EasyToRule: folds 
zicky78.r: folds 
Catania838: folds 
Uncalled bet (€0.02) returned to ZefirDevil
ZefirDevil collected €0.05 from pot
ZefirDevil: doesn't show hand 
*** SUMMARY ***
Total pot €0.05 | Rake €0 
Seat 1: EasyToRule (button) folded before Flop (didn't bet)
Seat 2: zicky78.r (small blind) folded before Flop
Seat 3: Catania838 (big blind) folded before Flop
Seat 4: MOLDAVO1069 folded before Flop (didn't bet)
Seat 5: ZefirDevil collected (€0.05)
Seat 6: caduceus369 folded before Flop (didn't bet)



PokerStars Zoom Hand #257987503729:  Hold'em No Limit (€0.01/€0.02) [ADM ID: M62BA304494E32ST] - 2025/10/03 22:54:05 CET [2025/10/03 16:54:05 ET]
Table 'Sirio' 6-max Seat #1 is the button
Seat 1: zicky78.r (€2.45 in chips) 
Seat 2: EasyToRule (€2.19 in chips) 
Seat 3: gs0097 (€0.89 in chips) 
Seat 4: Sium12302 (€3.63 in chips) 
Seat 5: stfuplzudonk (€2.87 in chips) 
Seat 6: caduceus369 (€1.59 in chips) 
EasyToRule: posts small blind €0.01
gs0097: posts big blind €0.02
*** HOLE CARDS ***
Dealt to caduceus369 [7h Ac]
Sium12302: folds 
stfuplzudonk: folds 
caduceus369: folds 
zicky78.r: folds 
EasyToRule: folds 
Uncalled bet (€0.01) returned to gs0097
gs0097 collected €0.02 from pot
gs0097: doesn't show hand 
*** SUMMARY ***
Total pot €0.02 | Rake €0 
Seat 1: zicky78.r (button) folded before Flop (didn't bet)
Seat 2: EasyToRule (small blind) folded before Flop
Seat 3: gs0097 (big blind) collected (€0.02)
Seat 4: Sium12302 folded before Flop (didn't bet)
Seat 5: stfuplzudonk folded before Flop (didn't bet)
Seat 6: caduceus369 folded before Flop (didn't bet)



PokerStars Zoom Hand #257987502410:  Hold'em No Limit (€0.01/€0.02) [ADM ID: M62BA304494E32ST] - 2025/10/03 22:54:00 CET [2025/10/03 16:54:00 ET]
Table 'Sirio' 6-max Seat #1 is the button
Seat 1: CacciatoreAA (€2.41 in chips) 
Seat 2: father2008 (€3.26 in chips) 
Seat 3: IKARO_3 (€1.75 in chips) 
Seat 4: Chia9711 (€2.59 in chips) 
Seat 5: caduceus369 (€1.59 in chips) 
Seat 6: robertoH2O (€2.11 in chips) 
father2008: posts small blind €0.01
IKARO_3: posts big blind €0.02
*** HOLE CARDS ***
Dealt to caduceus369 [7c Kc]
Chia9711: folds 
caduceus369: folds 
robertoH2O: folds 
CacciatoreAA: raises €0.06 to €0.08
father2008: folds 
IKARO_3: folds 
Uncalled bet (€0.06) returned to CacciatoreAA
CacciatoreAA collected €0.05 from pot
CacciatoreAA: doesn't show hand 
*** SUMMARY ***
Total pot €0.05 | Rake €0 
Seat 1: CacciatoreAA (button) collected (€0.05)
Seat 2: father2008 (small blind) folded before Flop
Seat 3: IKARO_3 (big blind) folded before Flop
Seat 4: Chia9711 folded before Flop (didn't bet)
Seat 5: caduceus369 folded before Flop (didn't bet)
Seat 6: robertoH2O folded before Flop (didn't bet)



PokerStars Zoom Hand #257987500464:  Hold'em No Limit (€0.01/€0.02) [ADM ID: M62BA304494E32ST] - 2025/10/03 22:53:52 CET [2025/10/03 16:53:52 ET]
Table 'Sirio' 6-max Seat #1 is the button
Seat 1: caduceus369 (€1.59 in chips) 
Seat 2: ivano747 (€4.17 in chips) 
Seat 3: Ptrcam (€1.80 in chips) 
Seat 4: pylonstrip (€3.69 in chips) 
Seat 5: OMGWOLFX (€11.04 in chips) 
Seat 6: goxstars (€2.05 in chips) 
ivano747: posts small blind €0.01
Ptrcam: posts big blind €0.02
*** HOLE CARDS ***
Dealt to caduceus369 [Js 5h]
pylonstrip: folds 
OMGWOLFX: folds 
goxstars: raises €0.03 to €0.05
caduceus369: folds 
ivano747: calls €0.04
Ptrcam: calls €0.03
*** FLOP *** [7h Kd 3d]
ivano747: checks 
Ptrcam: checks 
goxstars: bets €0.08
ivano747: folds 
Ptrcam: folds 
Uncalled bet (€0.08) returned to goxstars
goxstars collected €0.15 from pot
goxstars: doesn't show hand 
*** SUMMARY ***
Total pot €0.15 | Rake €0 
Board [7h Kd 3d]
Seat 1: caduceus369 (button) folded before Flop (didn't bet)
Seat 2: ivano747 (small blind) folded on the Flop
Seat 3: Ptrcam (big blind) folded on the Flop
Seat 4: pylonstrip folded before Flop (didn't bet)
Seat 5: OMGWOLFX folded before Flop (didn't bet)
Seat 6: goxstars collected (€0.15)



PokerStars Zoom Hand #257987505008:  Hold'em No Limit (€0.01/€0.02) [ADM ID: M62BA304494E32ST] - 2025/10/03 22:54:10 CET [2025/10/03 16:54:10 ET]
Table 'Sirio' 6-max Seat #1 is the button
Seat 1: pylonstrip (€3.67 in chips) 
Seat 2: Catania838 (€1.49 in chips) 
Seat 3: caduceus369 (€1.59 in chips) 
Seat 4: father2008 (€3.25 in chips) 
Seat 5: macchia1010 (€1.18 in chips) 
Seat 6: Ghost2773 (€3.53 in chips) 
Catania838: posts small blind €0.01
caduceus369: posts big blind €0.02
*** HOLE CARDS ***
Dealt to caduceus369 [8c Kd]
father2008: folds 
macchia1010: folds 
Ghost2773: folds 
pylonstrip: folds 
Catania838: raises €0.08 to €0.10
caduceus369: folds 
Uncalled bet (€0.08) returned to Catania838
Catania838 collected €0.04 from pot
Catania838: doesn't show hand 
*** SUMMARY ***
Total pot €0.04 | Rake €0 
Seat 1: pylonstrip (button) folded before Flop (didn't bet)
Seat 2: Catania838 (small blind) collected (€0.04)
Seat 3: caduceus369 (big blind) folded before Flop
Seat 4: father2008 folded before Flop (didn't bet)
Seat 5: macchia1010 folded before Flop (didn't bet)
Seat 6: Ghost2773 folded before Flop (didn't bet)



PokerStars Zoom Hand #257987509269:  Hold'em No Limit (€0.01/€0.02) [ADM ID: M62BA304494E32ST] - 2025/10/03 22:54:27 CET [2025/10/03 16:54:27 ET]
Table 'Sirio' 6-max Seat #1 is the button
Seat 1: H.Quinn.1987 (€2.25 in chips) 
Seat 2: pylonstrip (€3.67 in chips) 
Seat 3: Sium12302 (€2.26 in chips) 
Seat 4: caduceus369 (€1.57 in chips) 
Seat 5: SidneyPrescott (€3.17 in chips) 
Seat 6: robertoH2O (€2.06 in chips) 
pylonstrip: posts small blind €0.01
Sium12302: posts big blind €0.02
*** HOLE CARDS ***
Dealt to caduceus369 [6d As]
caduceus369: folds 
Sium12302 is disconnected 
SidneyPrescott: folds 
robertoH2O: folds 
H.Quinn.1987: folds 
pylonstrip: folds 
Uncalled bet (€0.01) returned to Sium12302
Sium12302 collected €0.02 from pot
Sium12302: doesn't show hand 
*** SUMMARY ***
Total pot €0.02 | Rake €0 
Seat 1: H.Quinn.1987 (button) folded before Flop (didn't bet)
Seat 2: pylonstrip (small blind) folded before Flop
Seat 3: Sium12302 (big blind) collected (€0.02)
Seat 4: caduceus369 folded before Flop (didn't bet)
Seat 5: SidneyPrescott folded before Flop (didn't bet)
Seat 6: robertoH2O folded before Flop (didn't bet)



PokerStars Zoom Hand #257987510804:  Hold'em No Limit (€0.01/€0.02) [ADM ID: M62BA304494E32ST] - 2025/10/03 22:54:33 CET [2025/10/03 16:54:33 ET]
Table 'Sirio' 6-max Seat #1 is the button
Seat 1: OMGWOLFX (€2.23 in chips) 
Seat 2: caduceus369 (€1.57 in chips) 
Seat 3: ADRIAN0_MEIS (€11.37 in chips) 
Seat 4: UtoUrten (€1.48 in chips) 
Seat 5: monsterc99 (€1.55 in chips) 
Seat 6: bruciapelo (€1.16 in chips) 
caduceus369: posts small blind €0.01
ADRIAN0_MEIS: posts big blind €0.02
*** HOLE CARDS ***
Dealt to caduceus369 [Tc 8c]
UtoUrten: raises €0.02 to €0.04
monsterc99: folds 
bruciapelo: calls €0.04
OMGWOLFX: calls €0.04
caduceus369: folds 
ADRIAN0_MEIS: folds 
*** FLOP *** [2s 5d Td]
UtoUrten: bets €0.08
bruciapelo: folds 
OMGWOLFX: folds 
Uncalled bet (€0.08) returned to UtoUrten
UtoUrten collected €0.15 from pot
UtoUrten: doesn't show hand 
*** SUMMARY ***
Total pot €0.15 | Rake €0 
Board [2s 5d Td]
Seat 1: OMGWOLFX (button) folded on the Flop
Seat 2: caduceus369 (small blind) folded before Flop
Seat 3: ADRIAN0_MEIS (big blind) folded before Flop
Seat 4: UtoUrten collected (€0.15)
Seat 5: monsterc99 folded before Flop (didn't bet)
Seat 6: bruciapelo folded on the Flop



PokerStars Zoom Hand #257987514429:  Hold'em No Limit (€0.01/€0.02) [ADM ID: M62BA304494E32ST] - 2025/10/03 22:54:47 CET [2025/10/03 16:54:47 ET]
Table 'Sirio' 6-max Seat #1 is the button
Seat 1: caduceus369 (€1.56 in chips) 
Seat 2: QUATTRODAME (€2 in chips) 
Seat 3: stfuplzudonk (€1.73 in chips) 
Seat 4: bullone58 (€0.96 in chips) 
Seat 5: pylonstrip (€3.64 in chips) 
Seat 6: SidneyPrescott (€3.76 in chips) 
QUATTRODAME: posts small blind €0.01
stfuplzudonk: posts big blind €0.02
*** HOLE CARDS ***
Dealt to caduceus369 [Ad Jc]
bullone58: calls €0.02
pylonstrip: folds 
SidneyPrescott: folds 
caduceus369: raises €0.06 to €0.08
QUATTRODAME: calls €0.07
stfuplzudonk: folds 
bullone58: calls €0.06
*** FLOP *** [Js 3c 7h]
QUATTRODAME: checks 
bullone58: bets €0.13
caduceus369: calls €0.13
QUATTRODAME: folds 
*** TURN *** [Js 3c 7h] [4s]
bullone58: checks 
caduceus369: bets €0.19
bullone58: folds 
Uncalled bet (€0.19) returned to caduceus369
caduceus369 collected €0.50 from pot
caduceus369: doesn't show hand 
*** SUMMARY ***
Total pot €0.52 | Rake €0.02 
Board [Js 3c 7h 4s]
Seat 1: caduceus369 (button) collected (€0.50)
Seat 2: QUATTRODAME (small blind) folded on the Flop
Seat 3: stfuplzudonk (big blind) folded before Flop
Seat 4: bullone58 folded on the Turn
Seat 5: pylonstrip folded before Flop (didn't bet)
Seat 6: SidneyPrescott folded before Flop (didn't bet)



PokerStars Zoom Hand #257987524110:  Hold'em No Limit (€0.01/€0.02) [ADM ID: M62BA304494E32ST] - 2025/10/03 22:55:38 CET [2025/10/03 16:55:38 ET]
Table 'Sirio' 6-max Seat #1 is the button
Seat 1: OMGWOLFX (€12.59 in chips) 
Seat 2: ahehihohuh0 (€1.13 in chips) 
Seat 3: father2008 (€3.12 in chips) 
Seat 4: ivano747 (€3.12 in chips) 
Seat 5: caduceus369 (€1.85 in chips) 
Seat 6: Ghost2773 (€3.34 in chips) 
ahehihohuh0: posts small blind €0.01
father2008: posts big blind €0.02
*** HOLE CARDS ***
Dealt to caduceus369 [7h Qc]
ivano747: folds 
caduceus369: folds 
Ghost2773: folds 
OMGWOLFX: folds 
ahehihohuh0: folds 
Uncalled bet (€0.01) returned to father2008
father2008 collected €0.02 from pot
father2008: doesn't show hand 
*** SUMMARY ***
Total pot €0.02 | Rake €0 
Seat 1: OMGWOLFX (button) folded before Flop (didn't bet)
Seat 2: ahehihohuh0 (small blind) folded before Flop
Seat 3: father2008 (big blind) collected (€0.02)
Seat 4: ivano747 folded before Flop (didn't bet)
Seat 5: caduceus369 folded before Flop (didn't bet)
Seat 6: Ghost2773 folded before Flop (didn't bet)



PokerStars Zoom Hand #257987524702:  Hold'em No Limit (€0.01/€0.02) [ADM ID: M62BA304494E32ST] - 2025/10/03 22:55:42 CET [2025/10/03 16:55:42 ET]
Table 'Sirio' 6-max Seat #1 is the button
Seat 1: caduceus369 (€1.85 in chips) 
Seat 2: monsterc99 (€1.49 in chips) 
Seat 3: ivano747 (€3.12 in chips) 
Seat 4: Catania838 (€1.86 in chips) 
Seat 5: H.Quinn.1987 (€2.19 in chips) 
Seat 6: zietta60 (€1.05 in chips) 
monsterc99: posts small blind €0.01
ivano747: posts big blind €0.02
*** HOLE CARDS ***
Dealt to caduceus369 [Ah 6h]
Catania838: folds 
H.Quinn.1987: folds 
zietta60: folds 
caduceus369: raises €0.02 to €0.04
monsterc99: calls €0.03
ivano747: folds 
*** FLOP *** [Ac As Js]
monsterc99: bets €0.04
caduceus369: calls €0.04
*** TURN *** [Ac As Js] [4h]
monsterc99: checks 
caduceus369: checks 
*** RIVER *** [Ac As Js 4h] [Th]
monsterc99: bets €0.04
caduceus369: raises €0.22 to €0.26
monsterc99: calls €0.22
*** SHOW DOWN ***
caduceus369: shows [Ah 6h] (three of a kind, Aces)
monsterc99: mucks hand 
caduceus369 collected €0.67 from pot
*** SUMMARY ***
Total pot €0.70 | Rake €0.03 
Board [Ac As Js 4h Th]
Seat 1: caduceus369 (button) showed [Ah 6h] and won (€0.67) with three of a kind, Aces
Seat 2: monsterc99 (small blind) mucked [Jc Kh]
Seat 3: ivano747 (big blind) folded before Flop
Seat 4: Catania838 folded before Flop (didn't bet)
Seat 5: H.Quinn.1987 folded before Flop (didn't bet)
Seat 6: zietta60 folded before Flop (didn't bet)



PokerStars Zoom Hand #257987534601:  Hold'em No Limit (€0.01/€0.02) [ADM ID: M62BA304494E32ST] - 2025/10/03 22:56:40 CET [2025/10/03 16:56:40 ET]
Table 'Sirio' 6-max Seat #1 is the button
Seat 1: ZanaM90 (€3.06 in chips) 
Seat 2: pylonstrip (€3.74 in chips) 
Seat 3: caduceus369 (€2.18 in chips) 
Seat 4: C8n_the_sheep (€0.86 in chips) 
Seat 5: ADRIAN0_MEIS (€11.38 in chips) 
Seat 6: monsterc99 (€1.15 in chips) 
pylonstrip: posts small blind €0.01
caduceus369: posts big blind €0.02
*** HOLE CARDS ***
Dealt to caduceus369 [6c Jh]
C8n_the_sheep: folds 
ADRIAN0_MEIS: folds 
monsterc99: raises €0.04 to €0.06
ZanaM90: calls €0.06
pylonstrip: calls €0.05
caduceus369: folds 
*** FLOP *** [2d 7s Tc]
pylonstrip: checks 
monsterc99: bets €0.19
ZanaM90: folds 
pylonstrip: folds 
Uncalled bet (€0.19) returned to monsterc99
monsterc99 collected €0.19 from pot
monsterc99: doesn't show hand 
*** SUMMARY ***
Total pot €0.20 | Rake €0.01 
Board [2d 7s Tc]
Seat 1: ZanaM90 (button) folded on the Flop
Seat 2: pylonstrip (small blind) folded on the Flop
Seat 3: caduceus369 (big blind) folded before Flop
Seat 4: C8n_the_sheep folded before Flop (didn't bet)
Seat 5: ADRIAN0_MEIS folded before Flop (didn't bet)
Seat 6: monsterc99 collected (€0.19)



PokerStars Zoom Hand #257987536301:  Hold'em No Limit (€0.01/€0.02) [ADM ID: M62BA304494E32ST] - 2025/10/03 22:56:49 CET [2025/10/03 16:56:49 ET]
Table 'Sirio' 6-max Seat #1 is the button
Seat 1: stfuplzudonk (€3.48 in chips) 
Seat 2: zicky78.r (€4.24 in chips) 
Seat 3: Mr_Frost02 (€1.71 in chips) 
Seat 4: Sium12302 (€2 in chips) 
Seat 5: goxstars (€2.09 in chips) 
Seat 6: caduceus369 (€2.16 in chips) 
zicky78.r: posts small blind €0.01
Mr_Frost02: posts big blind €0.02
*** HOLE CARDS ***
Dealt to caduceus369 [Ks 8d]
Sium12302: folds 
goxstars: raises €0.04 to €0.06
caduceus369: folds 
stfuplzudonk: folds 
zicky78.r: folds 
Mr_Frost02: folds 
Uncalled bet (€0.04) returned to goxstars
goxstars collected €0.05 from pot
goxstars: doesn't show hand 
*** SUMMARY ***
Total pot €0.05 | Rake €0 
Seat 1: stfuplzudonk (button) folded before Flop (didn't bet)
Seat 2: zicky78.r (small blind) folded before Flop
Seat 3: Mr_Frost02 (big blind) folded before Flop
Seat 4: Sium12302 folded before Flop (didn't bet)
Seat 5: goxstars collected (€0.05)
Seat 6: caduceus369 folded before Flop (didn't bet)



PokerStars Zoom Hand #257987537233:  Hold'em No Limit (€0.01/€0.02) [ADM ID: M62BA304494E32ST] - 2025/10/03 22:56:55 CET [2025/10/03 16:56:55 ET]
Table 'Sirio' 6-max Seat #1 is the button
Seat 1: potodds1979 (€3.13 in chips) 
Seat 2: stfuplzudonk (€3.48 in chips) 
Seat 3: xxcash88 (€2.10 in chips) 
Seat 4: caduceus369 (€2.16 in chips) 
Seat 5: OMGWOLFX (€12.45 in chips) 
Seat 6: pedrito271 (€6.65 in chips) 
stfuplzudonk: posts small blind €0.01
xxcash88: posts big blind €0.02
*** HOLE CARDS ***
Dealt to caduceus369 [Kh 5d]
caduceus369: folds 
OMGWOLFX: raises €0.04 to €0.06
pedrito271: folds 
potodds1979: calls €0.06
stfuplzudonk: folds 
xxcash88: raises €0.20 to €0.26
OMGWOLFX: folds 
potodds1979: folds 
Uncalled bet (€0.20) returned to xxcash88
xxcash88 collected €0.19 from pot
xxcash88: doesn't show hand 
*** SUMMARY ***
Total pot €0.19 | Rake €0 
Seat 1: potodds1979 (button) folded before Flop
Seat 2: stfuplzudonk (small blind) folded before Flop
Seat 3: xxcash88 (big blind) collected (€0.19)
Seat 4: caduceus369 folded before Flop (didn't bet)
Seat 5: OMGWOLFX folded before Flop
Seat 6: pedrito271 folded before Flop (didn't bet)



PokerStars Zoom Hand #257987540074:  Hold'em No Limit (€0.01/€0.02) [ADM ID: M62BA304494E32ST] - 2025/10/03 22:57:11 CET [2025/10/03 16:57:11 ET]
Table 'Sirio' 6-max Seat #1 is the button
Seat 1: OMGWOLFX (€8.24 in chips) 
Seat 2: Quelle128 (€1.79 in chips) 
Seat 3: CacciatoreAA (€2.46 in chips) 
Seat 4: PhilipAJFry (€1.29 in chips) 
Seat 5: Ivyberna (€2.30 in chips) 
Seat 6: caduceus369 (€2.15 in chips) 
Quelle128: posts small blind €0.01
CacciatoreAA: posts big blind €0.02
*** HOLE CARDS ***
Dealt to caduceus369 [5s 9s]
PhilipAJFry: folds 
Ivyberna: folds 
caduceus369: folds 
OMGWOLFX: folds 
Quelle128: calls €0.01
CacciatoreAA: checks 
*** FLOP *** [Tc 5d 6c]
Quelle128: checks 
CacciatoreAA: checks 
*** TURN *** [Tc 5d 6c] [5h]
Quelle128: checks 
CacciatoreAA: checks 
*** RIVER *** [Tc 5d 6c 5h] [4h]
Quelle128: checks 
CacciatoreAA: checks 
*** SHOW DOWN ***
Quelle128: shows [Kh Ah] (a pair of Fives)
CacciatoreAA: shows [2d 4s] (two pair, Fives and Fours)
CacciatoreAA collected €0.04 from pot
*** SUMMARY ***
Total pot €0.04 | Rake €0 
Board [Tc 5d 6c 5h 4h]
Seat 1: OMGWOLFX (button) folded before Flop (didn't bet)
Seat 2: Quelle128 (small blind) showed [Kh Ah] and lost with a pair of Fives
Seat 3: CacciatoreAA (big blind) showed [2d 4s] and won (€0.04) with two pair, Fives and Fours
Seat 4: PhilipAJFry folded before Flop (didn't bet)
Seat 5: Ivyberna folded before Flop (didn't bet)
Seat 6: caduceus369 folded before Flop (didn't bet)



PokerStars Zoom Hand #257987538315:  Hold'em No Limit (€0.01/€0.02) [ADM ID: M62BA304494E32ST] - 2025/10/03 22:57:01 CET [2025/10/03 16:57:01 ET]
Table 'Sirio' 6-max Seat #1 is the button
Seat 1: SidneyPrescott (€3.57 in chips) 
Seat 2: caduceus369 (€2.16 in chips) 
Seat 3: pia1256 (€0.80 in chips) 
Seat 4: Sium12302 (€2 in chips) 
Seat 5: pylonstrip (€3.68 in chips) 
Seat 6: IKARO_3 (€2.56 in chips) 
caduceus369: posts small blind €0.01
pia1256: posts big blind €0.02
*** HOLE CARDS ***
Dealt to caduceus369 [5d 3s]
Sium12302: folds 
pylonstrip: raises €0.02 to €0.04
IKARO_3: calls €0.04
SidneyPrescott: raises €0.16 to €0.20
caduceus369: folds 
pia1256: folds 
pylonstrip: folds 
IKARO_3: calls €0.16
*** FLOP *** [Kc 5c Th]
IKARO_3: checks 
SidneyPrescott: bets €0.23
IKARO_3: folds 
Uncalled bet (€0.23) returned to SidneyPrescott
SidneyPrescott collected €0.45 from pot
SidneyPrescott: doesn't show hand 
*** SUMMARY ***
Total pot €0.47 | Rake €0.02 
Board [Kc 5c Th]
Seat 1: SidneyPrescott (button) collected (€0.45)
Seat 2: caduceus369 (small blind) folded before Flop
Seat 3: pia1256 (big blind) folded before Flop
Seat 4: Sium12302 folded before Flop (didn't bet)
Seat 5: pylonstrip folded before Flop
Seat 6: IKARO_3 folded on the Flop



PokerStars Zoom Hand #257987539259:  Hold'em No Limit (€0.01/€0.02) [ADM ID: M62BA304494E32ST] - 2025/10/03 22:57:07 CET [2025/10/03 16:57:07 ET]
Table 'Sirio' 6-max Seat #1 is the button
Seat 1: stfuplzudonk (€1.43 in chips) 
Seat 2: goxstars (€2.12 in chips) 
Seat 3: Catania838 (€1.16 in chips) 
Seat 4: caduceus369 (€2.15 in chips) 
Seat 5: PhilipAJFry (€1.29 in chips) 
Seat 6: VagALiss (€3.93 in chips) 
goxstars: posts small blind €0.01
Catania838: posts big blind €0.02
*** HOLE CARDS ***
Dealt to caduceus369 [8c Ah]
caduceus369: folds 
PhilipAJFry: folds 
VagALiss: folds 
stfuplzudonk: folds 
goxstars: raises €0.02 to €0.04
Catania838: calls €0.02
*** FLOP *** [6d 5d 9c]
goxstars: bets €0.06
Catania838: calls €0.06
*** TURN *** [6d 5d 9c] [7h]
goxstars: checks 
Catania838: checks 
*** RIVER *** [6d 5d 9c 7h] [3s]
goxstars: checks 
Catania838: bets €0.06
goxstars: calls €0.06
*** SHOW DOWN ***
Catania838: shows [6c 6h] (three of a kind, Sixes)
goxstars: mucks hand 
Catania838 collected €0.31 from pot
*** SUMMARY ***
Total pot €0.32 | Rake €0.01 
Board [6d 5d 9c 7h 3s]
Seat 1: stfuplzudonk (button) folded before Flop (didn't bet)
Seat 2: goxstars (small blind) mucked [As 9h]
Seat 3: Catania838 (big blind) showed [6c 6h] and won (€0.31) with three of a kind, Sixes
Seat 4: caduceus369 folded before Flop (didn't bet)
Seat 5: PhilipAJFry folded before Flop (didn't bet)
Seat 6: VagALiss folded before Flop (didn't bet)



PokerStars Zoom Hand #257987540796:  Hold'em No Limit (€0.01/€0.02) [ADM ID: M62BA304494E32ST] - 2025/10/03 22:57:16 CET [2025/10/03 16:57:16 ET]
Table 'Sirio' 6-max Seat #1 is the button
Seat 1: zicky78.r (€2.02 in chips) 
Seat 2: bruciapelo (€1.12 in chips) 
Seat 3: montemeru (€1.60 in chips) 
Seat 4: potodds1979 (€3.07 in chips) 
Seat 5: caduceus369 (€2.15 in chips) 
Seat 6: Ivyberna (€2.30 in chips) 
bruciapelo: posts small blind €0.01
montemeru: posts big blind €0.02
*** HOLE CARDS ***
Dealt to caduceus369 [6h 6d]
potodds1979: folds 
caduceus369: calls €0.02
Ivyberna: folds 
zicky78.r: folds 
bruciapelo: raises €0.11 to €0.13
montemeru: calls €0.11
caduceus369: folds 
*** FLOP *** [4d Qd 9c]
bruciapelo: bets €0.14
montemeru: folds 
Uncalled bet (€0.14) returned to bruciapelo
bruciapelo collected €0.27 from pot
bruciapelo: doesn't show hand 
*** SUMMARY ***
Total pot €0.28 | Rake €0.01 
Board [4d Qd 9c]
Seat 1: zicky78.r (button) folded before Flop (didn't bet)
Seat 2: bruciapelo (small blind) collected (€0.27)
Seat 3: montemeru (big blind) folded on the Flop
Seat 4: potodds1979 folded before Flop (didn't bet)
Seat 5: caduceus369 folded before Flop
Seat 6: Ivyberna folded before Flop (didn't bet)



PokerStars Zoom Hand #257987549810:  Hold'em No Limit (€0.01/€0.02) [ADM ID: M62BA304494E32ST] - 2025/10/03 22:58:08 CET [2025/10/03 16:58:08 ET]
Table 'Sirio' 6-max Seat #1 is the button
Seat 1: zicky78.r (€2.69 in chips) 
Seat 2: caduceus369 (€2.13 in chips) 
Seat 3: OMGWOLFX (€2.32 in chips) 
Seat 4: UtoUrten (€2.14 in chips) 
Seat 5: IKARO_3 (€2.38 in chips) 
Seat 6: Ptrcam (€2.84 in chips) 
caduceus369: posts small blind €0.01
OMGWOLFX: posts big blind €0.02
*** HOLE CARDS ***
Dealt to caduceus369 [6h Jc]
UtoUrten: raises €0.02 to €0.04
IKARO_3: folds 
Ptrcam: calls €0.04
zicky78.r: folds 
caduceus369: folds 
OMGWOLFX: folds 
*** FLOP *** [7h 2s 9d]
UtoUrten: bets €0.04
Ptrcam: folds 
Uncalled bet (€0.04) returned to UtoUrten
UtoUrten collected €0.11 from pot
UtoUrten: doesn't show hand 
*** SUMMARY ***
Total pot €0.11 | Rake €0 
Board [7h 2s 9d]
Seat 1: zicky78.r (button) folded before Flop (didn't bet)
Seat 2: caduceus369 (small blind) folded before Flop
Seat 3: OMGWOLFX (big blind) folded before Flop
Seat 4: UtoUrten collected (€0.11)
Seat 5: IKARO_3 folded before Flop (didn't bet)
Seat 6: Ptrcam folded on the Flop



PokerStars Zoom Hand #257987550711:  Hold'em No Limit (€0.01/€0.02) [ADM ID: M62BA304494E32ST] - 2025/10/03 22:58:13 CET [2025/10/03 16:58:13 ET]
Table 'Sirio' 6-max Seat #1 is the button
Seat 1: IKARO_3 (€2.38 in chips) 
Seat 2: OMGWOLFX (€2.30 in chips) 
Seat 3: caduceus369 (€2.12 in chips) 
Seat 4: ADRIAN0_MEIS (€9.31 in chips) 
Seat 5: H.Quinn.1987 (€2.13 in chips) 
Seat 6: zicky78.r (€2 in chips) 
OMGWOLFX: posts small blind €0.01
caduceus369: posts big blind €0.02
*** HOLE CARDS ***
Dealt to caduceus369 [7d Ah]
ADRIAN0_MEIS: folds 
H.Quinn.1987: folds 
zicky78.r: folds 
IKARO_3: raises €0.04 to €0.06
OMGWOLFX: folds 
caduceus369: calls €0.04
*** FLOP *** [9h 5d Kd]
caduceus369: checks 
IKARO_3: bets €0.04
caduceus369: calls €0.04
*** TURN *** [9h 5d Kd] [Ts]
caduceus369: checks 
IKARO_3: checks 
*** RIVER *** [9h 5d Kd Ts] [4d]
caduceus369: bets €0.12
IKARO_3: folds 
Uncalled bet (€0.12) returned to caduceus369
caduceus369 collected €0.20 from pot
caduceus369: doesn't show hand 
*** SUMMARY ***
Total pot €0.21 | Rake €0.01 
Board [9h 5d Kd Ts 4d]
Seat 1: IKARO_3 (button) folded on the River
Seat 2: OMGWOLFX (small blind) folded before Flop
Seat 3: caduceus369 (big blind) collected (€0.20)
Seat 4: ADRIAN0_MEIS folded before Flop (didn't bet)
Seat 5: H.Quinn.1987 folded before Flop (didn't bet)
Seat 6: zicky78.r folded before Flop (didn't bet)



PokerStars Zoom Hand #257987560853:  Hold'em No Limit (€0.01/€0.02) [ADM ID: M62BA304494E32ST] - 2025/10/03 22:59:11 CET [2025/10/03 16:59:11 ET]
Table 'Sirio' 6-max Seat #1 is the button
Seat 1: VagALiss (€3.77 in chips) 
Seat 2: Sium12302 (€2.03 in chips) 
Seat 3: father2008 (€3.88 in chips) 
Seat 4: caduceus369 (€2.22 in chips) 
Seat 5: H.Quinn.1987 (€2.46 in chips) 
Seat 6: IKARO_3 (€2.32 in chips) 
Sium12302: posts small blind €0.01
father2008: posts big blind €0.02
*** HOLE CARDS ***
Dealt to caduceus369 [Qc 2d]
caduceus369: folds 
H.Quinn.1987: folds 
IKARO_3: folds 
VagALiss: folds 
Sium12302: folds 
Uncalled bet (€0.01) returned to father2008
father2008 collected €0.02 from pot
father2008: doesn't show hand 
*** SUMMARY ***
Total pot €0.02 | Rake €0 
Seat 1: VagALiss (button) folded before Flop (didn't bet)
Seat 2: Sium12302 (small blind) folded before Flop
Seat 3: father2008 (big blind) collected (€0.02)
Seat 4: caduceus369 folded before Flop (didn't bet)
Seat 5: H.Quinn.1987 folded before Flop (didn't bet)
Seat 6: IKARO_3 folded before Flop (didn't bet)



PokerStars Zoom Hand #257987561599:  Hold'em No Limit (€0.01/€0.02) [ADM ID: M62BA304494E32ST] - 2025/10/03 22:59:15 CET [2025/10/03 16:59:15 ET]
Table 'Sirio' 6-max Seat #1 is the button
Seat 1: caduceus369 (€2.22 in chips) 
Seat 2: Mr_Frost02 (€1.81 in chips) 
Seat 3: Sium12302 (€2.02 in chips) 
Seat 4: zietta60 (€1.24 in chips) 
Seat 5: SidneyPrescott (€3.63 in chips) 
Seat 6: lucpri (€1.58 in chips) 
Mr_Frost02: posts small blind €0.01
Sium12302: posts big blind €0.02
*** HOLE CARDS ***
Dealt to caduceus369 [Th Ac]
zietta60: folds 
SidneyPrescott: folds 
lucpri: folds 
caduceus369: raises €0.04 to €0.06
Mr_Frost02: folds 
Sium12302: folds 
Uncalled bet (€0.04) returned to caduceus369
caduceus369 collected €0.05 from pot
caduceus369: doesn't show hand 
*** SUMMARY ***
Total pot €0.05 | Rake €0 
Seat 1: caduceus369 (button) collected (€0.05)
Seat 2: Mr_Frost02 (small blind) folded before Flop
Seat 3: Sium12302 (big blind) folded before Flop
Seat 4: zietta60 folded before Flop (didn't bet)
Seat 5: SidneyPrescott folded before Flop (didn't bet)
Seat 6: lucpri folded before Flop (didn't bet)



PokerStars Zoom Hand #257987559974:  Hold'em No Limit (€0.01/€0.02) [ADM ID: M62BA304494E32ST] - 2025/10/03 22:59:06 CET [2025/10/03 16:59:06 ET]
Table 'Sirio' 6-max Seat #1 is the button
Seat 1: rounders121282 (€5.76 in chips) 
Seat 2: H.Quinn.1987 (€2.47 in chips) 
Seat 3: MOLDAVO1069 (€7.71 in chips) 
Seat 4: franky65124 (€0.96 in chips) 
Seat 5: caduceus369 (€2.22 in chips) 
Seat 6: ivano747 (€3.22 in chips) 
H.Quinn.1987: posts small blind €0.01
MOLDAVO1069: posts big blind €0.02
*** HOLE CARDS ***
Dealt to caduceus369 [5h 7d]
franky65124: calls €0.02
caduceus369: folds 
ivano747: raises €0.06 to €0.08
rounders121282: folds 
H.Quinn.1987: folds 
MOLDAVO1069: folds 
franky65124: calls €0.06
*** FLOP *** [9s 4c Td]
franky65124: checks 
ivano747: bets €0.09
franky65124: folds 
Uncalled bet (€0.09) returned to ivano747
ivano747 collected €0.18 from pot
ivano747: doesn't show hand 
*** SUMMARY ***
Total pot €0.19 | Rake €0.01 
Board [9s 4c Td]
Seat 1: rounders121282 (button) folded before Flop (didn't bet)
Seat 2: H.Quinn.1987 (small blind) folded before Flop
Seat 3: MOLDAVO1069 (big blind) folded before Flop
Seat 4: franky65124 folded on the Flop
Seat 5: caduceus369 folded before Flop (didn't bet)
Seat 6: ivano747 collected (€0.18)



PokerStars Zoom Hand #257987558447:  Hold'em No Limit (€0.01/€0.02) [ADM ID: M62BA304494E32ST] - 2025/10/03 22:58:57 CET [2025/10/03 16:58:57 ET]
Table 'Sirio' 6-max Seat #1 is the button
Seat 1: caduceus369 (€2.22 in chips) 
Seat 2: monsterc99 (€1.65 in chips) 
Seat 3: pia1256 (€0.69 in chips) 
Seat 4: gs0097 (€0.83 in chips) 
Seat 5: ADRIAN0_MEIS (€9.28 in chips) 
Seat 6: CacciatoreAA (€2.64 in chips) 
monsterc99: posts small blind €0.01
pia1256: posts big blind €0.02
*** HOLE CARDS ***
Dealt to caduceus369 [3h 6s]
gs0097: folds 
ADRIAN0_MEIS: raises €0.05 to €0.07
CacciatoreAA: folds 
caduceus369: folds 
monsterc99: folds 
pia1256: calls €0.05
*** FLOP *** [Kd 9s 7d]
pia1256: checks 
ADRIAN0_MEIS: bets €0.11
pia1256: calls €0.11
*** TURN *** [Kd 9s 7d] [3c]
pia1256: checks 
ADRIAN0_MEIS: checks 
*** RIVER *** [Kd 9s 7d 3c] [As]
pia1256: checks 
ADRIAN0_MEIS: bets €0.26
pia1256: folds 
Uncalled bet (€0.26) returned to ADRIAN0_MEIS
ADRIAN0_MEIS collected €0.35 from pot
ADRIAN0_MEIS: doesn't show hand 
*** SUMMARY ***
Total pot €0.37 | Rake €0.02 
Board [Kd 9s 7d 3c As]
Seat 1: caduceus369 (button) folded before Flop (didn't bet)
Seat 2: monsterc99 (small blind) folded before Flop
Seat 3: pia1256 (big blind) folded on the River
Seat 4: gs0097 folded before Flop (didn't bet)
Seat 5: ADRIAN0_MEIS collected (€0.35)
Seat 6: CacciatoreAA folded before Flop (didn't bet)



PokerStars Zoom Hand #257987559195:  Hold'em No Limit (€0.01/€0.02) [ADM ID: M62BA304494E32ST] - 2025/10/03 22:59:01 CET [2025/10/03 16:59:01 ET]
Table 'Sirio' 6-max Seat #1 is the button
Seat 1: potodds1979 (€2.03 in chips) 
Seat 2: Catania838 (€1.37 in chips) 
Seat 3: VagALiss (€3.79 in chips) 
Seat 4: CacciatoreAA (€2.64 in chips) 
Seat 5: zicky78.r (€8.13 in chips) 
Seat 6: caduceus369 (€2.22 in chips) 
Catania838: posts small blind €0.01
VagALiss: posts big blind €0.02
*** HOLE CARDS ***
Dealt to caduceus369 [5d 7s]
CacciatoreAA: folds 
zicky78.r: folds 
caduceus369: folds 
potodds1979: raises €0.04 to €0.06
Catania838: calls €0.05
VagALiss: folds 
*** FLOP *** [Ts 8h 5h]
Catania838: checks 
potodds1979: bets €0.07
Catania838: calls €0.07
*** TURN *** [Ts 8h 5h] [8d]
Catania838: checks 
potodds1979: checks 
*** RIVER *** [Ts 8h 5h 8d] [9s]
Catania838: bets €0.31
potodds1979: folds 
Uncalled bet (€0.31) returned to Catania838
Catania838 collected €0.27 from pot
Catania838: doesn't show hand 
*** SUMMARY ***
Total pot €0.28 | Rake €0.01 
Board [Ts 8h 5h 8d 9s]
Seat 1: potodds1979 (button) folded on the River
Seat 2: Catania838 (small blind) collected (€0.27)
Seat 3: VagALiss (big blind) folded before Flop
Seat 4: CacciatoreAA folded before Flop (didn't bet)
Seat 5: zicky78.r folded before Flop (didn't bet)
Seat 6: caduceus369 folded before Flop (didn't bet)



PokerStars Zoom Hand #257987563860:  Hold'em No Limit (€0.01/€0.02) [ADM ID: M62BA304494E32ST] - 2025/10/03 22:59:28 CET [2025/10/03 16:59:28 ET]
Table 'Sirio' 6-max Seat #1 is the button
Seat 1: xxcash88 (€2.25 in chips) 
Seat 2: zicky78.r (€2.69 in chips) 
Seat 3: caduceus369 (€2.25 in chips) 
Seat 4: VagALiss (€3.76 in chips) 
Seat 5: outshined8 (€1.65 in chips) 
Seat 6: MOLDAVO1069 (€7.68 in chips) 
zicky78.r: posts small blind €0.01
caduceus369: posts big blind €0.02
*** HOLE CARDS ***
Dealt to caduceus369 [4h 6d]
VagALiss: folds 
outshined8: folds 
MOLDAVO1069: folds 
xxcash88: calls €0.02
zicky78.r is disconnected 
zicky78.r has timed out while disconnected
zicky78.r: folds 
caduceus369: checks 
*** FLOP *** [Jd 9d 6h]
caduceus369: checks 
xxcash88: checks 
*** TURN *** [Jd 9d 6h] [8h]
caduceus369: bets €0.02
xxcash88: calls €0.02
*** RIVER *** [Jd 9d 6h 8h] [Js]
caduceus369: bets €0.03
xxcash88: raises €0.05 to €0.08
caduceus369: folds 
Uncalled bet (€0.05) returned to xxcash88
xxcash88 collected €0.15 from pot
xxcash88: doesn't show hand 
*** SUMMARY ***
Total pot €0.15 | Rake €0 
Board [Jd 9d 6h 8h Js]
Seat 1: xxcash88 (button) collected (€0.15)
Seat 2: zicky78.r (small blind) folded before Flop
Seat 3: caduceus369 (big blind) folded on the River
Seat 4: VagALiss folded before Flop (didn't bet)
Seat 5: outshined8 folded before Flop (didn't bet)
Seat 6: MOLDAVO1069 folded before Flop (didn't bet)



PokerStars Zoom Hand #257987580855:  Hold'em No Limit (€0.01/€0.02) [ADM ID: M62BA304494E32ST] - 2025/10/03 23:01:00 CET [2025/10/03 17:01:00 ET]
Table 'Sirio' 6-max Seat #1 is the button
Seat 1: OMGWOLFX (€10.90 in chips) 
Seat 2: bruciapelo (€0.88 in chips) 
Seat 3: EasyToRule (€2.78 in chips) 
Seat 4: caduceus369 (€2.17 in chips) 
Seat 5: Sium12302 (€2 in chips) 
Seat 6: QUATTRODAME (€1.83 in chips) 
bruciapelo: posts small blind €0.01
EasyToRule: posts big blind €0.02
*** HOLE CARDS ***
Dealt to caduceus369 [3d 7c]
caduceus369: folds 
Sium12302: folds 
QUATTRODAME: raises €0.02 to €0.04
OMGWOLFX: folds 
bruciapelo: folds 
EasyToRule: folds 
Uncalled bet (€0.02) returned to QUATTRODAME
QUATTRODAME collected €0.05 from pot
QUATTRODAME: doesn't show hand 
*** SUMMARY ***
Total pot €0.05 | Rake €0 
Seat 1: OMGWOLFX (button) folded before Flop (didn't bet)
Seat 2: bruciapelo (small blind) folded before Flop
Seat 3: EasyToRule (big blind) folded before Flop
Seat 4: caduceus369 folded before Flop (didn't bet)
Seat 5: Sium12302 folded before Flop (didn't bet)
Seat 6: QUATTRODAME collected (€0.05)



PokerStars Zoom Hand #257987579966:  Hold'em No Limit (€0.01/€0.02) [ADM ID: M62BA304494E32ST] - 2025/10/03 23:00:56 CET [2025/10/03 17:00:56 ET]
Table 'Sirio' 6-max Seat #1 is the button
Seat 1: sgiafun (€1.94 in chips) 
Seat 2: EasyToRule (€3.19 in chips) 
Seat 3: father2008 (€3.10 in chips) 
Seat 4: caduceus369 (€2.17 in chips) 
Seat 5: Sium12302 (€2.02 in chips) 
Seat 6: Ghost2773 (€3.12 in chips) 
EasyToRule: posts small blind €0.01
father2008: posts big blind €0.02
*** HOLE CARDS ***
Dealt to caduceus369 [7c Kc]
caduceus369: folds 
Sium12302: folds 
Ghost2773: folds 
sgiafun: calls €0.02
EasyToRule: folds 
father2008: checks 
*** FLOP *** [7d 4c 8h]
father2008: checks 
sgiafun: checks 
*** TURN *** [7d 4c 8h] [Ts]
father2008: checks 
sgiafun: checks 
*** RIVER *** [7d 4c 8h Ts] [5d]
father2008: checks 
sgiafun: checks 
*** SHOW DOWN ***
father2008: shows [Th Qc] (a pair of Tens)
sgiafun: mucks hand 
father2008 collected €0.05 from pot
*** SUMMARY ***
Total pot €0.05 | Rake €0 
Board [7d 4c 8h Ts 5d]
Seat 1: sgiafun (button) mucked [Ah 2c]
Seat 2: EasyToRule (small blind) folded before Flop
Seat 3: father2008 (big blind) showed [Th Qc] and won (€0.05) with a pair of Tens
Seat 4: caduceus369 folded before Flop (didn't bet)
Seat 5: Sium12302 folded before Flop (didn't bet)
Seat 6: Ghost2773 folded before Flop (didn't bet)



PokerStars Zoom Hand #257987578633:  Hold'em No Limit (€0.01/€0.02) [ADM ID: M62BA304494E32ST] - 2025/10/03 23:00:50 CET [2025/10/03 17:00:50 ET]
Table 'Sirio' 6-max Seat #1 is the button
Seat 1: EasyToRule (€3.19 in chips) 
Seat 2: caduceus369 (€2.18 in chips) 
Seat 3: ADRIAN0_MEIS (€4.51 in chips) 
Seat 4: H.Quinn.1987 (€1.77 in chips) 
Seat 5: zietta60 (€1.11 in chips) 
Seat 6: Sium12302 (€2.02 in chips) 
caduceus369: posts small blind €0.01
ADRIAN0_MEIS: posts big blind €0.02
*** HOLE CARDS ***
Dealt to caduceus369 [Jc 8d]
H.Quinn.1987: folds 
zietta60: calls €0.02
Sium12302: folds 
EasyToRule: folds 
caduceus369: folds 
ADRIAN0_MEIS: checks 
*** FLOP *** [Ts Ac 7d]
ADRIAN0_MEIS: checks 
zietta60: checks 
*** TURN *** [Ts Ac 7d] [Th]
ADRIAN0_MEIS: checks 
zietta60: checks 
*** RIVER *** [Ts Ac 7d Th] [Js]
ADRIAN0_MEIS: checks 
zietta60: bets €1.09 and is all-in
ADRIAN0_MEIS: folds 
Uncalled bet (€1.09) returned to zietta60
zietta60 collected €0.05 from pot
zietta60: doesn't show hand 
*** SUMMARY ***
Total pot €0.05 | Rake €0 
Board [Ts Ac 7d Th Js]
Seat 1: EasyToRule (button) folded before Flop (didn't bet)
Seat 2: caduceus369 (small blind) folded before Flop
Seat 3: ADRIAN0_MEIS (big blind) folded on the River
Seat 4: H.Quinn.1987 folded before Flop (didn't bet)
Seat 5: zietta60 collected (€0.05)
Seat 6: Sium12302 folded before Flop (didn't bet)



PokerStars Zoom Hand #257987582079:  Hold'em No Limit (€0.01/€0.02) [ADM ID: M62BA304494E32ST] - 2025/10/03 23:01:06 CET [2025/10/03 17:01:06 ET]
Table 'Sirio' 6-max Seat #1 is the button
Seat 1: OMGWOLFX (€8.10 in chips) 
Seat 2: H.Quinn.1987 (€1.77 in chips) 
Seat 3: caduceus369 (€2.17 in chips) 
Seat 4: Sium12302 (€2 in chips) 
Seat 5: ADRIAN0_MEIS (€11 in chips) 
Seat 6: SidneyPrescott (€3.53 in chips) 
H.Quinn.1987: posts small blind €0.01
caduceus369: posts big blind €0.02
*** HOLE CARDS ***
Dealt to caduceus369 [9d 2h]
Sium12302: folds 
ADRIAN0_MEIS: folds 
SidneyPrescott: raises €0.04 to €0.06
OMGWOLFX: folds 
H.Quinn.1987: raises €0.14 to €0.20
caduceus369: folds 
SidneyPrescott: calls €0.14
*** FLOP *** [8d 4s 3d]
H.Quinn.1987: bets €0.40
SidneyPrescott: folds 
Uncalled bet (€0.40) returned to H.Quinn.1987
H.Quinn.1987 collected €0.40 from pot
H.Quinn.1987: doesn't show hand 
*** SUMMARY ***
Total pot €0.42 | Rake €0.02 
Board [8d 4s 3d]
Seat 1: OMGWOLFX (button) folded before Flop (didn't bet)
Seat 2: H.Quinn.1987 (small blind) collected (€0.40)
Seat 3: caduceus369 (big blind) folded before Flop
Seat 4: Sium12302 folded before Flop (didn't bet)
Seat 5: ADRIAN0_MEIS folded before Flop (didn't bet)
Seat 6: SidneyPrescott folded on the Flop



PokerStars Zoom Hand #257987588316:  Hold'em No Limit (€0.01/€0.02) [ADM ID: M62BA304494E32ST] - 2025/10/03 23:01:33 CET [2025/10/03 17:01:33 ET]
Table 'Sirio' 6-max Seat #1 is the button
Seat 1: caduceus369 (€2.15 in chips) 
Seat 2: lucpri (€1.39 in chips) 
Seat 3: gs0097 (€0.83 in chips) 
Seat 4: ADRIAN0_MEIS (€11 in chips) 
Seat 5: MOLDAVO1069 (€7.74 in chips) 
Seat 6: Catania838 (€1.57 in chips) 
lucpri: posts small blind €0.01
gs0097: posts big blind €0.02
*** HOLE CARDS ***
Dealt to caduceus369 [6d 9d]
ADRIAN0_MEIS: folds 
MOLDAVO1069: folds 
Catania838: raises €0.08 to €0.10
caduceus369: folds 
lucpri: folds 
gs0097: folds 
Uncalled bet (€0.08) returned to Catania838
Catania838 collected €0.05 from pot
Catania838: doesn't show hand 
*** SUMMARY ***
Total pot €0.05 | Rake €0 
Seat 1: caduceus369 (button) folded before Flop (didn't bet)
Seat 2: lucpri (small blind) folded before Flop
Seat 3: gs0097 (big blind) folded before Flop
Seat 4: ADRIAN0_MEIS folded before Flop (didn't bet)
Seat 5: MOLDAVO1069 folded before Flop (didn't bet)
Seat 6: Catania838 collected (€0.05)



PokerStars Zoom Hand #257987589634:  Hold'em No Limit (€0.01/€0.02) [ADM ID: M62BA304494E32ST] - 2025/10/03 23:01:37 CET [2025/10/03 17:01:37 ET]
Table 'Sirio' 6-max Seat #1 is the button
Seat 1: father2008 (€3.59 in chips) 
Seat 2: caduceus369 (€2.15 in chips) 
Seat 3: SidneyPrescott (€4.33 in chips) 
Seat 4: pedrito271 (€7.07 in chips) 
Seat 5: MOLDAVO1069 (€2.05 in chips) 
Seat 6: TripInter (€1.57 in chips) 
caduceus369: posts small blind €0.01
SidneyPrescott: posts big blind €0.02
*** HOLE CARDS ***
Dealt to caduceus369 [Qh 5s]
pedrito271: calls €0.02
MOLDAVO1069: folds 
TripInter: folds 
father2008: folds 
caduceus369: folds 
SidneyPrescott: raises €0.06 to €0.08
pedrito271: folds 
Uncalled bet (€0.06) returned to SidneyPrescott
SidneyPrescott collected €0.05 from pot
SidneyPrescott: doesn't show hand 
*** SUMMARY ***
Total pot €0.05 | Rake €0 
Seat 1: father2008 (button) folded before Flop (didn't bet)
Seat 2: caduceus369 (small blind) folded before Flop
Seat 3: SidneyPrescott (big blind) collected (€0.05)
Seat 4: pedrito271 folded before Flop
Seat 5: MOLDAVO1069 folded before Flop (didn't bet)
Seat 6: TripInter folded before Flop (didn't bet)



PokerStars Zoom Hand #257987587045:  Hold'em No Limit (€0.01/€0.02) [ADM ID: M62BA304494E32ST] - 2025/10/03 23:01:28 CET [2025/10/03 17:01:28 ET]
Table 'Sirio' 6-max Seat #1 is the button
Seat 1: stfuplzudonk (€4.16 in chips) 
Seat 2: TripInter (€1.58 in chips) 
Seat 3: zietta60 (€1.14 in chips) 
Seat 4: IKARO_3 (€2.23 in chips) 
Seat 5: lucpri (€1.39 in chips) 
Seat 6: caduceus369 (€2.15 in chips) 
TripInter: posts small blind €0.01
zietta60: posts big blind €0.02
*** HOLE CARDS ***
Dealt to caduceus369 [3s 9h]
IKARO_3: raises €0.04 to €0.06
lucpri: folds 
caduceus369: folds 
stfuplzudonk: calls €0.06
TripInter: folds 
zietta60: folds 
*** FLOP *** [Qc Kd 8c]
IKARO_3: bets €0.05
stfuplzudonk: calls €0.05
*** TURN *** [Qc Kd 8c] [Jd]
IKARO_3: checks 
stfuplzudonk: checks 
*** RIVER *** [Qc Kd 8c Jd] [Kc]
IKARO_3: bets €0.29
stfuplzudonk: folds 
Uncalled bet (€0.29) returned to IKARO_3
IKARO_3 collected €0.24 from pot
IKARO_3: doesn't show hand 
*** SUMMARY ***
Total pot €0.25 | Rake €0.01 
Board [Qc Kd 8c Jd Kc]
Seat 1: stfuplzudonk (button) folded on the River
Seat 2: TripInter (small blind) folded before Flop
Seat 3: zietta60 (big blind) folded before Flop
Seat 4: IKARO_3 collected (€0.24)
Seat 5: lucpri folded before Flop (didn't bet)
Seat 6: caduceus369 folded before Flop (didn't bet)



PokerStars Zoom Hand #257987591531:  Hold'em No Limit (€0.01/€0.02) [ADM ID: M62BA304494E32ST] - 2025/10/03 23:01:45 CET [2025/10/03 17:01:45 ET]
Table 'Sirio' 6-max Seat #1 is the button
Seat 1: TripInter (€1.57 in chips) 
Seat 2: zietta60 (€1.12 in chips) 
Seat 3: ahehihohuh0 (€1.09 in chips) 
Seat 4: CacciatoreAA (€2.45 in chips) 
Seat 5: caduceus369 (€2.14 in chips) 
Seat 6: Lion080890 (€2.39 in chips) 
zietta60: posts small blind €0.01
ahehihohuh0: posts big blind €0.02
*** HOLE CARDS ***
Dealt to caduceus369 [2s 6c]
CacciatoreAA: folds 
caduceus369: folds 
Lion080890: calls €0.02
TripInter: folds 
zietta60: calls €0.01
ahehihohuh0: checks 
*** FLOP *** [8h Qh 4h]
zietta60: checks 
ahehihohuh0: checks 
Lion080890: bets €0.02
zietta60: calls €0.02
ahehihohuh0: folds 
*** TURN *** [8h Qh 4h] [4d]
zietta60: checks 
Lion080890: bets €0.02
zietta60: calls €0.02
*** RIVER *** [8h Qh 4h 4d] [6s]
zietta60: checks 
Lion080890: checks 
*** SHOW DOWN ***
zietta60: shows [Kh 9s] (a pair of Fours)
Lion080890: shows [Ks 8c] (two pair, Eights and Fours)
Lion080890 collected €0.14 from pot
*** SUMMARY ***
Total pot €0.14 | Rake €0 
Board [8h Qh 4h 4d 6s]
Seat 1: TripInter (button) folded before Flop (didn't bet)
Seat 2: zietta60 (small blind) showed [Kh 9s] and lost with a pair of Fours
Seat 3: ahehihohuh0 (big blind) folded on the Flop
Seat 4: CacciatoreAA folded before Flop (didn't bet)
Seat 5: caduceus369 folded before Flop (didn't bet)
Seat 6: Lion080890 showed [Ks 8c] and won (€0.14) with two pair, Eights and Fours



PokerStars Zoom Hand #257987592500:  Hold'em No Limit (€0.01/€0.02) [ADM ID: M62BA304494E32ST] - 2025/10/03 23:01:49 CET [2025/10/03 17:01:49 ET]
Table 'Sirio' 6-max Seat #1 is the button
Seat 1: EasyToRule (€2.79 in chips) 
Seat 2: outshined8 (€1.93 in chips) 
Seat 3: stfuplzudonk (€3.06 in chips) 
Seat 4: caduceus369 (€2.14 in chips) 
Seat 5: TripInter (€1.57 in chips) 
Seat 6: father2008 (€3.59 in chips) 
outshined8: posts small blind €0.01
stfuplzudonk: posts big blind €0.02
*** HOLE CARDS ***
Dealt to caduceus369 [Qs Ad]
caduceus369: raises €0.04 to €0.06
TripInter: folds 
father2008: folds 
EasyToRule: calls €0.06
outshined8: raises €0.18 to €0.24
stfuplzudonk: folds 
caduceus369: calls €0.18
EasyToRule: folds 
*** FLOP *** [4d 6s Kc]
outshined8: bets €0.27
caduceus369: calls €0.27
*** TURN *** [4d 6s Kc] [Js]
outshined8: checks 
caduceus369: bets €0.52
outshined8: calls €0.52
*** RIVER *** [4d 6s Kc Js] [5d]
outshined8: checks 
caduceus369: bets €1.11 and is all-in
outshined8: calls €0.90 and is all-in
Uncalled bet (€0.21) returned to caduceus369
*** SHOW DOWN ***
caduceus369: shows [Qs Ad] (high card Ace)
outshined8: shows [Kh Ac] (a pair of Kings)
outshined8 collected €3.73 from pot
*** SUMMARY ***
Total pot €3.94 | Rake €0.21 
Board [4d 6s Kc Js 5d]
Seat 1: EasyToRule (button) folded before Flop
Seat 2: outshined8 (small blind) showed [Kh Ac] and won (€3.73) with a pair of Kings
Seat 3: stfuplzudonk (big blind) folded before Flop
Seat 4: caduceus369 showed [Qs Ad] and lost with high card Ace
Seat 5: TripInter folded before Flop (didn't bet)
Seat 6: father2008 folded before Flop (didn't bet)



PokerStars Zoom Hand #257987605819:  Hold'em No Limit (€0.01/€0.02) [ADM ID: M62BA304494E32ST] - 2025/10/03 23:02:43 CET [2025/10/03 17:02:43 ET]
Table 'Sirio' 6-max Seat #1 is the button
Seat 1: MOLDAVO1069 (€7.68 in chips) 
Seat 2: Sium12302 (€2.08 in chips) 
Seat 3: gs0097 (€0.60 in chips) 
Seat 4: outshined8 (€3.73 in chips) 
Seat 5: xxcash88 (€2.09 in chips) 
Seat 6: caduceus369 (€0.21 in chips) 
Sium12302: posts small blind €0.01
gs0097: posts big blind €0.02
*** HOLE CARDS ***
Dealt to caduceus369 [Ad Qh]
outshined8: folds 
xxcash88: folds 
caduceus369: raises €0.04 to €0.06
MOLDAVO1069: folds 
Sium12302: calls €0.05
gs0097: folds 
*** FLOP *** [Kc Jc 2d]
Sium12302: checks 
caduceus369: bets €0.02
Sium12302: raises €0.04 to €0.06
caduceus369: raises €0.09 to €0.15 and is all-in
Sium12302: calls €0.09
*** TURN *** [Kc Jc 2d] [5s]
*** RIVER *** [Kc Jc 2d 5s] [2c]
*** SHOW DOWN ***
Sium12302: shows [Qd Kd] (two pair, Kings and Deuces)
caduceus369: shows [Ad Qh] (a pair of Deuces)
Sium12302 collected €0.42 from pot
*** SUMMARY ***
Total pot €0.44 | Rake €0.02 
Board [Kc Jc 2d 5s 2c]
Seat 1: MOLDAVO1069 (button) folded before Flop (didn't bet)
Seat 2: Sium12302 (small blind) showed [Qd Kd] and won (€0.42) with two pair, Kings and Deuces
Seat 3: gs0097 (big blind) folded before Flop
Seat 4: outshined8 folded before Flop (didn't bet)
Seat 5: xxcash88 folded before Flop (didn't bet)
Seat 6: caduceus369 showed [Ad Qh] and lost with a pair of Deuces



PokerStars Zoom Hand #257987704486:  Hold'em No Limit (€0.01/€0.02) [ADM ID: M62BA304494E32ST] - 2025/10/03 23:09:15 CET [2025/10/03 17:09:15 ET]
Table 'Sirio' 6-max Seat #1 is the button
Seat 1: caduceus369 (€2 in chips) 
Seat 2: ivano747 (€5.06 in chips) 
Seat 3: AIA427 (€0.83 in chips) 
Seat 4: SidneyPrescott (€2 in chips) 
Seat 5: H.Quinn.1987 (€3.91 in chips) 
Seat 6: father2008 (€3.30 in chips) 
ivano747: posts small blind €0.01
AIA427: posts big blind €0.02
*** HOLE CARDS ***
Dealt to caduceus369 [4s 4h]
SidneyPrescott: folds 
H.Quinn.1987: folds 
father2008: folds 
caduceus369: calls €0.02
ivano747: calls €0.01
AIA427: checks 
*** FLOP *** [2s 6s 3d]
ivano747: checks 
AIA427: bets €0.02
caduceus369: calls €0.02
ivano747: folds 
*** TURN *** [2s 6s 3d] [Jh]
AIA427: bets €0.02
caduceus369: calls €0.02
*** RIVER *** [2s 6s 3d Jh] [4c]
AIA427: bets €0.77 and is all-in
caduceus369: folds 
Uncalled bet (€0.77) returned to AIA427
AIA427 collected €0.14 from pot
AIA427: doesn't show hand 
*** SUMMARY ***
Total pot €0.14 | Rake €0 
Board [2s 6s 3d Jh 4c]
Seat 1: caduceus369 (button) folded on the River
Seat 2: ivano747 (small blind) folded on the Flop
Seat 3: AIA427 (big blind) collected (€0.14)
Seat 4: SidneyPrescott folded before Flop (didn't bet)
Seat 5: H.Quinn.1987 folded before Flop (didn't bet)
Seat 6: father2008 folded before Flop (didn't bet)



PokerStars Zoom Hand #257987723202:  Hold'em No Limit (€0.01/€0.02) [ADM ID: M62BA304494E32ST] - 2025/10/03 23:10:30 CET [2025/10/03 17:10:30 ET]
Table 'Sirio' 6-max Seat #1 is the button
Seat 1: robertoH2O (€2.02 in chips) 
Seat 2: caduceus369 (€1.92 in chips) 
Seat 3: bruciapelo (€1.36 in chips) 
Seat 4: ivano747 (€4.98 in chips) 
Seat 5: ADRIAN0_MEIS (€6.21 in chips) 
Seat 6: H.Quinn.1987 (€2.84 in chips) 
caduceus369: posts small blind €0.01
bruciapelo: posts big blind €0.02
*** HOLE CARDS ***
Dealt to caduceus369 [2h 2c]
ivano747: folds 
ADRIAN0_MEIS: folds 
H.Quinn.1987: raises €0.04 to €0.06
robertoH2O: folds 
caduceus369: folds 
bruciapelo: folds 
Uncalled bet (€0.04) returned to H.Quinn.1987
H.Quinn.1987 collected €0.05 from pot
H.Quinn.1987: doesn't show hand 
*** SUMMARY ***
Total pot €0.05 | Rake €0 
Seat 1: robertoH2O (button) folded before Flop (didn't bet)
Seat 2: caduceus369 (small blind) folded before Flop
Seat 3: bruciapelo (big blind) folded before Flop
Seat 4: ivano747 folded before Flop (didn't bet)
Seat 5: ADRIAN0_MEIS folded before Flop (didn't bet)
Seat 6: H.Quinn.1987 collected (€0.05)



PokerStars Zoom Hand #257987717686:  Hold'em No Limit (€0.01/€0.02) [ADM ID: M62BA304494E32ST] - 2025/10/03 23:10:08 CET [2025/10/03 17:10:08 ET]
Table 'Sirio' 6-max Seat #1 is the button
Seat 1: lucpri (€1.38 in chips) 
Seat 2: H.Quinn.1987 (€3.37 in chips) 
Seat 3: caduceus369 (€1.94 in chips) 
Seat 4: TripInter (€1.37 in chips) 
Seat 5: Quelle128 (€1.83 in chips) 
Seat 6: cialini1 (€2.09 in chips) 
H.Quinn.1987: posts small blind €0.01
caduceus369: posts big blind €0.02
*** HOLE CARDS ***
Dealt to caduceus369 [9s 7c]
TripInter: folds 
Quelle128: calls €0.02
cialini1: raises €0.04 to €0.06
lucpri: folds 
H.Quinn.1987: folds 
caduceus369: folds 
Quelle128: calls €0.04
*** FLOP *** [Js 2h 6s]
Quelle128: checks 
cialini1: checks 
*** TURN *** [Js 2h 6s] [Kd]
Quelle128: checks 
cialini1: bets €0.02
Quelle128: calls €0.02
*** RIVER *** [Js 2h 6s Kd] [8h]
Quelle128: bets €0.06
cialini1: raises €0.10 to €0.16
Quelle128: calls €0.10
*** SHOW DOWN ***
cialini1: shows [2s 2d] (three of a kind, Deuces)
Quelle128: mucks hand 
cialini1 collected €0.49 from pot
*** SUMMARY ***
Total pot €0.51 | Rake €0.02 
Board [Js 2h 6s Kd 8h]
Seat 1: lucpri (button) folded before Flop (didn't bet)
Seat 2: H.Quinn.1987 (small blind) folded before Flop
Seat 3: caduceus369 (big blind) folded before Flop
Seat 4: TripInter folded before Flop (didn't bet)
Seat 5: Quelle128 mucked [Ac Jc]
Seat 6: cialini1 showed [2s 2d] and won (€0.49) with three of a kind, Deuces



PokerStars Zoom Hand #257987721192:  Hold'em No Limit (€0.01/€0.02) [ADM ID: M62BA304494E32ST] - 2025/10/03 23:10:22 CET [2025/10/03 17:10:22 ET]
Table 'Sirio' 6-max Seat #1 is the button
Seat 1: IKARO_3 (€1.75 in chips) 
Seat 2: Catania838 (€1.52 in chips) 
Seat 3: stfuplzudonk (€2.11 in chips) 
Seat 4: Sium12302 (€2.14 in chips) 
Seat 5: caduceus369 (€1.92 in chips) 
Seat 6: AIA427 (€0.91 in chips) 
Catania838: posts small blind €0.01
stfuplzudonk: posts big blind €0.02
*** HOLE CARDS ***
Dealt to caduceus369 [Kh Ts]
Sium12302: folds 
caduceus369: folds 
AIA427: calls €0.02
IKARO_3: folds 
Catania838: folds 
stfuplzudonk: checks 
*** FLOP *** [9h 5s Qd]
stfuplzudonk: checks 
AIA427: checks 
*** TURN *** [9h 5s Qd] [2s]
stfuplzudonk: checks 
AIA427: checks 
*** RIVER *** [9h 5s Qd 2s] [8s]
stfuplzudonk: checks 
AIA427: bets €0.02
stfuplzudonk: folds 
Uncalled bet (€0.02) returned to AIA427
AIA427 collected €0.05 from pot
AIA427: doesn't show hand 
*** SUMMARY ***
Total pot €0.05 | Rake €0 
Board [9h 5s Qd 2s 8s]
Seat 1: IKARO_3 (button) folded before Flop (didn't bet)
Seat 2: Catania838 (small blind) folded before Flop
Seat 3: stfuplzudonk (big blind) folded on the River
Seat 4: Sium12302 folded before Flop (didn't bet)
Seat 5: caduceus369 folded before Flop (didn't bet)
Seat 6: AIA427 collected (€0.05)



PokerStars Zoom Hand #257987727919:  Hold'em No Limit (€0.01/€0.02) [ADM ID: M62BA304494E32ST] - 2025/10/03 23:10:49 CET [2025/10/03 17:10:49 ET]
Table 'Sirio' 6-max Seat #1 is the button
Seat 1: TripInter (€1.34 in chips) 
Seat 2: Sium12302 (€2.15 in chips) 
Seat 3: IKARO_3 (€1.97 in chips) 
Seat 4: skynet0308 (€0.82 in chips) 
Seat 5: H.Quinn.1987 (€3.37 in chips) 
Seat 6: caduceus369 (€1.91 in chips) 
Sium12302: posts small blind €0.01
IKARO_3: posts big blind €0.02
*** HOLE CARDS ***
Dealt to caduceus369 [5s 8h]
skynet0308: folds 
H.Quinn.1987: folds 
caduceus369: folds 
TripInter: folds 
Sium12302: folds 
Uncalled bet (€0.01) returned to IKARO_3
IKARO_3 collected €0.02 from pot
IKARO_3: doesn't show hand 
*** SUMMARY ***
Total pot €0.02 | Rake €0 
Seat 1: TripInter (button) folded before Flop (didn't bet)
Seat 2: Sium12302 (small blind) folded before Flop
Seat 3: IKARO_3 (big blind) collected (€0.02)
Seat 4: skynet0308 folded before Flop (didn't bet)
Seat 5: H.Quinn.1987 folded before Flop (didn't bet)
Seat 6: caduceus369 folded before Flop (didn't bet)



PokerStars Zoom Hand #257987729480:  Hold'em No Limit (€0.01/€0.02) [ADM ID: M62BA304494E32ST] - 2025/10/03 23:10:55 CET [2025/10/03 17:10:55 ET]
Table 'Sirio' 6-max Seat #1 is the button
Seat 1: caduceus369 (€1.91 in chips) 
Seat 2: ahehihohuh0 (€0.97 in chips) 
Seat 3: Sium12302 (€2.14 in chips) 
Seat 4: MOLDAVO1069 (€2.51 in chips) 
Seat 5: H.Quinn.1987 (€3.37 in chips) 
Seat 6: SidneyPrescott (€4.79 in chips) 
ahehihohuh0: posts small blind €0.01
Sium12302: posts big blind €0.02
*** HOLE CARDS ***
Dealt to caduceus369 [5d 6c]
MOLDAVO1069: folds 
H.Quinn.1987: raises €0.04 to €0.06
SidneyPrescott: folds 
caduceus369: folds 
ahehihohuh0: folds 
Sium12302: calls €0.04
*** FLOP *** [3c 7h 8d]
Sium12302: checks 
H.Quinn.1987: bets €0.07
Sium12302: calls €0.07
*** TURN *** [3c 7h 8d] [Ts]
Sium12302: checks 
H.Quinn.1987: bets €0.18
Sium12302: calls €0.18
*** RIVER *** [3c 7h 8d Ts] [2s]
Sium12302: checks 
H.Quinn.1987: bets €0.50
Sium12302: folds 
Uncalled bet (€0.50) returned to H.Quinn.1987
H.Quinn.1987 collected €0.60 from pot
H.Quinn.1987: doesn't show hand 
*** SUMMARY ***
Total pot €0.63 | Rake €0.03 
Board [3c 7h 8d Ts 2s]
Seat 1: caduceus369 (button) folded before Flop (didn't bet)
Seat 2: ahehihohuh0 (small blind) folded before Flop
Seat 3: Sium12302 (big blind) folded on the River
Seat 4: MOLDAVO1069 folded before Flop (didn't bet)
Seat 5: H.Quinn.1987 collected (€0.60)
Seat 6: SidneyPrescott folded before Flop (didn't bet)



PokerStars Zoom Hand #257987731970:  Hold'em No Limit (€0.01/€0.02) [ADM ID: M62BA304494E32ST] - 2025/10/03 23:11:05 CET [2025/10/03 17:11:05 ET]
Table 'Sirio' 6-max Seat #1 is the button
Seat 1: IKARO_3 (€1.97 in chips) 
Seat 2: AlwaisToRun (€0.69 in chips) 
Seat 3: Ghost2773 (€3.62 in chips) 
Seat 4: Catania838 (€1.51 in chips) 
Seat 5: caduceus369 (€1.91 in chips) 
Seat 6: Witness85906 (€2.10 in chips) 
AlwaisToRun: posts small blind €0.01
Ghost2773: posts big blind €0.02
*** HOLE CARDS ***
Dealt to caduceus369 [2h Qd]
Catania838: folds 
caduceus369: folds 
Witness85906: folds 
IKARO_3: folds 
AlwaisToRun: calls €0.01
Ghost2773: checks 
*** FLOP *** [2d 6s Th]
AlwaisToRun: checks 
Ghost2773: checks 
*** TURN *** [2d 6s Th] [3h]
AlwaisToRun: checks 
Ghost2773: checks 
*** RIVER *** [2d 6s Th 3h] [3s]
AlwaisToRun: checks 
Ghost2773: bets €0.02
AlwaisToRun: folds 
Uncalled bet (€0.02) returned to Ghost2773
Ghost2773 collected €0.04 from pot
Ghost2773: doesn't show hand 
*** SUMMARY ***
Total pot €0.04 | Rake €0 
Board [2d 6s Th 3h 3s]
Seat 1: IKARO_3 (button) folded before Flop (didn't bet)
Seat 2: AlwaisToRun (small blind) folded on the River
Seat 3: Ghost2773 (big blind) collected (€0.04)
Seat 4: Catania838 folded before Flop (didn't bet)
Seat 5: caduceus369 folded before Flop (didn't bet)
Seat 6: Witness85906 folded before Flop (didn't bet)



PokerStars Zoom Hand #257987735437:  Hold'em No Limit (€0.01/€0.02) [ADM ID: M62BA304494E32ST] - 2025/10/03 23:11:19 CET [2025/10/03 17:11:19 ET]
Table 'Sirio' 6-max Seat #1 is the button
Seat 1: Witness85906 (€2.10 in chips) 
Seat 2: Sium12302 (€2.91 in chips) 
Seat 3: caduceus369 (€1.91 in chips) 
Seat 4: Catania838 (€1.51 in chips) 
Seat 5: SidneyPrescott (€2.44 in chips) 
Seat 6: EasyToRule (€2.17 in chips) 
Sium12302: posts small blind €0.01
caduceus369: posts big blind €0.02
*** HOLE CARDS ***
Dealt to caduceus369 [Ah Qh]
Catania838: folds 
SidneyPrescott: folds 
EasyToRule: raises €0.04 to €0.06
Witness85906: folds 
Sium12302: folds 
caduceus369: calls €0.04
*** FLOP *** [Kc 4s 2s]
caduceus369: checks 
EasyToRule: bets €0.09
caduceus369: folds 
Uncalled bet (€0.09) returned to EasyToRule
EasyToRule collected €0.13 from pot
EasyToRule: doesn't show hand 
*** SUMMARY ***
Total pot €0.13 | Rake €0 
Board [Kc 4s 2s]
Seat 1: Witness85906 (button) folded before Flop (didn't bet)
Seat 2: Sium12302 (small blind) folded before Flop
Seat 3: caduceus369 (big blind) folded on the Flop
Seat 4: Catania838 folded before Flop (didn't bet)
Seat 5: SidneyPrescott folded before Flop (didn't bet)
Seat 6: EasyToRule collected (€0.13)



PokerStars Zoom Hand #257987746637:  Hold'em No Limit (€0.01/€0.02) [ADM ID: M62BA304494E32ST] - 2025/10/03 23:12:04 CET [2025/10/03 17:12:04 ET]
Table 'Sirio' 6-max Seat #1 is the button
Seat 1: CacciatoreAA (€2.23 in chips) 
Seat 2: caduceus369 (€1.85 in chips) 
Seat 3: H.Quinn.1987 (€3.84 in chips) 
Seat 4: EasyToRule (€2.24 in chips) 
Seat 5: rounders121282 (€6.26 in chips) 
Seat 6: Ghost2773 (€3.63 in chips) 
caduceus369: posts small blind €0.01
H.Quinn.1987: posts big blind €0.02
*** HOLE CARDS ***
Dealt to caduceus369 [Qc 2d]
EasyToRule: folds 
rounders121282: folds 
Ghost2773: folds 
CacciatoreAA: folds 
caduceus369: folds 
Uncalled bet (€0.01) returned to H.Quinn.1987
H.Quinn.1987 collected €0.02 from pot
H.Quinn.1987: doesn't show hand 
*** SUMMARY ***
Total pot €0.02 | Rake €0 
Seat 1: CacciatoreAA (button) folded before Flop (didn't bet)
Seat 2: caduceus369 (small blind) folded before Flop
Seat 3: H.Quinn.1987 (big blind) collected (€0.02)
Seat 4: EasyToRule folded before Flop (didn't bet)
Seat 5: rounders121282 folded before Flop (didn't bet)
Seat 6: Ghost2773 folded before Flop (didn't bet)



PokerStars Zoom Hand #257987747836:  Hold'em No Limit (€0.01/€0.02) [ADM ID: M62BA304494E32ST] - 2025/10/03 23:12:09 CET [2025/10/03 17:12:09 ET]
Table 'Sirio' 6-max Seat #1 is the button
Seat 1: caduceus369 (€1.84 in chips) 
Seat 2: father2008 (€3.52 in chips) 
Seat 3: ivano747 (€4.90 in chips) 
Seat 4: Ghost2773 (€3.63 in chips) 
Seat 5: CacciatoreAA (€2.23 in chips) 
Seat 6: ahehihohuh0 (€0.91 in chips) 
father2008: posts small blind €0.01
ivano747: posts big blind €0.02
*** HOLE CARDS ***
Dealt to caduceus369 [2d Kd]
Ghost2773: folds 
CacciatoreAA: folds 
ahehihohuh0: folds 
caduceus369: folds 
father2008: folds 
Uncalled bet (€0.01) returned to ivano747
ivano747 collected €0.02 from pot
ivano747: doesn't show hand 
*** SUMMARY ***
Total pot €0.02 | Rake €0 
Seat 1: caduceus369 (button) folded before Flop (didn't bet)
Seat 2: father2008 (small blind) folded before Flop
Seat 3: ivano747 (big blind) collected (€0.02)
Seat 4: Ghost2773 folded before Flop (didn't bet)
Seat 5: CacciatoreAA folded before Flop (didn't bet)
Seat 6: ahehihohuh0 folded before Flop (didn't bet)



PokerStars Zoom Hand #257987744146:  Hold'em No Limit (€0.01/€0.02) [ADM ID: M62BA304494E32ST] - 2025/10/03 23:11:54 CET [2025/10/03 17:11:54 ET]
Table 'Sirio' 6-max Seat #1 is the button
Seat 1: cartoonbest (€1.04 in chips) 
Seat 2: CacciatoreAA (€2.24 in chips) 
Seat 3: Sium12302 (€2 in chips) 
Seat 4: caduceus369 (€1.85 in chips) 
Seat 5: Ghost2773 (€3.63 in chips) 
Seat 6: AlwaisToRun (€0.67 in chips) 
CacciatoreAA: posts small blind €0.01
Sium12302: posts big blind €0.02
*** HOLE CARDS ***
Dealt to caduceus369 [Jc 9s]
caduceus369: folds 
Ghost2773: folds 
AlwaisToRun: calls €0.02
cartoonbest: calls €0.02
CacciatoreAA: folds 
Sium12302: checks 
*** FLOP *** [8c 6s 2d]
Sium12302: checks 
AlwaisToRun: checks 
cartoonbest: checks 
*** TURN *** [8c 6s 2d] [4h]
Sium12302: checks 
AlwaisToRun: checks 
cartoonbest: checks 
*** RIVER *** [8c 6s 2d 4h] [3s]
Sium12302: checks 
AlwaisToRun: checks 
cartoonbest: checks 
*** SHOW DOWN ***
Sium12302: shows [2s 9d] (a pair of Deuces)
AlwaisToRun: shows [2c Ad] (a pair of Deuces - Ace kicker)
cartoonbest: mucks hand 
AlwaisToRun collected €0.07 from pot
*** SUMMARY ***
Total pot €0.07 | Rake €0 
Board [8c 6s 2d 4h 3s]
Seat 1: cartoonbest (button) mucked [Ac 9h]
Seat 2: CacciatoreAA (small blind) folded before Flop
Seat 3: Sium12302 (big blind) showed [2s 9d] and lost with a pair of Deuces
Seat 4: caduceus369 folded before Flop (didn't bet)
Seat 5: Ghost2773 folded before Flop (didn't bet)
Seat 6: AlwaisToRun showed [2c Ad] and won (€0.07) with a pair of Deuces



PokerStars Zoom Hand #257987749047:  Hold'em No Limit (€0.01/€0.02) [ADM ID: M62BA304494E32ST] - 2025/10/03 23:12:14 CET [2025/10/03 17:12:14 ET]
Table 'Sirio' 6-max Seat #1 is the button
Seat 1: lucpri (€2.40 in chips) 
Seat 2: Quelle128 (€1.74 in chips) 
Seat 3: rounders121282 (€6.26 in chips) 
Seat 4: CacciatoreAA (€2.23 in chips) 
Seat 5: EasyToRule (€2 in chips) 
Seat 6: caduceus369 (€1.84 in chips) 
Quelle128: posts small blind €0.01
rounders121282: posts big blind €0.02
*** HOLE CARDS ***
Dealt to caduceus369 [Kd Qc]
CacciatoreAA: folds 
EasyToRule: raises €0.03 to €0.05
caduceus369: folds 
lucpri: folds 
Quelle128: folds 
rounders121282: calls €0.03
*** FLOP *** [4s 2c 9d]
rounders121282: checks 
EasyToRule: bets €0.07
rounders121282: folds 
Uncalled bet (€0.07) returned to EasyToRule
EasyToRule collected €0.11 from pot
EasyToRule: doesn't show hand 
*** SUMMARY ***
Total pot €0.11 | Rake €0 
Board [4s 2c 9d]
Seat 1: lucpri (button) folded before Flop (didn't bet)
Seat 2: Quelle128 (small blind) folded before Flop
Seat 3: rounders121282 (big blind) folded on the Flop
Seat 4: CacciatoreAA folded before Flop (didn't bet)
Seat 5: EasyToRule collected (€0.11)
Seat 6: caduceus369 folded before Flop (didn't bet)



PokerStars Zoom Hand #257987754462:  Hold'em No Limit (€0.01/€0.02) [ADM ID: M62BA304494E32ST] - 2025/10/03 23:12:36 CET [2025/10/03 17:12:36 ET]
Table 'Sirio' 6-max Seat #1 is the button
Seat 1: Sium12302 (€2 in chips) 
Seat 2: KindRonin (€1.16 in chips) 
Seat 3: caduceus369 (€1.84 in chips) 
Seat 4: SidneyPrescott (€2.40 in chips) 
Seat 5: lucpri (€2.40 in chips) 
Seat 6: cartoonbest (€1.02 in chips) 
KindRonin: posts small blind €0.01
caduceus369: posts big blind €0.02
*** HOLE CARDS ***
Dealt to caduceus369 [3c Tc]
SidneyPrescott: raises €0.04 to €0.06
lucpri: folds 
cartoonbest: folds 
Sium12302: folds 
KindRonin: folds 
caduceus369: folds 
Uncalled bet (€0.04) returned to SidneyPrescott
SidneyPrescott collected €0.05 from pot
SidneyPrescott: doesn't show hand 
*** SUMMARY ***
Total pot €0.05 | Rake €0 
Seat 1: Sium12302 (button) folded before Flop (didn't bet)
Seat 2: KindRonin (small blind) folded before Flop
Seat 3: caduceus369 (big blind) folded before Flop
Seat 4: SidneyPrescott collected (€0.05)
Seat 5: lucpri folded before Flop (didn't bet)
Seat 6: cartoonbest folded before Flop (didn't bet)



PokerStars Zoom Hand #257987753182:  Hold'em No Limit (€0.01/€0.02) [ADM ID: M62BA304494E32ST] - 2025/10/03 23:12:31 CET [2025/10/03 17:12:31 ET]
Table 'Sirio' 6-max Seat #1 is the button
Seat 1: gs0097 (€0.27 in chips) 
Seat 2: CacciatoreAA (€2.21 in chips) 
Seat 3: stfuplzudonk (€3.68 in chips) 
Seat 4: H.Quinn.1987 (€3.57 in chips) 
Seat 5: caduceus369 (€1.84 in chips) 
Seat 6: lucpri (€2.40 in chips) 
CacciatoreAA: posts small blind €0.01
stfuplzudonk: posts big blind €0.02
*** HOLE CARDS ***
Dealt to caduceus369 [5c 9d]
H.Quinn.1987: folds 
caduceus369: folds 
lucpri: folds 
gs0097: calls €0.02
CacciatoreAA: folds 
stfuplzudonk: checks 
*** FLOP *** [Kd As 8c]
stfuplzudonk: checks 
gs0097: checks 
*** TURN *** [Kd As 8c] [5s]
stfuplzudonk: checks 
gs0097: checks 
*** RIVER *** [Kd As 8c 5s] [Ad]
stfuplzudonk: checks 
gs0097: checks 
*** SHOW DOWN ***
stfuplzudonk: shows [4s 7d] (a pair of Aces)
gs0097: shows [2h 2s] (two pair, Aces and Deuces)
gs0097 collected €0.05 from pot
*** SUMMARY ***
Total pot €0.05 | Rake €0 
Board [Kd As 8c 5s Ad]
Seat 1: gs0097 (button) showed [2h 2s] and won (€0.05) with two pair, Aces and Deuces
Seat 2: CacciatoreAA (small blind) folded before Flop
Seat 3: stfuplzudonk (big blind) showed [4s 7d] and lost with a pair of Aces
Seat 4: H.Quinn.1987 folded before Flop (didn't bet)
Seat 5: caduceus369 folded before Flop (didn't bet)
Seat 6: lucpri folded before Flop (didn't bet)



PokerStars Zoom Hand #257987761379:  Hold'em No Limit (€0.01/€0.02) [ADM ID: M62BA304494E32ST] - 2025/10/03 23:13:04 CET [2025/10/03 17:13:04 ET]
Table 'Sirio' 6-max Seat #1 is the button
Seat 1: TripInter (€1.58 in chips) 
Seat 2: caduceus369 (€1.82 in chips) 
Seat 3: MOLDAVO1069 (€8.79 in chips) 
Seat 4: EasyToRule (€2.50 in chips) 
Seat 5: lucpri (€2.37 in chips) 
Seat 6: J.S.Somers (€3.33 in chips) 
caduceus369: posts small blind €0.01
MOLDAVO1069: posts big blind €0.02
*** HOLE CARDS ***
Dealt to caduceus369 [6c Jc]
EasyToRule: folds 
lucpri: folds 
J.S.Somers: raises €0.03 to €0.05
TripInter: folds 
caduceus369: folds 
MOLDAVO1069: folds 
Uncalled bet (€0.03) returned to J.S.Somers
J.S.Somers collected €0.05 from pot
J.S.Somers: doesn't show hand 
*** SUMMARY ***
Total pot €0.05 | Rake €0 
Seat 1: TripInter (button) folded before Flop (didn't bet)
Seat 2: caduceus369 (small blind) folded before Flop
Seat 3: MOLDAVO1069 (big blind) folded before Flop
Seat 4: EasyToRule folded before Flop (didn't bet)
Seat 5: lucpri folded before Flop (didn't bet)
Seat 6: J.S.Somers collected (€0.05)



PokerStars Zoom Hand #257987758844:  Hold'em No Limit (€0.01/€0.02) [ADM ID: M62BA304494E32ST] - 2025/10/03 23:12:54 CET [2025/10/03 17:12:54 ET]
Table 'Sirio' 6-max Seat #1 is the button
Seat 1: EasyToRule (€2.50 in chips) 
Seat 2: lucpri (€2.38 in chips) 
Seat 3: KindRonin (€1.15 in chips) 
Seat 4: Sium12302 (€2 in chips) 
Seat 5: caduceus369 (€1.82 in chips) 
Seat 6: IKARO_3 (€1.86 in chips) 
lucpri: posts small blind €0.01
KindRonin: posts big blind €0.02
*** HOLE CARDS ***
Dealt to caduceus369 [2c Ac]
Sium12302: raises €0.04 to €0.06
caduceus369: folds 
IKARO_3: calls €0.06
EasyToRule: folds 
lucpri: folds 
KindRonin: folds 
*** FLOP *** [5c 2d 9c]
Sium12302: checks 
IKARO_3: bets €0.11
Sium12302: folds 
Uncalled bet (€0.11) returned to IKARO_3
IKARO_3 collected €0.15 from pot
IKARO_3: doesn't show hand 
*** SUMMARY ***
Total pot €0.15 | Rake €0 
Board [5c 2d 9c]
Seat 1: EasyToRule (button) folded before Flop (didn't bet)
Seat 2: lucpri (small blind) folded before Flop
Seat 3: KindRonin (big blind) folded before Flop
Seat 4: Sium12302 folded on the Flop
Seat 5: caduceus369 folded before Flop (didn't bet)
Seat 6: IKARO_3 collected (€0.15)



PokerStars Zoom Hand #257987763905:  Hold'em No Limit (€0.01/€0.02) [ADM ID: M62BA304494E32ST] - 2025/10/03 23:13:14 CET [2025/10/03 17:13:14 ET]
Table 'Sirio' 6-max Seat #1 is the button
Seat 1: Witness85906 (€2.29 in chips) 
Seat 2: SidneyPrescott (€2.42 in chips) 
Seat 3: Quelle128 (€1.69 in chips) 
Seat 4: caduceus369 (€1.81 in chips) 
Seat 5: father2008 (€3.11 in chips) 
Seat 6: il capo906 (€1.14 in chips) 
SidneyPrescott: posts small blind €0.01
Quelle128: posts big blind €0.02
*** HOLE CARDS ***
Dealt to caduceus369 [4d Ah]
caduceus369: folds 
father2008: folds 
il capo906: calls €0.02
Witness85906: folds 
SidneyPrescott: raises €0.06 to €0.08
Quelle128: folds 
il capo906: calls €0.06
*** FLOP *** [As 7h Tc]
SidneyPrescott: bets €0.06
il capo906: folds 
Uncalled bet (€0.06) returned to SidneyPrescott
SidneyPrescott collected €0.18 from pot
SidneyPrescott: doesn't show hand 
*** SUMMARY ***
Total pot €0.18 | Rake €0 
Board [As 7h Tc]
Seat 1: Witness85906 (button) folded before Flop (didn't bet)
Seat 2: SidneyPrescott (small blind) collected (€0.18)
Seat 3: Quelle128 (big blind) folded before Flop
Seat 4: caduceus369 folded before Flop (didn't bet)
Seat 5: father2008 folded before Flop (didn't bet)
Seat 6: il capo906 folded on the Flop



PokerStars Zoom Hand #257987765513:  Hold'em No Limit (€0.01/€0.02) [ADM ID: M62BA304494E32ST] - 2025/10/03 23:13:21 CET [2025/10/03 17:13:21 ET]
Table 'Sirio' 6-max Seat #1 is the button
Seat 1: H.Quinn.1987 (€3.81 in chips) 
Seat 2: Witness85906 (€2.29 in chips) 
Seat 3: father2008 (€3.11 in chips) 
Seat 4: stfuplzudonk (€2.46 in chips) 
Seat 5: ADRIAN0_MEIS (€3.38 in chips) 
Seat 6: caduceus369 (€1.81 in chips) 
Witness85906: posts small blind €0.01
father2008: posts big blind €0.02
*** HOLE CARDS ***
Dealt to caduceus369 [6s 9h]
stfuplzudonk: folds 
ADRIAN0_MEIS has timed out while disconnected
ADRIAN0_MEIS: folds 
caduceus369: folds 
H.Quinn.1987: raises €0.04 to €0.06
Witness85906: folds 
father2008: calls €0.04
*** FLOP *** [Qs Jd 8h]
father2008: checks 
H.Quinn.1987: checks 
*** TURN *** [Qs Jd 8h] [Qh]
father2008: checks 
H.Quinn.1987: checks 
*** RIVER *** [Qs Jd 8h Qh] [2h]
father2008: checks 
H.Quinn.1987: checks 
*** SHOW DOWN ***
father2008: shows [Kc Tc] (a pair of Queens)
H.Quinn.1987: shows [7d 7c] (two pair, Queens and Sevens)
H.Quinn.1987 collected €0.13 from pot
*** SUMMARY ***
Total pot €0.13 | Rake €0 
Board [Qs Jd 8h Qh 2h]
Seat 1: H.Quinn.1987 (button) showed [7d 7c] and won (€0.13) with two pair, Queens and Sevens
Seat 2: Witness85906 (small blind) folded before Flop
Seat 3: father2008 (big blind) showed [Kc Tc] and lost with a pair of Queens
Seat 4: stfuplzudonk folded before Flop (didn't bet)
Seat 5: ADRIAN0_MEIS folded before Flop (didn't bet)
Seat 6: caduceus369 folded before Flop (didn't bet)



PokerStars Zoom Hand #257987768625:  Hold'em No Limit (€0.01/€0.02) [ADM ID: M62BA304494E32ST] - 2025/10/03 23:13:35 CET [2025/10/03 17:13:35 ET]
Table 'Sirio' 6-max Seat #1 is the button
Seat 1: Sium12302 (€2 in chips) 
Seat 2: Quelle128 (€1.67 in chips) 
Seat 3: caduceus369 (€1.81 in chips) 
Seat 4: sgiafun (€0.66 in chips) 
Seat 5: Neroonciolina (€2.28 in chips) 
Seat 6: SidneyPrescott (€3.56 in chips) 
Quelle128: posts small blind €0.01
caduceus369: posts big blind €0.02
*** HOLE CARDS ***
Dealt to caduceus369 [6c 4s]
sgiafun: raises €0.05 to €0.07
Neroonciolina: folds 
SidneyPrescott: folds 
Sium12302: folds 
Quelle128: calls €0.06
caduceus369: folds 
*** FLOP *** [Js 4c 4h]
Quelle128: checks 
sgiafun: checks 
*** TURN *** [Js 4c 4h] [9c]
Quelle128: checks 
sgiafun: bets €0.16
Quelle128: folds 
Uncalled bet (€0.16) returned to sgiafun
sgiafun collected €0.16 from pot
sgiafun: doesn't show hand 
*** SUMMARY ***
Total pot €0.16 | Rake €0 
Board [Js 4c 4h 9c]
Seat 1: Sium12302 (button) folded before Flop (didn't bet)
Seat 2: Quelle128 (small blind) folded on the Turn
Seat 3: caduceus369 (big blind) folded before Flop
Seat 4: sgiafun collected (€0.16)
Seat 5: Neroonciolina folded before Flop (didn't bet)
Seat 6: SidneyPrescott folded before Flop (didn't bet)



PokerStars Zoom Hand #257987773343:  Hold'em No Limit (€0.01/€0.02) [ADM ID: M62BA304494E32ST] - 2025/10/03 23:13:55 CET [2025/10/03 17:13:55 ET]
Table 'Sirio' 6-max Seat #1 is the button
Seat 1: H.Quinn.1987 (€3.48 in chips) 
Seat 2: caduceus369 (€1.79 in chips) 
Seat 3: stfuplzudonk (€3.59 in chips) 
Seat 4: IKARO_3 (€2.59 in chips) 
Seat 5: SidneyPrescott (€4.80 in chips) 
Seat 6: ivano747 (€4.91 in chips) 
caduceus369: posts small blind €0.01
stfuplzudonk: posts big blind €0.02
*** HOLE CARDS ***
Dealt to caduceus369 [9c 3d]
IKARO_3: folds 
SidneyPrescott: folds 
ivano747: folds 
H.Quinn.1987: raises €0.04 to €0.06
caduceus369: folds 
stfuplzudonk: calls €0.04
*** FLOP *** [3h 8c 7s]
stfuplzudonk: checks 
H.Quinn.1987: bets €0.08
stfuplzudonk: calls €0.08
*** TURN *** [3h 8c 7s] [8s]
stfuplzudonk: checks 
H.Quinn.1987: bets €0.14
stfuplzudonk: folds 
Uncalled bet (€0.14) returned to H.Quinn.1987
H.Quinn.1987 collected €0.28 from pot
H.Quinn.1987: doesn't show hand 
*** SUMMARY ***
Total pot €0.29 | Rake €0.01 
Board [3h 8c 7s 8s]
Seat 1: H.Quinn.1987 (button) collected (€0.28)
Seat 2: caduceus369 (small blind) folded before Flop
Seat 3: stfuplzudonk (big blind) folded on the Turn
Seat 4: IKARO_3 folded before Flop (didn't bet)
Seat 5: SidneyPrescott folded before Flop (didn't bet)
Seat 6: ivano747 folded before Flop (didn't bet)



PokerStars Zoom Hand #257987766681:  Hold'em No Limit (€0.01/€0.02) [ADM ID: M62BA304494E32ST] - 2025/10/03 23:13:26 CET [2025/10/03 17:13:26 ET]
Table 'Sirio' 6-max Seat #1 is the button
Seat 1: caduceus369 (€1.81 in chips) 
Seat 2: franky65124 (€0.78 in chips) 
Seat 3: Catania838 (€1.54 in chips) 
Seat 4: AlwaisToRun (€0.70 in chips) 
Seat 5: EasyToRule (€2.49 in chips) 
Seat 6: robertoH2O (€2.51 in chips) 
franky65124: posts small blind €0.01
Catania838: posts big blind €0.02
*** HOLE CARDS ***
Dealt to caduceus369 [Jc 9h]
AlwaisToRun: folds 
EasyToRule: raises €0.04 to €0.06
robertoH2O: folds 
caduceus369: folds 
franky65124: calls €0.05
Catania838: raises €1.48 to €1.54 and is all-in
EasyToRule: folds 
franky65124: folds 
Uncalled bet (€1.48) returned to Catania838
Catania838 collected €0.18 from pot
Catania838: doesn't show hand 
*** SUMMARY ***
Total pot €0.18 | Rake €0 
Seat 1: caduceus369 (button) folded before Flop (didn't bet)
Seat 2: franky65124 (small blind) folded before Flop
Seat 3: Catania838 (big blind) collected (€0.18)
Seat 4: AlwaisToRun folded before Flop (didn't bet)
Seat 5: EasyToRule folded before Flop
Seat 6: robertoH2O folded before Flop (didn't bet)



PokerStars Zoom Hand #257987772424:  Hold'em No Limit (€0.01/€0.02) [ADM ID: M62BA304494E32ST] - 2025/10/03 23:13:52 CET [2025/10/03 17:13:52 ET]
Table 'Sirio' 6-max Seat #1 is the button
Seat 1: H.Quinn.1987 (€2.83 in chips) 
Seat 2: Catania838 (€1.58 in chips) 
Seat 3: Chia9711 (€2.29 in chips) 
Seat 4: caduceus369 (€1.79 in chips) 
Seat 5: rounders121282 (€6.14 in chips) 
Seat 6: TripInter (€1.57 in chips) 
Catania838: posts small blind €0.01
Chia9711: posts big blind €0.02
*** HOLE CARDS ***
Dealt to caduceus369 [Kc 3c]
caduceus369: folds 
rounders121282: folds 
TripInter: folds 
H.Quinn.1987: raises €0.04 to €0.06
Catania838: folds 
Chia9711: folds 
Uncalled bet (€0.04) returned to H.Quinn.1987
H.Quinn.1987 collected €0.05 from pot
H.Quinn.1987: doesn't show hand 
*** SUMMARY ***
Total pot €0.05 | Rake €0 
Seat 1: H.Quinn.1987 (button) collected (€0.05)
Seat 2: Catania838 (small blind) folded before Flop
Seat 3: Chia9711 (big blind) folded before Flop
Seat 4: caduceus369 folded before Flop (didn't bet)
Seat 5: rounders121282 folded before Flop (didn't bet)
Seat 6: TripInter folded before Flop (didn't bet)



PokerStars Zoom Hand #257987776709:  Hold'em No Limit (€0.01/€0.02) [ADM ID: M62BA304494E32ST] - 2025/10/03 23:14:10 CET [2025/10/03 17:14:10 ET]
Table 'Sirio' 6-max Seat #1 is the button
Seat 1: ADRIAN0_MEIS (€12.53 in chips) 
Seat 2: Generalexx (€1.71 in chips) 
Seat 3: AIA427 (€1.28 in chips) 
Seat 4: EasyToRule (€2.08 in chips) 
Seat 5: stfuplzudonk (€2.40 in chips) 
Seat 6: caduceus369 (€1.78 in chips) 
Generalexx: posts small blind €0.01
AIA427: posts big blind €0.02
*** HOLE CARDS ***
Dealt to caduceus369 [5c 7d]
EasyToRule: folds 
stfuplzudonk: raises €0.02 to €0.04
caduceus369: folds 
ADRIAN0_MEIS: calls €0.04
Generalexx: calls €0.03
AIA427: raises €1.24 to €1.28 and is all-in
stfuplzudonk: folds 
ADRIAN0_MEIS: folds 
Generalexx: folds 
Uncalled bet (€1.24) returned to AIA427
AIA427 collected €0.16 from pot
AIA427: doesn't show hand 
*** SUMMARY ***
Total pot €0.16 | Rake €0 
Seat 1: ADRIAN0_MEIS (button) folded before Flop
Seat 2: Generalexx (small blind) folded before Flop
Seat 3: AIA427 (big blind) collected (€0.16)
Seat 4: EasyToRule folded before Flop (didn't bet)
Seat 5: stfuplzudonk folded before Flop
Seat 6: caduceus369 folded before Flop (didn't bet)



PokerStars Zoom Hand #257987782586:  Hold'em No Limit (€0.01/€0.02) [ADM ID: M62BA304494E32ST] - 2025/10/03 23:14:34 CET [2025/10/03 17:14:34 ET]
Table 'Sirio' 6-max Seat #1 is the button
Seat 1: KindRonin (€1.15 in chips) 
Seat 2: ivano747 (€3.70 in chips) 
Seat 3: gs0097 (€0.30 in chips) 
Seat 4: ahehihohuh0 (€0.92 in chips) 
Seat 5: caduceus369 (€1.76 in chips) 
Seat 6: CacciatoreAA (€2.34 in chips) 
ivano747: posts small blind €0.01
gs0097: posts big blind €0.02
*** HOLE CARDS ***
Dealt to caduceus369 [5c Ts]
ahehihohuh0: folds 
caduceus369: folds 
CacciatoreAA: raises €0.06 to €0.08
KindRonin: folds 
ivano747: folds 
gs0097: folds 
Uncalled bet (€0.06) returned to CacciatoreAA
CacciatoreAA collected €0.05 from pot
CacciatoreAA: doesn't show hand 
*** SUMMARY ***
Total pot €0.05 | Rake €0 
Seat 1: KindRonin (button) folded before Flop (didn't bet)
Seat 2: ivano747 (small blind) folded before Flop
Seat 3: gs0097 (big blind) folded before Flop
Seat 4: ahehihohuh0 folded before Flop (didn't bet)
Seat 5: caduceus369 folded before Flop (didn't bet)
Seat 6: CacciatoreAA collected (€0.05)



PokerStars Zoom Hand #257987778375:  Hold'em No Limit (€0.01/€0.02) [ADM ID: M62BA304494E32ST] - 2025/10/03 23:14:17 CET [2025/10/03 17:14:17 ET]
Table 'Sirio' 6-max Seat #1 is the button
Seat 1: montemeru (€1.91 in chips) 
Seat 2: robertoH2O (€2.93 in chips) 
Seat 3: caduceus369 (€1.78 in chips) 
Seat 4: H.Quinn.1987 (€3.88 in chips) 
Seat 5: Neroonciolina (€2.33 in chips) 
Seat 6: fantaasso (€1.84 in chips) 
robertoH2O: posts small blind €0.01
caduceus369: posts big blind €0.02
*** HOLE CARDS ***
Dealt to caduceus369 [8h Th]
H.Quinn.1987: raises €0.04 to €0.06
Neroonciolina: calls €0.06
fantaasso: raises €0.13 to €0.19
montemeru: folds 
robertoH2O: folds 
caduceus369: folds 
H.Quinn.1987: calls €0.13
Neroonciolina: calls €0.13
*** FLOP *** [3s 6d 7h]
H.Quinn.1987: checks 
Neroonciolina: checks 
fantaasso: bets €0.29
H.Quinn.1987: folds 
Neroonciolina: folds 
Uncalled bet (€0.29) returned to fantaasso
fantaasso collected €0.57 from pot
fantaasso: doesn't show hand 
*** SUMMARY ***
Total pot €0.60 | Rake €0.03 
Board [3s 6d 7h]
Seat 1: montemeru (button) folded before Flop (didn't bet)
Seat 2: robertoH2O (small blind) folded before Flop
Seat 3: caduceus369 (big blind) folded before Flop
Seat 4: H.Quinn.1987 folded on the Flop
Seat 5: Neroonciolina folded on the Flop
Seat 6: fantaasso collected (€0.57)



PokerStars Zoom Hand #257987775536:  Hold'em No Limit (€0.01/€0.02) [ADM ID: M62BA304494E32ST] - 2025/10/03 23:14:05 CET [2025/10/03 17:14:05 ET]
Table 'Sirio' 6-max Seat #1 is the button
Seat 1: caduceus369 (€1.78 in chips) 
Seat 2: Genny040893 (€0.65 in chips) 
Seat 3: Sium12302 (€2 in chips) 
Seat 4: ivano747 (€3.72 in chips) 
Seat 5: Quelle128 (€1.60 in chips) 
Seat 6: IKARO_3 (€1.98 in chips) 
Genny040893: posts small blind €0.01
Sium12302: posts big blind €0.02
*** HOLE CARDS ***
Dealt to caduceus369 [3d 9s]
ivano747: folds 
Quelle128: folds 
IKARO_3: raises €0.04 to €0.06
caduceus369: folds 
Genny040893: calls €0.05
Sium12302: folds 
*** FLOP *** [4c Jd 5s]
Genny040893: checks 
IKARO_3: bets €0.11
Genny040893: folds 
Uncalled bet (€0.11) returned to IKARO_3
IKARO_3 collected €0.14 from pot
IKARO_3: doesn't show hand 
*** SUMMARY ***
Total pot €0.14 | Rake €0 
Board [4c Jd 5s]
Seat 1: caduceus369 (button) folded before Flop (didn't bet)
Seat 2: Genny040893 (small blind) folded on the Flop
Seat 3: Sium12302 (big blind) folded before Flop
Seat 4: ivano747 folded before Flop (didn't bet)
Seat 5: Quelle128 folded before Flop (didn't bet)
Seat 6: IKARO_3 collected (€0.14)



PokerStars Zoom Hand #257987783895:  Hold'em No Limit (€0.01/€0.02) [ADM ID: M62BA304494E32ST] - 2025/10/03 23:14:39 CET [2025/10/03 17:14:39 ET]
Table 'Sirio' 6-max Seat #1 is the button
Seat 1: skynet0308 (€0.42 in chips) 
Seat 2: father2008 (€3.67 in chips) 
Seat 3: trillycata (€3.85 in chips) 
Seat 4: caduceus369 (€1.76 in chips) 
Seat 5: ivano747 (€4.85 in chips) 
Seat 6: robertoH2O (€2.67 in chips) 
father2008: posts small blind €0.01
trillycata: posts big blind €0.02
*** HOLE CARDS ***
Dealt to caduceus369 [3h Jd]
caduceus369: folds 
ivano747: folds 
robertoH2O: folds 
skynet0308: folds 
father2008: folds 
Uncalled bet (€0.01) returned to trillycata
trillycata collected €0.02 from pot
trillycata: doesn't show hand 
*** SUMMARY ***
Total pot €0.02 | Rake €0 
Seat 1: skynet0308 (button) folded before Flop (didn't bet)
Seat 2: father2008 (small blind) folded before Flop
Seat 3: trillycata (big blind) collected (€0.02)
Seat 4: caduceus369 folded before Flop (didn't bet)
Seat 5: ivano747 folded before Flop (didn't bet)
Seat 6: robertoH2O folded before Flop (didn't bet)



PokerStars Zoom Hand #257987785358:  Hold'em No Limit (€0.01/€0.02) [ADM ID: M62BA304494E32ST] - 2025/10/03 23:14:45 CET [2025/10/03 17:14:45 ET]
Table 'Sirio' 6-max Seat #1 is the button
Seat 1: Catania838 (€1.57 in chips) 
Seat 2: caduceus369 (€1.76 in chips) 
Seat 3: Neroonciolina (€2.14 in chips) 
Seat 4: ADRIAN0_MEIS (€3.38 in chips) 
Seat 5: ivano747 (€3.69 in chips) 
Seat 6: Sium12302 (€2.96 in chips) 
caduceus369: posts small blind €0.01
Neroonciolina: posts big blind €0.02
*** HOLE CARDS ***
Dealt to caduceus369 [Jc 4d]
ADRIAN0_MEIS: raises €0.05 to €0.07
ivano747: folds 
Sium12302: folds 
Catania838: folds 
caduceus369: folds 
Neroonciolina: folds 
Uncalled bet (€0.05) returned to ADRIAN0_MEIS
ADRIAN0_MEIS collected €0.05 from pot
ADRIAN0_MEIS: doesn't show hand 
*** SUMMARY ***
Total pot €0.05 | Rake €0 
Seat 1: Catania838 (button) folded before Flop (didn't bet)
Seat 2: caduceus369 (small blind) folded before Flop
Seat 3: Neroonciolina (big blind) folded before Flop
Seat 4: ADRIAN0_MEIS collected (€0.05)
Seat 5: ivano747 folded before Flop (didn't bet)
Seat 6: Sium12302 folded before Flop (didn't bet)



PokerStars Zoom Hand #257987790435:  Hold'em No Limit (€0.01/€0.02) [ADM ID: M62BA304494E32ST] - 2025/10/03 23:15:05 CET [2025/10/03 17:15:05 ET]
Table 'Sirio' 6-max Seat #1 is the button
Seat 1: il capo906 (€0.85 in chips) 
Seat 2: MOLDAVO1069 (€2.34 in chips) 
Seat 3: montemeru (€2.71 in chips) 
Seat 4: Sium12302 (€2.95 in chips) 
Seat 5: caduceus369 (€1.75 in chips) 
Seat 6: stfuplzudonk (€2.35 in chips) 
MOLDAVO1069: posts small blind €0.01
montemeru: posts big blind €0.02
*** HOLE CARDS ***
Dealt to caduceus369 [Ah Ac]
Sium12302: folds 
caduceus369: raises €0.04 to €0.06
stfuplzudonk: calls €0.06
il capo906: raises €0.79 to €0.85 and is all-in
MOLDAVO1069: folds 
montemeru: folds 
caduceus369: raises €0.90 to €1.75 and is all-in
stfuplzudonk: folds 
Uncalled bet (€0.90) returned to caduceus369
*** FLOP *** [9c 4c 6h]
*** TURN *** [9c 4c 6h] [2h]
*** RIVER *** [9c 4c 6h 2h] [3h]
*** SHOW DOWN ***
caduceus369: shows [Ah Ac] (a pair of Aces)
il capo906: shows [6s Ks] (a pair of Sixes)
caduceus369 collected €1.70 from pot
*** SUMMARY ***
Total pot €1.79 | Rake €0.09 
Board [9c 4c 6h 2h 3h]
Seat 1: il capo906 (button) showed [6s Ks] and lost with a pair of Sixes
Seat 2: MOLDAVO1069 (small blind) folded before Flop
Seat 3: montemeru (big blind) folded before Flop
Seat 4: Sium12302 folded before Flop (didn't bet)
Seat 5: caduceus369 showed [Ah Ac] and won (€1.70) with a pair of Aces
Seat 6: stfuplzudonk folded before Flop



PokerStars Zoom Hand #257987797410:  Hold'em No Limit (€0.01/€0.02) [ADM ID: M62BA304494E32ST] - 2025/10/03 23:15:33 CET [2025/10/03 17:15:33 ET]
Table 'Sirio' 6-max Seat #1 is the button
Seat 1: fantaasso (€2.19 in chips) 
Seat 2: caduceus369 (€2.60 in chips) 
Seat 3: skynet0308 (€0.42 in chips) 
Seat 4: H.Quinn.1987 (€2.83 in chips) 
Seat 5: Catania838 (€1.57 in chips) 
Seat 6: MOLDAVO1069 (€2.31 in chips) 
caduceus369: posts small blind €0.01
skynet0308: posts big blind €0.02
*** HOLE CARDS ***
Dealt to caduceus369 [9c 4d]
H.Quinn.1987: folds 
Catania838: folds 
MOLDAVO1069: folds 
fantaasso: raises €0.04 to €0.06
caduceus369: folds 
skynet0308: folds 
Uncalled bet (€0.04) returned to fantaasso
fantaasso collected €0.05 from pot
fantaasso: doesn't show hand 
*** SUMMARY ***
Total pot €0.05 | Rake €0 
Seat 1: fantaasso (button) collected (€0.05)
Seat 2: caduceus369 (small blind) folded before Flop
Seat 3: skynet0308 (big blind) folded before Flop
Seat 4: H.Quinn.1987 folded before Flop (didn't bet)
Seat 5: Catania838 folded before Flop (didn't bet)
Seat 6: MOLDAVO1069 folded before Flop (didn't bet)



PokerStars Zoom Hand #257987801326:  Hold'em No Limit (€0.01/€0.02) [ADM ID: M62BA304494E32ST] - 2025/10/03 23:15:49 CET [2025/10/03 17:15:49 ET]
Table 'Sirio' 6-max Seat #1 is the button
Seat 1: SidneyPrescott (€3.65 in chips) 
Seat 2: outshined8 (€1.18 in chips) 
Seat 3: caduceus369 (€2.59 in chips) 
Seat 4: trillycata (€3.84 in chips) 
Seat 5: curlinho (€1.41 in chips) 
Seat 6: ahehihohuh0 (€0.92 in chips) 
outshined8: posts small blind €0.01
caduceus369: posts big blind €0.02
*** HOLE CARDS ***
Dealt to caduceus369 [6h Td]
trillycata: folds 
curlinho: folds 
ahehihohuh0: folds 
SidneyPrescott: folds 
outshined8: folds 
Uncalled bet (€0.01) returned to caduceus369
caduceus369 collected €0.02 from pot
caduceus369: doesn't show hand 
*** SUMMARY ***
Total pot €0.02 | Rake €0 
Seat 1: SidneyPrescott (button) folded before Flop (didn't bet)
Seat 2: outshined8 (small blind) folded before Flop
Seat 3: caduceus369 (big blind) collected (€0.02)
Seat 4: trillycata folded before Flop (didn't bet)
Seat 5: curlinho folded before Flop (didn't bet)
Seat 6: ahehihohuh0 folded before Flop (didn't bet)



PokerStars Zoom Hand #257987799106:  Hold'em No Limit (€0.01/€0.02) [ADM ID: M62BA304494E32ST] - 2025/10/03 23:15:40 CET [2025/10/03 17:15:40 ET]
Table 'Sirio' 6-max Seat #1 is the button
Seat 1: caduceus369 (€2.59 in chips) 
Seat 2: sgiafun (€0.40 in chips) 
Seat 3: H.Quinn.1987 (€3.73 in chips) 
Seat 4: Mr_Frost02 (€1.15 in chips) 
Seat 5: rounders121282 (€6.05 in chips) 
Seat 6: Generalexx (€1.63 in chips) 
sgiafun: posts small blind €0.01
H.Quinn.1987: posts big blind €0.02
*** HOLE CARDS ***
Dealt to caduceus369 [Th Qc]
Mr_Frost02: folds 
rounders121282: calls €0.02
Generalexx: calls €0.02
caduceus369: folds 
sgiafun: calls €0.01
H.Quinn.1987: checks 
*** FLOP *** [7c 5h 6h]
sgiafun: bets €0.02
H.Quinn.1987: folds 
rounders121282: calls €0.02
Generalexx: calls €0.02
*** TURN *** [7c 5h 6h] [4c]
sgiafun: bets €0.36 and is all-in
rounders121282: folds 
Generalexx: calls €0.36
*** RIVER *** [7c 5h 6h 4c] [2h]
*** SHOW DOWN ***
sgiafun: shows [Ks 8d] (a straight, Four to Eight)
Generalexx: shows [6c 7s] (two pair, Sevens and Sixes)
sgiafun collected €0.82 from pot
*** SUMMARY ***
Total pot €0.86 | Rake €0.04 
Board [7c 5h 6h 4c 2h]
Seat 1: caduceus369 (button) folded before Flop (didn't bet)
Seat 2: sgiafun (small blind) showed [Ks 8d] and won (€0.82) with a straight, Four to Eight
Seat 3: H.Quinn.1987 (big blind) folded on the Flop
Seat 4: Mr_Frost02 folded before Flop (didn't bet)
Seat 5: rounders121282 folded on the Turn
Seat 6: Generalexx showed [6c 7s] and lost with two pair, Sevens and Sixes



PokerStars Zoom Hand #257987809642:  Hold'em No Limit (€0.01/€0.02) [ADM ID: M62BA304494E32ST] - 2025/10/03 23:16:22 CET [2025/10/03 17:16:22 ET]
Table 'Sirio' 6-max Seat #1 is the button
Seat 1: MOLDAVO1069 (€9.40 in chips) 
Seat 2: SidneyPrescott (€3.63 in chips) 
Seat 3: ivano747 (€4.64 in chips) 
Seat 4: caduceus369 (€2.60 in chips) 
Seat 5: cartoonbest (€0.88 in chips) 
Seat 6: Genny040893 (€0.42 in chips) 
SidneyPrescott: posts small blind €0.01
ivano747: posts big blind €0.02
*** HOLE CARDS ***
Dealt to caduceus369 [Qh 6s]
caduceus369: folds 
cartoonbest: folds 
Genny040893: folds 
MOLDAVO1069: folds 
SidneyPrescott: folds 
Uncalled bet (€0.01) returned to ivano747
ivano747 collected €0.02 from pot
ivano747: doesn't show hand 
*** SUMMARY ***
Total pot €0.02 | Rake €0 
Seat 1: MOLDAVO1069 (button) folded before Flop (didn't bet)
Seat 2: SidneyPrescott (small blind) folded before Flop
Seat 3: ivano747 (big blind) collected (€0.02)
Seat 4: caduceus369 folded before Flop (didn't bet)
Seat 5: cartoonbest folded before Flop (didn't bet)
Seat 6: Genny040893 folded before Flop (didn't bet)



PokerStars Zoom Hand #257987805366:  Hold'em No Limit (€0.01/€0.02) [ADM ID: M62BA304494E32ST] - 2025/10/03 23:16:05 CET [2025/10/03 17:16:05 ET]
Table 'Sirio' 6-max Seat #1 is the button
Seat 1: H.Quinn.1987 (€3.71 in chips) 
Seat 2: Sium12302 (€4.22 in chips) 
Seat 3: skynet0308 (€0.39 in chips) 
Seat 4: J.S.Somers (€1.52 in chips) 
Seat 5: outshined8 (€1.17 in chips) 
Seat 6: caduceus369 (€2.60 in chips) 
Sium12302: posts small blind €0.01
skynet0308: posts big blind €0.02
*** HOLE CARDS ***
Dealt to caduceus369 [6s 3d]
J.S.Somers: raises €0.03 to €0.05
outshined8: calls €0.05
caduceus369: folds 
H.Quinn.1987: folds 
Sium12302: folds 
skynet0308: calls €0.03
*** FLOP *** [Ac 2h 3c]
skynet0308: checks 
J.S.Somers: checks 
outshined8: bets €0.02
skynet0308: folds 
J.S.Somers: calls €0.02
*** TURN *** [Ac 2h 3c] [Td]
J.S.Somers: checks 
outshined8: bets €0.02
J.S.Somers: folds 
Uncalled bet (€0.02) returned to outshined8
outshined8 collected €0.19 from pot
outshined8: doesn't show hand 
*** SUMMARY ***
Total pot €0.20 | Rake €0.01 
Board [Ac 2h 3c Td]
Seat 1: H.Quinn.1987 (button) folded before Flop (didn't bet)
Seat 2: Sium12302 (small blind) folded before Flop
Seat 3: skynet0308 (big blind) folded on the Flop
Seat 4: J.S.Somers folded on the Turn
Seat 5: outshined8 collected (€0.19)
Seat 6: caduceus369 folded before Flop (didn't bet)



PokerStars Zoom Hand #257987810431:  Hold'em No Limit (€0.01/€0.02) [ADM ID: M62BA304494E32ST] - 2025/10/03 23:16:25 CET [2025/10/03 17:16:25 ET]
Table 'Sirio' 6-max Seat #1 is the button
Seat 1: SidneyPrescott (€6.18 in chips) 
Seat 2: father2008 (€6.31 in chips) 
Seat 3: Catania838 (€1.66 in chips) 
Seat 4: AIA427 (€1.41 in chips) 
Seat 5: montemeru (€2.66 in chips) 
Seat 6: caduceus369 (€2.60 in chips) 
father2008: posts small blind €0.01
Catania838: posts big blind €0.02
*** HOLE CARDS ***
Dealt to caduceus369 [6h 7c]
AIA427: calls €0.02
montemeru: raises €0.07 to €0.09
caduceus369: folds 
SidneyPrescott: folds 
father2008: folds 
Catania838: folds 
AIA427: folds 
Uncalled bet (€0.07) returned to montemeru
montemeru collected €0.07 from pot
montemeru: doesn't show hand 
*** SUMMARY ***
Total pot €0.07 | Rake €0 
Seat 1: SidneyPrescott (button) folded before Flop (didn't bet)
Seat 2: father2008 (small blind) folded before Flop
Seat 3: Catania838 (big blind) folded before Flop
Seat 4: AIA427 folded before Flop
Seat 5: montemeru collected (€0.07)
Seat 6: caduceus369 folded before Flop (didn't bet)



PokerStars Zoom Hand #257987806888:  Hold'em No Limit (€0.01/€0.02) [ADM ID: M62BA304494E32ST] - 2025/10/03 23:16:11 CET [2025/10/03 17:16:11 ET]
Table 'Sirio' 6-max Seat #1 is the button
Seat 1: father2008 (€3.66 in chips) 
Seat 2: MOLDAVO1069 (€9.41 in chips) 
Seat 3: H.Quinn.1987 (€3.71 in chips) 
Seat 4: rounders121282 (€6 in chips) 
Seat 5: caduceus369 (€2.60 in chips) 
Seat 6: Chia9711 (€2.17 in chips) 
MOLDAVO1069: posts small blind €0.01
H.Quinn.1987: posts big blind €0.02
*** HOLE CARDS ***
Dealt to caduceus369 [Kd 9s]
rounders121282: calls €0.02
caduceus369: folds 
Chia9711: calls €0.02
father2008: folds 
MOLDAVO1069: folds 
H.Quinn.1987: checks 
*** FLOP *** [As 3s 8c]
H.Quinn.1987: checks 
rounders121282: checks 
Chia9711: bets €0.04
H.Quinn.1987: folds 
rounders121282: folds 
Uncalled bet (€0.04) returned to Chia9711
Chia9711 collected €0.07 from pot
Chia9711: doesn't show hand 
*** SUMMARY ***
Total pot €0.07 | Rake €0 
Board [As 3s 8c]
Seat 1: father2008 (button) folded before Flop (didn't bet)
Seat 2: MOLDAVO1069 (small blind) folded before Flop
Seat 3: H.Quinn.1987 (big blind) folded on the Flop
Seat 4: rounders121282 folded on the Flop
Seat 5: caduceus369 folded before Flop (didn't bet)
Seat 6: Chia9711 collected (€0.07)



PokerStars Zoom Hand #257987811900:  Hold'em No Limit (€0.01/€0.02) [ADM ID: M62BA304494E32ST] - 2025/10/03 23:16:31 CET [2025/10/03 17:16:31 ET]
Table 'Sirio' 6-max Seat #1 is the button
Seat 1: skynet0308 (€0.34 in chips) 
Seat 2: lucpri (€2.36 in chips) 
Seat 3: caduceus369 (€2.60 in chips) 
Seat 4: ivano747 (€4.65 in chips) 
Seat 5: SidneyPrescott (€6.18 in chips) 
Seat 6: MOLDAVO1069 (€2.39 in chips) 
lucpri: posts small blind €0.01
caduceus369: posts big blind €0.02
*** HOLE CARDS ***
Dealt to caduceus369 [Js 4d]
ivano747: folds 
SidneyPrescott: folds 
MOLDAVO1069: folds 
skynet0308: raises €0.04 to €0.06
lucpri: folds 
caduceus369: folds 
Uncalled bet (€0.04) returned to skynet0308
skynet0308 collected €0.05 from pot
skynet0308: doesn't show hand 
*** SUMMARY ***
Total pot €0.05 | Rake €0 
Seat 1: skynet0308 (button) collected (€0.05)
Seat 2: lucpri (small blind) folded before Flop
Seat 3: caduceus369 (big blind) folded before Flop
Seat 4: ivano747 folded before Flop (didn't bet)
Seat 5: SidneyPrescott folded before Flop (didn't bet)
Seat 6: MOLDAVO1069 folded before Flop (didn't bet)



PokerStars Zoom Hand #257987816367:  Hold'em No Limit (€0.01/€0.02) [ADM ID: M62BA304494E32ST] - 2025/10/03 23:16:49 CET [2025/10/03 17:16:49 ET]
Table 'Sirio' 6-max Seat #1 is the button
Seat 1: ivano747 (€4.64 in chips) 
Seat 2: caduceus369 (€2.58 in chips) 
Seat 3: MOLDAVO1069 (€2.39 in chips) 
Seat 4: H.Quinn.1987 (€3.68 in chips) 
Seat 5: AlwaisToRun (€0.67 in chips) 
Seat 6: ADRIAN0_MEIS (€3.52 in chips) 
caduceus369: posts small blind €0.01
MOLDAVO1069: posts big blind €0.02
*** HOLE CARDS ***
Dealt to caduceus369 [7d Qc]
H.Quinn.1987: raises €0.04 to €0.06
AlwaisToRun: folds 
ADRIAN0_MEIS: folds 
ivano747: folds 
caduceus369: folds 
MOLDAVO1069: folds 
Uncalled bet (€0.04) returned to H.Quinn.1987
H.Quinn.1987 collected €0.05 from pot
H.Quinn.1987: doesn't show hand 
*** SUMMARY ***
Total pot €0.05 | Rake €0 
Seat 1: ivano747 (button) folded before Flop (didn't bet)
Seat 2: caduceus369 (small blind) folded before Flop
Seat 3: MOLDAVO1069 (big blind) folded before Flop
Seat 4: H.Quinn.1987 collected (€0.05)
Seat 5: AlwaisToRun folded before Flop (didn't bet)
Seat 6: ADRIAN0_MEIS folded before Flop (didn't bet)



PokerStars Zoom Hand #257987818344:  Hold'em No Limit (€0.01/€0.02) [ADM ID: M62BA304494E32ST] - 2025/10/03 23:16:57 CET [2025/10/03 17:16:57 ET]
Table 'Sirio' 6-max Seat #1 is the button
Seat 1: caduceus369 (€2.57 in chips) 
Seat 2: AlwaisToRun (€0.67 in chips) 
Seat 3: Witness85906 (€4.34 in chips) 
Seat 4: MOLDAVO1069 (€9.40 in chips) 
Seat 5: skynet0308 (€0.36 in chips) 
Seat 6: stfuplzudonk (€3.24 in chips) 
AlwaisToRun: posts small blind €0.01
Witness85906: posts big blind €0.02
*** HOLE CARDS ***
Dealt to caduceus369 [9d 3s]
MOLDAVO1069: folds 
skynet0308: folds 
stfuplzudonk: raises €0.02 to €0.04
caduceus369: folds 
AlwaisToRun: folds 
Witness85906: folds 
Uncalled bet (€0.02) returned to stfuplzudonk
stfuplzudonk collected €0.05 from pot
stfuplzudonk: doesn't show hand 
*** SUMMARY ***
Total pot €0.05 | Rake €0 
Seat 1: caduceus369 (button) folded before Flop (didn't bet)
Seat 2: AlwaisToRun (small blind) folded before Flop
Seat 3: Witness85906 (big blind) folded before Flop
Seat 4: MOLDAVO1069 folded before Flop (didn't bet)
Seat 5: skynet0308 folded before Flop (didn't bet)
Seat 6: stfuplzudonk collected (€0.05)



PokerStars Zoom Hand #257987823007:  Hold'em No Limit (€0.01/€0.02) [ADM ID: M62BA304494E32ST] - 2025/10/03 23:17:17 CET [2025/10/03 17:17:17 ET]
Table 'Sirio' 6-max Seat #1 is the button
Seat 1: SidneyPrescott (€3.59 in chips) 
Seat 2: lucpri (€2.36 in chips) 
Seat 3: stfuplzudonk (€3.27 in chips) 
Seat 4: ivano747 (€3.03 in chips) 
Seat 5: caduceus369 (€2.57 in chips) 
Seat 6: Catania838 (€1.63 in chips) 
lucpri: posts small blind €0.01
stfuplzudonk: posts big blind €0.02
*** HOLE CARDS ***
Dealt to caduceus369 [8h 4d]
ivano747: folds 
caduceus369: folds 
Catania838: folds 
SidneyPrescott: raises €0.06 to €0.08
lucpri: folds 
stfuplzudonk: raises €0.17 to €0.25
SidneyPrescott: folds 
Uncalled bet (€0.17) returned to stfuplzudonk
stfuplzudonk collected €0.17 from pot
stfuplzudonk: doesn't show hand 
*** SUMMARY ***
Total pot €0.17 | Rake €0 
Seat 1: SidneyPrescott (button) folded before Flop
Seat 2: lucpri (small blind) folded before Flop
Seat 3: stfuplzudonk (big blind) collected (€0.17)
Seat 4: ivano747 folded before Flop (didn't bet)
Seat 5: caduceus369 folded before Flop (didn't bet)
Seat 6: Catania838 folded before Flop (didn't bet)



PokerStars Zoom Hand #257987824108:  Hold'em No Limit (€0.01/€0.02) [ADM ID: M62BA304494E32ST] - 2025/10/03 23:17:21 CET [2025/10/03 17:17:21 ET]
Table 'Sirio' 6-max Seat #1 is the button
Seat 1: TripInter (€1.21 in chips) 
Seat 2: fantaasso (€2.57 in chips) 
Seat 3: MOLDAVO1069 (€9.40 in chips) 
Seat 4: caduceus369 (€2.57 in chips) 
Seat 5: robertoH2O (€3.51 in chips) 
Seat 6: Mr_Frost02 (€1.15 in chips) 
fantaasso: posts small blind €0.01
MOLDAVO1069: posts big blind €0.02
*** HOLE CARDS ***
Dealt to caduceus369 [Th 4d]
caduceus369: folds 
robertoH2O: folds 
Mr_Frost02: raises €0.04 to €0.06
TripInter: folds 
fantaasso: folds 
MOLDAVO1069: folds 
Uncalled bet (€0.04) returned to Mr_Frost02
Mr_Frost02 collected €0.05 from pot
Mr_Frost02: doesn't show hand 
*** SUMMARY ***
Total pot €0.05 | Rake €0 
Seat 1: TripInter (button) folded before Flop (didn't bet)
Seat 2: fantaasso (small blind) folded before Flop
Seat 3: MOLDAVO1069 (big blind) folded before Flop
Seat 4: caduceus369 folded before Flop (didn't bet)
Seat 5: robertoH2O folded before Flop (didn't bet)
Seat 6: Mr_Frost02 collected (€0.05)



PokerStars Zoom Hand #257987821468:  Hold'em No Limit (€0.01/€0.02) [ADM ID: M62BA304494E32ST] - 2025/10/03 23:17:10 CET [2025/10/03 17:17:10 ET]
Table 'Sirio' 6-max Seat #1 is the button
Seat 1: father2008 (€6.31 in chips) 
Seat 2: outshined8 (€1.11 in chips) 
Seat 3: gs0097 (€0.49 in chips) 
Seat 4: caduceus369 (€2.57 in chips) 
Seat 5: CacciatoreAA (€3.48 in chips) 
Seat 6: rounders121282 (€5.96 in chips) 
outshined8: posts small blind €0.01
gs0097: posts big blind €0.02
*** HOLE CARDS ***
Dealt to caduceus369 [2d 4s]
caduceus369: folds 
CacciatoreAA: raises €0.06 to €0.08
rounders121282: calls €0.08
father2008: folds 
outshined8: calls €0.07
gs0097: folds 
*** FLOP *** [Js Qs Jc]
outshined8: bets €0.13
CacciatoreAA: folds 
rounders121282: folds 
Uncalled bet (€0.13) returned to outshined8
outshined8 collected €0.25 from pot
outshined8: doesn't show hand 
*** SUMMARY ***
Total pot €0.26 | Rake €0.01 
Board [Js Qs Jc]
Seat 1: father2008 (button) folded before Flop (didn't bet)
Seat 2: outshined8 (small blind) collected (€0.25)
Seat 3: gs0097 (big blind) folded before Flop
Seat 4: caduceus369 folded before Flop (didn't bet)
Seat 5: CacciatoreAA folded on the Flop
Seat 6: rounders121282 folded on the Flop



PokerStars Zoom Hand #257987825276:  Hold'em No Limit (€0.01/€0.02) [ADM ID: M62BA304494E32ST] - 2025/10/03 23:17:26 CET [2025/10/03 17:17:26 ET]
Table 'Sirio' 6-max Seat #1 is the button
Seat 1: robertoH2O (€3.51 in chips) 
Seat 2: J.S.Somers (€1.03 in chips) 
Seat 3: caduceus369 (€2.57 in chips) 
Seat 4: TripInter (€1.21 in chips) 
Seat 5: Catania838 (€1.63 in chips) 
Seat 6: Chia9711 (€2.19 in chips) 
J.S.Somers: posts small blind €0.01
caduceus369: posts big blind €0.02
*** HOLE CARDS ***
Dealt to caduceus369 [Qs 4d]
TripInter: folds 
Catania838: calls €0.02
Chia9711: calls €0.02
robertoH2O: folds 
J.S.Somers: folds 
caduceus369: checks 
*** FLOP *** [Jc Kd Jh]
caduceus369: checks 
Catania838: bets €1.61 and is all-in
Chia9711: folds 
caduceus369: folds 
Uncalled bet (€1.61) returned to Catania838
Catania838 collected €0.07 from pot
Catania838: doesn't show hand 
*** SUMMARY ***
Total pot €0.07 | Rake €0 
Board [Jc Kd Jh]
Seat 1: robertoH2O (button) folded before Flop (didn't bet)
Seat 2: J.S.Somers (small blind) folded before Flop
Seat 3: caduceus369 (big blind) folded on the Flop
Seat 4: TripInter folded before Flop (didn't bet)
Seat 5: Catania838 collected (€0.07)
Seat 6: Chia9711 folded on the Flop



PokerStars Zoom Hand #257987832575:  Hold'em No Limit (€0.01/€0.02) [ADM ID: M62BA304494E32ST] - 2025/10/03 23:17:56 CET [2025/10/03 17:17:56 ET]
Table 'Sirio' 6-max Seat #1 is the button
Seat 1: caduceus369 (€2.55 in chips) 
Seat 2: ADRIAN0_MEIS (€6.76 in chips) 
Seat 3: cartoonbest (€1.08 in chips) 
Seat 4: Chia9711 (€2.17 in chips) 
Seat 5: stfuplzudonk (€2.55 in chips) 
Seat 6: AlwaisToRun (€0.64 in chips) 
ADRIAN0_MEIS: posts small blind €0.01
cartoonbest: posts big blind €0.02
*** HOLE CARDS ***
Dealt to caduceus369 [3c 4c]
Chia9711: folds 
stfuplzudonk: raises €0.02 to €0.04
AlwaisToRun: folds 
caduceus369: folds 
ADRIAN0_MEIS: folds 
cartoonbest: folds 
Uncalled bet (€0.02) returned to stfuplzudonk
stfuplzudonk collected €0.05 from pot
stfuplzudonk: doesn't show hand 
*** SUMMARY ***
Total pot €0.05 | Rake €0 
Seat 1: caduceus369 (button) folded before Flop (didn't bet)
Seat 2: ADRIAN0_MEIS (small blind) folded before Flop
Seat 3: cartoonbest (big blind) folded before Flop
Seat 4: Chia9711 folded before Flop (didn't bet)
Seat 5: stfuplzudonk collected (€0.05)
Seat 6: AlwaisToRun folded before Flop (didn't bet)



PokerStars Zoom Hand #257987833594:  Hold'em No Limit (€0.01/€0.02) [ADM ID: M62BA304494E32ST] - 2025/10/03 23:18:00 CET [2025/10/03 17:18:00 ET]
Table 'Sirio' 6-max Seat #1 is the button
Seat 1: pia1256 (€0.83 in chips) 
Seat 2: neoilnervoso (€1.98 in chips) 
Seat 3: Witness85906 (€4.39 in chips) 
Seat 4: caduceus369 (€2.55 in chips) 
Seat 5: skynet0308 (€1.03 in chips) 
Seat 6: ivano747 (€4.58 in chips) 
neoilnervoso: posts small blind €0.01
Witness85906: posts big blind €0.02
*** HOLE CARDS ***
Dealt to caduceus369 [Qc Qs]
caduceus369: raises €0.04 to €0.06
skynet0308: folds 
ivano747: folds 
pia1256: calls €0.06
neoilnervoso: folds 
Witness85906: folds 
*** FLOP *** [Ts 9d Js]
caduceus369: checks 
pia1256: checks 
*** TURN *** [Ts 9d Js] [5c]
caduceus369: bets €0.02
pia1256: calls €0.02
*** RIVER *** [Ts 9d Js 5c] [Ks]
caduceus369: bets €0.24
pia1256: calls €0.24
*** SHOW DOWN ***
caduceus369: shows [Qc Qs] (a straight, Nine to King)
pia1256: shows [3d Qd] (a straight, Nine to King)
caduceus369 collected €0.32 from pot
pia1256 collected €0.32 from pot
*** SUMMARY ***
Total pot €0.67 | Rake €0.03 
Board [Ts 9d Js 5c Ks]
Seat 1: pia1256 (button) showed [3d Qd] and won (€0.32) with a straight, Nine to King
Seat 2: neoilnervoso (small blind) folded before Flop
Seat 3: Witness85906 (big blind) folded before Flop
Seat 4: caduceus369 showed [Qc Qs] and won (€0.32) with a straight, Nine to King
Seat 5: skynet0308 folded before Flop (didn't bet)
Seat 6: ivano747 folded before Flop (didn't bet)



PokerStars Zoom Hand #257987846314:  Hold'em No Limit (€0.01/€0.02) [ADM ID: M62BA304494E32ST] - 2025/10/03 23:18:53 CET [2025/10/03 17:18:53 ET]
Table 'Sirio' 6-max Seat #1 is the button
Seat 1: MOLDAVO1069 (€2.35 in chips) 
Seat 2: macchia1010 (€1.24 in chips) 
Seat 3: father2008 (€3.59 in chips) 
Seat 4: AIA427 (€1.35 in chips) 
Seat 5: SidneyPrescott (€3.59 in chips) 
Seat 6: caduceus369 (€2.54 in chips) 
macchia1010: posts small blind €0.01
father2008: posts big blind €0.02
*** HOLE CARDS ***
Dealt to caduceus369 [5c Ks]
AIA427: folds 
SidneyPrescott: raises €0.04 to €0.06
caduceus369: folds 
MOLDAVO1069: folds 
macchia1010: folds 
father2008: folds 
Uncalled bet (€0.04) returned to SidneyPrescott
SidneyPrescott collected €0.05 from pot
SidneyPrescott: doesn't show hand 
*** SUMMARY ***
Total pot €0.05 | Rake €0 
Seat 1: MOLDAVO1069 (button) folded before Flop (didn't bet)
Seat 2: macchia1010 (small blind) folded before Flop
Seat 3: father2008 (big blind) folded before Flop
Seat 4: AIA427 folded before Flop (didn't bet)
Seat 5: SidneyPrescott collected (€0.05)
Seat 6: caduceus369 folded before Flop (didn't bet)



PokerStars Zoom Hand #257987843490:  Hold'em No Limit (€0.01/€0.02) [ADM ID: M62BA304494E32ST] - 2025/10/03 23:18:41 CET [2025/10/03 17:18:41 ET]
Table 'Sirio' 6-max Seat #1 is the button
Seat 1: father2008 (€3.59 in chips) 
Seat 2: caduceus369 (€2.55 in chips) 
Seat 3: Catania838 (€1.82 in chips) 
Seat 4: pia1256 (€0.83 in chips) 
Seat 5: stfuplzudonk (€3.29 in chips) 
Seat 6: SidneyPrescott (€3.59 in chips) 
caduceus369: posts small blind €0.01
Catania838: posts big blind €0.02
*** HOLE CARDS ***
Dealt to caduceus369 [3d 3s]
pia1256: folds 
stfuplzudonk: raises €0.04 to €0.06
SidneyPrescott: folds 
father2008: folds 
caduceus369: folds 
Catania838: calls €0.04
*** FLOP *** [4c Kh Jh]
Catania838: checks 
stfuplzudonk: bets €0.07
Catania838: calls €0.07
*** TURN *** [4c Kh Jh] [Ac]
Catania838: checks 
stfuplzudonk: checks 
*** RIVER *** [4c Kh Jh Ac] [Js]
Catania838: bets €0.13
stfuplzudonk: folds 
Uncalled bet (€0.13) returned to Catania838
Catania838 collected €0.26 from pot
Catania838: doesn't show hand 
*** SUMMARY ***
Total pot €0.27 | Rake €0.01 
Board [4c Kh Jh Ac Js]
Seat 1: father2008 (button) folded before Flop (didn't bet)
Seat 2: caduceus369 (small blind) folded before Flop
Seat 3: Catania838 (big blind) collected (€0.26)
Seat 4: pia1256 folded before Flop (didn't bet)
Seat 5: stfuplzudonk folded on the River
Seat 6: SidneyPrescott folded before Flop (didn't bet)



PokerStars Zoom Hand #257987847299:  Hold'em No Limit (€0.01/€0.02) [ADM ID: M62BA304494E32ST] - 2025/10/03 23:18:57 CET [2025/10/03 17:18:57 ET]
Table 'Sirio' 6-max Seat #1 is the button
Seat 1: stfuplzudonk (€1.76 in chips) 
Seat 2: Catania838 (€1.63 in chips) 
Seat 3: lucpri (€2.32 in chips) 
Seat 4: ahehihohuh0 (€0.96 in chips) 
Seat 5: caduceus369 (€2.54 in chips) 
Seat 6: cartoonbest (€0.99 in chips) 
Catania838: posts small blind €0.01
lucpri: posts big blind €0.02
*** HOLE CARDS ***
Dealt to caduceus369 [7d 8h]
ahehihohuh0: raises €0.02 to €0.04
caduceus369: folds 
cartoonbest: calls €0.04
stfuplzudonk: folds 
Catania838: folds 
lucpri: calls €0.02
*** FLOP *** [6h Qc 9d]
lucpri: checks 
ahehihohuh0: bets €0.07
cartoonbest: raises €0.09 to €0.16
lucpri: folds 
ahehihohuh0: folds 
Uncalled bet (€0.09) returned to cartoonbest
cartoonbest collected €0.26 from pot
cartoonbest: doesn't show hand 
*** SUMMARY ***
Total pot €0.27 | Rake €0.01 
Board [6h Qc 9d]
Seat 1: stfuplzudonk (button) folded before Flop (didn't bet)
Seat 2: Catania838 (small blind) folded before Flop
Seat 3: lucpri (big blind) folded on the Flop
Seat 4: ahehihohuh0 folded on the Flop
Seat 5: caduceus369 folded before Flop (didn't bet)
Seat 6: cartoonbest collected (€0.26)



PokerStars Zoom Hand #257987849716:  Hold'em No Limit (€0.01/€0.02) [ADM ID: M62BA304494E32ST] - 2025/10/03 23:19:07 CET [2025/10/03 17:19:07 ET]
Table 'Sirio' 6-max Seat #1 is the button
Seat 1: skynet0308 (€0.62 in chips) 
Seat 2: ADRIAN0_MEIS (€9.17 in chips) 
Seat 3: caduceus369 (€2.54 in chips) 
Seat 4: trillycata (€4.04 in chips) 
Seat 5: J.S.Somers (€2.19 in chips) 
Seat 6: MOLDAVO1069 (€9.41 in chips) 
ADRIAN0_MEIS: posts small blind €0.01
caduceus369: posts big blind €0.02
*** HOLE CARDS ***
Dealt to caduceus369 [As 5d]
trillycata: folds 
J.S.Somers: folds 
MOLDAVO1069: raises €0.03 to €0.05
skynet0308: folds 
ADRIAN0_MEIS: folds 
caduceus369: calls €0.03
*** FLOP *** [6d 9h Js]
caduceus369: checks 
MOLDAVO1069: bets €0.05
caduceus369: raises €0.11 to €0.16
MOLDAVO1069: folds 
Uncalled bet (€0.11) returned to caduceus369
caduceus369 collected €0.20 from pot
caduceus369: doesn't show hand 
*** SUMMARY ***
Total pot €0.21 | Rake €0.01 
Board [6d 9h Js]
Seat 1: skynet0308 (button) folded before Flop (didn't bet)
Seat 2: ADRIAN0_MEIS (small blind) folded before Flop
Seat 3: caduceus369 (big blind) collected (€0.20)
Seat 4: trillycata folded before Flop (didn't bet)
Seat 5: J.S.Somers folded before Flop (didn't bet)
Seat 6: MOLDAVO1069 folded on the Flop



PokerStars Zoom Hand #257987864262:  Hold'em No Limit (€0.01/€0.02) [ADM ID: M62BA304494E32ST] - 2025/10/03 23:20:07 CET [2025/10/03 17:20:07 ET]
Table 'Sirio' 6-max Seat #1 is the button
Seat 1: outshined8 (€0.97 in chips) 
Seat 2: cartoonbest (€1.15 in chips) 
Seat 3: ivano747 (€2.84 in chips) 
Seat 4: stfuplzudonk (€1.70 in chips) 
Seat 5: caduceus369 (€2.64 in chips) 
Seat 6: fantaasso (€2.59 in chips) 
cartoonbest: posts small blind €0.01
ivano747: posts big blind €0.02
*** HOLE CARDS ***
Dealt to caduceus369 [9h 8h]
stfuplzudonk: raises €0.04 to €0.06
caduceus369: folds 
fantaasso: folds 
outshined8: folds 
cartoonbest: folds 
ivano747: folds 
Uncalled bet (€0.04) returned to stfuplzudonk
stfuplzudonk collected €0.05 from pot
stfuplzudonk: doesn't show hand 
*** SUMMARY ***
Total pot €0.05 | Rake €0 
Seat 1: outshined8 (button) folded before Flop (didn't bet)
Seat 2: cartoonbest (small blind) folded before Flop
Seat 3: ivano747 (big blind) folded before Flop
Seat 4: stfuplzudonk collected (€0.05)
Seat 5: caduceus369 folded before Flop (didn't bet)
Seat 6: fantaasso folded before Flop (didn't bet)



PokerStars Zoom Hand #257987868258:  Hold'em No Limit (€0.01/€0.02) [ADM ID: M62BA304494E32ST] - 2025/10/03 23:20:23 CET [2025/10/03 17:20:23 ET]
Table 'Sirio' 6-max Seat #1 is the button
Seat 1: father2008 (€6.30 in chips) 
Seat 2: caduceus369 (€2.64 in chips) 
Seat 3: outshined8 (€0.97 in chips) 
Seat 4: skynet0308 (€0.58 in chips) 
Seat 5: J.S.Somers (€1.87 in chips) 
Seat 6: Catania838 (€1.59 in chips) 
caduceus369: posts small blind €0.01
outshined8: posts big blind €0.02
*** HOLE CARDS ***
Dealt to caduceus369 [Ad Ts]
skynet0308: folds 
J.S.Somers: folds 
Catania838: folds 
father2008 has timed out
father2008: folds 
caduceus369: calls €0.01
outshined8: checks 
*** FLOP *** [8h 6s 2c]
caduceus369: checks 
outshined8: bets €0.02
caduceus369: calls €0.02
*** TURN *** [8h 6s 2c] [5d]
caduceus369: checks 
outshined8: bets €0.02
caduceus369: folds 
Uncalled bet (€0.02) returned to outshined8
outshined8 collected €0.08 from pot
outshined8: doesn't show hand 
*** SUMMARY ***
Total pot €0.08 | Rake €0 
Board [8h 6s 2c 5d]
Seat 1: father2008 (button) folded before Flop (didn't bet)
Seat 2: caduceus369 (small blind) folded on the Turn
Seat 3: outshined8 (big blind) collected (€0.08)
Seat 4: skynet0308 folded before Flop (didn't bet)
Seat 5: J.S.Somers folded before Flop (didn't bet)
Seat 6: Catania838 folded before Flop (didn't bet)



PokerStars Zoom Hand #257987879510:  Hold'em No Limit (€0.01/€0.02) [ADM ID: M62BA304494E32ST] - 2025/10/03 23:21:10 CET [2025/10/03 17:21:10 ET]
Table 'Sirio' 6-max Seat #1 is the button
Seat 1: caduceus369 (€2.60 in chips) 
Seat 2: stfuplzudonk (€4.53 in chips) 
Seat 3: EasyToRule (€2.45 in chips) 
Seat 4: ADRIAN0_MEIS (€3.28 in chips) 
Seat 5: sgiafun (€0.58 in chips) 
Seat 6: robertoH2O (€3.65 in chips) 
stfuplzudonk: posts small blind €0.01
EasyToRule: posts big blind €0.02
*** HOLE CARDS ***
Dealt to caduceus369 [9h 5d]
ADRIAN0_MEIS: folds 
sgiafun: folds 
robertoH2O: raises €0.03 to €0.05
caduceus369: folds 
stfuplzudonk: folds 
EasyToRule: folds 
Uncalled bet (€0.03) returned to robertoH2O
robertoH2O collected €0.05 from pot
robertoH2O: doesn't show hand 
*** SUMMARY ***
Total pot €0.05 | Rake €0 
Seat 1: caduceus369 (button) folded before Flop (didn't bet)
Seat 2: stfuplzudonk (small blind) folded before Flop
Seat 3: EasyToRule (big blind) folded before Flop
Seat 4: ADRIAN0_MEIS folded before Flop (didn't bet)
Seat 5: sgiafun folded before Flop (didn't bet)
Seat 6: robertoH2O collected (€0.05)



PokerStars Zoom Hand #257987881888:  Hold'em No Limit (€0.01/€0.02) [ADM ID: M62BA304494E32ST] - 2025/10/03 23:21:19 CET [2025/10/03 17:21:19 ET]
Table 'Sirio' 6-max Seat #1 is the button
Seat 1: sgiafun (€0.58 in chips) 
Seat 2: SidneyPrescott (€3.87 in chips) 
Seat 3: cartoonbest (€1.08 in chips) 
Seat 4: outshined8 (€1 in chips) 
Seat 5: bruciapelo (€1.80 in chips) 
Seat 6: caduceus369 (€2.60 in chips) 
SidneyPrescott: posts small blind €0.01
cartoonbest: posts big blind €0.02
*** HOLE CARDS ***
Dealt to caduceus369 [3d Ks]
outshined8: folds 
bruciapelo: folds 
caduceus369: folds 
sgiafun: raises €0.04 to €0.06
SidneyPrescott: folds 
cartoonbest: folds 
Uncalled bet (€0.04) returned to sgiafun
sgiafun collected €0.05 from pot
sgiafun: doesn't show hand 
*** SUMMARY ***
Total pot €0.05 | Rake €0 
Seat 1: sgiafun (button) collected (€0.05)
Seat 2: SidneyPrescott (small blind) folded before Flop
Seat 3: cartoonbest (big blind) folded before Flop
Seat 4: outshined8 folded before Flop (didn't bet)
Seat 5: bruciapelo folded before Flop (didn't bet)
Seat 6: caduceus369 folded before Flop (didn't bet)



PokerStars Zoom Hand #257987886598:  Hold'em No Limit (€0.01/€0.02) [ADM ID: M62BA304494E32ST] - 2025/10/03 23:21:39 CET [2025/10/03 17:21:39 ET]
Table 'Sirio' 6-max Seat #1 is the button
Seat 1: montemeru (€2 in chips) 
Seat 2: Chia9711 (€2.65 in chips) 
Seat 3: robertoH2O (€2.25 in chips) 
Seat 4: caduceus369 (€2.60 in chips) 
Seat 5: sgiafun (€0.61 in chips) 
Seat 6: stfuplzudonk (€3.06 in chips) 
Chia9711: posts small blind €0.01
robertoH2O: posts big blind €0.02
*** HOLE CARDS ***
Dealt to caduceus369 [6s Ah]
caduceus369: folds 
sgiafun: folds 
stfuplzudonk: folds 
montemeru: folds 
Chia9711: calls €0.01
robertoH2O: checks 
*** FLOP *** [6c 6h 8d]
Chia9711: checks 
robertoH2O: checks 
*** TURN *** [6c 6h 8d] [Qs]
Chia9711: checks 
robertoH2O: checks 
*** RIVER *** [6c 6h 8d Qs] [8h]
Chia9711: checks 
robertoH2O: checks 
*** SHOW DOWN ***
Chia9711: shows [5c Th] (two pair, Eights and Sixes)
robertoH2O: shows [2d Js] (two pair, Eights and Sixes)
Chia9711 collected €0.02 from pot
robertoH2O collected €0.02 from pot
*** SUMMARY ***
Total pot €0.04 | Rake €0 
Board [6c 6h 8d Qs 8h]
Seat 1: montemeru (button) folded before Flop (didn't bet)
Seat 2: Chia9711 (small blind) showed [5c Th] and won (€0.02) with two pair, Eights and Sixes
Seat 3: robertoH2O (big blind) showed [2d Js] and won (€0.02) with two pair, Eights and Sixes
Seat 4: caduceus369 folded before Flop (didn't bet)
Seat 5: sgiafun folded before Flop (didn't bet)
Seat 6: stfuplzudonk folded before Flop (didn't bet)



PokerStars Zoom Hand #257987885003:  Hold'em No Limit (€0.01/€0.02) [ADM ID: M62BA304494E32ST] - 2025/10/03 23:21:32 CET [2025/10/03 17:21:32 ET]
Table 'Sirio' 6-max Seat #1 is the button
Seat 1: gs0097 (€0.82 in chips) 
Seat 2: father2008 (€6.35 in chips) 
Seat 3: KindRonin (€1.72 in chips) 
Seat 4: montemeru (€2.34 in chips) 
Seat 5: caduceus369 (€2.60 in chips) 
Seat 6: stfuplzudonk (€2.81 in chips) 
father2008: posts small blind €0.01
KindRonin: posts big blind €0.02
*** HOLE CARDS ***
Dealt to caduceus369 [6c 3s]
montemeru: raises €0.04 to €0.06
caduceus369: folds 
stfuplzudonk: folds 
gs0097: calls €0.06
father2008: folds 
KindRonin: calls €0.04
*** FLOP *** [Kd Kh 2c]
KindRonin: checks 
montemeru: checks 
gs0097: checks 
*** TURN *** [Kd Kh 2c] [4c]
KindRonin: bets €0.06
montemeru: folds 
gs0097: folds 
Uncalled bet (€0.06) returned to KindRonin
KindRonin collected €0.18 from pot
KindRonin: doesn't show hand 
*** SUMMARY ***
Total pot €0.19 | Rake €0.01 
Board [Kd Kh 2c 4c]
Seat 1: gs0097 (button) folded on the Turn
Seat 2: father2008 (small blind) folded before Flop
Seat 3: KindRonin (big blind) collected (€0.18)
Seat 4: montemeru folded on the Turn
Seat 5: caduceus369 folded before Flop (didn't bet)
Seat 6: stfuplzudonk folded before Flop (didn't bet)



PokerStars Zoom Hand #257987887593:  Hold'em No Limit (€0.01/€0.02) [ADM ID: M62BA304494E32ST] - 2025/10/03 23:21:43 CET [2025/10/03 17:21:43 ET]
Table 'Sirio' 6-max Seat #1 is the button
Seat 1: caduceus369 (€2.60 in chips) 
Seat 2: lucpri (€2.25 in chips) 
Seat 3: sgiafun (€0.61 in chips) 
Seat 4: Catania838 (€1.99 in chips) 
Seat 5: montemeru (€2 in chips) 
Seat 6: father2008 (€4.36 in chips) 
lucpri: posts small blind €0.01
sgiafun: posts big blind €0.02
*** HOLE CARDS ***
Dealt to caduceus369 [8c 7d]
Catania838: calls €0.02
montemeru: raises €0.07 to €0.09
father2008: folds 
caduceus369: folds 
lucpri: folds 
sgiafun: raises €0.21 to €0.30
Catania838: raises €1.69 to €1.99 and is all-in
montemeru: folds 
sgiafun: calls €0.31 and is all-in
Uncalled bet (€1.38) returned to Catania838
*** FLOP *** [5d Jd Qs]
*** TURN *** [5d Jd Qs] [2c]
*** RIVER *** [5d Jd Qs 2c] [5s]
*** SHOW DOWN ***
sgiafun: shows [As Td] (a pair of Fives)
Catania838: shows [Ks Ad] (a pair of Fives - Ace+King kicker)
Catania838 collected €1.25 from pot
*** SUMMARY ***
Total pot €1.32 | Rake €0.07 
Board [5d Jd Qs 2c 5s]
Seat 1: caduceus369 (button) folded before Flop (didn't bet)
Seat 2: lucpri (small blind) folded before Flop
Seat 3: sgiafun (big blind) showed [As Td] and lost with a pair of Fives
Seat 4: Catania838 showed [Ks Ad] and won (€1.25) with a pair of Fives
Seat 5: montemeru folded before Flop
Seat 6: father2008 folded before Flop (didn't bet)



PokerStars Zoom Hand #257987888983:  Hold'em No Limit (€0.01/€0.02) [ADM ID: M62BA304494E32ST] - 2025/10/03 23:21:49 CET [2025/10/03 17:21:49 ET]
Table 'Sirio' 6-max Seat #1 is the button
Seat 1: ADRIAN0_MEIS (€3.25 in chips) 
Seat 2: giua1980 (€1.21 in chips) 
Seat 3: caduceus369 (€2.60 in chips) 
Seat 4: sparky91580 (€0.64 in chips) 
Seat 5: EasyToRule (€2.07 in chips) 
Seat 6: rounders121282 (€5.23 in chips) 
giua1980: posts small blind €0.01
caduceus369: posts big blind €0.02
*** HOLE CARDS ***
Dealt to caduceus369 [8s 5d]
sparky91580: folds 
EasyToRule: raises €0.03 to €0.05
rounders121282: folds 
ADRIAN0_MEIS: folds 
giua1980 has timed out
giua1980: folds 
caduceus369: calls €0.03
*** FLOP *** [9d 7c Ts]
caduceus369: bets €0.04
EasyToRule: folds 
Uncalled bet (€0.04) returned to caduceus369
caduceus369 collected €0.11 from pot
caduceus369: doesn't show hand 
*** SUMMARY ***
Total pot €0.11 | Rake €0 
Board [9d 7c Ts]
Seat 1: ADRIAN0_MEIS (button) folded before Flop (didn't bet)
Seat 2: giua1980 (small blind) folded before Flop
Seat 3: caduceus369 (big blind) collected (€0.11)
Seat 4: sparky91580 folded before Flop (didn't bet)
Seat 5: EasyToRule folded on the Flop
Seat 6: rounders121282 folded before Flop (didn't bet)



PokerStars Zoom Hand #257987904141:  Hold'em No Limit (€0.01/€0.02) [ADM ID: M62BA304494E32ST] - 2025/10/03 23:22:51 CET [2025/10/03 17:22:51 ET]
Table 'Sirio' 6-max Seat #1 is the button
Seat 1: skynet0308 (€0.59 in chips) 
Seat 2: father2008 (€4.34 in chips) 
Seat 3: Neroonciolina (€4.44 in chips) 
Seat 4: SidneyPrescott (€5.01 in chips) 
Seat 5: macchia1010 (€1.37 in chips) 
Seat 6: caduceus369 (€2.66 in chips) 
father2008: posts small blind €0.01
Neroonciolina: posts big blind €0.02
*** HOLE CARDS ***
Dealt to caduceus369 [Qc Qh]
SidneyPrescott: raises €0.04 to €0.06
macchia1010: folds 
caduceus369: raises €0.12 to €0.18
skynet0308: folds 
father2008: folds 
Neroonciolina: calls €0.16
SidneyPrescott: calls €0.12
*** FLOP *** [6d Th Kh]
Neroonciolina: checks 
SidneyPrescott: checks 
caduceus369: checks 
*** TURN *** [6d Th Kh] [3c]
Neroonciolina: checks 
SidneyPrescott: bets €0.30
caduceus369: folds 
Neroonciolina: folds 
Uncalled bet (€0.30) returned to SidneyPrescott
SidneyPrescott collected €0.52 from pot
SidneyPrescott: doesn't show hand 
*** SUMMARY ***
Total pot €0.55 | Rake €0.03 
Board [6d Th Kh 3c]
Seat 1: skynet0308 (button) folded before Flop (didn't bet)
Seat 2: father2008 (small blind) folded before Flop
Seat 3: Neroonciolina (big blind) folded on the Turn
Seat 4: SidneyPrescott collected (€0.52)
Seat 5: macchia1010 folded before Flop (didn't bet)
Seat 6: caduceus369 folded on the Turn



PokerStars Zoom Hand #257987912724:  Hold'em No Limit (€0.01/€0.02) [ADM ID: M62BA304494E32ST] - 2025/10/03 23:23:27 CET [2025/10/03 17:23:27 ET]
Table 'Sirio' 6-max Seat #1 is the button
Seat 1: tigermiscio (€0.57 in chips) 
Seat 2: caduceus369 (€2.48 in chips) 
Seat 3: SidneyPrescott (€2.06 in chips) 
Seat 4: ADRIAN0_MEIS (€8.53 in chips) 
Seat 5: stfuplzudonk (€3.01 in chips) 
Seat 6: father2008 (€6.34 in chips) 
caduceus369: posts small blind €0.01
SidneyPrescott: posts big blind €0.02
*** HOLE CARDS ***
Dealt to caduceus369 [7h 3d]
ADRIAN0_MEIS: folds 
stfuplzudonk: folds 
father2008: folds 
tigermiscio: folds 
caduceus369: folds 
Uncalled bet (€0.01) returned to SidneyPrescott
SidneyPrescott collected €0.02 from pot
SidneyPrescott: doesn't show hand 
*** SUMMARY ***
Total pot €0.02 | Rake €0 
Seat 1: tigermiscio (button) folded before Flop (didn't bet)
Seat 2: caduceus369 (small blind) folded before Flop
Seat 3: SidneyPrescott (big blind) collected (€0.02)
Seat 4: ADRIAN0_MEIS folded before Flop (didn't bet)
Seat 5: stfuplzudonk folded before Flop (didn't bet)
Seat 6: father2008 folded before Flop (didn't bet)



PokerStars Zoom Hand #257987915226:  Hold'em No Limit (€0.01/€0.02) [ADM ID: M62BA304494E32ST] - 2025/10/03 23:23:37 CET [2025/10/03 17:23:37 ET]
Table 'Sirio' 6-max Seat #1 is the button
Seat 1: Scardo84 (€2.46 in chips) 
Seat 2: ivano747 (€3.19 in chips) 
Seat 3: workman75 (€2.80 in chips) 
Seat 4: ADRIAN0_MEIS (€9.10 in chips) 
Seat 5: caduceus369 (€2.47 in chips) 
Seat 6: fantaasso (€1.98 in chips) 
ivano747: posts small blind €0.01
workman75: posts big blind €0.02
*** HOLE CARDS ***
Dealt to caduceus369 [Js 7s]
ADRIAN0_MEIS: raises €0.05 to €0.07
caduceus369: folds 
fantaasso: folds 
Scardo84: folds 
ivano747: folds 
workman75: folds 
Uncalled bet (€0.05) returned to ADRIAN0_MEIS
ADRIAN0_MEIS collected €0.05 from pot
ADRIAN0_MEIS: doesn't show hand 
*** SUMMARY ***
Total pot €0.05 | Rake €0 
Seat 1: Scardo84 (button) folded before Flop (didn't bet)
Seat 2: ivano747 (small blind) folded before Flop
Seat 3: workman75 (big blind) folded before Flop
Seat 4: ADRIAN0_MEIS collected (€0.05)
Seat 5: caduceus369 folded before Flop (didn't bet)
Seat 6: fantaasso folded before Flop (didn't bet)



PokerStars Zoom Hand #257987913593:  Hold'em No Limit (€0.01/€0.02) [ADM ID: M62BA304494E32ST] - 2025/10/03 23:23:30 CET [2025/10/03 17:23:30 ET]
Table 'Sirio' 6-max Seat #1 is the button
Seat 1: Catania838 (€1.76 in chips) 
Seat 2: macchia1010 (€1.62 in chips) 
Seat 3: EasyToRule (€2.19 in chips) 
Seat 4: caduceus369 (€2.47 in chips) 
Seat 5: ivano747 (€4.43 in chips) 
Seat 6: tigermiscio (€0.57 in chips) 
macchia1010: posts small blind €0.01
EasyToRule: posts big blind €0.02
*** HOLE CARDS ***
Dealt to caduceus369 [Jh 9s]
caduceus369: folds 
ivano747: folds 
tigermiscio: folds 
Catania838: folds 
macchia1010: calls €0.01
EasyToRule: checks 
*** FLOP *** [Kc 8s As]
macchia1010: checks 
EasyToRule: checks 
*** TURN *** [Kc 8s As] [Jd]
macchia1010: checks 
EasyToRule: checks 
*** RIVER *** [Kc 8s As Jd] [Ts]
macchia1010: checks 
EasyToRule: checks 
*** SHOW DOWN ***
macchia1010: shows [Qc 6c] (a straight, Ten to Ace)
EasyToRule: mucks hand 
macchia1010 collected €0.04 from pot
*** SUMMARY ***
Total pot €0.04 | Rake €0 
Board [Kc 8s As Jd Ts]
Seat 1: Catania838 (button) folded before Flop (didn't bet)
Seat 2: macchia1010 (small blind) showed [Qc 6c] and won (€0.04) with a straight, Ten to Ace
Seat 3: EasyToRule (big blind) mucked [4h 4d]
Seat 4: caduceus369 folded before Flop (didn't bet)
Seat 5: ivano747 folded before Flop (didn't bet)
Seat 6: tigermiscio folded before Flop (didn't bet)



PokerStars Zoom Hand #257987917404:  Hold'em No Limit (€0.01/€0.02) [ADM ID: M62BA304494E32ST] - 2025/10/03 23:23:46 CET [2025/10/03 17:23:46 ET]
Table 'Sirio' 6-max Seat #1 is the button
Seat 1: pia1256 (€1.81 in chips) 
Seat 2: montemeru (€1.91 in chips) 
Seat 3: caduceus369 (€2.47 in chips) 
Seat 4: ivano747 (€3.18 in chips) 
Seat 5: tigermiscio (€0.89 in chips) 
Seat 6: stfuplzudonk (€3.01 in chips) 
montemeru: posts small blind €0.01
caduceus369: posts big blind €0.02
*** HOLE CARDS ***
Dealt to caduceus369 [Jd 9h]
ivano747: folds 
tigermiscio: calls €0.02
stfuplzudonk: folds 
pia1256: folds 
montemeru: raises €0.06 to €0.08
caduceus369: folds 
tigermiscio: folds 
Uncalled bet (€0.06) returned to montemeru
montemeru collected €0.06 from pot
montemeru: doesn't show hand 
*** SUMMARY ***
Total pot €0.06 | Rake €0 
Seat 1: pia1256 (button) folded before Flop (didn't bet)
Seat 2: montemeru (small blind) collected (€0.06)
Seat 3: caduceus369 (big blind) folded before Flop
Seat 4: ivano747 folded before Flop (didn't bet)
Seat 5: tigermiscio folded before Flop
Seat 6: stfuplzudonk folded before Flop (didn't bet)



PokerStars Zoom Hand #257987920774:  Hold'em No Limit (€0.01/€0.02) [ADM ID: M62BA304494E32ST] - 2025/10/03 23:24:00 CET [2025/10/03 17:24:00 ET]
Table 'Sirio' 6-max Seat #1 is the button
Seat 1: diego-rigano (€0.84 in chips) 
Seat 2: stfuplzudonk (€2.89 in chips) 
Seat 3: cartoonbest (€1.05 in chips) 
Seat 4: Catania838 (€2.53 in chips) 
Seat 5: pia1256 (€1.81 in chips) 
Seat 6: caduceus369 (€2.45 in chips) 
stfuplzudonk: posts small blind €0.01
cartoonbest: posts big blind €0.02
*** HOLE CARDS ***
Dealt to caduceus369 [4c Ks]
Catania838: folds 
pia1256: folds 
caduceus369: folds 
diego-rigano: raises €0.82 to €0.84 and is all-in
stfuplzudonk: folds 
cartoonbest: folds 
Uncalled bet (€0.82) returned to diego-rigano
diego-rigano collected €0.05 from pot
diego-rigano: doesn't show hand 
*** SUMMARY ***
Total pot €0.05 | Rake €0 
Seat 1: diego-rigano (button) collected (€0.05)
Seat 2: stfuplzudonk (small blind) folded before Flop
Seat 3: cartoonbest (big blind) folded before Flop
Seat 4: Catania838 folded before Flop (didn't bet)
Seat 5: pia1256 folded before Flop (didn't bet)
Seat 6: caduceus369 folded before Flop (didn't bet)



PokerStars Zoom Hand #257987922661:  Hold'em No Limit (€0.01/€0.02) [ADM ID: M62BA304494E32ST] - 2025/10/03 23:24:08 CET [2025/10/03 17:24:08 ET]
Table 'Sirio' 6-max Seat #1 is the button
Seat 1: caduceus369 (€2.45 in chips) 
Seat 2: ADRIAN0_MEIS (€9.11 in chips) 
Seat 3: tigermiscio (€0.87 in chips) 
Seat 4: pia1256 (€1.81 in chips) 
Seat 5: MOLDAVO1069 (€2.78 in chips) 
Seat 6: bruciapelo (€1.27 in chips) 
ADRIAN0_MEIS: posts small blind €0.01
tigermiscio: posts big blind €0.02
*** HOLE CARDS ***
Dealt to caduceus369 [Js 9d]
pia1256: folds 
MOLDAVO1069: raises €0.03 to €0.05
bruciapelo: folds 
caduceus369: folds 
ADRIAN0_MEIS: folds 
tigermiscio: calls €0.03
*** FLOP *** [3s 8c 3d]
tigermiscio: bets €0.02
MOLDAVO1069: folds 
Uncalled bet (€0.02) returned to tigermiscio
tigermiscio collected €0.11 from pot
tigermiscio: doesn't show hand 
*** SUMMARY ***
Total pot €0.11 | Rake €0 
Board [3s 8c 3d]
Seat 1: caduceus369 (button) folded before Flop (didn't bet)
Seat 2: ADRIAN0_MEIS (small blind) folded before Flop
Seat 3: tigermiscio (big blind) collected (€0.11)
Seat 4: pia1256 folded before Flop (didn't bet)
Seat 5: MOLDAVO1069 folded on the Flop
Seat 6: bruciapelo folded before Flop (didn't bet)



PokerStars Zoom Hand #257987928464:  Hold'em No Limit (€0.01/€0.02) [ADM ID: M62BA304494E32ST] - 2025/10/03 23:24:32 CET [2025/10/03 17:24:32 ET]
Table 'Sirio' 6-max Seat #1 is the button
Seat 1: ivano747 (€4.39 in chips) 
Seat 2: cartoonbest (€1.03 in chips) 
Seat 3: SidneyPrescott (€5.15 in chips) 
Seat 4: caduceus369 (€2.44 in chips) 
Seat 5: fantaasso (€1.83 in chips) 
Seat 6: MOLDAVO1069 (€2.73 in chips) 
cartoonbest: posts small blind €0.01
SidneyPrescott: posts big blind €0.02
*** HOLE CARDS ***
Dealt to caduceus369 [Qc 5c]
caduceus369: folds 
fantaasso: folds 
MOLDAVO1069: folds 
ivano747: folds 
cartoonbest: calls €0.01
SidneyPrescott: checks 
*** FLOP *** [6d 4d Tc]
cartoonbest: bets €0.04
SidneyPrescott: calls €0.04
*** TURN *** [6d 4d Tc] [4h]
cartoonbest: bets €0.06
SidneyPrescott: folds 
Uncalled bet (€0.06) returned to cartoonbest
cartoonbest collected €0.12 from pot
cartoonbest: doesn't show hand 
*** SUMMARY ***
Total pot €0.12 | Rake €0 
Board [6d 4d Tc 4h]
Seat 1: ivano747 (button) folded before Flop (didn't bet)
Seat 2: cartoonbest (small blind) collected (€0.12)
Seat 3: SidneyPrescott (big blind) folded on the Turn
Seat 4: caduceus369 folded before Flop (didn't bet)
Seat 5: fantaasso folded before Flop (didn't bet)
Seat 6: MOLDAVO1069 folded before Flop (didn't bet)



PokerStars Zoom Hand #257987931481:  Hold'em No Limit (€0.01/€0.02) [ADM ID: M62BA304494E32ST] - 2025/10/03 23:24:45 CET [2025/10/03 17:24:45 ET]
Table 'Sirio' 6-max Seat #1 is the button
Seat 1: SidneyPrescott (€2 in chips) 
Seat 2: maury999999 (€2 in chips) 
Seat 3: sancarlo18 (€1.43 in chips) 
Seat 4: Catania838 (€1.48 in chips) 
Seat 5: ImArese89 (€1.28 in chips) 
Seat 6: caduceus369 (€2.44 in chips) 
maury999999: posts small blind €0.01
sancarlo18: posts big blind €0.02
*** HOLE CARDS ***
Dealt to caduceus369 [Ks Ac]
Catania838: folds 
ImArese89 is disconnected 
ImArese89 has timed out while disconnected
ImArese89: folds 
caduceus369: raises €0.04 to €0.06
SidneyPrescott: folds 
maury999999: folds 
sancarlo18: folds 
Uncalled bet (€0.04) returned to caduceus369
caduceus369 collected €0.05 from pot
caduceus369: doesn't show hand 
*** SUMMARY ***
Total pot €0.05 | Rake €0 
Seat 1: SidneyPrescott (button) folded before Flop (didn't bet)
Seat 2: maury999999 (small blind) folded before Flop
Seat 3: sancarlo18 (big blind) folded before Flop
Seat 4: Catania838 folded before Flop (didn't bet)
Seat 5: ImArese89 folded before Flop (didn't bet)
Seat 6: caduceus369 collected (€0.05)



PokerStars Zoom Hand #257987925324:  Hold'em No Limit (€0.01/€0.02) [ADM ID: M62BA304494E32ST] - 2025/10/03 23:24:19 CET [2025/10/03 17:24:19 ET]
Table 'Sirio' 6-max Seat #1 is the button
Seat 1: SKERZA (€1.97 in chips) 
Seat 2: caduceus369 (€2.45 in chips) 
Seat 3: stfuplzudonk (€2.88 in chips) 
Seat 4: Neroonciolina (€4.17 in chips) 
Seat 5: sparky91580 (€0.65 in chips) 
Seat 6: father2008 (€4.30 in chips) 
caduceus369: posts small blind €0.01
stfuplzudonk: posts big blind €0.02
*** HOLE CARDS ***
Dealt to caduceus369 [2d 3h]
Neroonciolina: calls €0.02
sparky91580: folds 
father2008: calls €0.02
SKERZA: calls €0.02
caduceus369: folds 
stfuplzudonk: checks 
*** FLOP *** [9c 8h 2s]
stfuplzudonk: checks 
Neroonciolina: checks 
father2008: checks 
SKERZA: bets €0.11
stfuplzudonk: folds 
Neroonciolina: calls €0.11
father2008: folds 
*** TURN *** [9c 8h 2s] [8c]
Neroonciolina: checks 
SKERZA: checks 
*** RIVER *** [9c 8h 2s 8c] [Th]
Neroonciolina: bets €0.14
SKERZA: calls €0.14
*** SHOW DOWN ***
Neroonciolina: shows [Td Qc] (two pair, Tens and Eights)
SKERZA: mucks hand 
Neroonciolina collected €0.56 from pot
*** SUMMARY ***
Total pot €0.59 | Rake €0.03 
Board [9c 8h 2s 8c Th]
Seat 1: SKERZA (button) mucked [9d Kc]
Seat 2: caduceus369 (small blind) folded before Flop
Seat 3: stfuplzudonk (big blind) folded on the Flop
Seat 4: Neroonciolina showed [Td Qc] and won (€0.56) with two pair, Tens and Eights
Seat 5: sparky91580 folded before Flop (didn't bet)
Seat 6: father2008 folded on the Flop



PokerStars Zoom Hand #257987938170:  Hold'em No Limit (€0.01/€0.02) [ADM ID: M62BA304494E32ST] - 2025/10/03 23:25:12 CET [2025/10/03 17:25:12 ET]
Table 'Sirio' 6-max Seat #1 is the button
Seat 1: Catania838 (€1.41 in chips) 
Seat 2: diego-rigano (€0.93 in chips) 
Seat 3: savicevic74 (€1.80 in chips) 
Seat 4: father2008 (€6.15 in chips) 
Seat 5: caduceus369 (€2.47 in chips) 
Seat 6: stfuplzudonk (€1.68 in chips) 
diego-rigano: posts small blind €0.01
savicevic74: posts big blind €0.02
*** HOLE CARDS ***
Dealt to caduceus369 [Qd Tc]
father2008: folds 
caduceus369: folds 
stfuplzudonk: folds 
Catania838: calls €0.02
diego-rigano: folds 
savicevic74: checks 
*** FLOP *** [Kc 2h 8h]
savicevic74: checks 
Catania838: checks 
*** TURN *** [Kc 2h 8h] [Td]
savicevic74: bets €0.05
Catania838: folds 
Uncalled bet (€0.05) returned to savicevic74
savicevic74 collected €0.05 from pot
savicevic74: doesn't show hand 
*** SUMMARY ***
Total pot €0.05 | Rake €0 
Board [Kc 2h 8h Td]
Seat 1: Catania838 (button) folded on the Turn
Seat 2: diego-rigano (small blind) folded before Flop
Seat 3: savicevic74 (big blind) collected (€0.05)
Seat 4: father2008 folded before Flop (didn't bet)
Seat 5: caduceus369 folded before Flop (didn't bet)
Seat 6: stfuplzudonk folded before Flop (didn't bet)



PokerStars Zoom Hand #257987939883:  Hold'em No Limit (€0.01/€0.02) [ADM ID: M62BA304494E32ST] - 2025/10/03 23:25:19 CET [2025/10/03 17:25:19 ET]
Table 'Sirio' 6-max Seat #1 is the button
Seat 1: stfuplzudonk (€4.58 in chips) 
Seat 2: ADRIAN0_MEIS (€9.08 in chips) 
Seat 3: caduceus369 (€2.47 in chips) 
Seat 4: fantaasso (€1.80 in chips) 
Seat 5: EasyToRule (€2.12 in chips) 
Seat 6: SidneyPrescott (€2 in chips) 
ADRIAN0_MEIS: posts small blind €0.01
caduceus369: posts big blind €0.02
*** HOLE CARDS ***
Dealt to caduceus369 [Qs 9h]
fantaasso: folds 
EasyToRule: folds 
SidneyPrescott: raises €0.04 to €0.06
stfuplzudonk: calls €0.06
ADRIAN0_MEIS: folds 
caduceus369: folds 
*** FLOP *** [7h 3h Ts]
SidneyPrescott: checks 
stfuplzudonk: bets €0.08
SidneyPrescott: raises €0.16 to €0.24
stfuplzudonk: folds 
Uncalled bet (€0.16) returned to SidneyPrescott
SidneyPrescott collected €0.30 from pot
SidneyPrescott: doesn't show hand 
*** SUMMARY ***
Total pot €0.31 | Rake €0.01 
Board [7h 3h Ts]
Seat 1: stfuplzudonk (button) folded on the Flop
Seat 2: ADRIAN0_MEIS (small blind) folded before Flop
Seat 3: caduceus369 (big blind) folded before Flop
Seat 4: fantaasso folded before Flop (didn't bet)
Seat 5: EasyToRule folded before Flop (didn't bet)
Seat 6: SidneyPrescott collected (€0.30)



PokerStars Zoom Hand #257987944108:  Hold'em No Limit (€0.01/€0.02) [ADM ID: M62BA304494E32ST] - 2025/10/03 23:25:36 CET [2025/10/03 17:25:36 ET]
Table 'Sirio' 6-max Seat #1 is the button
Seat 1: montemeru (€2.30 in chips) 
Seat 2: ADRIAN0_MEIS (€8.50 in chips) 
Seat 3: workman75 (€2.72 in chips) 
Seat 4: maury999999 (€2.21 in chips) 
Seat 5: caduceus369 (€2.44 in chips) 
Seat 6: Catania838 (€1.39 in chips) 
ADRIAN0_MEIS: posts small blind €0.01
workman75: posts big blind €0.02
*** HOLE CARDS ***
Dealt to caduceus369 [5c Ts]
maury999999: folds 
caduceus369: folds 
Catania838: raises €0.02 to €0.04
montemeru: folds 
ADRIAN0_MEIS: folds 
workman75: calls €0.02
*** FLOP *** [9s 4c 4s]
workman75: checks 
Catania838: bets €0.02
workman75: folds 
Uncalled bet (€0.02) returned to Catania838
Catania838 collected €0.09 from pot
Catania838: doesn't show hand 
*** SUMMARY ***
Total pot €0.09 | Rake €0 
Board [9s 4c 4s]
Seat 1: montemeru (button) folded before Flop (didn't bet)
Seat 2: ADRIAN0_MEIS (small blind) folded before Flop
Seat 3: workman75 (big blind) folded on the Flop
Seat 4: maury999999 folded before Flop (didn't bet)
Seat 5: caduceus369 folded before Flop (didn't bet)
Seat 6: Catania838 collected (€0.09)



PokerStars Zoom Hand #257987930168:  Hold'em No Limit (€0.01/€0.02) [ADM ID: M62BA304494E32ST] - 2025/10/03 23:24:39 CET [2025/10/03 17:24:39 ET]
Table 'Sirio' 6-max Seat #1 is the button
Seat 1: caduceus369 (€2.44 in chips) 
Seat 2: SidneyPrescott (€2 in chips) 
Seat 3: fantaasso (€1.83 in chips) 
Seat 4: tigermiscio (€0.50 in chips) 
Seat 5: MOLDAVO1069 (€2.73 in chips) 
Seat 6: ADRIAN0_MEIS (€2.19 in chips) 
SidneyPrescott: posts small blind €0.01
fantaasso: posts big blind €0.02
*** HOLE CARDS ***
Dealt to caduceus369 [5s 2s]
tigermiscio: folds 
MOLDAVO1069: raises €0.03 to €0.05
ADRIAN0_MEIS: raises €0.13 to €0.18
caduceus369: folds 
SidneyPrescott: folds 
fantaasso: folds 
MOLDAVO1069: calls €0.13
*** FLOP *** [2c Tc 3c]
MOLDAVO1069: checks 
ADRIAN0_MEIS: bets €0.12
MOLDAVO1069: calls €0.12
*** TURN *** [2c Tc 3c] [8c]
MOLDAVO1069: checks 
ADRIAN0_MEIS: checks 
*** RIVER *** [2c Tc 3c 8c] [7c]
MOLDAVO1069: bets €0.50
ADRIAN0_MEIS: folds 
Uncalled bet (€0.50) returned to MOLDAVO1069
MOLDAVO1069 collected €0.60 from pot
MOLDAVO1069: doesn't show hand 
*** SUMMARY ***
Total pot €0.63 | Rake €0.03 
Board [2c Tc 3c 8c 7c]
Seat 1: caduceus369 (button) folded before Flop (didn't bet)
Seat 2: SidneyPrescott (small blind) folded before Flop
Seat 3: fantaasso (big blind) folded before Flop
Seat 4: tigermiscio folded before Flop (didn't bet)
Seat 5: MOLDAVO1069 collected (€0.60)
Seat 6: ADRIAN0_MEIS folded on the River



PokerStars Zoom Hand #257987945056:  Hold'em No Limit (€0.01/€0.02) [ADM ID: M62BA304494E32ST] - 2025/10/03 23:25:40 CET [2025/10/03 17:25:40 ET]
Table 'Sirio' 6-max Seat #1 is the button
Seat 1: caduceus369 (€2.44 in chips) 
Seat 2: EasyToRule (€2.33 in chips) 
Seat 3: lucpri (€2.19 in chips) 
Seat 4: Scardo84 (€2.51 in chips) 
Seat 5: Generalexx (€1.93 in chips) 
Seat 6: neoilnervoso (€1.63 in chips) 
EasyToRule: posts small blind €0.01
lucpri: posts big blind €0.02
*** HOLE CARDS ***
Dealt to caduceus369 [Qs 9c]
Scardo84: folds 
Generalexx: calls €0.02
neoilnervoso: calls €0.02
caduceus369: folds 
EasyToRule: folds 
lucpri: checks 
*** FLOP *** [4c Ks Ad]
lucpri: checks 
Generalexx: checks 
neoilnervoso: checks 
*** TURN *** [4c Ks Ad] [Ac]
lucpri: checks 
Generalexx: checks 
neoilnervoso: checks 
*** RIVER *** [4c Ks Ad Ac] [Td]
lucpri: checks 
Generalexx: checks 
neoilnervoso: bets €0.07
lucpri: folds 
Generalexx: folds 
Uncalled bet (€0.07) returned to neoilnervoso
neoilnervoso collected €0.07 from pot
neoilnervoso: doesn't show hand 
*** SUMMARY ***
Total pot €0.07 | Rake €0 
Board [4c Ks Ad Ac Td]
Seat 1: caduceus369 (button) folded before Flop (didn't bet)
Seat 2: EasyToRule (small blind) folded before Flop
Seat 3: lucpri (big blind) folded on the River
Seat 4: Scardo84 folded before Flop (didn't bet)
Seat 5: Generalexx folded on the River
Seat 6: neoilnervoso collected (€0.07)



PokerStars Zoom Hand #257987943049:  Hold'em No Limit (€0.01/€0.02) [ADM ID: M62BA304494E32ST] - 2025/10/03 23:25:32 CET [2025/10/03 17:25:32 ET]
Table 'Sirio' 6-max Seat #1 is the button
Seat 1: cesaretto23 (€3.40 in chips) 
Seat 2: caduceus369 (€2.45 in chips) 
Seat 3: CacciatoreAA (€2.35 in chips) 
Seat 4: Neroonciolina (€4.47 in chips) 
Seat 5: lucpri (€2.19 in chips) 
Seat 6: sancarlo18 (€1.40 in chips) 
caduceus369: posts small blind €0.01
CacciatoreAA: posts big blind €0.02
*** HOLE CARDS ***
Dealt to caduceus369 [4c Kh]
Neroonciolina: calls €0.02
lucpri: folds 
sancarlo18: folds 
cesaretto23: calls €0.02
caduceus369: folds 
CacciatoreAA: raises €0.14 to €0.16
Neroonciolina: calls €0.14
cesaretto23: calls €0.14
*** FLOP *** [Qs 8h 2h]
CacciatoreAA: checks 
Neroonciolina: bets €0.20
cesaretto23: folds 
CacciatoreAA: folds 
Uncalled bet (€0.20) returned to Neroonciolina
Neroonciolina collected €0.47 from pot
Neroonciolina: doesn't show hand 
*** SUMMARY ***
Total pot €0.49 | Rake €0.02 
Board [Qs 8h 2h]
Seat 1: cesaretto23 (button) folded on the Flop
Seat 2: caduceus369 (small blind) folded before Flop
Seat 3: CacciatoreAA (big blind) folded on the Flop
Seat 4: Neroonciolina collected (€0.47)
Seat 5: lucpri folded before Flop (didn't bet)
Seat 6: sancarlo18 folded before Flop (didn't bet)



PokerStars Zoom Hand #257987947903:  Hold'em No Limit (€0.01/€0.02) [ADM ID: M62BA304494E32ST] - 2025/10/03 23:25:52 CET [2025/10/03 17:25:52 ET]
Table 'Sirio' 6-max Seat #1 is the button
Seat 1: EasyToRule (€2.32 in chips) 
Seat 2: SidneyPrescott (€2.16 in chips) 
Seat 3: ADRIAN0_MEIS (€12.70 in chips) 
Seat 4: caduceus369 (€2.44 in chips) 
Seat 5: ivano747 (€4.44 in chips) 
Seat 6: outshined8 (€2.05 in chips) 
SidneyPrescott: posts small blind €0.01
ADRIAN0_MEIS: posts big blind €0.02
*** HOLE CARDS ***
Dealt to caduceus369 [2s 5c]
caduceus369: folds 
ivano747: raises €0.04 to €0.06
outshined8: folds 
EasyToRule: folds 
SidneyPrescott: raises €0.18 to €0.24
ADRIAN0_MEIS: calls €0.22
ivano747: folds 
*** FLOP *** [Qc Jd 8h]
SidneyPrescott: bets €0.36
ADRIAN0_MEIS: folds 
Uncalled bet (€0.36) returned to SidneyPrescott
SidneyPrescott collected €0.52 from pot
SidneyPrescott: doesn't show hand 
*** SUMMARY ***
Total pot €0.54 | Rake €0.02 
Board [Qc Jd 8h]
Seat 1: EasyToRule (button) folded before Flop (didn't bet)
Seat 2: SidneyPrescott (small blind) collected (€0.52)
Seat 3: ADRIAN0_MEIS (big blind) folded on the Flop
Seat 4: caduceus369 folded before Flop (didn't bet)
Seat 5: ivano747 folded before Flop
Seat 6: outshined8 folded before Flop (didn't bet)



PokerStars Zoom Hand #257987948852:  Hold'em No Limit (€0.01/€0.02) [ADM ID: M62BA304494E32ST] - 2025/10/03 23:25:56 CET [2025/10/03 17:25:56 ET]
Table 'Sirio' 6-max Seat #1 is the button
Seat 1: stfuplzudonk (€1.63 in chips) 
Seat 2: Scardo84 (€2.51 in chips) 
Seat 3: caduceus369 (€2.44 in chips) 
Seat 4: KindRonin (€0.78 in chips) 
Seat 5: sancarlo18 (€1.40 in chips) 
Seat 6: nicolobs (€2 in chips) 
Scardo84: posts small blind €0.01
caduceus369: posts big blind €0.02
*** HOLE CARDS ***
Dealt to caduceus369 [As 3s]
KindRonin: folds 
sancarlo18: raises €0.04 to €0.06
nicolobs: folds 
stfuplzudonk: folds 
Scardo84: calls €0.05
caduceus369: calls €0.04
*** FLOP *** [Qs 3c Jc]
Scardo84: checks 
caduceus369: checks 
sancarlo18: checks 
*** TURN *** [Qs 3c Jc] [9d]
Scardo84: checks 
caduceus369: bets €0.06
sancarlo18: folds 
Scardo84: calls €0.06
*** RIVER *** [Qs 3c Jc 9d] [Ad]
Scardo84: checks 
caduceus369: bets €0.35
Scardo84: calls €0.35
*** SHOW DOWN ***
caduceus369: shows [As 3s] (two pair, Aces and Threes)
Scardo84: mucks hand 
caduceus369 collected €0.95 from pot
*** SUMMARY ***
Total pot €1 | Rake €0.05 
Board [Qs 3c Jc 9d Ad]
Seat 1: stfuplzudonk (button) folded before Flop (didn't bet)
Seat 2: Scardo84 (small blind) mucked [Kh Ac]
Seat 3: caduceus369 (big blind) showed [As 3s] and won (€0.95) with two pair, Aces and Threes
Seat 4: KindRonin folded before Flop (didn't bet)
Seat 5: sancarlo18 folded on the Turn
Seat 6: nicolobs folded before Flop (didn't bet)



PokerStars Zoom Hand #257987975677:  Hold'em No Limit (€0.01/€0.02) [ADM ID: M62BA304494E32ST] - 2025/10/03 23:27:48 CET [2025/10/03 17:27:48 ET]
Table 'Sirio' 6-max Seat #1 is the button
Seat 1: outshined8 (€2.21 in chips) 
Seat 2: SKERZA (€1.62 in chips) 
Seat 3: SidneyPrescott (€5.11 in chips) 
Seat 4: caduceus369 (€2.92 in chips) 
Seat 5: maury999999 (€2.06 in chips) 
Seat 6: montemeru (€2.20 in chips) 
SKERZA: posts small blind €0.01
SidneyPrescott: posts big blind €0.02
*** HOLE CARDS ***
Dealt to caduceus369 [Kc 9s]
caduceus369: folds 
maury999999: folds 
montemeru: raises €0.04 to €0.06
outshined8: folds 
SKERZA: folds 
SidneyPrescott: folds 
Uncalled bet (€0.04) returned to montemeru
montemeru collected €0.05 from pot
montemeru: doesn't show hand 
*** SUMMARY ***
Total pot €0.05 | Rake €0 
Seat 1: outshined8 (button) folded before Flop (didn't bet)
Seat 2: SKERZA (small blind) folded before Flop
Seat 3: SidneyPrescott (big blind) folded before Flop
Seat 4: caduceus369 folded before Flop (didn't bet)
Seat 5: maury999999 folded before Flop (didn't bet)
Seat 6: montemeru collected (€0.05)



PokerStars Zoom Hand #257987977176:  Hold'em No Limit (€0.01/€0.02) [ADM ID: M62BA304494E32ST] - 2025/10/03 23:27:54 CET [2025/10/03 17:27:54 ET]
Table 'Sirio' 6-max Seat #1 is the button
Seat 1: ivano747 (€3 in chips) 
Seat 2: caduceus369 (€2.92 in chips) 
Seat 3: outshined8 (€2.21 in chips) 
Seat 4: EasyToRule (€3.99 in chips) 
Seat 5: xxcash88 (€1.99 in chips) 
Seat 6: lucpri (€2.11 in chips) 
caduceus369: posts small blind €0.01
outshined8: posts big blind €0.02
*** HOLE CARDS ***
Dealt to caduceus369 [6s 6c]
EasyToRule: folds 
xxcash88: folds 
lucpri: folds 
ivano747: folds 
caduceus369: calls €0.01
outshined8: checks 
*** FLOP *** [Kc 3h 9d]
caduceus369: checks 
outshined8: checks 
*** TURN *** [Kc 3h 9d] [9c]
caduceus369: bets €0.02
outshined8: folds 
Uncalled bet (€0.02) returned to caduceus369
caduceus369 collected €0.04 from pot
caduceus369: doesn't show hand 
*** SUMMARY ***
Total pot €0.04 | Rake €0 
Board [Kc 3h 9d 9c]
Seat 1: ivano747 (button) folded before Flop (didn't bet)
Seat 2: caduceus369 (small blind) collected (€0.04)
Seat 3: outshined8 (big blind) folded on the Turn
Seat 4: EasyToRule folded before Flop (didn't bet)
Seat 5: xxcash88 folded before Flop (didn't bet)
Seat 6: lucpri folded before Flop (didn't bet)



PokerStars Zoom Hand #257987973784:  Hold'em No Limit (€0.01/€0.02) [ADM ID: M62BA304494E32ST] - 2025/10/03 23:27:40 CET [2025/10/03 17:27:40 ET]
Table 'Sirio' 6-max Seat #1 is the button
Seat 1: Scardo84 (€2.04 in chips) 
Seat 2: J.S.Somers (€1.95 in chips) 
Seat 3: cesaretto23 (€3.18 in chips) 
Seat 4: EasyToRule (€2.07 in chips) 
Seat 5: Hope7075 (€0.80 in chips) 
Seat 6: caduceus369 (€2.92 in chips) 
J.S.Somers: posts small blind €0.01
cesaretto23: posts big blind €0.02
*** HOLE CARDS ***
Dealt to caduceus369 [5s 8c]
EasyToRule: folds 
Hope7075: calls €0.02
caduceus369: folds 
Scardo84: folds 
J.S.Somers: calls €0.01
cesaretto23: checks 
*** FLOP *** [7s Jh Js]
J.S.Somers: bets €0.03
cesaretto23: folds 
Hope7075: calls €0.03
*** TURN *** [7s Jh Js] [Qc]
J.S.Somers: checks 
Hope7075: checks 
*** RIVER *** [7s Jh Js Qc] [As]
J.S.Somers: checks 
Hope7075: bets €0.02
J.S.Somers: calls €0.02
*** SHOW DOWN ***
Hope7075: shows [Ah 4c] (two pair, Aces and Jacks)
J.S.Somers: mucks hand 
Hope7075 collected €0.16 from pot
*** SUMMARY ***
Total pot €0.16 | Rake €0 
Board [7s Jh Js Qc As]
Seat 1: Scardo84 (button) folded before Flop (didn't bet)
Seat 2: J.S.Somers (small blind) mucked [7h 6h]
Seat 3: cesaretto23 (big blind) folded on the Flop
Seat 4: EasyToRule folded before Flop (didn't bet)
Seat 5: Hope7075 showed [Ah 4c] and won (€0.16) with two pair, Aces and Jacks
Seat 6: caduceus369 folded before Flop (didn't bet)



PokerStars Zoom Hand #257987983311:  Hold'em No Limit (€0.01/€0.02) [ADM ID: M62BA304494E32ST] - 2025/10/03 23:28:20 CET [2025/10/03 17:28:20 ET]
Table 'Sirio' 6-max Seat #1 is the button
Seat 1: caduceus369 (€2.94 in chips) 
Seat 2: CacciatoreAA (€1.84 in chips) 
Seat 3: Neroonciolina (€4.67 in chips) 
Seat 4: ivano747 (€3 in chips) 
Seat 5: skynet0308 (€1.25 in chips) 
Seat 6: father2008 (€6.07 in chips) 
CacciatoreAA: posts small blind €0.01
Neroonciolina: posts big blind €0.02
*** HOLE CARDS ***
Dealt to caduceus369 [3s 9d]
ivano747: folds 
skynet0308: folds 
father2008: folds 
caduceus369: folds 
CacciatoreAA: folds 
Uncalled bet (€0.01) returned to Neroonciolina
Neroonciolina collected €0.02 from pot
Neroonciolina: doesn't show hand 
*** SUMMARY ***
Total pot €0.02 | Rake €0 
Seat 1: caduceus369 (button) folded before Flop (didn't bet)
Seat 2: CacciatoreAA (small blind) folded before Flop
Seat 3: Neroonciolina (big blind) collected (€0.02)
Seat 4: ivano747 folded before Flop (didn't bet)
Seat 5: skynet0308 folded before Flop (didn't bet)
Seat 6: father2008 folded before Flop (didn't bet)



PokerStars Zoom Hand #257987984947:  Hold'em No Limit (€0.01/€0.02) [ADM ID: M62BA304494E32ST] - 2025/10/03 23:28:26 CET [2025/10/03 17:28:26 ET]
Table 'Sirio' 6-max Seat #1 is the button
Seat 1: SidneyPrescott (€5.08 in chips) 
Seat 2: EasyToRule (€2 in chips) 
Seat 3: father2008 (€6.07 in chips) 
Seat 4: CacciatoreAA (€1.83 in chips) 
Seat 5: lucpri (€2.08 in chips) 
Seat 6: caduceus369 (€2.94 in chips) 
EasyToRule: posts small blind €0.01
father2008: posts big blind €0.02
*** HOLE CARDS ***
Dealt to caduceus369 [Ah 8h]
CacciatoreAA: folds 
lucpri: folds 
caduceus369: folds 
SidneyPrescott: raises €0.04 to €0.06
EasyToRule: folds 
father2008: folds 
Uncalled bet (€0.04) returned to SidneyPrescott
SidneyPrescott collected €0.05 from pot
SidneyPrescott: doesn't show hand 
*** SUMMARY ***
Total pot €0.05 | Rake €0 
Seat 1: SidneyPrescott (button) collected (€0.05)
Seat 2: EasyToRule (small blind) folded before Flop
Seat 3: father2008 (big blind) folded before Flop
Seat 4: CacciatoreAA folded before Flop (didn't bet)
Seat 5: lucpri folded before Flop (didn't bet)
Seat 6: caduceus369 folded before Flop (didn't bet)



PokerStars Zoom Hand #257987988566:  Hold'em No Limit (€0.01/€0.02) [ADM ID: M62BA304494E32ST] - 2025/10/03 23:28:41 CET [2025/10/03 17:28:41 ET]
Table 'Sirio' 6-max Seat #1 is the button
Seat 1: macchia1010 (€0.29 in chips) 
Seat 2: trillycata (€0.66 in chips) 
Seat 3: EasyToRule (€4.05 in chips) 
Seat 4: fantaasso (€1.97 in chips) 
Seat 5: caduceus369 (€2.94 in chips) 
Seat 6: maury999999 (€2.38 in chips) 
trillycata: posts small blind €0.01
EasyToRule: posts big blind €0.02
*** HOLE CARDS ***
Dealt to caduceus369 [Qs 7h]
fantaasso: folds 
caduceus369: folds 
maury999999: folds 
macchia1010: raises €0.27 to €0.29 and is all-in
trillycata: folds 
EasyToRule: folds 
Uncalled bet (€0.27) returned to macchia1010
macchia1010 collected €0.05 from pot
macchia1010: doesn't show hand 
*** SUMMARY ***
Total pot €0.05 | Rake €0 
Seat 1: macchia1010 (button) collected (€0.05)
Seat 2: trillycata (small blind) folded before Flop
Seat 3: EasyToRule (big blind) folded before Flop
Seat 4: fantaasso folded before Flop (didn't bet)
Seat 5: caduceus369 folded before Flop (didn't bet)
Seat 6: maury999999 folded before Flop (didn't bet)



PokerStars Zoom Hand #257987990049:  Hold'em No Limit (€0.01/€0.02) [ADM ID: M62BA304494E32ST] - 2025/10/03 23:28:47 CET [2025/10/03 17:28:47 ET]
Table 'Sirio' 6-max Seat #1 is the button
Seat 1: trillycata (€0.65 in chips) 
Seat 2: stfuplzudonk (€3.18 in chips) 
Seat 3: CacciatoreAA (€1.83 in chips) 
Seat 4: caduceus369 (€2.94 in chips) 
Seat 5: cesaretto23 (€3.32 in chips) 
Seat 6: SidneyPrescott (€5.11 in chips) 
stfuplzudonk: posts small blind €0.01
CacciatoreAA: posts big blind €0.02
*** HOLE CARDS ***
Dealt to caduceus369 [4d Kd]
caduceus369 has timed out
caduceus369: folds 
cesaretto23: folds 
SidneyPrescott: raises €0.04 to €0.06
trillycata: folds 
stfuplzudonk: folds 
CacciatoreAA: folds 
Uncalled bet (€0.04) returned to SidneyPrescott
SidneyPrescott collected €0.05 from pot
SidneyPrescott: doesn't show hand 
*** SUMMARY ***
Total pot €0.05 | Rake €0 
Seat 1: trillycata (button) folded before Flop (didn't bet)
Seat 2: stfuplzudonk (small blind) folded before Flop
Seat 3: CacciatoreAA (big blind) folded before Flop
Seat 4: caduceus369 folded before Flop (didn't bet)
Seat 5: cesaretto23 folded before Flop (didn't bet)
Seat 6: SidneyPrescott collected (€0.05)



PokerStars Zoom Hand #257987993707:  Hold'em No Limit (€0.01/€0.02) [ADM ID: M62BA304494E32ST] - 2025/10/03 23:29:02 CET [2025/10/03 17:29:02 ET]
Table 'Sirio' 6-max Seat #1 is the button
Seat 1: SidneyPrescott (€4.37 in chips) 
Seat 2: Catania838 (€1.44 in chips) 
Seat 3: caduceus369 (€2.94 in chips) 
Seat 4: ADRIAN0_MEIS (€2.39 in chips) 
Seat 5: ivano747 (€4.40 in chips) 
Seat 6: stfuplzudonk (€3.17 in chips) 
Catania838: posts small blind €0.01
caduceus369: posts big blind €0.02
*** HOLE CARDS ***
Dealt to caduceus369 [8c Kc]
ADRIAN0_MEIS: folds 
ivano747: folds 
stfuplzudonk: raises €0.02 to €0.04
SidneyPrescott: folds 
Catania838: folds 
caduceus369: calls €0.02
*** FLOP *** [Qh Kd 7c]
caduceus369: checks 
stfuplzudonk: bets €0.05
caduceus369: calls €0.05
*** TURN *** [Qh Kd 7c] [9d]
caduceus369: checks 
stfuplzudonk: checks 
*** RIVER *** [Qh Kd 7c 9d] [4d]
caduceus369: bets €0.04
stfuplzudonk: calls €0.04
*** SHOW DOWN ***
caduceus369: shows [8c Kc] (a pair of Kings)
stfuplzudonk: shows [Th Kh] (a pair of Kings - Queen+Ten kicker)
stfuplzudonk collected €0.26 from pot
*** SUMMARY ***
Total pot €0.27 | Rake €0.01 
Board [Qh Kd 7c 9d 4d]
Seat 1: SidneyPrescott (button) folded before Flop (didn't bet)
Seat 2: Catania838 (small blind) folded before Flop
Seat 3: caduceus369 (big blind) showed [8c Kc] and lost with a pair of Kings
Seat 4: ADRIAN0_MEIS folded before Flop (didn't bet)
Seat 5: ivano747 folded before Flop (didn't bet)
Seat 6: stfuplzudonk showed [Th Kh] and won (€0.26) with a pair of Kings



PokerStars Zoom Hand #257988011732:  Hold'em No Limit (€0.01/€0.02) [ADM ID: M62BA304494E32ST] - 2025/10/03 23:30:17 CET [2025/10/03 17:30:17 ET]
Table 'Sirio' 6-max Seat #1 is the button
Seat 1: cartoonbest (€0.81 in chips) 
Seat 2: KindRonin (€1.21 in chips) 
Seat 3: workman75 (€2.67 in chips) 
Seat 4: SidneyPrescott (€5.39 in chips) 
Seat 5: ivano747 (€4.33 in chips) 
Seat 6: caduceus369 (€2.80 in chips) 
KindRonin: posts small blind €0.01
workman75: posts big blind €0.02
*** HOLE CARDS ***
Dealt to caduceus369 [Ks 8h]
SidneyPrescott: raises €0.04 to €0.06
ivano747: raises €0.64 to €0.70
caduceus369: folds 
cartoonbest: folds 
KindRonin: folds 
workman75: folds 
SidneyPrescott: folds 
Uncalled bet (€0.64) returned to ivano747
ivano747 collected €0.15 from pot
ivano747: doesn't show hand 
*** SUMMARY ***
Total pot €0.15 | Rake €0 
Seat 1: cartoonbest (button) folded before Flop (didn't bet)
Seat 2: KindRonin (small blind) folded before Flop
Seat 3: workman75 (big blind) folded before Flop
Seat 4: SidneyPrescott folded before Flop
Seat 5: ivano747 collected (€0.15)
Seat 6: caduceus369 folded before Flop (didn't bet)



PokerStars Zoom Hand #257988009280:  Hold'em No Limit (€0.01/€0.02) [ADM ID: M62BA304494E32ST] - 2025/10/03 23:30:06 CET [2025/10/03 17:30:06 ET]
Table 'Sirio' 6-max Seat #1 is the button
Seat 1: EasyToRule (€2 in chips) 
Seat 2: caduceus369 (€2.81 in chips) 
Seat 3: KindRonin (€1.23 in chips) 
Seat 4: Chia9711 (€2.40 in chips) 
Seat 5: SKERZA (€1.06 in chips) 
Seat 6: Neroonciolina (€4.56 in chips) 
caduceus369: posts small blind €0.01
KindRonin: posts big blind €0.02
*** HOLE CARDS ***
Dealt to caduceus369 [Ad 3h]
Chia9711: calls €0.02
SKERZA: raises €0.04 to €0.06
Neroonciolina: calls €0.06
EasyToRule: folds 
caduceus369: folds 
KindRonin: folds 
Chia9711: calls €0.04
*** FLOP *** [Kh 6h Js]
Chia9711: checks 
SKERZA: bets €0.11
Neroonciolina: calls €0.11
Chia9711: folds 
*** TURN *** [Kh 6h Js] [Ah]
SKERZA: checks 
Neroonciolina: bets €0.26
SKERZA: folds 
Uncalled bet (€0.26) returned to Neroonciolina
Neroonciolina collected €0.41 from pot
Neroonciolina: doesn't show hand 
*** SUMMARY ***
Total pot €0.43 | Rake €0.02 
Board [Kh 6h Js Ah]
Seat 1: EasyToRule (button) folded before Flop (didn't bet)
Seat 2: caduceus369 (small blind) folded before Flop
Seat 3: KindRonin (big blind) folded before Flop
Seat 4: Chia9711 folded on the Flop
Seat 5: SKERZA folded on the Turn
Seat 6: Neroonciolina collected (€0.41)



PokerStars Zoom Hand #257988016226:  Hold'em No Limit (€0.01/€0.02) [ADM ID: M62BA304494E32ST] - 2025/10/03 23:30:36 CET [2025/10/03 17:30:36 ET]
Table 'Sirio' 6-max Seat #1 is the button
Seat 1: SidneyPrescott (€4.22 in chips) 
Seat 2: diego-rigano (€0.78 in chips) 
Seat 3: caduceus369 (€2.80 in chips) 
Seat 4: Hope7075 (€0.65 in chips) 
Seat 5: tigermiscio (€0.56 in chips) 
Seat 6: KindRonin (€1.20 in chips) 
diego-rigano: posts small blind €0.01
caduceus369: posts big blind €0.02
*** HOLE CARDS ***
Dealt to caduceus369 [6s 5h]
Hope7075: calls €0.02
tigermiscio: calls €0.02
KindRonin: folds 
SidneyPrescott: calls €0.02
diego-rigano: calls €0.01
caduceus369: checks 
*** FLOP *** [8d 3c 4d]
diego-rigano: checks 
caduceus369: bets €0.02
Hope7075: raises €0.04 to €0.06
tigermiscio: folds 
SidneyPrescott: folds 
diego-rigano: calls €0.06
caduceus369: calls €0.04
*** TURN *** [8d 3c 4d] [Jc]
diego-rigano: checks 
caduceus369: checks 
Hope7075: bets €0.27
diego-rigano: folds 
caduceus369: folds 
Uncalled bet (€0.27) returned to Hope7075
Hope7075 collected €0.27 from pot
Hope7075: doesn't show hand 
*** SUMMARY ***
Total pot €0.28 | Rake €0.01 
Board [8d 3c 4d Jc]
Seat 1: SidneyPrescott (button) folded on the Flop
Seat 2: diego-rigano (small blind) folded on the Turn
Seat 3: caduceus369 (big blind) folded on the Turn
Seat 4: Hope7075 collected (€0.27)
Seat 5: tigermiscio folded on the Flop
Seat 6: KindRonin folded before Flop (didn't bet)



PokerStars Zoom Hand #257988014040:  Hold'em No Limit (€0.01/€0.02) [ADM ID: M62BA304494E32ST] - 2025/10/03 23:30:27 CET [2025/10/03 17:30:27 ET]
Table 'Sirio' 6-max Seat #1 is the button
Seat 1: caduceus369 (€2.80 in chips) 
Seat 2: 999rizla (€0.93 in chips) 
Seat 3: Catania838 (€2.09 in chips) 
Seat 4: Goblin1999 (€2.35 in chips) 
Seat 5: Sium12302 (€2 in chips) 
Seat 6: ADRIAN0_MEIS (€9.58 in chips) 
999rizla: posts small blind €0.01
Catania838: posts big blind €0.02
*** HOLE CARDS ***
Dealt to caduceus369 [5d Qd]
Goblin1999: calls €0.02
Sium12302: folds 
ADRIAN0_MEIS: raises €0.07 to €0.09
caduceus369: folds 
999rizla: folds 
Catania838: folds 
Goblin1999: raises €0.19 to €0.28
ADRIAN0_MEIS: calls €0.19
*** FLOP *** [5h Tc 7c]
Goblin1999: bets €2.07 and is all-in
ADRIAN0_MEIS: calls €2.07
*** TURN *** [5h Tc 7c] [Kd]
*** RIVER *** [5h Tc 7c Kd] [4c]
*** SHOW DOWN ***
Goblin1999: shows [Qs Kc] (a pair of Kings)
ADRIAN0_MEIS: shows [Jd Jc] (a pair of Jacks)
Goblin1999 collected €4.47 from pot
*** SUMMARY ***
Total pot €4.73 | Rake €0.26 
Board [5h Tc 7c Kd 4c]
Seat 1: caduceus369 (button) folded before Flop (didn't bet)
Seat 2: 999rizla (small blind) folded before Flop
Seat 3: Catania838 (big blind) folded before Flop
Seat 4: Goblin1999 showed [Qs Kc] and won (€4.47) with a pair of Kings
Seat 5: Sium12302 folded before Flop (didn't bet)
Seat 6: ADRIAN0_MEIS showed [Jd Jc] and lost with a pair of Jacks



PokerStars Zoom Hand #257988027671:  Hold'em No Limit (€0.01/€0.02) [ADM ID: M62BA304494E32ST] - 2025/10/03 23:31:24 CET [2025/10/03 17:31:24 ET]
Table 'Sirio' 6-max Seat #1 is the button
Seat 1: fantaasso (€1.98 in chips) 
Seat 2: Sium12302 (€2 in chips) 
Seat 3: Catania838 (€2.06 in chips) 
Seat 4: caduceus369 (€2.72 in chips) 
Seat 5: maury999999 (€2.16 in chips) 
Seat 6: MOLDAVO1069 (€3.42 in chips) 
Sium12302: posts small blind €0.01
Catania838: posts big blind €0.02
*** HOLE CARDS ***
Dealt to caduceus369 [2s Kh]
caduceus369: folds 
maury999999: folds 
MOLDAVO1069: folds 
fantaasso: folds 
Sium12302: folds 
Uncalled bet (€0.01) returned to Catania838
Catania838 collected €0.02 from pot
Catania838: doesn't show hand 
*** SUMMARY ***
Total pot €0.02 | Rake €0 
Seat 1: fantaasso (button) folded before Flop (didn't bet)
Seat 2: Sium12302 (small blind) folded before Flop
Seat 3: Catania838 (big blind) collected (€0.02)
Seat 4: caduceus369 folded before Flop (didn't bet)
Seat 5: maury999999 folded before Flop (didn't bet)
Seat 6: MOLDAVO1069 folded before Flop (didn't bet)



PokerStars Zoom Hand #257988026717:  Hold'em No Limit (€0.01/€0.02) [ADM ID: M62BA304494E32ST] - 2025/10/03 23:31:20 CET [2025/10/03 17:31:20 ET]
Table 'Sirio' 6-max Seat #1 is the button
Seat 1: ivano747 (€4.39 in chips) 
Seat 2: KindRonin (€1.12 in chips) 
Seat 3: EasyToRule (€2.03 in chips) 
Seat 4: stfuplzudonk (€3.23 in chips) 
Seat 5: caduceus369 (€2.72 in chips) 
Seat 6: SidneyPrescott (€5.57 in chips) 
KindRonin: posts small blind €0.01
EasyToRule: posts big blind €0.02
*** HOLE CARDS ***
Dealt to caduceus369 [4h 9c]
stfuplzudonk: folds 
caduceus369: folds 
SidneyPrescott: raises €0.04 to €0.06
ivano747: folds 
KindRonin: folds 
EasyToRule: raises €0.21 to €0.27
SidneyPrescott: folds 
Uncalled bet (€0.21) returned to EasyToRule
EasyToRule collected €0.13 from pot
EasyToRule: doesn't show hand 
*** SUMMARY ***
Total pot €0.13 | Rake €0 
Seat 1: ivano747 (button) folded before Flop (didn't bet)
Seat 2: KindRonin (small blind) folded before Flop
Seat 3: EasyToRule (big blind) collected (€0.13)
Seat 4: stfuplzudonk folded before Flop (didn't bet)
Seat 5: caduceus369 folded before Flop (didn't bet)
Seat 6: SidneyPrescott folded before Flop



PokerStars Zoom Hand #257988030994:  Hold'em No Limit (€0.01/€0.02) [ADM ID: M62BA304494E32ST] - 2025/10/03 23:31:38 CET [2025/10/03 17:31:38 ET]
Table 'Sirio' 6-max Seat #1 is the button
Seat 1: ADRIAN0_MEIS (€12.41 in chips) 
Seat 2: Scardo84 (€2.06 in chips) 
Seat 3: tigermiscio (€0.52 in chips) 
Seat 4: sparky91580 (€0.64 in chips) 
Seat 5: caduceus369 (€2.71 in chips) 
Seat 6: neoilnervoso (€1.85 in chips) 
Scardo84: posts small blind €0.01
tigermiscio: posts big blind €0.02
*** HOLE CARDS ***
Dealt to caduceus369 [Ad 8s]
sparky91580: folds 
caduceus369: folds 
neoilnervoso: folds 
ADRIAN0_MEIS: folds 
Scardo84: folds 
Uncalled bet (€0.01) returned to tigermiscio
tigermiscio collected €0.02 from pot
tigermiscio: doesn't show hand 
*** SUMMARY ***
Total pot €0.02 | Rake €0 
Seat 1: ADRIAN0_MEIS (button) folded before Flop (didn't bet)
Seat 2: Scardo84 (small blind) folded before Flop
Seat 3: tigermiscio (big blind) collected (€0.02)
Seat 4: sparky91580 folded before Flop (didn't bet)
Seat 5: caduceus369 folded before Flop (didn't bet)
Seat 6: neoilnervoso folded before Flop (didn't bet)



PokerStars Zoom Hand #257988028603:  Hold'em No Limit (€0.01/€0.02) [ADM ID: M62BA304494E32ST] - 2025/10/03 23:31:28 CET [2025/10/03 17:31:28 ET]
Table 'Sirio' 6-max Seat #1 is the button
Seat 1: MOLDAVO1069 (€3.42 in chips) 
Seat 2: robertoH2O (€2.08 in chips) 
Seat 3: ivano747 (€3.32 in chips) 
Seat 4: caduceus369 (€2.72 in chips) 
Seat 5: fantaasso (€1.98 in chips) 
Seat 6: Chia9711 (€2.27 in chips) 
robertoH2O: posts small blind €0.01
ivano747: posts big blind €0.02
*** HOLE CARDS ***
Dealt to caduceus369 [4h 3d]
caduceus369: folds 
fantaasso: folds 
Chia9711: folds 
MOLDAVO1069: folds 
robertoH2O: raises €0.04 to €0.06
ivano747: calls €0.04
*** FLOP *** [2c Jh Ts]
robertoH2O: bets €0.06
ivano747: calls €0.06
*** TURN *** [2c Jh Ts] [Jc]
robertoH2O: bets €0.14
ivano747: calls €0.14
*** RIVER *** [2c Jh Ts Jc] [9s]
robertoH2O: bets €0.19
ivano747: calls €0.19
*** SHOW DOWN ***
robertoH2O: shows [Kh Js] (three of a kind, Jacks)
ivano747: mucks hand 
robertoH2O collected €0.86 from pot
*** SUMMARY ***
Total pot €0.90 | Rake €0.04 
Board [2c Jh Ts Jc 9s]
Seat 1: MOLDAVO1069 (button) folded before Flop (didn't bet)
Seat 2: robertoH2O (small blind) showed [Kh Js] and won (€0.86) with three of a kind, Jacks
Seat 3: ivano747 (big blind) mucked [Tc Kd]
Seat 4: caduceus369 folded before Flop (didn't bet)
Seat 5: fantaasso folded before Flop (didn't bet)
Seat 6: Chia9711 folded before Flop (didn't bet)



PokerStars Zoom Hand #257988029577:  Hold'em No Limit (€0.01/€0.02) [ADM ID: M62BA304494E32ST] - 2025/10/03 23:31:32 CET [2025/10/03 17:31:32 ET]
Table 'Sirio' 6-max Seat #1 is the button
Seat 1: capovujadin (€1.78 in chips) 
Seat 2: caduceus369 (€2.72 in chips) 
Seat 3: father2008 (€4.03 in chips) 
Seat 4: MOLDAVO1069 (€3.42 in chips) 
Seat 5: SidneyPrescott (€2 in chips) 
Seat 6: fantaasso (€1.98 in chips) 
caduceus369: posts small blind €0.01
father2008: posts big blind €0.02
*** HOLE CARDS ***
Dealt to caduceus369 [4h 8c]
MOLDAVO1069: folds 
SidneyPrescott: folds 
fantaasso: raises €0.04 to €0.06
capovujadin: calls €0.06
caduceus369: folds 
father2008: calls €0.04
*** FLOP *** [As 8s Ac]
father2008: checks 
fantaasso: checks 
capovujadin: checks 
*** TURN *** [As 8s Ac] [Qh]
father2008: checks 
fantaasso: checks 
capovujadin: bets €0.02
father2008: calls €0.02
fantaasso: calls €0.02
*** RIVER *** [As 8s Ac Qh] [Qs]
father2008: checks 
fantaasso: checks 
capovujadin: bets €0.12
father2008: folds 
fantaasso: folds 
Uncalled bet (€0.12) returned to capovujadin
capovujadin collected €0.24 from pot
capovujadin: doesn't show hand 
*** SUMMARY ***
Total pot €0.25 | Rake €0.01 
Board [As 8s Ac Qh Qs]
Seat 1: capovujadin (button) collected (€0.24)
Seat 2: caduceus369 (small blind) folded before Flop
Seat 3: father2008 (big blind) folded on the River
Seat 4: MOLDAVO1069 folded before Flop (didn't bet)
Seat 5: SidneyPrescott folded before Flop (didn't bet)
Seat 6: fantaasso folded on the River



PokerStars Zoom Hand #257988032887:  Hold'em No Limit (€0.01/€0.02) [ADM ID: M62BA304494E32ST] - 2025/10/03 23:31:46 CET [2025/10/03 17:31:46 ET]
Table 'Sirio' 6-max Seat #1 is the button
Seat 1: EasyToRule (€2.10 in chips) 
Seat 2: sparky91580 (€0.64 in chips) 
Seat 3: caduceus369 (€2.71 in chips) 
Seat 4: SidneyPrescott (€4.15 in chips) 
Seat 5: fantaasso (€1.58 in chips) 
Seat 6: 999rizla (€1.03 in chips) 
sparky91580: posts small blind €0.01
caduceus369: posts big blind €0.02
*** HOLE CARDS ***
Dealt to caduceus369 [5h 6h]
SidneyPrescott: folds 
fantaasso: folds 
999rizla: folds 
EasyToRule: raises €0.04 to €0.06
sparky91580: calls €0.05
caduceus369: calls €0.04
*** FLOP *** [6c 4d 4s]
sparky91580: bets €0.09
caduceus369: calls €0.09
EasyToRule: folds 
*** TURN *** [6c 4d 4s] [3s]
sparky91580: checks 
caduceus369: bets €0.18
sparky91580: folds 
Uncalled bet (€0.18) returned to caduceus369
caduceus369 collected €0.35 from pot
caduceus369: doesn't show hand 
*** SUMMARY ***
Total pot €0.36 | Rake €0.01 
Board [6c 4d 4s 3s]
Seat 1: EasyToRule (button) folded on the Flop
Seat 2: sparky91580 (small blind) folded on the Turn
Seat 3: caduceus369 (big blind) collected (€0.35)
Seat 4: SidneyPrescott folded before Flop (didn't bet)
Seat 5: fantaasso folded before Flop (didn't bet)
Seat 6: 999rizla folded before Flop (didn't bet)



PokerStars Zoom Hand #257988041996:  Hold'em No Limit (€0.01/€0.02) [ADM ID: M62BA304494E32ST] - 2025/10/03 23:32:24 CET [2025/10/03 17:32:24 ET]
Table 'Sirio' 6-max Seat #1 is the button
Seat 1: caduceus369 (€2.91 in chips) 
Seat 2: EasyToRule (€2.07 in chips) 
Seat 3: fantaasso (€1.90 in chips) 
Seat 4: Sium12302 (€4.37 in chips) 
Seat 5: ADRIAN0_MEIS (€7.39 in chips) 
Seat 6: sparky91580 (€0.49 in chips) 
EasyToRule: posts small blind €0.01
fantaasso: posts big blind €0.02
*** HOLE CARDS ***
Dealt to caduceus369 [8h 2s]
Sium12302: folds 
ADRIAN0_MEIS: raises €0.05 to €0.07
sparky91580: folds 
caduceus369: folds 
EasyToRule: folds 
fantaasso: folds 
Uncalled bet (€0.05) returned to ADRIAN0_MEIS
ADRIAN0_MEIS collected €0.05 from pot
ADRIAN0_MEIS: doesn't show hand 
*** SUMMARY ***
Total pot €0.05 | Rake €0 
Seat 1: caduceus369 (button) folded before Flop (didn't bet)
Seat 2: EasyToRule (small blind) folded before Flop
Seat 3: fantaasso (big blind) folded before Flop
Seat 4: Sium12302 folded before Flop (didn't bet)
Seat 5: ADRIAN0_MEIS collected (€0.05)
Seat 6: sparky91580 folded before Flop (didn't bet)



PokerStars Zoom Hand #257988045630:  Hold'em No Limit (€0.01/€0.02) [ADM ID: M62BA304494E32ST] - 2025/10/03 23:32:40 CET [2025/10/03 17:32:40 ET]
Table 'Sirio' 6-max Seat #1 is the button
Seat 1: ivano747 (€2.86 in chips) 
Seat 2: pia1256 (€1.75 in chips) 
Seat 3: SidneyPrescott (€5.51 in chips) 
Seat 4: stfuplzudonk (€1.42 in chips) 
Seat 5: Catania838 (€3.18 in chips) 
Seat 6: caduceus369 (€2.91 in chips) 
pia1256: posts small blind €0.01
SidneyPrescott: posts big blind €0.02
*** HOLE CARDS ***
Dealt to caduceus369 [Kc 2c]
stfuplzudonk: raises €0.02 to €0.04
Catania838: folds 
caduceus369: folds 
ivano747: folds 
pia1256: calls €0.03
SidneyPrescott: folds 
*** FLOP *** [Ah Qs Jc]
pia1256: checks 
stfuplzudonk: checks 
*** TURN *** [Ah Qs Jc] [Qh]
pia1256: checks 
stfuplzudonk: bets €0.05
pia1256: folds 
Uncalled bet (€0.05) returned to stfuplzudonk
stfuplzudonk collected €0.10 from pot
stfuplzudonk: doesn't show hand 
*** SUMMARY ***
Total pot €0.10 | Rake €0 
Board [Ah Qs Jc Qh]
Seat 1: ivano747 (button) folded before Flop (didn't bet)
Seat 2: pia1256 (small blind) folded on the Turn
Seat 3: SidneyPrescott (big blind) folded before Flop
Seat 4: stfuplzudonk collected (€0.10)
Seat 5: Catania838 folded before Flop (didn't bet)
Seat 6: caduceus369 folded before Flop (didn't bet)



PokerStars Zoom Hand #257988046529:  Hold'em No Limit (€0.01/€0.02) [ADM ID: M62BA304494E32ST] - 2025/10/03 23:32:43 CET [2025/10/03 17:32:43 ET]
Table 'Sirio' 6-max Seat #1 is the button
Seat 1: maury999999 (€2.41 in chips) 
Seat 2: xxcash88 (€1.98 in chips) 
Seat 3: cartoonbest (€1.73 in chips) 
Seat 4: caduceus369 (€2.91 in chips) 
Seat 5: trillycata (€1.31 in chips) 
Seat 6: outshined8 (€1.58 in chips) 
xxcash88: posts small blind €0.01
cartoonbest: posts big blind €0.02
*** HOLE CARDS ***
Dealt to caduceus369 [3s Ks]
caduceus369: folds 
trillycata: folds 
outshined8: folds 
maury999999: folds 
xxcash88: raises €0.04 to €0.06
cartoonbest: folds 
Uncalled bet (€0.04) returned to xxcash88
xxcash88 collected €0.04 from pot
xxcash88: doesn't show hand 
*** SUMMARY ***
Total pot €0.04 | Rake €0 
Seat 1: maury999999 (button) folded before Flop (didn't bet)
Seat 2: xxcash88 (small blind) collected (€0.04)
Seat 3: cartoonbest (big blind) folded before Flop
Seat 4: caduceus369 folded before Flop (didn't bet)
Seat 5: trillycata folded before Flop (didn't bet)
Seat 6: outshined8 folded before Flop (didn't bet)



PokerStars Zoom Hand #257988047979:  Hold'em No Limit (€0.01/€0.02) [ADM ID: M62BA304494E32ST] - 2025/10/03 23:32:49 CET [2025/10/03 17:32:49 ET]
Table 'Sirio' 6-max Seat #1 is the button
Seat 1: MOLDAVO1069 (€3.33 in chips) 
Seat 2: fantaasso (€1.88 in chips) 
Seat 3: caduceus369 (€2.91 in chips) 
Seat 4: maury999999 (€2.17 in chips) 
Seat 5: ADRIAN0_MEIS (€12.47 in chips) 
Seat 6: SidneyPrescott (€2 in chips) 
fantaasso: posts small blind €0.01
caduceus369: posts big blind €0.02
*** HOLE CARDS ***
Dealt to caduceus369 [5d Jc]
maury999999: folds 
ADRIAN0_MEIS: folds 
SidneyPrescott: folds 
MOLDAVO1069: folds 
fantaasso: raises €0.02 to €0.04
caduceus369: folds 
Uncalled bet (€0.02) returned to fantaasso
fantaasso collected €0.04 from pot
fantaasso: doesn't show hand 
*** SUMMARY ***
Total pot €0.04 | Rake €0 
Seat 1: MOLDAVO1069 (button) folded before Flop (didn't bet)
Seat 2: fantaasso (small blind) collected (€0.04)
Seat 3: caduceus369 (big blind) folded before Flop
Seat 4: maury999999 folded before Flop (didn't bet)
Seat 5: ADRIAN0_MEIS folded before Flop (didn't bet)
Seat 6: SidneyPrescott folded before Flop (didn't bet)



PokerStars Zoom Hand #257988051874:  Hold'em No Limit (€0.01/€0.02) [ADM ID: M62BA304494E32ST] - 2025/10/03 23:33:05 CET [2025/10/03 17:33:05 ET]
Table 'Sirio' 6-max Seat #1 is the button
Seat 1: SidneyPrescott (€3.99 in chips) 
Seat 2: caduceus369 (€2.89 in chips) 
Seat 3: Redfire827 (€1.10 in chips) 
Seat 4: CacciatoreAA (€1.88 in chips) 
Seat 5: xxcash88 (€2 in chips) 
Seat 6: Neroonciolina (€5.42 in chips) 
caduceus369: posts small blind €0.01
Redfire827: posts big blind €0.02
*** HOLE CARDS ***
Dealt to caduceus369 [Td 6c]
CacciatoreAA: folds 
xxcash88: folds 
Neroonciolina: raises €0.10 to €0.12
SidneyPrescott: folds 
caduceus369: folds 
Redfire827: folds 
Uncalled bet (€0.10) returned to Neroonciolina
Neroonciolina collected €0.05 from pot
Neroonciolina: doesn't show hand 
*** SUMMARY ***
Total pot €0.05 | Rake €0 
Seat 1: SidneyPrescott (button) folded before Flop (didn't bet)
Seat 2: caduceus369 (small blind) folded before Flop
Seat 3: Redfire827 (big blind) folded before Flop
Seat 4: CacciatoreAA folded before Flop (didn't bet)
Seat 5: xxcash88 folded before Flop (didn't bet)
Seat 6: Neroonciolina collected (€0.05)



PokerStars Zoom Hand #257988054009:  Hold'em No Limit (€0.01/€0.02) [ADM ID: M62BA304494E32ST] - 2025/10/03 23:33:14 CET [2025/10/03 17:33:14 ET]
Table 'Sirio' 6-max Seat #1 is the button
Seat 1: MOLDAVO1069 (€10.04 in chips) 
Seat 2: 999rizla (€1.02 in chips) 
Seat 3: stfuplzudonk (€1.48 in chips) 
Seat 4: SidneyPrescott (€3.98 in chips) 
Seat 5: caduceus369 (€2.88 in chips) 
Seat 6: Goblin1999 (€4.44 in chips) 
999rizla: posts small blind €0.01
stfuplzudonk: posts big blind €0.02
*** HOLE CARDS ***
Dealt to caduceus369 [Kh Qc]
SidneyPrescott: folds 
caduceus369: raises €0.04 to €0.06
Goblin1999: calls €0.06
MOLDAVO1069: calls €0.06
999rizla: folds 
stfuplzudonk: calls €0.04
*** FLOP *** [5h 9d 2c]
stfuplzudonk: checks 
caduceus369: checks 
Goblin1999: bets €0.24
MOLDAVO1069: calls €0.24
stfuplzudonk: folds 
caduceus369: folds 
*** TURN *** [5h 9d 2c] [5s]
Goblin1999: bets €0.69
MOLDAVO1069: folds 
Uncalled bet (€0.69) returned to Goblin1999
Goblin1999 collected €0.69 from pot
Goblin1999: doesn't show hand 
*** SUMMARY ***
Total pot €0.73 | Rake €0.04 
Board [5h 9d 2c 5s]
Seat 1: MOLDAVO1069 (button) folded on the Turn
Seat 2: 999rizla (small blind) folded before Flop
Seat 3: stfuplzudonk (big blind) folded on the Flop
Seat 4: SidneyPrescott folded before Flop (didn't bet)
Seat 5: caduceus369 folded on the Flop
Seat 6: Goblin1999 collected (€0.69)



PokerStars Zoom Hand #257988060010:  Hold'em No Limit (€0.01/€0.02) [ADM ID: M62BA304494E32ST] - 2025/10/03 23:33:39 CET [2025/10/03 17:33:39 ET]
Table 'Sirio' 6-max Seat #1 is the button
Seat 1: caduceus369 (€2.81 in chips) 
Seat 2: cartoonbest (€1.65 in chips) 
Seat 3: KindRonin (€0.33 in chips) 
Seat 4: MOLDAVO1069 (€3.34 in chips) 
Seat 5: ivano747 (€2.83 in chips) 
Seat 6: workman75 (€2.59 in chips) 
cartoonbest: posts small blind €0.01
KindRonin: posts big blind €0.02
*** HOLE CARDS ***
Dealt to caduceus369 [4h Qs]
MOLDAVO1069: folds 
ivano747: folds 
workman75: raises €0.04 to €0.06
caduceus369: folds 
cartoonbest: folds 
KindRonin: calls €0.04
*** FLOP *** [4s 5d As]
KindRonin: checks 
workman75: bets €0.06
KindRonin: folds 
Uncalled bet (€0.06) returned to workman75
workman75 collected €0.13 from pot
workman75: doesn't show hand 
*** SUMMARY ***
Total pot €0.13 | Rake €0 
Board [4s 5d As]
Seat 1: caduceus369 (button) folded before Flop (didn't bet)
Seat 2: cartoonbest (small blind) folded before Flop
Seat 3: KindRonin (big blind) folded on the Flop
Seat 4: MOLDAVO1069 folded before Flop (didn't bet)
Seat 5: ivano747 folded before Flop (didn't bet)
Seat 6: workman75 collected (€0.13)



PokerStars Zoom Hand #257988059046:  Hold'em No Limit (€0.01/€0.02) [ADM ID: M62BA304494E32ST] - 2025/10/03 23:33:35 CET [2025/10/03 17:33:35 ET]
Table 'Sirio' 6-max Seat #1 is the button
Seat 1: maury999999 (€2.31 in chips) 
Seat 2: caduceus369 (€2.82 in chips) 
Seat 3: tigermiscio (€0.62 in chips) 
Seat 4: ADRIAN0_MEIS (€2.69 in chips) 
Seat 5: Witness85906 (€5.15 in chips) 
Seat 6: diego-rigano (€0.62 in chips) 
caduceus369: posts small blind €0.01
tigermiscio: posts big blind €0.02
*** HOLE CARDS ***
Dealt to caduceus369 [9h 6h]
ADRIAN0_MEIS: folds 
Witness85906: raises €0.03 to €0.05
diego-rigano: calls €0.05
maury999999: folds 
caduceus369: folds 
tigermiscio: calls €0.03
*** FLOP *** [9d Kh 4s]
tigermiscio: checks 
Witness85906: checks 
diego-rigano: checks 
*** TURN *** [9d Kh 4s] [Ah]
tigermiscio: checks 
Witness85906: checks 
diego-rigano: checks 
*** RIVER *** [9d Kh 4s Ah] [6s]
tigermiscio: checks 
Witness85906: checks 
diego-rigano: checks 
*** SHOW DOWN ***
tigermiscio: shows [Ac Th] (a pair of Aces)
Witness85906: mucks hand 
diego-rigano: mucks hand 
tigermiscio collected €0.16 from pot
*** SUMMARY ***
Total pot €0.16 | Rake €0 
Board [9d Kh 4s Ah 6s]
Seat 1: maury999999 (button) folded before Flop (didn't bet)
Seat 2: caduceus369 (small blind) folded before Flop
Seat 3: tigermiscio (big blind) showed [Ac Th] and won (€0.16) with a pair of Aces
Seat 4: ADRIAN0_MEIS folded before Flop (didn't bet)
Seat 5: Witness85906 mucked [Qd 7d]
Seat 6: diego-rigano mucked [Ts 9s]



PokerStars Zoom Hand #257988060705:  Hold'em No Limit (€0.01/€0.02) [ADM ID: M62BA304494E32ST] - 2025/10/03 23:33:42 CET [2025/10/03 17:33:42 ET]
Table 'Sirio' 6-max Seat #1 is the button
Seat 1: father2008 (€6.46 in chips) 
Seat 2: ADRIAN0_MEIS (€7.40 in chips) 
Seat 3: Catania838 (€1.77 in chips) 
Seat 4: savicevic74 (€3.45 in chips) 
Seat 5: 999rizla (€1.02 in chips) 
Seat 6: caduceus369 (€2.81 in chips) 
ADRIAN0_MEIS: posts small blind €0.01
Catania838: posts big blind €0.02
*** HOLE CARDS ***
Dealt to caduceus369 [Kd Th]
savicevic74: folds 
999rizla: folds 
caduceus369: raises €0.04 to €0.06
father2008: folds 
ADRIAN0_MEIS: folds 
Catania838: calls €0.04
*** FLOP *** [Jh 7s 9d]
Catania838: checks 
caduceus369: bets €0.04
Catania838: raises €0.04 to €0.08
caduceus369: calls €0.04
*** TURN *** [Jh 7s 9d] [2h]
Catania838: checks 
caduceus369: checks 
*** RIVER *** [Jh 7s 9d 2h] [3s]
Catania838: bets €0.04
caduceus369: folds 
Uncalled bet (€0.04) returned to Catania838
Catania838 collected €0.28 from pot
Catania838: doesn't show hand 
*** SUMMARY ***
Total pot €0.29 | Rake €0.01 
Board [Jh 7s 9d 2h 3s]
Seat 1: father2008 (button) folded before Flop (didn't bet)
Seat 2: ADRIAN0_MEIS (small blind) folded before Flop
Seat 3: Catania838 (big blind) collected (€0.28)
Seat 4: savicevic74 folded before Flop (didn't bet)
Seat 5: 999rizla folded before Flop (didn't bet)
Seat 6: caduceus369 folded on the River



PokerStars Zoom Hand #257988071191:  Hold'em No Limit (€0.01/€0.02) [ADM ID: M62BA304494E32ST] - 2025/10/03 23:34:26 CET [2025/10/03 17:34:26 ET]
Table 'Sirio' 6-max Seat #1 is the button
Seat 1: Sium12302 (€4.29 in chips) 
Seat 2: Catania838 (€1.91 in chips) 
Seat 3: neoilnervoso (€0.97 in chips) 
Seat 4: Neroonciolina (€5.40 in chips) 
Seat 5: caduceus369 (€2.67 in chips) 
Seat 6: stfuplzudonk (€4.42 in chips) 
Catania838: posts small blind €0.01
neoilnervoso: posts big blind €0.02
*** HOLE CARDS ***
Dealt to caduceus369 [Js Qc]
Neroonciolina: folds 
caduceus369: folds 
stfuplzudonk: raises €0.04 to €0.06
Sium12302: folds 
Catania838: folds 
neoilnervoso: calls €0.04
*** FLOP *** [7s 4s Kc]
neoilnervoso: checks 
stfuplzudonk: bets €0.07
neoilnervoso: folds 
Uncalled bet (€0.07) returned to stfuplzudonk
stfuplzudonk collected €0.13 from pot
stfuplzudonk: doesn't show hand 
*** SUMMARY ***
Total pot €0.13 | Rake €0 
Board [7s 4s Kc]
Seat 1: Sium12302 (button) folded before Flop (didn't bet)
Seat 2: Catania838 (small blind) folded before Flop
Seat 3: neoilnervoso (big blind) folded on the Flop
Seat 4: Neroonciolina folded before Flop (didn't bet)
Seat 5: caduceus369 folded before Flop (didn't bet)
Seat 6: stfuplzudonk collected (€0.13)



PokerStars Zoom Hand #257988073938:  Hold'em No Limit (€0.01/€0.02) [ADM ID: M62BA304494E32ST] - 2025/10/03 23:34:37 CET [2025/10/03 17:34:37 ET]
Table 'Sirio' 6-max Seat #1 is the button
Seat 1: Genny040893 (€0.95 in chips) 
Seat 2: ADRIAN0_MEIS (€7.39 in chips) 
Seat 3: caduceus369 (€2.67 in chips) 
Seat 4: EasyToRule (€2.24 in chips) 
Seat 5: stfuplzudonk (€3.98 in chips) 
Seat 6: Catania838 (€1.90 in chips) 
ADRIAN0_MEIS: posts small blind €0.01
caduceus369: posts big blind €0.02
*** HOLE CARDS ***
Dealt to caduceus369 [5h 3s]
EasyToRule: folds 
stfuplzudonk: folds 
Catania838: folds 
Genny040893: raises €0.06 to €0.08
ADRIAN0_MEIS: raises €0.23 to €0.31
caduceus369: folds 
Genny040893: folds 
Uncalled bet (€0.23) returned to ADRIAN0_MEIS
ADRIAN0_MEIS collected €0.18 from pot
ADRIAN0_MEIS: doesn't show hand 
*** SUMMARY ***
Total pot €0.18 | Rake €0 
Seat 1: Genny040893 (button) folded before Flop
Seat 2: ADRIAN0_MEIS (small blind) collected (€0.18)
Seat 3: caduceus369 (big blind) folded before Flop
Seat 4: EasyToRule folded before Flop (didn't bet)
Seat 5: stfuplzudonk folded before Flop (didn't bet)
Seat 6: Catania838 folded before Flop (didn't bet)



PokerStars Zoom Hand #257988070242:  Hold'em No Limit (€0.01/€0.02) [ADM ID: M62BA304494E32ST] - 2025/10/03 23:34:22 CET [2025/10/03 17:34:22 ET]
Table 'Sirio' 6-max Seat #1 is the button
Seat 1: ADRIAN0_MEIS (€7.39 in chips) 
Seat 2: MOLDAVO1069 (€3.34 in chips) 
Seat 3: robertoH2O (€2.71 in chips) 
Seat 4: father2008 (€4.59 in chips) 
Seat 5: neoilnervoso (€0.97 in chips) 
Seat 6: caduceus369 (€2.67 in chips) 
MOLDAVO1069: posts small blind €0.01
robertoH2O: posts big blind €0.02
*** HOLE CARDS ***
Dealt to caduceus369 [4c 9d]
father2008: folds 
neoilnervoso: folds 
caduceus369: folds 
ADRIAN0_MEIS: folds 
MOLDAVO1069: raises €0.04 to €0.06
robertoH2O: calls €0.04
*** FLOP *** [7c 5c Js]
MOLDAVO1069: checks 
robertoH2O: bets €0.06
MOLDAVO1069: folds 
Uncalled bet (€0.06) returned to robertoH2O
robertoH2O collected €0.12 from pot
robertoH2O: doesn't show hand 
*** SUMMARY ***
Total pot €0.12 | Rake €0 
Board [7c 5c Js]
Seat 1: ADRIAN0_MEIS (button) folded before Flop (didn't bet)
Seat 2: MOLDAVO1069 (small blind) folded on the Flop
Seat 3: robertoH2O (big blind) collected (€0.12)
Seat 4: father2008 folded before Flop (didn't bet)
Seat 5: neoilnervoso folded before Flop (didn't bet)
Seat 6: caduceus369 folded before Flop (didn't bet)



PokerStars Zoom Hand #257988078218:  Hold'em No Limit (€0.01/€0.02) [ADM ID: M62BA304494E32ST] - 2025/10/03 23:34:55 CET [2025/10/03 17:34:55 ET]
Table 'Sirio' 6-max Seat #1 is the button
Seat 1: workman75 (€3.18 in chips) 
Seat 2: Hope7075 (€0.79 in chips) 
Seat 3: diego-rigano (€0.41 in chips) 
Seat 4: ivano747 (€3.81 in chips) 
Seat 5: caduceus369 (€2.64 in chips) 
Seat 6: CacciatoreAA (€1.81 in chips) 
Hope7075: posts small blind €0.01
diego-rigano: posts big blind €0.02
*** HOLE CARDS ***
Dealt to caduceus369 [4h 3d]
ivano747: folds 
caduceus369: folds 
CacciatoreAA: folds 
workman75: folds 
Hope7075: calls €0.01
diego-rigano: raises €0.39 to €0.41 and is all-in
Hope7075: folds 
Uncalled bet (€0.39) returned to diego-rigano
diego-rigano collected €0.04 from pot
diego-rigano: doesn't show hand 
*** SUMMARY ***
Total pot €0.04 | Rake €0 
Seat 1: workman75 (button) folded before Flop (didn't bet)
Seat 2: Hope7075 (small blind) folded before Flop
Seat 3: diego-rigano (big blind) collected (€0.04)
Seat 4: ivano747 folded before Flop (didn't bet)
Seat 5: caduceus369 folded before Flop (didn't bet)
Seat 6: CacciatoreAA folded before Flop (didn't bet)



PokerStars Zoom Hand #257988077561:  Hold'em No Limit (€0.01/€0.02) [ADM ID: M62BA304494E32ST] - 2025/10/03 23:34:52 CET [2025/10/03 17:34:52 ET]
Table 'Sirio' 6-max Seat #1 is the button
Seat 1: caduceus369 (€2.64 in chips) 
Seat 2: Catania838 (€1.94 in chips) 
Seat 3: fantaasso (€1.84 in chips) 
Seat 4: tigermiscio (€0.82 in chips) 
Seat 5: father2008 (€4.59 in chips) 
Seat 6: workman75 (€3.18 in chips) 
Catania838: posts small blind €0.01
fantaasso: posts big blind €0.02
*** HOLE CARDS ***
Dealt to caduceus369 [3s 6h]
tigermiscio: calls €0.02
father2008: folds 
workman75: folds 
caduceus369: folds 
Catania838: folds 
fantaasso: checks 
*** FLOP *** [Ac 7d Th]
fantaasso: checks 
tigermiscio: checks 
*** TURN *** [Ac 7d Th] [4c]
fantaasso: checks 
tigermiscio: checks 
*** RIVER *** [Ac 7d Th 4c] [Qs]
fantaasso: bets €0.03
tigermiscio: calls €0.03
*** SHOW DOWN ***
fantaasso: shows [4d Qd] (two pair, Queens and Fours)
tigermiscio: mucks hand 
fantaasso collected €0.11 from pot
*** SUMMARY ***
Total pot €0.11 | Rake €0 
Board [Ac 7d Th 4c Qs]
Seat 1: caduceus369 (button) folded before Flop (didn't bet)
Seat 2: Catania838 (small blind) folded before Flop
Seat 3: fantaasso (big blind) showed [4d Qd] and won (€0.11) with two pair, Queens and Fours
Seat 4: tigermiscio mucked [5h 5s]
Seat 5: father2008 folded before Flop (didn't bet)
Seat 6: workman75 folded before Flop (didn't bet)



PokerStars Zoom Hand #257988076310:  Hold'em No Limit (€0.01/€0.02) [ADM ID: M62BA304494E32ST] - 2025/10/03 23:34:47 CET [2025/10/03 17:34:47 ET]
Table 'Sirio' 6-max Seat #1 is the button
Seat 1: CacciatoreAA (€1.81 in chips) 
Seat 2: caduceus369 (€2.65 in chips) 
Seat 3: Ceribelli1705 (€0.78 in chips) 
Seat 4: trillycata (€1.29 in chips) 
Seat 5: xxcash88 (€2 in chips) 
Seat 6: Freddy15081988 (€0.76 in chips) 
caduceus369: posts small blind €0.01
Ceribelli1705: posts big blind €0.02
*** HOLE CARDS ***
Dealt to caduceus369 [4s Th]
trillycata: folds 
xxcash88: folds 
Freddy15081988: calls €0.02
CacciatoreAA: folds 
caduceus369: folds 
Ceribelli1705: checks 
*** FLOP *** [4h Ac Jd]
Ceribelli1705: bets €0.04
Freddy15081988: calls €0.04
*** TURN *** [4h Ac Jd] [6s]
Ceribelli1705: checks 
Freddy15081988: checks 
*** RIVER *** [4h Ac Jd 6s] [7c]
Ceribelli1705: checks 
Freddy15081988: bets €0.06
Ceribelli1705: calls €0.06
*** SHOW DOWN ***
Freddy15081988: shows [Td Qs] (high card Ace)
Ceribelli1705: shows [8s Jc] (a pair of Jacks)
Ceribelli1705 collected €0.24 from pot
*** SUMMARY ***
Total pot €0.25 | Rake €0.01 
Board [4h Ac Jd 6s 7c]
Seat 1: CacciatoreAA (button) folded before Flop (didn't bet)
Seat 2: caduceus369 (small blind) folded before Flop
Seat 3: Ceribelli1705 (big blind) showed [8s Jc] and won (€0.24) with a pair of Jacks
Seat 4: trillycata folded before Flop (didn't bet)
Seat 5: xxcash88 folded before Flop (didn't bet)
Seat 6: Freddy15081988 showed [Td Qs] and lost with high card Ace



PokerStars Zoom Hand #257988083082:  Hold'em No Limit (€0.01/€0.02) [ADM ID: M62BA304494E32ST] - 2025/10/03 23:35:15 CET [2025/10/03 17:35:15 ET]
Table 'Sirio' 6-max Seat #1 is the button
Seat 1: Goblin1999 (€4.84 in chips) 
Seat 2: father2008 (€4.57 in chips) 
Seat 3: Catania838 (€1.88 in chips) 
Seat 4: caduceus369 (€2.62 in chips) 
Seat 5: Witness85906 (€4.96 in chips) 
Seat 6: outshined8 (€1.57 in chips) 
father2008: posts small blind €0.01
Catania838: posts big blind €0.02
*** HOLE CARDS ***
Dealt to caduceus369 [7s 2h]
caduceus369: folds 
Witness85906: folds 
outshined8: raises €0.04 to €0.06
Goblin1999: folds 
father2008: folds 
Catania838: folds 
Uncalled bet (€0.04) returned to outshined8
outshined8 collected €0.05 from pot
outshined8: doesn't show hand 
*** SUMMARY ***
Total pot €0.05 | Rake €0 
Seat 1: Goblin1999 (button) folded before Flop (didn't bet)
Seat 2: father2008 (small blind) folded before Flop
Seat 3: Catania838 (big blind) folded before Flop
Seat 4: caduceus369 folded before Flop (didn't bet)
Seat 5: Witness85906 folded before Flop (didn't bet)
Seat 6: outshined8 collected (€0.05)



PokerStars Zoom Hand #257988086701:  Hold'em No Limit (€0.01/€0.02) [ADM ID: M62BA304494E32ST] - 2025/10/03 23:35:30 CET [2025/10/03 17:35:30 ET]
Table 'Sirio' 6-max Seat #1 is the button
Seat 1: ADRIAN0_MEIS (€7.23 in chips) 
Seat 2: caduceus369 (€2.62 in chips) 
Seat 3: SidneyPrescott (€5.53 in chips) 
Seat 4: Catania838 (€1.91 in chips) 
Seat 5: diego-rigano (€0.41 in chips) 
Seat 6: Neroonciolina (€5.33 in chips) 
caduceus369: posts small blind €0.01
SidneyPrescott: posts big blind €0.02
*** HOLE CARDS ***
Dealt to caduceus369 [Th 8h]
Catania838: folds 
diego-rigano: raises €0.39 to €0.41 and is all-in
Neroonciolina: folds 
ADRIAN0_MEIS: folds 
caduceus369: folds 
SidneyPrescott: folds 
Uncalled bet (€0.39) returned to diego-rigano
diego-rigano collected €0.05 from pot
diego-rigano: doesn't show hand 
*** SUMMARY ***
Total pot €0.05 | Rake €0 
Seat 1: ADRIAN0_MEIS (button) folded before Flop (didn't bet)
Seat 2: caduceus369 (small blind) folded before Flop
Seat 3: SidneyPrescott (big blind) folded before Flop
Seat 4: Catania838 folded before Flop (didn't bet)
Seat 5: diego-rigano collected (€0.05)
Seat 6: Neroonciolina folded before Flop (didn't bet)



PokerStars Zoom Hand #257988079450:  Hold'em No Limit (€0.01/€0.02) [ADM ID: M62BA304494E32ST] - 2025/10/03 23:35:00 CET [2025/10/03 17:35:00 ET]
Table 'Sirio' 6-max Seat #1 is the button
Seat 1: capovujadin (€1.47 in chips) 
Seat 2: KindRonin (€1.25 in chips) 
Seat 3: ADRIAN0_MEIS (€7.49 in chips) 
Seat 4: stfuplzudonk (€1.42 in chips) 
Seat 5: father2008 (€6.44 in chips) 
Seat 6: caduceus369 (€2.64 in chips) 
KindRonin: posts small blind €0.01
ADRIAN0_MEIS: posts big blind €0.02
*** HOLE CARDS ***
Dealt to caduceus369 [Ac 5h]
stfuplzudonk: folds 
father2008: raises €0.05 to €0.07
caduceus369: folds 
capovujadin: calls €0.07
KindRonin: folds 
ADRIAN0_MEIS: folds 
*** FLOP *** [3h Ad Jh]
father2008: bets €0.10
capovujadin: raises €0.10 to €0.20
father2008: calls €0.10
*** TURN *** [3h Ad Jh] [Jd]
father2008: checks 
capovujadin: bets €0.27
father2008: folds 
Uncalled bet (€0.27) returned to capovujadin
capovujadin collected €0.54 from pot
capovujadin: doesn't show hand 
*** SUMMARY ***
Total pot €0.57 | Rake €0.03 
Board [3h Ad Jh Jd]
Seat 1: capovujadin (button) collected (€0.54)
Seat 2: KindRonin (small blind) folded before Flop
Seat 3: ADRIAN0_MEIS (big blind) folded before Flop
Seat 4: stfuplzudonk folded before Flop (didn't bet)
Seat 5: father2008 folded on the Turn
Seat 6: caduceus369 folded before Flop (didn't bet)



PokerStars Zoom Hand #257988085557:  Hold'em No Limit (€0.01/€0.02) [ADM ID: M62BA304494E32ST] - 2025/10/03 23:35:25 CET [2025/10/03 17:35:25 ET]
Table 'Sirio' 6-max Seat #1 is the button
Seat 1: MOLDAVO1069 (€9.54 in chips) 
Seat 2: montemeru (€3.99 in chips) 
Seat 3: CacciatoreAA (€1.78 in chips) 
Seat 4: EasyToRule (€3.61 in chips) 
Seat 5: caduceus369 (€2.62 in chips) 
Seat 6: Goblin1999 (€4.84 in chips) 
montemeru: posts small blind €0.01
CacciatoreAA: posts big blind €0.02
*** HOLE CARDS ***
Dealt to caduceus369 [Jc 4c]
EasyToRule: folds 
caduceus369: folds 
Goblin1999: calls €0.02
MOLDAVO1069: folds 
montemeru: folds 
CacciatoreAA: checks 
*** FLOP *** [Qh 5h 2s]
CacciatoreAA: checks 
Goblin1999: bets €0.02
CacciatoreAA: calls €0.02
*** TURN *** [Qh 5h 2s] [6s]
CacciatoreAA: checks 
Goblin1999: bets €0.02
CacciatoreAA: calls €0.02
*** RIVER *** [Qh 5h 2s 6s] [Ks]
CacciatoreAA: checks 
Goblin1999: checks 
*** SHOW DOWN ***
CacciatoreAA: shows [7c Qs] (a pair of Queens)
Goblin1999: mucks hand 
CacciatoreAA collected €0.13 from pot
*** SUMMARY ***
Total pot €0.13 | Rake €0 
Board [Qh 5h 2s 6s Ks]
Seat 1: MOLDAVO1069 (button) folded before Flop (didn't bet)
Seat 2: montemeru (small blind) folded before Flop
Seat 3: CacciatoreAA (big blind) showed [7c Qs] and won (€0.13) with a pair of Queens
Seat 4: EasyToRule folded before Flop (didn't bet)
Seat 5: caduceus369 folded before Flop (didn't bet)
Seat 6: Goblin1999 mucked [6h As]



PokerStars Zoom Hand #257988080812:  Hold'em No Limit (€0.01/€0.02) [ADM ID: M62BA304494E32ST] - 2025/10/03 23:35:06 CET [2025/10/03 17:35:06 ET]
Table 'Sirio' 6-max Seat #1 is the button
Seat 1: SidneyPrescott (€4.33 in chips) 
Seat 2: stfuplzudonk (€4.07 in chips) 
Seat 3: caduceus369 (€2.64 in chips) 
Seat 4: fantaasso (€1.87 in chips) 
Seat 5: Gabrielefante (€2.06 in chips) 
Seat 6: robertoH2O (€2.77 in chips) 
stfuplzudonk: posts small blind €0.01
caduceus369: posts big blind €0.02
*** HOLE CARDS ***
Dealt to caduceus369 [2s 5h]
fantaasso: folds 
Gabrielefante: folds 
robertoH2O: raises €0.03 to €0.05
SidneyPrescott: folds 
stfuplzudonk: calls €0.04
caduceus369: folds 
*** FLOP *** [9c 8c Qc]
stfuplzudonk: checks 
robertoH2O: checks 
*** TURN *** [9c 8c Qc] [3c]
stfuplzudonk: checks 
robertoH2O: checks 
*** RIVER *** [9c 8c Qc 3c] [5c]
stfuplzudonk: checks 
robertoH2O: checks 
*** SHOW DOWN ***
stfuplzudonk: shows [9h Ad] (a flush, Queen high)
robertoH2O: shows [Ah Td] (a flush, Queen high)
stfuplzudonk collected €0.06 from pot
robertoH2O collected €0.06 from pot
*** SUMMARY ***
Total pot €0.12 | Rake €0 
Board [9c 8c Qc 3c 5c]
Seat 1: SidneyPrescott (button) folded before Flop (didn't bet)
Seat 2: stfuplzudonk (small blind) showed [9h Ad] and won (€0.06) with a flush, Queen high
Seat 3: caduceus369 (big blind) folded before Flop
Seat 4: fantaasso folded before Flop (didn't bet)
Seat 5: Gabrielefante folded before Flop (didn't bet)
Seat 6: robertoH2O showed [Ah Td] and won (€0.06) with a flush, Queen high



PokerStars Zoom Hand #257988084261:  Hold'em No Limit (€0.01/€0.02) [ADM ID: M62BA304494E32ST] - 2025/10/03 23:35:20 CET [2025/10/03 17:35:20 ET]
Table 'Sirio' 6-max Seat #1 is the button
Seat 1: caduceus369 (€2.62 in chips) 
Seat 2: pia1256 (€1.85 in chips) 
Seat 3: Catania838 (€3.15 in chips) 
Seat 4: montemeru (€3.99 in chips) 
Seat 5: ADRIAN0_MEIS (€11.88 in chips) 
Seat 6: CacciatoreAA (€1.78 in chips) 
pia1256: posts small blind €0.01
Catania838: posts big blind €0.02
*** HOLE CARDS ***
Dealt to caduceus369 [2s 3d]
montemeru: folds 
ADRIAN0_MEIS: folds 
CacciatoreAA: folds 
caduceus369: folds 
pia1256: calls €0.01
Catania838: checks 
*** FLOP *** [8s 6h Td]
pia1256: checks 
Catania838: checks 
*** TURN *** [8s 6h Td] [2d]
pia1256: bets €0.02
Catania838: calls €0.02
*** RIVER *** [8s 6h Td 2d] [Qh]
pia1256: checks 
Catania838: checks 
*** SHOW DOWN ***
pia1256: shows [8d Ks] (a pair of Eights)
Catania838: mucks hand 
pia1256 collected €0.08 from pot
*** SUMMARY ***
Total pot €0.08 | Rake €0 
Board [8s 6h Td 2d Qh]
Seat 1: caduceus369 (button) folded before Flop (didn't bet)
Seat 2: pia1256 (small blind) showed [8d Ks] and won (€0.08) with a pair of Eights
Seat 3: Catania838 (big blind) mucked [As 9d]
Seat 4: montemeru folded before Flop (didn't bet)
Seat 5: ADRIAN0_MEIS folded before Flop (didn't bet)
Seat 6: CacciatoreAA folded before Flop (didn't bet)



PokerStars Zoom Hand #257988089025:  Hold'em No Limit (€0.01/€0.02) [ADM ID: M62BA304494E32ST] - 2025/10/03 23:35:40 CET [2025/10/03 17:35:40 ET]
Table 'Sirio' 6-max Seat #1 is the button
Seat 1: SKERZA (€0.99 in chips) 
Seat 2: xxcash88 (€2.01 in chips) 
Seat 3: Genny040893 (€0.51 in chips) 
Seat 4: workman75 (€3.12 in chips) 
Seat 5: Sium12302 (€4.20 in chips) 
Seat 6: caduceus369 (€2.61 in chips) 
xxcash88: posts small blind €0.01
Genny040893: posts big blind €0.02
*** HOLE CARDS ***
Dealt to caduceus369 [9c Kc]
workman75: folds 
Sium12302: folds 
caduceus369: raises €0.04 to €0.06
SKERZA: folds 
xxcash88: folds 
Genny040893: calls €0.04
*** FLOP *** [Ac Qh Js]
Genny040893: bets €0.04
caduceus369: calls €0.04
*** TURN *** [Ac Qh Js] [8d]
Genny040893: bets €0.06
caduceus369: folds 
Uncalled bet (€0.06) returned to Genny040893
Genny040893 collected €0.20 from pot
Genny040893: doesn't show hand 
*** SUMMARY ***
Total pot €0.21 | Rake €0.01 
Board [Ac Qh Js 8d]
Seat 1: SKERZA (button) folded before Flop (didn't bet)
Seat 2: xxcash88 (small blind) folded before Flop
Seat 3: Genny040893 (big blind) collected (€0.20)
Seat 4: workman75 folded before Flop (didn't bet)
Seat 5: Sium12302 folded before Flop (didn't bet)
Seat 6: caduceus369 folded on the Turn



PokerStars Zoom Hand #257988099065:  Hold'em No Limit (€0.01/€0.02) [ADM ID: M62BA304494E32ST] - 2025/10/03 23:36:22 CET [2025/10/03 17:36:22 ET]
Table 'Sirio' 6-max Seat #1 is the button
Seat 1: trillycata (€1.23 in chips) 
Seat 2: ivano747 (€3.45 in chips) 
Seat 3: caduceus369 (€2.51 in chips) 
Seat 4: SidneyPrescott (€5.64 in chips) 
Seat 5: stfuplzudonk (€4.45 in chips) 
Seat 6: Sium12302 (€4.17 in chips) 
ivano747: posts small blind €0.01
caduceus369: posts big blind €0.02
*** HOLE CARDS ***
Dealt to caduceus369 [9c As]
SidneyPrescott: folds 
stfuplzudonk: raises €0.04 to €0.06
Sium12302: folds 
trillycata: folds 
ivano747: folds 
caduceus369: calls €0.04
*** FLOP *** [3h Ac 2h]
caduceus369: checks 
stfuplzudonk: bets €0.07
caduceus369: calls €0.07
*** TURN *** [3h Ac 2h] [Ts]
caduceus369: checks 
stfuplzudonk: checks 
*** RIVER *** [3h Ac 2h Ts] [Js]
caduceus369: bets €0.15
stfuplzudonk: folds 
Uncalled bet (€0.15) returned to caduceus369
caduceus369 collected €0.26 from pot
caduceus369: doesn't show hand 
*** SUMMARY ***
Total pot €0.27 | Rake €0.01 
Board [3h Ac 2h Ts Js]
Seat 1: trillycata (button) folded before Flop (didn't bet)
Seat 2: ivano747 (small blind) folded before Flop
Seat 3: caduceus369 (big blind) collected (€0.26)
Seat 4: SidneyPrescott folded before Flop (didn't bet)
Seat 5: stfuplzudonk folded on the River
Seat 6: Sium12302 folded before Flop (didn't bet)



PokerStars Zoom Hand #257988108078:  Hold'em No Limit (€0.01/€0.02) [ADM ID: M62BA304494E32ST] - 2025/10/03 23:37:00 CET [2025/10/03 17:37:00 ET]
Table 'Sirio' 6-max Seat #1 is the button
Seat 1: SidneyPrescott (€5.67 in chips) 
Seat 2: SKERZA (€0.47 in chips) 
Seat 3: Sium12302 (€4.40 in chips) 
Seat 4: caduceus369 (€2.64 in chips) 
Seat 5: neoilnervoso (€0.98 in chips) 
Seat 6: ivano747 (€3.41 in chips) 
SKERZA: posts small blind €0.01
Sium12302: posts big blind €0.02
*** HOLE CARDS ***
Dealt to caduceus369 [5s 6h]
caduceus369: folds 
neoilnervoso: folds 
ivano747: raises €0.04 to €0.06
SidneyPrescott: raises €0.12 to €0.18
SKERZA: folds 
Sium12302: folds 
ivano747: folds 
Uncalled bet (€0.12) returned to SidneyPrescott
SidneyPrescott collected €0.15 from pot
SidneyPrescott: doesn't show hand 
*** SUMMARY ***
Total pot €0.15 | Rake €0 
Seat 1: SidneyPrescott (button) collected (€0.15)
Seat 2: SKERZA (small blind) folded before Flop
Seat 3: Sium12302 (big blind) folded before Flop
Seat 4: caduceus369 folded before Flop (didn't bet)
Seat 5: neoilnervoso folded before Flop (didn't bet)
Seat 6: ivano747 folded before Flop



PokerStars Zoom Hand #257988109648:  Hold'em No Limit (€0.01/€0.02) [ADM ID: M62BA304494E32ST] - 2025/10/03 23:37:06 CET [2025/10/03 17:37:06 ET]
Table 'Sirio' 6-max Seat #1 is the button
Seat 1: Sium12302 (€2.59 in chips) 
Seat 2: caduceus369 (€2.64 in chips) 
Seat 3: 999rizla (€1.25 in chips) 
Seat 4: MOLDAVO1069 (€9.53 in chips) 
Seat 5: stfuplzudonk (€2.87 in chips) 
Seat 6: Neroonciolina (€5.65 in chips) 
caduceus369: posts small blind €0.01
999rizla: posts big blind €0.02
*** HOLE CARDS ***
Dealt to caduceus369 [8h Ah]
MOLDAVO1069: folds 
stfuplzudonk: raises €0.02 to €0.04
Neroonciolina: raises €0.02 to €0.06
Sium12302: folds 
caduceus369: folds 
999rizla: calls €0.04
stfuplzudonk: calls €0.02
*** FLOP *** [3c Ks Kc]
999rizla: checks 
stfuplzudonk: checks 
Neroonciolina: bets €0.14
999rizla: folds 
stfuplzudonk: folds 
Uncalled bet (€0.14) returned to Neroonciolina
Neroonciolina collected €0.18 from pot
Neroonciolina: doesn't show hand 
*** SUMMARY ***
Total pot €0.19 | Rake €0.01 
Board [3c Ks Kc]
Seat 1: Sium12302 (button) folded before Flop (didn't bet)
Seat 2: caduceus369 (small blind) folded before Flop
Seat 3: 999rizla (big blind) folded on the Flop
Seat 4: MOLDAVO1069 folded before Flop (didn't bet)
Seat 5: stfuplzudonk folded on the Flop
Seat 6: Neroonciolina collected (€0.18)



PokerStars Zoom Hand #257988113175:  Hold'em No Limit (€0.01/€0.02) [ADM ID: M62BA304494E32ST] - 2025/10/03 23:37:21 CET [2025/10/03 17:37:21 ET]
Table 'Sirio' 6-max Seat #1 is the button
Seat 1: caduceus369 (€2.63 in chips) 
Seat 2: ADRIAN0_MEIS (€7.64 in chips) 
Seat 3: CacciatoreAA (€1.84 in chips) 
Seat 4: franky65124 (€2.03 in chips) 
Seat 5: cartoonbest (€2.70 in chips) 
Seat 6: SidneyPrescott (€2.29 in chips) 
ADRIAN0_MEIS: posts small blind €0.01
CacciatoreAA: posts big blind €0.02
*** HOLE CARDS ***
Dealt to caduceus369 [As Ah]
franky65124: calls €0.02
cartoonbest: calls €0.02
SidneyPrescott: folds 
caduceus369: raises €0.06 to €0.08
ADRIAN0_MEIS: folds 
CacciatoreAA: folds 
franky65124: calls €0.06
cartoonbest: calls €0.06
*** FLOP *** [6s 3s 5c]
franky65124: checks 
cartoonbest: checks 
caduceus369: bets €0.13
franky65124: folds 
cartoonbest: folds 
Uncalled bet (€0.13) returned to caduceus369
caduceus369 collected €0.26 from pot
caduceus369: doesn't show hand 
*** SUMMARY ***
Total pot €0.27 | Rake €0.01 
Board [6s 3s 5c]
Seat 1: caduceus369 (button) collected (€0.26)
Seat 2: ADRIAN0_MEIS (small blind) folded before Flop
Seat 3: CacciatoreAA (big blind) folded before Flop
Seat 4: franky65124 folded on the Flop
Seat 5: cartoonbest folded on the Flop
Seat 6: SidneyPrescott folded before Flop (didn't bet)



PokerStars Zoom Hand #257988122259:  Hold'em No Limit (€0.01/€0.02) [ADM ID: M62BA304494E32ST] - 2025/10/03 23:38:00 CET [2025/10/03 17:38:00 ET]
Table 'Sirio' 6-max Seat #1 is the button
Seat 1: Sium12302 (€4.39 in chips) 
Seat 2: cap e'bomb95 (€1.98 in chips) 
Seat 3: SidneyPrescott (€5.78 in chips) 
Seat 4: caduceus369 (€2.81 in chips) 
Seat 5: EasyToRule (€2.79 in chips) 
Seat 6: savicevic74 (€3.10 in chips) 
cap e'bomb95: posts small blind €0.01
SidneyPrescott: posts big blind €0.02
*** HOLE CARDS ***
Dealt to caduceus369 [Th 6c]
caduceus369 has timed out
caduceus369: folds 
EasyToRule: folds 
savicevic74: folds 
Sium12302: folds 
cap e'bomb95: folds 
Uncalled bet (€0.01) returned to SidneyPrescott
SidneyPrescott collected €0.02 from pot
SidneyPrescott: doesn't show hand 
*** SUMMARY ***
Total pot €0.02 | Rake €0 
Seat 1: Sium12302 (button) folded before Flop (didn't bet)
Seat 2: cap e'bomb95 (small blind) folded before Flop
Seat 3: SidneyPrescott (big blind) collected (€0.02)
Seat 4: caduceus369 folded before Flop (didn't bet)
Seat 5: EasyToRule folded before Flop (didn't bet)
Seat 6: savicevic74 folded before Flop (didn't bet)



PokerStars Zoom Hand #257988125786:  Hold'em No Limit (€0.01/€0.02) [ADM ID: M62BA304494E32ST] - 2025/10/03 23:38:15 CET [2025/10/03 17:38:15 ET]
Table 'Sirio' 6-max Seat #1 is the button
Seat 1: montemeru (€1.89 in chips) 
Seat 2: stfuplzudonk (€1.21 in chips) 
Seat 3: father2008 (€4.35 in chips) 
Seat 4: caduceus369 (€2.81 in chips) 
Seat 5: Genny040893 (€0.69 in chips) 
Seat 6: cap e'bomb95 (€1.97 in chips) 
stfuplzudonk: posts small blind €0.01
father2008: posts big blind €0.02
*** HOLE CARDS ***
Dealt to caduceus369 [Ks Kd]
caduceus369: raises €0.04 to €0.06
Genny040893: raises €0.04 to €0.10
cap e'bomb95: folds 
montemeru: folds 
stfuplzudonk: folds 
father2008: folds 
caduceus369: raises €0.04 to €0.14
Genny040893: calls €0.04
*** FLOP *** [Jc Tc Qs]
caduceus369: checks 
Genny040893: bets €0.55 and is all-in
caduceus369: calls €0.55
*** TURN *** [Jc Tc Qs] [9d]
*** RIVER *** [Jc Tc Qs 9d] [6c]
*** SHOW DOWN ***
caduceus369: shows [Ks Kd] (a straight, Nine to King)
Genny040893: shows [Qc Qh] (three of a kind, Queens)
caduceus369 collected €1.34 from pot
*** SUMMARY ***
Total pot €1.41 | Rake €0.07 
Board [Jc Tc Qs 9d 6c]
Seat 1: montemeru (button) folded before Flop (didn't bet)
Seat 2: stfuplzudonk (small blind) folded before Flop
Seat 3: father2008 (big blind) folded before Flop
Seat 4: caduceus369 showed [Ks Kd] and won (€1.34) with a straight, Nine to King
Seat 5: Genny040893 showed [Qc Qh] and lost with three of a kind, Queens
Seat 6: cap e'bomb95 folded before Flop (didn't bet)



PokerStars Zoom Hand #257988138777:  Hold'em No Limit (€0.01/€0.02) [ADM ID: M62BA304494E32ST] - 2025/10/03 23:39:10 CET [2025/10/03 17:39:10 ET]
Table 'Sirio' 6-max Seat #1 is the button
Seat 1: Gabrielefante (€2 in chips) 
Seat 2: SidneyPrescott (€5.82 in chips) 
Seat 3: caduceus369 (€3.46 in chips) 
Seat 4: father2008 (€4.32 in chips) 
Seat 5: ADRIAN0_MEIS (€7.60 in chips) 
Seat 6: workman75 (€3.45 in chips) 
SidneyPrescott: posts small blind €0.01
caduceus369: posts big blind €0.02
*** HOLE CARDS ***
Dealt to caduceus369 [2s Kh]
father2008: folds 
ADRIAN0_MEIS: raises €0.04 to €0.06
workman75: folds 
Gabrielefante: folds 
SidneyPrescott: folds 
caduceus369: folds 
Uncalled bet (€0.04) returned to ADRIAN0_MEIS
ADRIAN0_MEIS collected €0.05 from pot
ADRIAN0_MEIS: doesn't show hand 
*** SUMMARY ***
Total pot €0.05 | Rake €0 
Seat 1: Gabrielefante (button) folded before Flop (didn't bet)
Seat 2: SidneyPrescott (small blind) folded before Flop
Seat 3: caduceus369 (big blind) folded before Flop
Seat 4: father2008 folded before Flop (didn't bet)
Seat 5: ADRIAN0_MEIS collected (€0.05)
Seat 6: workman75 folded before Flop (didn't bet)



PokerStars Zoom Hand #257988143832:  Hold'em No Limit (€0.01/€0.02) [ADM ID: M62BA304494E32ST] - 2025/10/03 23:39:31 CET [2025/10/03 17:39:31 ET]
Table 'Sirio' 6-max Seat #1 is the button
Seat 1: KindRonin (€0.78 in chips) 
Seat 2: caduceus369 (€3.44 in chips) 
Seat 3: ivano747 (€1.92 in chips) 
Seat 4: SKERZA (€0.58 in chips) 
Seat 5: Gabrielefante (€1.99 in chips) 
Seat 6: father2008 (€4.33 in chips) 
caduceus369: posts small blind €0.01
ivano747: posts big blind €0.02
*** HOLE CARDS ***
Dealt to caduceus369 [6h 7d]
SKERZA: folds 
Gabrielefante: folds 
father2008: raises €0.05 to €0.07
KindRonin: folds 
caduceus369: folds 
ivano747: raises €0.23 to €0.30
father2008: folds 
Uncalled bet (€0.23) returned to ivano747
ivano747 collected €0.15 from pot
ivano747: doesn't show hand 
*** SUMMARY ***
Total pot €0.15 | Rake €0 
Seat 1: KindRonin (button) folded before Flop (didn't bet)
Seat 2: caduceus369 (small blind) folded before Flop
Seat 3: ivano747 (big blind) collected (€0.15)
Seat 4: SKERZA folded before Flop (didn't bet)
Seat 5: Gabrielefante folded before Flop (didn't bet)
Seat 6: father2008 folded before Flop



PokerStars Zoom Hand #257988137849:  Hold'em No Limit (€0.01/€0.02) [ADM ID: M62BA304494E32ST] - 2025/10/03 23:39:06 CET [2025/10/03 17:39:06 ET]
Table 'Sirio' 6-max Seat #1 is the button
Seat 1: Chia9711 (€2.91 in chips) 
Seat 2: Gabrielefante (€2.01 in chips) 
Seat 3: EasyToRule (€4.02 in chips) 
Seat 4: Sium12302 (€2.52 in chips) 
Seat 5: workman75 (€3.45 in chips) 
Seat 6: caduceus369 (€3.46 in chips) 
Gabrielefante: posts small blind €0.01
EasyToRule: posts big blind €0.02
*** HOLE CARDS ***
Dealt to caduceus369 [9h Js]
Sium12302: folds 
workman75: folds 
caduceus369: folds 
Chia9711: calls €0.02
Gabrielefante: folds 
EasyToRule: checks 
*** FLOP *** [Tc 2d Ah]
EasyToRule: checks 
Chia9711: bets €0.02
EasyToRule: calls €0.02
*** TURN *** [Tc 2d Ah] [8c]
EasyToRule: checks 
Chia9711: bets €0.02
EasyToRule: raises €0.07 to €0.09
Chia9711: calls €0.07
*** RIVER *** [Tc 2d Ah 8c] [8d]
EasyToRule: bets €0.09
Chia9711: calls €0.09
*** SHOW DOWN ***
EasyToRule: shows [5c Ad] (two pair, Aces and Eights)
Chia9711: shows [7h As] (two pair, Aces and Eights)
EasyToRule collected €0.22 from pot
Chia9711 collected €0.21 from pot
*** SUMMARY ***
Total pot €0.45 | Rake €0.02 
Board [Tc 2d Ah 8c 8d]
Seat 1: Chia9711 (button) showed [7h As] and won (€0.21) with two pair, Aces and Eights
Seat 2: Gabrielefante (small blind) folded before Flop
Seat 3: EasyToRule (big blind) showed [5c Ad] and won (€0.22) with two pair, Aces and Eights
Seat 4: Sium12302 folded before Flop (didn't bet)
Seat 5: workman75 folded before Flop (didn't bet)
Seat 6: caduceus369 folded before Flop (didn't bet)



PokerStars Zoom Hand #257988149063:  Hold'em No Limit (€0.01/€0.02) [ADM ID: M62BA304494E32ST] - 2025/10/03 23:39:53 CET [2025/10/03 17:39:53 ET]
Table 'Sirio' 6-max Seat #1 is the button
Seat 1: savicevic74 (€3.04 in chips) 
Seat 2: stfuplzudonk (€1.05 in chips) 
Seat 3: cap e'bomb95 (€2.05 in chips) 
Seat 4: ivano747 (€2 in chips) 
Seat 5: caduceus369 (€3.43 in chips) 
Seat 6: father2008 (€5.89 in chips) 
stfuplzudonk: posts small blind €0.01
cap e'bomb95: posts big blind €0.02
*** HOLE CARDS ***
Dealt to caduceus369 [8h 3d]
ivano747: folds 
caduceus369: folds 
father2008: raises €0.05 to €0.07
savicevic74: folds 
stfuplzudonk: folds 
cap e'bomb95: folds 
Uncalled bet (€0.05) returned to father2008
father2008 collected €0.05 from pot
father2008: doesn't show hand 
*** SUMMARY ***
Total pot €0.05 | Rake €0 
Seat 1: savicevic74 (button) folded before Flop (didn't bet)
Seat 2: stfuplzudonk (small blind) folded before Flop
Seat 3: cap e'bomb95 (big blind) folded before Flop
Seat 4: ivano747 folded before Flop (didn't bet)
Seat 5: caduceus369 folded before Flop (didn't bet)
Seat 6: father2008 collected (€0.05)



PokerStars Zoom Hand #257988149762:  Hold'em No Limit (€0.01/€0.02) [ADM ID: M62BA304494E32ST] - 2025/10/03 23:39:56 CET [2025/10/03 17:39:56 ET]
Table 'Sirio' 6-max Seat #1 is the button
Seat 1: ivano747 (€2 in chips) 
Seat 2: SidneyPrescott (€2.40 in chips) 
Seat 3: caduceus369 (€3.43 in chips) 
Seat 4: Gabrielefante (€1.97 in chips) 
Seat 5: tigermiscio (€0.56 in chips) 
Seat 6: Peru91j (€2.23 in chips) 
SidneyPrescott: posts small blind €0.01
caduceus369: posts big blind €0.02
*** HOLE CARDS ***
Dealt to caduceus369 [9s 3h]
Gabrielefante: folds 
tigermiscio: folds 
Peru91j: folds 
ivano747: raises €0.04 to €0.06
SidneyPrescott: folds 
caduceus369: folds 
Uncalled bet (€0.04) returned to ivano747
ivano747 collected €0.05 from pot
ivano747: doesn't show hand 
*** SUMMARY ***
Total pot €0.05 | Rake €0 
Seat 1: ivano747 (button) collected (€0.05)
Seat 2: SidneyPrescott (small blind) folded before Flop
Seat 3: caduceus369 (big blind) folded before Flop
Seat 4: Gabrielefante folded before Flop (didn't bet)
Seat 5: tigermiscio folded before Flop (didn't bet)
Seat 6: Peru91j folded before Flop (didn't bet)



PokerStars Zoom Hand #257988148315:  Hold'em No Limit (€0.01/€0.02) [ADM ID: M62BA304494E32ST] - 2025/10/03 23:39:50 CET [2025/10/03 17:39:50 ET]
Table 'Sirio' 6-max Seat #1 is the button
Seat 1: tigermiscio (€0.56 in chips) 
Seat 2: EasyToRule (€4.02 in chips) 
Seat 3: Chia9711 (€2.90 in chips) 
Seat 4: Hope7075 (€0.70 in chips) 
Seat 5: SidneyPrescott (€2.40 in chips) 
Seat 6: caduceus369 (€3.43 in chips) 
EasyToRule: posts small blind €0.01
Chia9711: posts big blind €0.02
*** HOLE CARDS ***
Dealt to caduceus369 [7c 8h]
Hope7075: raises €0.04 to €0.06
SidneyPrescott: folds 
caduceus369: folds 
tigermiscio: folds 
EasyToRule: folds 
Chia9711: calls €0.04
*** FLOP *** [4c 3s 7s]
Chia9711: checks 
Hope7075: checks 
*** TURN *** [4c 3s 7s] [Ac]
Chia9711: bets €0.02
Hope7075: calls €0.02
*** RIVER *** [4c 3s 7s Ac] [9s]
Chia9711: checks 
Hope7075: checks 
*** SHOW DOWN ***
Chia9711: shows [Kc 6s] (high card Ace)
Hope7075: shows [Kd 9h] (a pair of Nines)
Hope7075 collected €0.17 from pot
*** SUMMARY ***
Total pot €0.17 | Rake €0 
Board [4c 3s 7s Ac 9s]
Seat 1: tigermiscio (button) folded before Flop (didn't bet)
Seat 2: EasyToRule (small blind) folded before Flop
Seat 3: Chia9711 (big blind) showed [Kc 6s] and lost with high card Ace
Seat 4: Hope7075 showed [Kd 9h] and won (€0.17) with a pair of Nines
Seat 5: SidneyPrescott folded before Flop (didn't bet)
Seat 6: caduceus369 folded before Flop (didn't bet)



PokerStars Zoom Hand #257988146669:  Hold'em No Limit (€0.01/€0.02) [ADM ID: M62BA304494E32ST] - 2025/10/03 23:39:43 CET [2025/10/03 17:39:43 ET]
Table 'Sirio' 6-max Seat #1 is the button
Seat 1: caduceus369 (€3.43 in chips) 
Seat 2: fantaasso (€1.75 in chips) 
Seat 3: Catania838 (€3.42 in chips) 
Seat 4: cap e'bomb95 (€3.80 in chips) 
Seat 5: capovujadin (€1.29 in chips) 
Seat 6: SidneyPrescott (€5.81 in chips) 
fantaasso: posts small blind €0.01
Catania838: posts big blind €0.02
*** HOLE CARDS ***
Dealt to caduceus369 [2s 6d]
cap e'bomb95: folds 
capovujadin: calls €0.02
SidneyPrescott: folds 
caduceus369: folds 
fantaasso: folds 
Catania838: checks 
*** FLOP *** [9h Ac 4s]
Catania838: checks 
capovujadin: checks 
*** TURN *** [9h Ac 4s] [6s]
Catania838: bets €0.12
capovujadin: calls €0.12
*** RIVER *** [9h Ac 4s 6s] [9s]
Catania838: checks 
capovujadin: checks 
*** SHOW DOWN ***
Catania838: shows [Ah 4h] (two pair, Aces and Nines)
capovujadin: mucks hand 
Catania838 collected €0.28 from pot
*** SUMMARY ***
Total pot €0.29 | Rake €0.01 
Board [9h Ac 4s 6s 9s]
Seat 1: caduceus369 (button) folded before Flop (didn't bet)
Seat 2: fantaasso (small blind) folded before Flop
Seat 3: Catania838 (big blind) showed [Ah 4h] and won (€0.28) with two pair, Aces and Nines
Seat 4: cap e'bomb95 folded before Flop (didn't bet)
Seat 5: capovujadin mucked [Qd 6h]
Seat 6: SidneyPrescott folded before Flop (didn't bet)



PokerStars Zoom Hand #257988136461:  Hold'em No Limit (€0.01/€0.02) [ADM ID: M62BA304494E32ST] - 2025/10/03 23:39:00 CET [2025/10/03 17:39:00 ET]
Table 'Sirio' 6-max Seat #1 is the button
Seat 1: SidneyPrescott (€4.41 in chips) 
Seat 2: workman75 (€3.46 in chips) 
Seat 3: trillycata (€1.37 in chips) 
Seat 4: stfuplzudonk (€4.07 in chips) 
Seat 5: caduceus369 (€3.46 in chips) 
Seat 6: Catania838 (€2.35 in chips) 
workman75: posts small blind €0.01
trillycata: posts big blind €0.02
*** HOLE CARDS ***
Dealt to caduceus369 [8h 7s]
stfuplzudonk: raises €0.02 to €0.04
caduceus369: folds 
Catania838: folds 
SidneyPrescott: folds 
workman75: folds 
trillycata: calls €0.02
*** FLOP *** [9d Jc Ac]
trillycata: checks 
stfuplzudonk: bets €0.05
trillycata: calls €0.05
*** TURN *** [9d Jc Ac] [2c]
trillycata: checks 
stfuplzudonk: bets €0.18
trillycata: folds 
Uncalled bet (€0.18) returned to stfuplzudonk
stfuplzudonk collected €0.18 from pot
stfuplzudonk: doesn't show hand 
*** SUMMARY ***
Total pot €0.19 | Rake €0.01 
Board [9d Jc Ac 2c]
Seat 1: SidneyPrescott (button) folded before Flop (didn't bet)
Seat 2: workman75 (small blind) folded before Flop
Seat 3: trillycata (big blind) folded on the Turn
Seat 4: stfuplzudonk collected (€0.18)
Seat 5: caduceus369 folded before Flop (didn't bet)
Seat 6: Catania838 folded before Flop (didn't bet)



PokerStars Zoom Hand #257988154067:  Hold'em No Limit (€0.01/€0.02) [ADM ID: M62BA304494E32ST] - 2025/10/03 23:40:14 CET [2025/10/03 17:40:14 ET]
Table 'Sirio' 6-max Seat #1 is the button
Seat 1: stfuplzudonk (€4.55 in chips) 
Seat 2: KindRonin (€1.35 in chips) 
Seat 3: SidneyPrescott (€4.38 in chips) 
Seat 4: caduceus369 (€3.41 in chips) 
Seat 5: cap e'bomb95 (€3.85 in chips) 
Seat 6: ivano747 (€2.03 in chips) 
KindRonin: posts small blind €0.01
SidneyPrescott: posts big blind €0.02
*** HOLE CARDS ***
Dealt to caduceus369 [2s Js]
caduceus369: folds 
cap e'bomb95: folds 
ivano747: folds 
stfuplzudonk: folds 
KindRonin: raises €0.02 to €0.04
SidneyPrescott: folds 
Uncalled bet (€0.02) returned to KindRonin
KindRonin collected €0.04 from pot
KindRonin: doesn't show hand 
*** SUMMARY ***
Total pot €0.04 | Rake €0 
Seat 1: stfuplzudonk (button) folded before Flop (didn't bet)
Seat 2: KindRonin (small blind) collected (€0.04)
Seat 3: SidneyPrescott (big blind) folded before Flop
Seat 4: caduceus369 folded before Flop (didn't bet)
Seat 5: cap e'bomb95 folded before Flop (didn't bet)
Seat 6: ivano747 folded before Flop (didn't bet)



PokerStars Zoom Hand #257988154762:  Hold'em No Limit (€0.01/€0.02) [ADM ID: M62BA304494E32ST] - 2025/10/03 23:40:17 CET [2025/10/03 17:40:17 ET]
Table 'Sirio' 6-max Seat #1 is the button
Seat 1: Sium12302 (€6.26 in chips) 
Seat 2: caduceus369 (€3.41 in chips) 
Seat 3: SidneyPrescott (€2.39 in chips) 
Seat 4: Freddy15081988 (€1 in chips) 
Seat 5: neoilnervoso (€1.98 in chips) 
Seat 6: ADRIAN0_MEIS (€10.34 in chips) 
caduceus369: posts small blind €0.01
SidneyPrescott: posts big blind €0.02
*** HOLE CARDS ***
Dealt to caduceus369 [3d 7c]
Freddy15081988: folds 
neoilnervoso: folds 
ADRIAN0_MEIS: folds 
Sium12302: folds 
caduceus369: folds 
Uncalled bet (€0.01) returned to SidneyPrescott
SidneyPrescott collected €0.02 from pot
SidneyPrescott: doesn't show hand 
*** SUMMARY ***
Total pot €0.02 | Rake €0 
Seat 1: Sium12302 (button) folded before Flop (didn't bet)
Seat 2: caduceus369 (small blind) folded before Flop
Seat 3: SidneyPrescott (big blind) collected (€0.02)
Seat 4: Freddy15081988 folded before Flop (didn't bet)
Seat 5: neoilnervoso folded before Flop (didn't bet)
Seat 6: ADRIAN0_MEIS folded before Flop (didn't bet)



PokerStars Zoom Hand #257988158175:  Hold'em No Limit (€0.01/€0.02) [ADM ID: M62BA304494E32ST] - 2025/10/03 23:40:32 CET [2025/10/03 17:40:32 ET]
Table 'Sirio' 6-max Seat #1 is the button
Seat 1: capovujadin (€1.13 in chips) 
Seat 2: ivano747 (€2.04 in chips) 
Seat 3: workman75 (€3.57 in chips) 
Seat 4: caduceus369 (€3.40 in chips) 
Seat 5: cap e'bomb95 (€1.75 in chips) 
Seat 6: 999rizla (€1.13 in chips) 
ivano747: posts small blind €0.01
workman75: posts big blind €0.02
*** HOLE CARDS ***
Dealt to caduceus369 [Jd 5s]
caduceus369: folds 
cap e'bomb95: folds 
999rizla: folds 
capovujadin: folds 
ivano747: folds 
Uncalled bet (€0.01) returned to workman75
workman75 collected €0.02 from pot
workman75: doesn't show hand 
*** SUMMARY ***
Total pot €0.02 | Rake €0 
Seat 1: capovujadin (button) folded before Flop (didn't bet)
Seat 2: ivano747 (small blind) folded before Flop
Seat 3: workman75 (big blind) collected (€0.02)
Seat 4: caduceus369 folded before Flop (didn't bet)
Seat 5: cap e'bomb95 folded before Flop (didn't bet)
Seat 6: 999rizla folded before Flop (didn't bet)



PokerStars Zoom Hand #257988153042:  Hold'em No Limit (€0.01/€0.02) [ADM ID: M62BA304494E32ST] - 2025/10/03 23:40:10 CET [2025/10/03 17:40:10 ET]
Table 'Sirio' 6-max Seat #1 is the button
Seat 1: Peru91j (€2 in chips) 
Seat 2: cap e'bomb95 (€2.03 in chips) 
Seat 3: VrDmNl (€1.35 in chips) 
Seat 4: caduceus369 (€3.41 in chips) 
Seat 5: ADRIAN0_MEIS (€7.63 in chips) 
Seat 6: ivano747 (€3.44 in chips) 
cap e'bomb95: posts small blind €0.01
VrDmNl: posts big blind €0.02
*** HOLE CARDS ***
Dealt to caduceus369 [2d 4h]
caduceus369: folds 
ADRIAN0_MEIS: folds 
ivano747: folds 
Peru91j: raises €0.04 to €0.06
cap e'bomb95: calls €0.05
VrDmNl: folds 
*** FLOP *** [Ah 7c 6s]
cap e'bomb95: checks 
Peru91j: bets €0.07
cap e'bomb95: folds 
Uncalled bet (€0.07) returned to Peru91j
Peru91j collected €0.14 from pot
Peru91j: doesn't show hand 
*** SUMMARY ***
Total pot €0.14 | Rake €0 
Board [Ah 7c 6s]
Seat 1: Peru91j (button) collected (€0.14)
Seat 2: cap e'bomb95 (small blind) folded on the Flop
Seat 3: VrDmNl (big blind) folded before Flop
Seat 4: caduceus369 folded before Flop (didn't bet)
Seat 5: ADRIAN0_MEIS folded before Flop (didn't bet)
Seat 6: ivano747 folded before Flop (didn't bet)



PokerStars Zoom Hand #257988156839:  Hold'em No Limit (€0.01/€0.02) [ADM ID: M62BA304494E32ST] - 2025/10/03 23:40:26 CET [2025/10/03 17:40:26 ET]
Table 'Sirio' 6-max Seat #1 is the button
Seat 1: MOLDAVO1069 (€3.20 in chips) 
Seat 2: Catania838 (€3.56 in chips) 
Seat 3: stfuplzudonk (€0.98 in chips) 
Seat 4: Gabrielefante (€1.92 in chips) 
Seat 5: Neroonciolina (€5.46 in chips) 
Seat 6: caduceus369 (€3.40 in chips) 
Catania838: posts small blind €0.01
stfuplzudonk: posts big blind €0.02
*** HOLE CARDS ***
Dealt to caduceus369 [6c 3d]
Gabrielefante: raises €0.02 to €0.04
Neroonciolina: folds 
caduceus369: folds 
MOLDAVO1069: folds 
Catania838: folds 
stfuplzudonk: raises €0.14 to €0.18
Gabrielefante: raises €0.22 to €0.40
stfuplzudonk: raises €0.58 to €0.98 and is all-in
Gabrielefante: calls €0.58
*** FLOP *** [5h 7d 7s]
*** TURN *** [5h 7d 7s] [4c]
*** RIVER *** [5h 7d 7s 4c] [As]
*** SHOW DOWN ***
stfuplzudonk: shows [Qd Qs] (two pair, Queens and Sevens)
Gabrielefante: shows [Ks Ac] (two pair, Aces and Sevens)
Gabrielefante collected €1.87 from pot
*** SUMMARY ***
Total pot €1.97 | Rake €0.10 
Board [5h 7d 7s 4c As]
Seat 1: MOLDAVO1069 (button) folded before Flop (didn't bet)
Seat 2: Catania838 (small blind) folded before Flop
Seat 3: stfuplzudonk (big blind) showed [Qd Qs] and lost with two pair, Queens and Sevens
Seat 4: Gabrielefante showed [Ks Ac] and won (€1.87) with two pair, Aces and Sevens
Seat 5: Neroonciolina folded before Flop (didn't bet)
Seat 6: caduceus369 folded before Flop (didn't bet)



PokerStars Zoom Hand #257988155704:  Hold'em No Limit (€0.01/€0.02) [ADM ID: M62BA304494E32ST] - 2025/10/03 23:40:21 CET [2025/10/03 17:40:21 ET]
Table 'Sirio' 6-max Seat #1 is the button
Seat 1: caduceus369 (€3.40 in chips) 
Seat 2: pia1256 (€1.49 in chips) 
Seat 3: Hope7075 (€0.79 in chips) 
Seat 4: Sium12302 (€6.26 in chips) 
Seat 5: CacciatoreAA (€1.54 in chips) 
Seat 6: Freddy15081988 (€1 in chips) 
pia1256: posts small blind €0.01
Hope7075: posts big blind €0.02
*** HOLE CARDS ***
Dealt to caduceus369 [8h Qd]
Sium12302: folds 
CacciatoreAA: folds 
Freddy15081988: calls €0.02
caduceus369: folds 
pia1256: calls €0.01
Hope7075: raises €0.06 to €0.08
Freddy15081988 has timed out
Freddy15081988: folds 
pia1256: calls €0.06
*** FLOP *** [9c Ks 5d]
pia1256: checks 
Hope7075: checks 
*** TURN *** [9c Ks 5d] [Qc]
pia1256: checks 
Hope7075: checks 
*** RIVER *** [9c Ks 5d Qc] [6c]
pia1256: checks 
Hope7075: checks 
*** SHOW DOWN ***
pia1256: shows [7h Jc] (high card King)
Hope7075: shows [Ad Jh] (high card Ace)
Hope7075 collected €0.18 from pot
*** SUMMARY ***
Total pot €0.18 | Rake €0 
Board [9c Ks 5d Qc 6c]
Seat 1: caduceus369 (button) folded before Flop (didn't bet)
Seat 2: pia1256 (small blind) showed [7h Jc] and lost with high card King
Seat 3: Hope7075 (big blind) showed [Ad Jh] and won (€0.18) with high card Ace
Seat 4: Sium12302 folded before Flop (didn't bet)
Seat 5: CacciatoreAA folded before Flop (didn't bet)
Seat 6: Freddy15081988 folded before Flop



PokerStars Zoom Hand #257988159860:  Hold'em No Limit (€0.01/€0.02) [ADM ID: M62BA304494E32ST] - 2025/10/03 23:40:39 CET [2025/10/03 17:40:39 ET]
Table 'Sirio' 6-max Seat #1 is the button
Seat 1: fantaasso (€2.26 in chips) 
Seat 2: VrDmNl (€1.33 in chips) 
Seat 3: caduceus369 (€3.40 in chips) 
Seat 4: SidneyPrescott (€4.36 in chips) 
Seat 5: ivano747 (€2.03 in chips) 
Seat 6: franky65124 (€1.94 in chips) 
VrDmNl: posts small blind €0.01
caduceus369: posts big blind €0.02
*** HOLE CARDS ***
Dealt to caduceus369 [Qh 8s]
SidneyPrescott: raises €0.04 to €0.06
ivano747: folds 
franky65124: folds 
fantaasso: folds 
VrDmNl: calls €0.05
caduceus369: folds 
*** FLOP *** [Kh 6c 7c]
VrDmNl: checks 
SidneyPrescott: checks 
*** TURN *** [Kh 6c 7c] [7h]
VrDmNl: checks 
SidneyPrescott: checks 
*** RIVER *** [Kh 6c 7c 7h] [6s]
VrDmNl: checks 
SidneyPrescott: checks 
*** SHOW DOWN ***
VrDmNl: shows [As Th] (two pair, Sevens and Sixes)
SidneyPrescott: mucks hand 
VrDmNl collected €0.14 from pot
*** SUMMARY ***
Total pot €0.14 | Rake €0 
Board [Kh 6c 7c 7h 6s]
Seat 1: fantaasso (button) folded before Flop (didn't bet)
Seat 2: VrDmNl (small blind) showed [As Th] and won (€0.14) with two pair, Sevens and Sixes
Seat 3: caduceus369 (big blind) folded before Flop
Seat 4: SidneyPrescott mucked [5s 5d]
Seat 5: ivano747 folded before Flop (didn't bet)
Seat 6: franky65124 folded before Flop (didn't bet)



PokerStars Zoom Hand #257988163381:  Hold'em No Limit (€0.01/€0.02) [ADM ID: M62BA304494E32ST] - 2025/10/03 23:40:54 CET [2025/10/03 17:40:54 ET]
Table 'Sirio' 6-max Seat #1 is the button
Seat 1: Neroonciolina (€5.43 in chips) 
Seat 2: caduceus369 (€3.38 in chips) 
Seat 3: EasyToRule (€4.28 in chips) 
Seat 4: xxcash88 (€2 in chips) 
Seat 5: neoilnervoso (€1.95 in chips) 
Seat 6: Catania838 (€1.52 in chips) 
caduceus369: posts small blind €0.01
EasyToRule: posts big blind €0.02
*** HOLE CARDS ***
Dealt to caduceus369 [Ah Kc]
xxcash88: folds 
neoilnervoso: folds 
Catania838: folds 
Neroonciolina: raises €0.12 to €0.14
caduceus369: raises €0.52 to €0.66
EasyToRule: folds 
Neroonciolina: calls €0.52
*** FLOP *** [Jc 6d Ks]
caduceus369: checks 
Neroonciolina: bets €0.06
caduceus369: raises €0.26 to €0.32
Neroonciolina: folds 
Uncalled bet (€0.26) returned to caduceus369
caduceus369 collected €1.38 from pot
caduceus369: doesn't show hand 
*** SUMMARY ***
Total pot €1.46 | Rake €0.08 
Board [Jc 6d Ks]
Seat 1: Neroonciolina (button) folded on the Flop
Seat 2: caduceus369 (small blind) collected (€1.38)
Seat 3: EasyToRule (big blind) folded before Flop
Seat 4: xxcash88 folded before Flop (didn't bet)
Seat 5: neoilnervoso folded before Flop (didn't bet)
Seat 6: Catania838 folded before Flop (didn't bet)



PokerStars Zoom Hand #257988179449:  Hold'em No Limit (€0.01/€0.02) [ADM ID: M62BA304494E32ST] - 2025/10/03 23:42:03 CET [2025/10/03 17:42:03 ET]
Table 'Sirio' 6-max Seat #1 is the button
Seat 1: SidneyPrescott (€2 in chips) 
Seat 2: bruciapelo (€2.01 in chips) 
Seat 3: stfuplzudonk (€2.47 in chips) 
Seat 4: cap e'bomb95 (€1.70 in chips) 
Seat 5: trillycata (€1.28 in chips) 
Seat 6: caduceus369 (€4.04 in chips) 
bruciapelo: posts small blind €0.01
stfuplzudonk: posts big blind €0.02
*** HOLE CARDS ***
Dealt to caduceus369 [6h 2c]
cap e'bomb95: folds 
trillycata: folds 
caduceus369: folds 
SidneyPrescott: folds 
bruciapelo: folds 
Uncalled bet (€0.01) returned to stfuplzudonk
stfuplzudonk collected €0.02 from pot
stfuplzudonk: doesn't show hand 
*** SUMMARY ***
Total pot €0.02 | Rake €0 
Seat 1: SidneyPrescott (button) folded before Flop (didn't bet)
Seat 2: bruciapelo (small blind) folded before Flop
Seat 3: stfuplzudonk (big blind) collected (€0.02)
Seat 4: cap e'bomb95 folded before Flop (didn't bet)
Seat 5: trillycata folded before Flop (didn't bet)
Seat 6: caduceus369 folded before Flop (didn't bet)



PokerStars Zoom Hand #257988178236:  Hold'em No Limit (€0.01/€0.02) [ADM ID: M62BA304494E32ST] - 2025/10/03 23:41:58 CET [2025/10/03 17:41:58 ET]
Table 'Sirio' 6-max Seat #1 is the button
Seat 1: 999rizla (€1.07 in chips) 
Seat 2: Peru91j (€2.06 in chips) 
Seat 3: robertoH2O (€3.71 in chips) 
Seat 4: stfuplzudonk (€2.03 in chips) 
Seat 5: caduceus369 (€4.04 in chips) 
Seat 6: Goblin1999 (€5.16 in chips) 
Peru91j: posts small blind €0.01
robertoH2O: posts big blind €0.02
*** HOLE CARDS ***
Dealt to caduceus369 [7s Qh]
stfuplzudonk: folds 
caduceus369: folds 
Goblin1999: calls €0.02
999rizla: folds 
Peru91j: folds 
robertoH2O: raises €0.06 to €0.08
Goblin1999: calls €0.06
*** FLOP *** [7d Tc Qc]
robertoH2O: checks 
Goblin1999: checks 
*** TURN *** [7d Tc Qc] [3s]
robertoH2O: bets €0.11
Goblin1999: folds 
Uncalled bet (€0.11) returned to robertoH2O
robertoH2O collected €0.17 from pot
robertoH2O: doesn't show hand 
*** SUMMARY ***
Total pot €0.17 | Rake €0 
Board [7d Tc Qc 3s]
Seat 1: 999rizla (button) folded before Flop (didn't bet)
Seat 2: Peru91j (small blind) folded before Flop
Seat 3: robertoH2O (big blind) collected (€0.17)
Seat 4: stfuplzudonk folded before Flop (didn't bet)
Seat 5: caduceus369 folded before Flop (didn't bet)
Seat 6: Goblin1999 folded on the Turn



PokerStars Zoom Hand #257988177221:  Hold'em No Limit (€0.01/€0.02) [ADM ID: M62BA304494E32ST] - 2025/10/03 23:41:53 CET [2025/10/03 17:41:53 ET]
Table 'Sirio' 6-max Seat #1 is the button
Seat 1: caduceus369 (€4.04 in chips) 
Seat 2: fantaasso (€2.42 in chips) 
Seat 3: maury999999 (€2.24 in chips) 
Seat 4: diego-rigano (€0.78 in chips) 
Seat 5: Hope7075 (€0.97 in chips) 
Seat 6: 999rizla (€1.07 in chips) 
fantaasso: posts small blind €0.01
maury999999: posts big blind €0.02
*** HOLE CARDS ***
Dealt to caduceus369 [8h 4h]
diego-rigano: raises €0.03 to €0.05
Hope7075: calls €0.05
999rizla: folds 
caduceus369: folds 
fantaasso: folds 
maury999999: calls €0.03
*** FLOP *** [9h 6h Ts]
maury999999: checks 
diego-rigano: checks 
Hope7075: bets €0.16
maury999999: folds 
diego-rigano: calls €0.16
*** TURN *** [9h 6h Ts] [Qd]
diego-rigano: checks 
Hope7075: bets €0.10
diego-rigano: calls €0.10
*** RIVER *** [9h 6h Ts Qd] [Jh]
diego-rigano: bets €0.33
Hope7075: calls €0.33
*** SHOW DOWN ***
diego-rigano: shows [Kh Ad] (a straight, Ten to Ace)
Hope7075: mucks hand 
diego-rigano collected €1.27 from pot
*** SUMMARY ***
Total pot €1.34 | Rake €0.07 
Board [9h 6h Ts Qd Jh]
Seat 1: caduceus369 (button) folded before Flop (didn't bet)
Seat 2: fantaasso (small blind) folded before Flop
Seat 3: maury999999 (big blind) folded on the Flop
Seat 4: diego-rigano showed [Kh Ad] and won (€1.27) with a straight, Ten to Ace
Seat 5: Hope7075 mucked [Th Kc]
Seat 6: 999rizla folded before Flop (didn't bet)



PokerStars Zoom Hand #257988180969:  Hold'em No Limit (€0.01/€0.02) [ADM ID: M62BA304494E32ST] - 2025/10/03 23:42:09 CET [2025/10/03 17:42:09 ET]
Table 'Sirio' 6-max Seat #1 is the button
Seat 1: KindRonin (€0.76 in chips) 
Seat 2: SidneyPrescott (€2 in chips) 
Seat 3: cap e'bomb95 (€1.70 in chips) 
Seat 4: CacciatoreAA (€1.63 in chips) 
Seat 5: caduceus369 (€4.04 in chips) 
Seat 6: trillycata (€1.28 in chips) 
SidneyPrescott: posts small blind €0.01
cap e'bomb95: posts big blind €0.02
*** HOLE CARDS ***
Dealt to caduceus369 [9d Qh]
CacciatoreAA: raises €0.06 to €0.08
caduceus369: folds 
trillycata: folds 
KindRonin: calls €0.08
SidneyPrescott: calls €0.07
cap e'bomb95: folds 
*** FLOP *** [Kh 9c 2s]
SidneyPrescott: checks 
CacciatoreAA: checks 
KindRonin: checks 
*** TURN *** [Kh 9c 2s] [2c]
SidneyPrescott: checks 
CacciatoreAA: checks 
KindRonin: checks 
*** RIVER *** [Kh 9c 2s 2c] [Qs]
SidneyPrescott: checks 
CacciatoreAA: checks 
KindRonin: checks 
*** SHOW DOWN ***
SidneyPrescott: shows [5h 5c] (two pair, Fives and Deuces)
CacciatoreAA: mucks hand 
KindRonin: mucks hand 
SidneyPrescott collected €0.25 from pot
*** SUMMARY ***
Total pot €0.26 | Rake €0.01 
Board [Kh 9c 2s 2c Qs]
Seat 1: KindRonin (button) mucked [Td 8d]
Seat 2: SidneyPrescott (small blind) showed [5h 5c] and won (€0.25) with two pair, Fives and Deuces
Seat 3: cap e'bomb95 (big blind) folded before Flop
Seat 4: CacciatoreAA mucked [4h Ah]
Seat 5: caduceus369 folded before Flop (didn't bet)
Seat 6: trillycata folded before Flop (didn't bet)



PokerStars Zoom Hand #257988188147:  Hold'em No Limit (€0.01/€0.02) [ADM ID: M62BA304494E32ST] - 2025/10/03 23:42:40 CET [2025/10/03 17:42:40 ET]
Table 'Sirio' 6-max Seat #1 is the button
Seat 1: Sium12302 (€2 in chips) 
Seat 2: caduceus369 (€4.02 in chips) 
Seat 3: Catania838 (€3.56 in chips) 
Seat 4: EasyToRule (€2.39 in chips) 
Seat 5: VrDmNl (€1.48 in chips) 
Seat 6: father2008 (€6.01 in chips) 
caduceus369: posts small blind €0.01
Catania838: posts big blind €0.02
*** HOLE CARDS ***
Dealt to caduceus369 [Ks 2c]
EasyToRule: folds 
VrDmNl: folds 
father2008: folds 
Sium12302: folds 
caduceus369: folds 
Uncalled bet (€0.01) returned to Catania838
Catania838 collected €0.02 from pot
Catania838: doesn't show hand 
*** SUMMARY ***
Total pot €0.02 | Rake €0 
Seat 1: Sium12302 (button) folded before Flop (didn't bet)
Seat 2: caduceus369 (small blind) folded before Flop
Seat 3: Catania838 (big blind) collected (€0.02)
Seat 4: EasyToRule folded before Flop (didn't bet)
Seat 5: VrDmNl folded before Flop (didn't bet)
Seat 6: father2008 folded before Flop (didn't bet)



PokerStars Zoom Hand #257988182068:  Hold'em No Limit (€0.01/€0.02) [ADM ID: M62BA304494E32ST] - 2025/10/03 23:42:14 CET [2025/10/03 17:42:14 ET]
Table 'Sirio' 6-max Seat #1 is the button
Seat 1: bruciapelo (€2 in chips) 
Seat 2: trillycata (€1.28 in chips) 
Seat 3: caduceus369 (€4.04 in chips) 
Seat 4: Catania838 (€1.47 in chips) 
Seat 5: Ceribelli1705 (€0.76 in chips) 
Seat 6: fantaasso (€2.41 in chips) 
trillycata: posts small blind €0.01
caduceus369: posts big blind €0.02
*** HOLE CARDS ***
Dealt to caduceus369 [Ks 8c]
Catania838: folds 
Ceribelli1705: folds 
fantaasso: raises €0.04 to €0.06
bruciapelo: folds 
trillycata: calls €0.05
caduceus369: folds 
*** FLOP *** [Jh 2s 5d]
trillycata: checks 
fantaasso: bets €0.07
trillycata: calls €0.07
*** TURN *** [Jh 2s 5d] [Kh]
trillycata: checks 
fantaasso: checks 
*** RIVER *** [Jh 2s 5d Kh] [4d]
trillycata: checks 
fantaasso: checks 
*** SHOW DOWN ***
trillycata: shows [4s Ad] (a pair of Fours)
fantaasso: shows [9s 9c] (a pair of Nines)
fantaasso collected €0.27 from pot
*** SUMMARY ***
Total pot €0.28 | Rake €0.01 
Board [Jh 2s 5d Kh 4d]
Seat 1: bruciapelo (button) folded before Flop (didn't bet)
Seat 2: trillycata (small blind) showed [4s Ad] and lost with a pair of Fours
Seat 3: caduceus369 (big blind) folded before Flop
Seat 4: Catania838 folded before Flop (didn't bet)
Seat 5: Ceribelli1705 folded before Flop (didn't bet)
Seat 6: fantaasso showed [9s 9c] and won (€0.27) with a pair of Nines



PokerStars Zoom Hand #257988190240:  Hold'em No Limit (€0.01/€0.02) [ADM ID: M62BA304494E32ST] - 2025/10/03 23:42:49 CET [2025/10/03 17:42:49 ET]
Table 'Sirio' 6-max Seat #1 is the button
Seat 1: savicevic74 (€3.09 in chips) 
Seat 2: Sium12302 (€6.28 in chips) 
Seat 3: KindRonin (€0.68 in chips) 
Seat 4: Catania838 (€2.58 in chips) 
Seat 5: caduceus369 (€4.01 in chips) 
Seat 6: michy0757 (€0.96 in chips) 
Sium12302: posts small blind €0.01
KindRonin: posts big blind €0.02
*** HOLE CARDS ***
Dealt to caduceus369 [9c 2s]
Catania838: folds 
caduceus369: folds 
michy0757: folds 
savicevic74: raises €0.05 to €0.07
Sium12302: folds 
KindRonin: calls €0.05
*** FLOP *** [5d Jh 2c]
KindRonin: checks 
savicevic74: bets €0.04
KindRonin: folds 
Uncalled bet (€0.04) returned to savicevic74
savicevic74 collected €0.15 from pot
savicevic74: doesn't show hand 
*** SUMMARY ***
Total pot €0.15 | Rake €0 
Board [5d Jh 2c]
Seat 1: savicevic74 (button) collected (€0.15)
Seat 2: Sium12302 (small blind) folded before Flop
Seat 3: KindRonin (big blind) folded on the Flop
Seat 4: Catania838 folded before Flop (didn't bet)
Seat 5: caduceus369 folded before Flop (didn't bet)
Seat 6: michy0757 folded before Flop (didn't bet)



PokerStars Zoom Hand #257988186001:  Hold'em No Limit (€0.01/€0.02) [ADM ID: M62BA304494E32ST] - 2025/10/03 23:42:31 CET [2025/10/03 17:42:31 ET]
Table 'Sirio' 6-max Seat #1 is the button
Seat 1: caduceus369 (€4.02 in chips) 
Seat 2: Catania838 (€1.47 in chips) 
Seat 3: Neroonciolina (€4.74 in chips) 
Seat 4: Peru91j (€2.05 in chips) 
Seat 5: robertoH2O (€3.79 in chips) 
Seat 6: Witness85906 (€4.76 in chips) 
Catania838: posts small blind €0.01
Neroonciolina: posts big blind €0.02
*** HOLE CARDS ***
Dealt to caduceus369 [5s 3h]
Peru91j: folds 
robertoH2O: folds 
Witness85906: raises €0.03 to €0.05
caduceus369: folds 
Catania838: raises €1.42 to €1.47 and is all-in
Neroonciolina: calls €1.45
Witness85906: folds 
*** FLOP *** [3c Jh 6h]
*** TURN *** [3c Jh 6h] [Js]
*** RIVER *** [3c Jh 6h Js] [As]
*** SHOW DOWN ***
Catania838: shows [Ad Ks] (two pair, Aces and Jacks)
Neroonciolina: shows [Jd 8h] (three of a kind, Jacks)
Neroonciolina collected €2.83 from pot
*** SUMMARY ***
Total pot €2.99 | Rake €0.16 
Board [3c Jh 6h Js As]
Seat 1: caduceus369 (button) folded before Flop (didn't bet)
Seat 2: Catania838 (small blind) showed [Ad Ks] and lost with two pair, Aces and Jacks
Seat 3: Neroonciolina (big blind) showed [Jd 8h] and won (€2.83) with three of a kind, Jacks
Seat 4: Peru91j folded before Flop (didn't bet)
Seat 5: robertoH2O folded before Flop (didn't bet)
Seat 6: Witness85906 folded before Flop



PokerStars Zoom Hand #257988187009:  Hold'em No Limit (€0.01/€0.02) [ADM ID: M62BA304494E32ST] - 2025/10/03 23:42:35 CET [2025/10/03 17:42:35 ET]
Table 'Sirio' 6-max Seat #1 is the button
Seat 1: ivano747 (€2.09 in chips) 
Seat 2: Chia9711 (€3.44 in chips) 
Seat 3: robertoH2O (€3.79 in chips) 
Seat 4: VrDmNl (€1.48 in chips) 
Seat 5: EasyToRule (€2.39 in chips) 
Seat 6: caduceus369 (€4.02 in chips) 
Chia9711: posts small blind €0.01
robertoH2O: posts big blind €0.02
*** HOLE CARDS ***
Dealt to caduceus369 [Kh 5d]
VrDmNl: folds 
EasyToRule: folds 
caduceus369: folds 
ivano747: raises €0.04 to €0.06
Chia9711: folds 
robertoH2O: calls €0.04
*** FLOP *** [2h 7d Ks]
robertoH2O: checks 
ivano747: checks 
*** TURN *** [2h 7d Ks] [3s]
robertoH2O: bets €0.09
ivano747: folds 
Uncalled bet (€0.09) returned to robertoH2O
robertoH2O collected €0.13 from pot
robertoH2O: doesn't show hand 
*** SUMMARY ***
Total pot €0.13 | Rake €0 
Board [2h 7d Ks 3s]
Seat 1: ivano747 (button) folded on the Turn
Seat 2: Chia9711 (small blind) folded before Flop
Seat 3: robertoH2O (big blind) collected (€0.13)
Seat 4: VrDmNl folded before Flop (didn't bet)
Seat 5: EasyToRule folded before Flop (didn't bet)
Seat 6: caduceus369 folded before Flop (didn't bet)



PokerStars Zoom Hand #257988192126:  Hold'em No Limit (€0.01/€0.02) [ADM ID: M62BA304494E32ST] - 2025/10/03 23:42:57 CET [2025/10/03 17:42:57 ET]
Table 'Sirio' 6-max Seat #1 is the button
Seat 1: cap e'bomb95 (€2 in chips) 
Seat 2: Gigo373 (€0.73 in chips) 
Seat 3: Sium12302 (€2 in chips) 
Seat 4: Peru91j (€2.03 in chips) 
Seat 5: ivano747 (€2.68 in chips) 
Seat 6: caduceus369 (€4.01 in chips) 
Gigo373: posts small blind €0.01
Sium12302: posts big blind €0.02
*** HOLE CARDS ***
Dealt to caduceus369 [8c 3s]
Peru91j: folds 
ivano747: folds 
caduceus369: folds 
cap e'bomb95: folds 
Gigo373: calls €0.01
Sium12302: checks 
*** FLOP *** [Qd Kd 9s]
Gigo373: checks 
Sium12302: checks 
*** TURN *** [Qd Kd 9s] [6h]
Gigo373: checks 
Sium12302: bets €0.02
Gigo373: calls €0.02
*** RIVER *** [Qd Kd 9s 6h] [4c]
Gigo373: bets €0.02
Sium12302: raises €0.08 to €0.10
Gigo373: folds 
Uncalled bet (€0.08) returned to Sium12302
Sium12302 collected €0.12 from pot
Sium12302: doesn't show hand 
*** SUMMARY ***
Total pot €0.12 | Rake €0 
Board [Qd Kd 9s 6h 4c]
Seat 1: cap e'bomb95 (button) folded before Flop (didn't bet)
Seat 2: Gigo373 (small blind) folded on the River
Seat 3: Sium12302 (big blind) collected (€0.12)
Seat 4: Peru91j folded before Flop (didn't bet)
Seat 5: ivano747 folded before Flop (didn't bet)
Seat 6: caduceus369 folded before Flop (didn't bet)



PokerStars Zoom Hand #257988191419:  Hold'em No Limit (€0.01/€0.02) [ADM ID: M62BA304494E32ST] - 2025/10/03 23:42:54 CET [2025/10/03 17:42:54 ET]
Table 'Sirio' 6-max Seat #1 is the button
Seat 1: Sium12302 (€6.27 in chips) 
Seat 2: stfuplzudonk (€2.11 in chips) 
Seat 3: cap e'bomb95 (€5.21 in chips) 
Seat 4: caduceus369 (€4.01 in chips) 
Seat 5: michy0757 (€0.96 in chips) 
Seat 6: tigermiscio (€0.28 in chips) 
stfuplzudonk: posts small blind €0.01
cap e'bomb95: posts big blind €0.02
*** HOLE CARDS ***
Dealt to caduceus369 [4h 7s]
caduceus369: folds 
michy0757: raises €0.02 to €0.04
tigermiscio: calls €0.04
Sium12302: folds 
stfuplzudonk: calls €0.03
cap e'bomb95: folds 
*** FLOP *** [5c Ks Ac]
stfuplzudonk: checks 
michy0757: checks 
tigermiscio: checks 
*** TURN *** [5c Ks Ac] [2s]
stfuplzudonk: bets €0.07
michy0757: folds 
tigermiscio: calls €0.07
*** RIVER *** [5c Ks Ac 2s] [5h]
stfuplzudonk: checks 
tigermiscio: checks 
*** SHOW DOWN ***
stfuplzudonk: shows [Jc Kc] (two pair, Kings and Fives)
tigermiscio: mucks hand 
stfuplzudonk collected €0.27 from pot
*** SUMMARY ***
Total pot €0.28 | Rake €0.01 
Board [5c Ks Ac 2s 5h]
Seat 1: Sium12302 (button) folded before Flop (didn't bet)
Seat 2: stfuplzudonk (small blind) showed [Jc Kc] and won (€0.27) with two pair, Kings and Fives
Seat 3: cap e'bomb95 (big blind) folded before Flop
Seat 4: caduceus369 folded before Flop (didn't bet)
Seat 5: michy0757 folded on the Turn
Seat 6: tigermiscio mucked [3d 3c]



PokerStars Zoom Hand #257988193042:  Hold'em No Limit (€0.01/€0.02) [ADM ID: M62BA304494E32ST] - 2025/10/03 23:43:01 CET [2025/10/03 17:43:01 ET]
Table 'Sirio' 6-max Seat #1 is the button
Seat 1: maury999999 (€2.02 in chips) 
Seat 2: cap e'bomb95 (€2 in chips) 
Seat 3: caduceus369 (€4.01 in chips) 
Seat 4: ivano747 (€2.68 in chips) 
Seat 5: ADRIAN0_MEIS (€11.16 in chips) 
Seat 6: Catania838 (€3.56 in chips) 
cap e'bomb95: posts small blind €0.01
caduceus369: posts big blind €0.02
*** HOLE CARDS ***
Dealt to caduceus369 [Ac 9s]
ivano747: folds 
ADRIAN0_MEIS: folds 
Catania838: folds 
maury999999: folds 
cap e'bomb95: raises €0.03 to €0.05
caduceus369: calls €0.03
*** FLOP *** [Qs 3c 8c]
cap e'bomb95: bets €0.07
caduceus369: calls €0.07
*** TURN *** [Qs 3c 8c] [Ts]
cap e'bomb95: bets €0.15
caduceus369: folds 
Uncalled bet (€0.15) returned to cap e'bomb95
cap e'bomb95 collected €0.23 from pot
cap e'bomb95: doesn't show hand 
*** SUMMARY ***
Total pot €0.24 | Rake €0.01 
Board [Qs 3c 8c Ts]
Seat 1: maury999999 (button) folded before Flop (didn't bet)
Seat 2: cap e'bomb95 (small blind) collected (€0.23)
Seat 3: caduceus369 (big blind) folded on the Turn
Seat 4: ivano747 folded before Flop (didn't bet)
Seat 5: ADRIAN0_MEIS folded before Flop (didn't bet)
Seat 6: Catania838 folded before Flop (didn't bet)



PokerStars Zoom Hand #257988211279:  Hold'em No Limit (€0.01/€0.02) [ADM ID: M62BA304494E32ST] - 2025/10/03 23:44:19 CET [2025/10/03 17:44:19 ET]
Table 'Sirio' 6-max Seat #1 is the button
Seat 1: criptlux (€1.97 in chips) 
Seat 2: SidneyPrescott (€2.12 in chips) 
Seat 3: Genny040893 (€0.80 in chips) 
Seat 4: caduceus369 (€3.88 in chips) 
Seat 5: Chia9711 (€4.06 in chips) 
Seat 6: ADRIAN0_MEIS (€8.46 in chips) 
SidneyPrescott: posts small blind €0.01
Genny040893: posts big blind €0.02
*** HOLE CARDS ***
Dealt to caduceus369 [4d 2c]
caduceus369: folds 
Chia9711: folds 
ADRIAN0_MEIS: folds 
criptlux: folds 
SidneyPrescott: folds 
Uncalled bet (€0.01) returned to Genny040893
Genny040893 collected €0.02 from pot
Genny040893: doesn't show hand 
*** SUMMARY ***
Total pot €0.02 | Rake €0 
Seat 1: criptlux (button) folded before Flop (didn't bet)
Seat 2: SidneyPrescott (small blind) folded before Flop
Seat 3: Genny040893 (big blind) collected (€0.02)
Seat 4: caduceus369 folded before Flop (didn't bet)
Seat 5: Chia9711 folded before Flop (didn't bet)
Seat 6: ADRIAN0_MEIS folded before Flop (didn't bet)



PokerStars Zoom Hand #257988207985:  Hold'em No Limit (€0.01/€0.02) [ADM ID: M62BA304494E32ST] - 2025/10/03 23:44:05 CET [2025/10/03 17:44:05 ET]
Table 'Sirio' 6-max Seat #1 is the button
Seat 1: Peru91j (€2.38 in chips) 
Seat 2: caduceus369 (€3.89 in chips) 
Seat 3: 999rizla (€0.93 in chips) 
Seat 4: Gabrielefante (€2.92 in chips) 
Seat 5: SidneyPrescott (€2.12 in chips) 
Seat 6: Sium12302 (€2.03 in chips) 
caduceus369: posts small blind €0.01
999rizla: posts big blind €0.02
*** HOLE CARDS ***
Dealt to caduceus369 [9s 6c]
Gabrielefante: folds 
SidneyPrescott: folds 
Sium12302: raises €0.04 to €0.06
Peru91j: folds 
caduceus369: folds 
999rizla: folds 
Uncalled bet (€0.04) returned to Sium12302
Sium12302 collected €0.05 from pot
Sium12302: doesn't show hand 
*** SUMMARY ***
Total pot €0.05 | Rake €0 
Seat 1: Peru91j (button) folded before Flop (didn't bet)
Seat 2: caduceus369 (small blind) folded before Flop
Seat 3: 999rizla (big blind) folded before Flop
Seat 4: Gabrielefante folded before Flop (didn't bet)
Seat 5: SidneyPrescott folded before Flop (didn't bet)
Seat 6: Sium12302 collected (€0.05)



PokerStars Zoom Hand #257988206642:  Hold'em No Limit (€0.01/€0.02) [ADM ID: M62BA304494E32ST] - 2025/10/03 23:43:59 CET [2025/10/03 17:43:59 ET]
Table 'Sirio' 6-max Seat #1 is the button
Seat 1: Ceribelli1705 (€0.71 in chips) 
Seat 2: 999rizla (€0.94 in chips) 
Seat 3: fantaasso (€2.55 in chips) 
Seat 4: caduceus369 (€3.89 in chips) 
Seat 5: EasyToRule (€4.29 in chips) 
Seat 6: Witness85906 (€4.61 in chips) 
999rizla: posts small blind €0.01
fantaasso: posts big blind €0.02
*** HOLE CARDS ***
Dealt to caduceus369 [9h Ad]
caduceus369: folds 
EasyToRule: folds 
Witness85906: raises €0.03 to €0.05
Ceribelli1705: calls €0.05
999rizla: folds 
fantaasso: folds 
*** FLOP *** [7s 4h Ks]
Witness85906: bets €0.04
Ceribelli1705: folds 
Uncalled bet (€0.04) returned to Witness85906
Witness85906 collected €0.13 from pot
Witness85906: doesn't show hand 
*** SUMMARY ***
Total pot €0.13 | Rake €0 
Board [7s 4h Ks]
Seat 1: Ceribelli1705 (button) folded on the Flop
Seat 2: 999rizla (small blind) folded before Flop
Seat 3: fantaasso (big blind) folded before Flop
Seat 4: caduceus369 folded before Flop (didn't bet)
Seat 5: EasyToRule folded before Flop (didn't bet)
Seat 6: Witness85906 collected (€0.13)



PokerStars Zoom Hand #257988212859:  Hold'em No Limit (€0.01/€0.02) [ADM ID: M62BA304494E32ST] - 2025/10/03 23:44:26 CET [2025/10/03 17:44:26 ET]
Table 'Sirio' 6-max Seat #1 is the button
Seat 1: stfuplzudonk (€2.36 in chips) 
Seat 2: ADRIAN0_MEIS (€11.14 in chips) 
Seat 3: caduceus369 (€3.88 in chips) 
Seat 4: pia1256 (€1.93 in chips) 
Seat 5: maury999999 (€2.02 in chips) 
Seat 6: EasyToRule (€4.29 in chips) 
ADRIAN0_MEIS: posts small blind €0.01
caduceus369: posts big blind €0.02
*** HOLE CARDS ***
Dealt to caduceus369 [5d 3c]
pia1256: folds 
maury999999: folds 
EasyToRule: raises €0.04 to €0.06
stfuplzudonk: calls €0.06
ADRIAN0_MEIS: raises €0.20 to €0.26
caduceus369: folds 
EasyToRule: folds 
stfuplzudonk: folds 
Uncalled bet (€0.20) returned to ADRIAN0_MEIS
ADRIAN0_MEIS collected €0.20 from pot
ADRIAN0_MEIS: doesn't show hand 
*** SUMMARY ***
Total pot €0.20 | Rake €0 
Seat 1: stfuplzudonk (button) folded before Flop
Seat 2: ADRIAN0_MEIS (small blind) collected (€0.20)
Seat 3: caduceus369 (big blind) folded before Flop
Seat 4: pia1256 folded before Flop (didn't bet)
Seat 5: maury999999 folded before Flop (didn't bet)
Seat 6: EasyToRule folded before Flop



PokerStars Zoom Hand #257988210141:  Hold'em No Limit (€0.01/€0.02) [ADM ID: M62BA304494E32ST] - 2025/10/03 23:44:14 CET [2025/10/03 17:44:14 ET]
Table 'Sirio' 6-max Seat #1 is the button
Seat 1: father2008 (€6.09 in chips) 
Seat 2: trillycata (€1.19 in chips) 
Seat 3: VrDmNl (€1.52 in chips) 
Seat 4: savicevic74 (€3.29 in chips) 
Seat 5: caduceus369 (€3.88 in chips) 
Seat 6: stfuplzudonk (€2.27 in chips) 
trillycata: posts small blind €0.01
VrDmNl: posts big blind €0.02
*** HOLE CARDS ***
Dealt to caduceus369 [2d Ks]
savicevic74: calls €0.02
caduceus369: folds 
stfuplzudonk: folds 
father2008: folds 
trillycata: calls €0.01
VrDmNl: checks 
*** FLOP *** [Qs 3s Jd]
trillycata: bets €0.03
VrDmNl: calls €0.03
savicevic74: calls €0.03
*** TURN *** [Qs 3s Jd] [8d]
trillycata: bets €0.15
VrDmNl: folds 
savicevic74: calls €0.15
*** RIVER *** [Qs 3s Jd 8d] [Ah]
trillycata: bets €0.43
savicevic74: folds 
Uncalled bet (€0.43) returned to trillycata
trillycata collected €0.43 from pot
trillycata: doesn't show hand 
*** SUMMARY ***
Total pot €0.45 | Rake €0.02 
Board [Qs 3s Jd 8d Ah]
Seat 1: father2008 (button) folded before Flop (didn't bet)
Seat 2: trillycata (small blind) collected (€0.43)
Seat 3: VrDmNl (big blind) folded on the Turn
Seat 4: savicevic74 folded on the River
Seat 5: caduceus369 folded before Flop (didn't bet)
Seat 6: stfuplzudonk folded before Flop (didn't bet)



PokerStars Zoom Hand #257988208901:  Hold'em No Limit (€0.01/€0.02) [ADM ID: M62BA304494E32ST] - 2025/10/03 23:44:09 CET [2025/10/03 17:44:09 ET]
Table 'Sirio' 6-max Seat #1 is the button
Seat 1: caduceus369 (€3.88 in chips) 
Seat 2: criptlux (€1.98 in chips) 
Seat 3: ivano747 (€2.59 in chips) 
Seat 4: neoilnervoso (€1.83 in chips) 
Seat 5: tigermiscio (€0.17 in chips) 
Seat 6: ADRIAN0_MEIS (€2.56 in chips) 
criptlux: posts small blind €0.01
ivano747: posts big blind €0.02
*** HOLE CARDS ***
Dealt to caduceus369 [Ks 5c]
neoilnervoso: calls €0.02
tigermiscio is disconnected 
tigermiscio has timed out while disconnected
tigermiscio: folds 
ADRIAN0_MEIS: folds 
caduceus369: folds 
criptlux: folds 
ivano747: checks 
*** FLOP *** [Qh 7c Th]
ivano747: bets €0.03
neoilnervoso: raises €0.03 to €0.06
ivano747: calls €0.03
*** TURN *** [Qh 7c Th] [2s]
ivano747: bets €0.09
neoilnervoso: calls €0.09
*** RIVER *** [Qh 7c Th 2s] [4h]
ivano747: bets €0.34
neoilnervoso: folds 
Uncalled bet (€0.34) returned to ivano747
ivano747 collected €0.34 from pot
ivano747: doesn't show hand 
*** SUMMARY ***
Total pot €0.35 | Rake €0.01 
Board [Qh 7c Th 2s 4h]
Seat 1: caduceus369 (button) folded before Flop (didn't bet)
Seat 2: criptlux (small blind) folded before Flop
Seat 3: ivano747 (big blind) collected (€0.34)
Seat 4: neoilnervoso folded on the River
Seat 5: tigermiscio folded before Flop (didn't bet)
Seat 6: ADRIAN0_MEIS folded before Flop (didn't bet)



PokerStars Zoom Hand #257988220720:  Hold'em No Limit (€0.01/€0.02) [ADM ID: M62BA304494E32ST] - 2025/10/03 23:44:59 CET [2025/10/03 17:44:59 ET]
Table 'Sirio' 6-max Seat #1 is the button
Seat 1: caduceus369 (€3.85 in chips) 
Seat 2: ivano747 (€2.76 in chips) 
Seat 3: SidneyPrescott (€4.77 in chips) 
Seat 4: ADRIAN0_MEIS (€8.49 in chips) 
Seat 5: stfuplzudonk (€4.08 in chips) 
Seat 6: Sium12302 (€2.06 in chips) 
ivano747: posts small blind €0.01
SidneyPrescott: posts big blind €0.02
*** HOLE CARDS ***
Dealt to caduceus369 [Ah 7h]
ADRIAN0_MEIS: folds 
stfuplzudonk: folds 
Sium12302: folds 
caduceus369: raises €0.04 to €0.06
ivano747: folds 
SidneyPrescott: folds 
Uncalled bet (€0.04) returned to caduceus369
caduceus369 collected €0.05 from pot
caduceus369: doesn't show hand 
*** SUMMARY ***
Total pot €0.05 | Rake €0 
Seat 1: caduceus369 (button) collected (€0.05)
Seat 2: ivano747 (small blind) folded before Flop
Seat 3: SidneyPrescott (big blind) folded before Flop
Seat 4: ADRIAN0_MEIS folded before Flop (didn't bet)
Seat 5: stfuplzudonk folded before Flop (didn't bet)
Seat 6: Sium12302 folded before Flop (didn't bet)



PokerStars Zoom Hand #257988216866:  Hold'em No Limit (€0.01/€0.02) [ADM ID: M62BA304494E32ST] - 2025/10/03 23:44:43 CET [2025/10/03 17:44:43 ET]
Table 'Sirio' 6-max Seat #1 is the button
Seat 1: criptlux (€1.97 in chips) 
Seat 2: caduceus369 (€3.86 in chips) 
Seat 3: fantaasso (€2.42 in chips) 
Seat 4: Witness85906 (€4.69 in chips) 
Seat 5: Neroonciolina (€6.21 in chips) 
Seat 6: Peru91j (€2.37 in chips) 
caduceus369: posts small blind €0.01
fantaasso: posts big blind €0.02
*** HOLE CARDS ***
Dealt to caduceus369 [6h 6d]
Witness85906: folds 
Neroonciolina: raises €0.12 to €0.14
Peru91j: folds 
criptlux: raises €0.46 to €0.60
caduceus369: folds 
fantaasso: folds 
Neroonciolina: calls €0.46
*** FLOP *** [Qc 9d 6c]
Neroonciolina: checks 
criptlux: bets €1.37 and is all-in
Neroonciolina: folds 
Uncalled bet (€1.37) returned to criptlux
criptlux collected €1.17 from pot
criptlux: doesn't show hand 
*** SUMMARY ***
Total pot €1.23 | Rake €0.06 
Board [Qc 9d 6c]
Seat 1: criptlux (button) collected (€1.17)
Seat 2: caduceus369 (small blind) folded before Flop
Seat 3: fantaasso (big blind) folded before Flop
Seat 4: Witness85906 folded before Flop (didn't bet)
Seat 5: Neroonciolina folded on the Flop
Seat 6: Peru91j folded before Flop (didn't bet)



PokerStars Zoom Hand #257988223910:  Hold'em No Limit (€0.01/€0.02) [ADM ID: M62BA304494E32ST] - 2025/10/03 23:45:13 CET [2025/10/03 17:45:13 ET]
Table 'Sirio' 6-max Seat #1 is the button
Seat 1: CacciatoreAA (€1.72 in chips) 
Seat 2: stfuplzudonk (€4.33 in chips) 
Seat 3: Sium12302 (€6.43 in chips) 
Seat 4: ADRIAN0_MEIS (€8.43 in chips) 
Seat 5: caduceus369 (€3.88 in chips) 
Seat 6: SidneyPrescott (€4.75 in chips) 
stfuplzudonk: posts small blind €0.01
Sium12302: posts big blind €0.02
*** HOLE CARDS ***
Dealt to caduceus369 [4d 7c]
ADRIAN0_MEIS: folds 
caduceus369: folds 
SidneyPrescott: folds 
CacciatoreAA: folds 
stfuplzudonk: folds 
Uncalled bet (€0.01) returned to Sium12302
Sium12302 collected €0.02 from pot
Sium12302: doesn't show hand 
*** SUMMARY ***
Total pot €0.02 | Rake €0 
Seat 1: CacciatoreAA (button) folded before Flop (didn't bet)
Seat 2: stfuplzudonk (small blind) folded before Flop
Seat 3: Sium12302 (big blind) collected (€0.02)
Seat 4: ADRIAN0_MEIS folded before Flop (didn't bet)
Seat 5: caduceus369 folded before Flop (didn't bet)
Seat 6: SidneyPrescott folded before Flop (didn't bet)



PokerStars Zoom Hand #257988219018:  Hold'em No Limit (€0.01/€0.02) [ADM ID: M62BA304494E32ST] - 2025/10/03 23:44:52 CET [2025/10/03 17:44:52 ET]
Table 'Sirio' 6-max Seat #1 is the button
Seat 1: ADRIAN0_MEIS (€8.49 in chips) 
Seat 2: Genny040893 (€0.77 in chips) 
Seat 3: savicevic74 (€3.09 in chips) 
Seat 4: neoilnervoso (€1.66 in chips) 
Seat 5: SidneyPrescott (€4.78 in chips) 
Seat 6: caduceus369 (€3.85 in chips) 
Genny040893: posts small blind €0.01
savicevic74: posts big blind €0.02
*** HOLE CARDS ***
Dealt to caduceus369 [Jh 6s]
neoilnervoso: raises €0.04 to €0.06
SidneyPrescott: folds 
caduceus369: folds 
ADRIAN0_MEIS: folds 
Genny040893: calls €0.05
savicevic74 is disconnected 
savicevic74 has timed out while disconnected
savicevic74: folds 
*** FLOP *** [7s Qs Tc]
Genny040893: checks 
neoilnervoso: checks 
*** TURN *** [7s Qs Tc] [4d]
Genny040893: bets €0.02
neoilnervoso: calls €0.02
*** RIVER *** [7s Qs Tc 4d] [Ad]
Genny040893: checks 
neoilnervoso: bets €0.18
Genny040893: folds 
Uncalled bet (€0.18) returned to neoilnervoso
neoilnervoso collected €0.18 from pot
neoilnervoso: doesn't show hand 
*** SUMMARY ***
Total pot €0.18 | Rake €0 
Board [7s Qs Tc 4d Ad]
Seat 1: ADRIAN0_MEIS (button) folded before Flop (didn't bet)
Seat 2: Genny040893 (small blind) folded on the River
Seat 3: savicevic74 (big blind) folded before Flop
Seat 4: neoilnervoso collected (€0.18)
Seat 5: SidneyPrescott folded before Flop (didn't bet)
Seat 6: caduceus369 folded before Flop (didn't bet)



PokerStars Zoom Hand #257988224626:  Hold'em No Limit (€0.01/€0.02) [ADM ID: M62BA304494E32ST] - 2025/10/03 23:45:16 CET [2025/10/03 17:45:16 ET]
Table 'Sirio' 6-max Seat #1 is the button
Seat 1: SidneyPrescott (€4.75 in chips) 
Seat 2: father2008 (€6.02 in chips) 
Seat 3: CacciatoreAA (€1.72 in chips) 
Seat 4: caduceus369 (€3.88 in chips) 
Seat 5: cap e'bomb95 (€1.98 in chips) 
Seat 6: robertoH2O (€2 in chips) 
father2008: posts small blind €0.01
CacciatoreAA: posts big blind €0.02
*** HOLE CARDS ***
Dealt to caduceus369 [Kd 8d]
caduceus369: folds 
cap e'bomb95: folds 
robertoH2O: raises €0.03 to €0.05
SidneyPrescott: raises €0.11 to €0.16
father2008: folds 
CacciatoreAA: folds 
robertoH2O: folds 
Uncalled bet (€0.11) returned to SidneyPrescott
SidneyPrescott collected €0.13 from pot
SidneyPrescott: doesn't show hand 
*** SUMMARY ***
Total pot €0.13 | Rake €0 
Seat 1: SidneyPrescott (button) collected (€0.13)
Seat 2: father2008 (small blind) folded before Flop
Seat 3: CacciatoreAA (big blind) folded before Flop
Seat 4: caduceus369 folded before Flop (didn't bet)
Seat 5: cap e'bomb95 folded before Flop (didn't bet)
Seat 6: robertoH2O folded before Flop



PokerStars Zoom Hand #257988226935:  Hold'em No Limit (€0.01/€0.02) [ADM ID: M62BA304494E32ST] - 2025/10/03 23:45:27 CET [2025/10/03 17:45:27 ET]
Table 'Sirio' 6-max Seat #1 is the button
Seat 1: stfuplzudonk (€4.07 in chips) 
Seat 2: Sium12302 (€6.44 in chips) 
Seat 3: caduceus369 (€3.88 in chips) 
Seat 4: Peru91j (€2.02 in chips) 
Seat 5: KindRonin (€0.71 in chips) 
Seat 6: cap e'bomb95 (€1.66 in chips) 
Sium12302: posts small blind €0.01
caduceus369: posts big blind €0.02
*** HOLE CARDS ***
Dealt to caduceus369 [9h Ts]
Peru91j: folds 
KindRonin: raises €0.02 to €0.04
cap e'bomb95: folds 
stfuplzudonk: calls €0.04
Sium12302: folds 
caduceus369: folds 
*** FLOP *** [2c Kh 4h]
KindRonin: checks 
stfuplzudonk: checks 
*** TURN *** [2c Kh 4h] [3h]
KindRonin: checks 
stfuplzudonk: checks 
*** RIVER *** [2c Kh 4h 3h] [Kd]
KindRonin: bets €0.04
stfuplzudonk: folds 
Uncalled bet (€0.04) returned to KindRonin
KindRonin collected €0.11 from pot
KindRonin: doesn't show hand 
*** SUMMARY ***
Total pot €0.11 | Rake €0 
Board [2c Kh 4h 3h Kd]
Seat 1: stfuplzudonk (button) folded on the River
Seat 2: Sium12302 (small blind) folded before Flop
Seat 3: caduceus369 (big blind) folded before Flop
Seat 4: Peru91j folded before Flop (didn't bet)
Seat 5: KindRonin collected (€0.11)
Seat 6: cap e'bomb95 folded before Flop (didn't bet)



PokerStars Zoom Hand #257988225767:  Hold'em No Limit (€0.01/€0.02) [ADM ID: M62BA304494E32ST] - 2025/10/03 23:45:22 CET [2025/10/03 17:45:22 ET]
Table 'Sirio' 6-max Seat #1 is the button
Seat 1: ADRIAN0_MEIS (€2.53 in chips) 
Seat 2: cap e'bomb95 (€1.98 in chips) 
Seat 3: Peru91j (€2.37 in chips) 
Seat 4: EasyToRule (€2.40 in chips) 
Seat 5: caduceus369 (€3.88 in chips) 
Seat 6: KindRonin (€0.71 in chips) 
cap e'bomb95: posts small blind €0.01
Peru91j: posts big blind €0.02
*** HOLE CARDS ***
Dealt to caduceus369 [9c 4s]
EasyToRule: raises €0.03 to €0.05
caduceus369: folds 
KindRonin: folds 
ADRIAN0_MEIS: folds 
cap e'bomb95: folds 
Peru91j: calls €0.03
*** FLOP *** [7d Qh 4d]
Peru91j: checks 
EasyToRule: bets €0.03
Peru91j: folds 
Uncalled bet (€0.03) returned to EasyToRule
EasyToRule collected €0.11 from pot
EasyToRule: doesn't show hand 
*** SUMMARY ***
Total pot €0.11 | Rake €0 
Board [7d Qh 4d]
Seat 1: ADRIAN0_MEIS (button) folded before Flop (didn't bet)
Seat 2: cap e'bomb95 (small blind) folded before Flop
Seat 3: Peru91j (big blind) folded on the Flop
Seat 4: EasyToRule collected (€0.11)
Seat 5: caduceus369 folded before Flop (didn't bet)
Seat 6: KindRonin folded before Flop (didn't bet)



PokerStars Zoom Hand #257988231378:  Hold'em No Limit (€0.01/€0.02) [ADM ID: M62BA304494E32ST] - 2025/10/03 23:45:46 CET [2025/10/03 17:45:46 ET]
Table 'Sirio' 6-max Seat #1 is the button
Seat 1: Peru91j (€2.01 in chips) 
Seat 2: caduceus369 (€3.86 in chips) 
Seat 3: fantaasso (€2.34 in chips) 
Seat 4: Witness85906 (€4.33 in chips) 
Seat 5: SidneyPrescott (€4.83 in chips) 
Seat 6: father2008 (€4.23 in chips) 
caduceus369: posts small blind €0.01
fantaasso: posts big blind €0.02
*** HOLE CARDS ***
Dealt to caduceus369 [As Js]
Witness85906: folds 
SidneyPrescott: folds 
father2008: folds 
Peru91j: folds 
caduceus369: calls €0.01
fantaasso: checks 
*** FLOP *** [6d 6c 5h]
caduceus369: bets €0.02
fantaasso: calls €0.02
*** TURN *** [6d 6c 5h] [7c]
caduceus369: checks 
fantaasso: bets €0.04
caduceus369: folds 
Uncalled bet (€0.04) returned to fantaasso
fantaasso collected €0.08 from pot
fantaasso: doesn't show hand 
*** SUMMARY ***
Total pot €0.08 | Rake €0 
Board [6d 6c 5h 7c]
Seat 1: Peru91j (button) folded before Flop (didn't bet)
Seat 2: caduceus369 (small blind) folded on the Turn
Seat 3: fantaasso (big blind) collected (€0.08)
Seat 4: Witness85906 folded before Flop (didn't bet)
Seat 5: SidneyPrescott folded before Flop (didn't bet)
Seat 6: father2008 folded before Flop (didn't bet)



PokerStars Zoom Hand #257988230202:  Hold'em No Limit (€0.01/€0.02) [ADM ID: M62BA304494E32ST] - 2025/10/03 23:45:41 CET [2025/10/03 17:45:41 ET]
Table 'Sirio' 6-max Seat #1 is the button
Seat 1: caduceus369 (€3.86 in chips) 
Seat 2: father2008 (€4.24 in chips) 
Seat 3: Fengjie82 (€1.40 in chips) 
Seat 4: montemeru (€1.98 in chips) 
Seat 5: SidneyPrescott (€3.96 in chips) 
Seat 6: Sium12302 (€2.03 in chips) 
father2008: posts small blind €0.01
Fengjie82: posts big blind €0.02
*** HOLE CARDS ***
Dealt to caduceus369 [7c 2h]
montemeru: raises €0.04 to €0.06
SidneyPrescott: folds 
Sium12302: folds 
caduceus369: folds 
father2008: folds 
Fengjie82: calls €0.04
*** FLOP *** [Qc 6s 8h]
Fengjie82: checks 
montemeru: checks 
*** TURN *** [Qc 6s 8h] [Th]
Fengjie82: checks 
montemeru: checks 
*** RIVER *** [Qc 6s 8h Th] [Kd]
Fengjie82: bets €0.04
montemeru: folds 
Uncalled bet (€0.04) returned to Fengjie82
Fengjie82 collected €0.13 from pot
Fengjie82: doesn't show hand 
*** SUMMARY ***
Total pot €0.13 | Rake €0 
Board [Qc 6s 8h Th Kd]
Seat 1: caduceus369 (button) folded before Flop (didn't bet)
Seat 2: father2008 (small blind) folded before Flop
Seat 3: Fengjie82 (big blind) collected (€0.13)
Seat 4: montemeru folded on the River
Seat 5: SidneyPrescott folded before Flop (didn't bet)
Seat 6: Sium12302 folded before Flop (didn't bet)



PokerStars Zoom Hand #257988238333:  Hold'em No Limit (€0.01/€0.02) [ADM ID: M62BA304494E32ST] - 2025/10/03 23:46:16 CET [2025/10/03 17:46:16 ET]
Table 'Sirio' 6-max Seat #1 is the button
Seat 1: ivano747 (€2.87 in chips) 
Seat 2: VrDmNl (€1.46 in chips) 
Seat 3: cap e'bomb95 (€4.92 in chips) 
Seat 4: Sium12302 (€2 in chips) 
Seat 5: SidneyPrescott (€2.07 in chips) 
Seat 6: caduceus369 (€3.82 in chips) 
VrDmNl: posts small blind €0.01
cap e'bomb95: posts big blind €0.02
*** HOLE CARDS ***
Dealt to caduceus369 [7d 3h]
Sium12302: folds 
SidneyPrescott: folds 
caduceus369: folds 
ivano747: folds 
VrDmNl: calls €0.01
cap e'bomb95: checks 
*** FLOP *** [Ad Qc 2d]
VrDmNl: checks 
cap e'bomb95: checks 
*** TURN *** [Ad Qc 2d] [Jc]
VrDmNl: checks 
cap e'bomb95: checks 
*** RIVER *** [Ad Qc 2d Jc] [Kc]
VrDmNl: checks 
cap e'bomb95: checks 
*** SHOW DOWN ***
VrDmNl: shows [4d 8s] (high card Ace)
cap e'bomb95: shows [Ts 4h] (a straight, Ten to Ace)
cap e'bomb95 collected €0.04 from pot
*** SUMMARY ***
Total pot €0.04 | Rake €0 
Board [Ad Qc 2d Jc Kc]
Seat 1: ivano747 (button) folded before Flop (didn't bet)
Seat 2: VrDmNl (small blind) showed [4d 8s] and lost with high card Ace
Seat 3: cap e'bomb95 (big blind) showed [Ts 4h] and won (€0.04) with a straight, Ten to Ace
Seat 4: Sium12302 folded before Flop (didn't bet)
Seat 5: SidneyPrescott folded before Flop (didn't bet)
Seat 6: caduceus369 folded before Flop (didn't bet)



PokerStars Zoom Hand #257988276906:  Hold'em No Limit (€0.01/€0.02) [ADM ID: M62BA304494E32ST] - 2025/10/03 23:49:06 CET [2025/10/03 17:49:06 ET]
Table 'Sirio' 6-max Seat #1 is the button
Seat 1: 999rizla (€0.63 in chips) 
Seat 2: EasyToRule (€4.58 in chips) 
Seat 3: Ceribelli1705 (€0.83 in chips) 
Seat 4: caduceus369 (€3.82 in chips) 
Seat 5: Catania838 (€1.86 in chips) 
Seat 6: Sium12302 (€6.47 in chips) 
EasyToRule: posts small blind €0.01
Ceribelli1705: posts big blind €0.02
*** HOLE CARDS ***
Dealt to caduceus369 [Jh Ac]
caduceus369: raises €0.04 to €0.06
Catania838: folds 
Sium12302: folds 
999rizla: folds 
EasyToRule: folds 
Ceribelli1705: folds 
Uncalled bet (€0.04) returned to caduceus369
caduceus369 collected €0.05 from pot
caduceus369: doesn't show hand 
*** SUMMARY ***
Total pot €0.05 | Rake €0 
Seat 1: 999rizla (button) folded before Flop (didn't bet)
Seat 2: EasyToRule (small blind) folded before Flop
Seat 3: Ceribelli1705 (big blind) folded before Flop
Seat 4: caduceus369 collected (€0.05)
Seat 5: Catania838 folded before Flop (didn't bet)
Seat 6: Sium12302 folded before Flop (didn't bet)



PokerStars Zoom Hand #257988281604:  Hold'em No Limit (€0.01/€0.02) [ADM ID: M62BA304494E32ST] - 2025/10/03 23:49:27 CET [2025/10/03 17:49:27 ET]
Table 'Sirio' 6-max Seat #1 is the button
Seat 1: fantaasso (€2.47 in chips) 
Seat 2: Ceribelli1705 (€0.81 in chips) 
Seat 3: caduceus369 (€3.85 in chips) 
Seat 4: criptlux (€2.43 in chips) 
Seat 5: father2008 (€4.25 in chips) 
Seat 6: VrDmNl (€1.23 in chips) 
Ceribelli1705: posts small blind €0.01
caduceus369: posts big blind €0.02
*** HOLE CARDS ***
Dealt to caduceus369 [2s 9c]
criptlux: folds 
father2008: raises €0.05 to €0.07
VrDmNl: folds 
fantaasso: folds 
Ceribelli1705: folds 
caduceus369: folds 
Uncalled bet (€0.05) returned to father2008
father2008 collected €0.05 from pot
father2008: doesn't show hand 
*** SUMMARY ***
Total pot €0.05 | Rake €0 
Seat 1: fantaasso (button) folded before Flop (didn't bet)
Seat 2: Ceribelli1705 (small blind) folded before Flop
Seat 3: caduceus369 (big blind) folded before Flop
Seat 4: criptlux folded before Flop (didn't bet)
Seat 5: father2008 collected (€0.05)
Seat 6: VrDmNl folded before Flop (didn't bet)



PokerStars Zoom Hand #257988280596:  Hold'em No Limit (€0.01/€0.02) [ADM ID: M62BA304494E32ST] - 2025/10/03 23:49:23 CET [2025/10/03 17:49:23 ET]
Table 'Sirio' 6-max Seat #1 is the button
Seat 1: cap e'bomb95 (€5 in chips) 
Seat 2: Witness85906 (€4.49 in chips) 
Seat 3: stfuplzudonk (€4.37 in chips) 
Seat 4: criptlux (€2.43 in chips) 
Seat 5: caduceus369 (€3.85 in chips) 
Seat 6: Catania838 (€2.87 in chips) 
Witness85906: posts small blind €0.01
stfuplzudonk: posts big blind €0.02
*** HOLE CARDS ***
Dealt to caduceus369 [2s 5s]
criptlux: folds 
caduceus369: folds 
Catania838: folds 
cap e'bomb95: raises €0.03 to €0.05
Witness85906: folds 
stfuplzudonk: calls €0.03
*** FLOP *** [Tc Td 3h]
stfuplzudonk: checks 
cap e'bomb95: checks 
*** TURN *** [Tc Td 3h] [9d]
stfuplzudonk: checks 
cap e'bomb95: bets €0.07
stfuplzudonk: calls €0.07
*** RIVER *** [Tc Td 3h 9d] [Kc]
stfuplzudonk: checks 
cap e'bomb95: bets €0.20
stfuplzudonk: folds 
Uncalled bet (€0.20) returned to cap e'bomb95
cap e'bomb95 collected €0.24 from pot
cap e'bomb95: doesn't show hand 
*** SUMMARY ***
Total pot €0.25 | Rake €0.01 
Board [Tc Td 3h 9d Kc]
Seat 1: cap e'bomb95 (button) collected (€0.24)
Seat 2: Witness85906 (small blind) folded before Flop
Seat 3: stfuplzudonk (big blind) folded on the River
Seat 4: criptlux folded before Flop (didn't bet)
Seat 5: caduceus369 folded before Flop (didn't bet)
Seat 6: Catania838 folded before Flop (didn't bet)



PokerStars Zoom Hand #257988284638:  Hold'em No Limit (€0.01/€0.02) [ADM ID: M62BA304494E32ST] - 2025/10/03 23:49:41 CET [2025/10/03 17:49:41 ET]
Table 'Sirio' 6-max Seat #1 is the button
Seat 1: caduceus369 (€3.83 in chips) 
Seat 2: maury999999 (€2.04 in chips) 
Seat 3: Gabrielefante (€2.93 in chips) 
Seat 4: Witness85906 (€4.48 in chips) 
Seat 5: Sium12302 (€6.44 in chips) 
Seat 6: robertoH2O (€2.16 in chips) 
maury999999: posts small blind €0.01
Gabrielefante: posts big blind €0.02
*** HOLE CARDS ***
Dealt to caduceus369 [Jc As]
Witness85906: folds 
Sium12302: raises €0.03 to €0.05
robertoH2O: folds 
caduceus369: calls €0.05
maury999999: raises €0.19 to €0.24
Gabrielefante: folds 
Sium12302: folds 
caduceus369: calls €0.19
*** FLOP *** [9c Qc 5c]
maury999999: bets €0.34
caduceus369: calls €0.34
*** TURN *** [9c Qc 5c] [7d]
maury999999: bets €0.77
caduceus369: calls €0.77
*** RIVER *** [9c Qc 5c 7d] [9s]
maury999999: bets €0.69 and is all-in
caduceus369: folds 
Uncalled bet (€0.69) returned to maury999999
maury999999 collected €2.62 from pot
maury999999: doesn't show hand 
*** SUMMARY ***
Total pot €2.77 | Rake €0.15 
Board [9c Qc 5c 7d 9s]
Seat 1: caduceus369 (button) folded on the River
Seat 2: maury999999 (small blind) collected (€2.62)
Seat 3: Gabrielefante (big blind) folded before Flop
Seat 4: Witness85906 folded before Flop (didn't bet)
Seat 5: Sium12302 folded before Flop
Seat 6: robertoH2O folded before Flop (didn't bet)



PokerStars Zoom Hand #257988308756:  Hold'em No Limit (€0.01/€0.02) [ADM ID: M62BA304494E32ST] - 2025/10/03 23:51:28 CET [2025/10/03 17:51:28 ET]
Table 'Sirio' 6-max Seat #1 is the button
Seat 1: KindRonin (€0.66 in chips) 
Seat 2: Sium12302 (€6.29 in chips) 
Seat 3: Fengjie82 (€1.48 in chips) 
Seat 4: cap e'bomb95 (€1.32 in chips) 
Seat 5: Ceribelli1705 (€0.89 in chips) 
Seat 6: caduceus369 (€2.47 in chips) 
Sium12302: posts small blind €0.01
Fengjie82: posts big blind €0.02
*** HOLE CARDS ***
Dealt to caduceus369 [3h 4c]
cap e'bomb95: folds 
Ceribelli1705: folds 
caduceus369: folds 
KindRonin: folds 
Sium12302: folds 
Uncalled bet (€0.01) returned to Fengjie82
Fengjie82 collected €0.02 from pot
Fengjie82: doesn't show hand 
*** SUMMARY ***
Total pot €0.02 | Rake €0 
Seat 1: KindRonin (button) folded before Flop (didn't bet)
Seat 2: Sium12302 (small blind) folded before Flop
Seat 3: Fengjie82 (big blind) collected (€0.02)
Seat 4: cap e'bomb95 folded before Flop (didn't bet)
Seat 5: Ceribelli1705 folded before Flop (didn't bet)
Seat 6: caduceus369 folded before Flop (didn't bet)



PokerStars Zoom Hand #257988309661:  Hold'em No Limit (€0.01/€0.02) [ADM ID: M62BA304494E32ST] - 2025/10/03 23:51:32 CET [2025/10/03 17:51:32 ET]
Table 'Sirio' 6-max Seat #1 is the button
Seat 1: stfuplzudonk (€3.82 in chips) 
Seat 2: macchia1010 (€1.22 in chips) 
Seat 3: tigermiscio (€0.80 in chips) 
Seat 4: caduceus369 (€2.47 in chips) 
Seat 5: Sium12302 (€6.28 in chips) 
Seat 6: KindRonin (€0.66 in chips) 
macchia1010: posts small blind €0.01
tigermiscio: posts big blind €0.02
*** HOLE CARDS ***
Dealt to caduceus369 [3c 3d]
caduceus369: folds 
Sium12302: folds 
KindRonin: folds 
stfuplzudonk: raises €0.02 to €0.04
macchia1010: calls €0.03
tigermiscio: calls €0.02
*** FLOP *** [7h Jd 8c]
macchia1010: bets €0.02
tigermiscio: folds 
stfuplzudonk: raises €0.08 to €0.10
macchia1010: calls €0.08
*** TURN *** [7h Jd 8c] [4c]
macchia1010: checks 
stfuplzudonk: bets €0.16
macchia1010: calls €0.16
*** RIVER *** [7h Jd 8c 4c] [Qh]
macchia1010: checks 
stfuplzudonk: checks 
*** SHOW DOWN ***
macchia1010: shows [6h 9h] (high card Queen)
stfuplzudonk: shows [Ks Jh] (a pair of Jacks)
stfuplzudonk collected €0.61 from pot
*** SUMMARY ***
Total pot €0.64 | Rake €0.03 
Board [7h Jd 8c 4c Qh]
Seat 1: stfuplzudonk (button) showed [Ks Jh] and won (€0.61) with a pair of Jacks
Seat 2: macchia1010 (small blind) showed [6h 9h] and lost with high card Queen
Seat 3: tigermiscio (big blind) folded on the Flop
Seat 4: caduceus369 folded before Flop (didn't bet)
Seat 5: Sium12302 folded before Flop (didn't bet)
Seat 6: KindRonin folded before Flop (didn't bet)



PokerStars Zoom Hand #257988305551:  Hold'em No Limit (€0.01/€0.02) [ADM ID: M62BA304494E32ST] - 2025/10/03 23:51:14 CET [2025/10/03 17:51:14 ET]
Table 'Sirio' 6-max Seat #1 is the button
Seat 1: Fengjie82 (€1.48 in chips) 
Seat 2: caduceus369 (€2.48 in chips) 
Seat 3: maury999999 (€2.73 in chips) 
Seat 4: bruciapelo (€1.81 in chips) 
Seat 5: stevalmg (€1.98 in chips) 
Seat 6: Gabrielefante (€2.95 in chips) 
caduceus369: posts small blind €0.01
maury999999: posts big blind €0.02
*** HOLE CARDS ***
Dealt to caduceus369 [Kh 8d]
bruciapelo: raises €0.04 to €0.06
stevalmg: folds 
Gabrielefante: calls €0.06
Fengjie82: folds 
caduceus369: folds 
maury999999: folds 
*** FLOP *** [6h 7s Ad]
bruciapelo: bets €0.08
Gabrielefante: calls €0.08
*** TURN *** [6h 7s Ad] [5c]
bruciapelo: bets €0.15
Gabrielefante: calls €0.15
*** RIVER *** [6h 7s Ad 5c] [3c]
bruciapelo: checks 
Gabrielefante: checks 
*** SHOW DOWN ***
bruciapelo: shows [8c Jc] (high card Ace)
Gabrielefante: shows [Js As] (a pair of Aces)
Gabrielefante collected €0.58 from pot
*** SUMMARY ***
Total pot €0.61 | Rake €0.03 
Board [6h 7s Ad 5c 3c]
Seat 1: Fengjie82 (button) folded before Flop (didn't bet)
Seat 2: caduceus369 (small blind) folded before Flop
Seat 3: maury999999 (big blind) folded before Flop
Seat 4: bruciapelo showed [8c Jc] and lost with high card Ace
Seat 5: stevalmg folded before Flop (didn't bet)
Seat 6: Gabrielefante showed [Js As] and won (€0.58) with a pair of Aces



PokerStars Zoom Hand #257988313023:  Hold'em No Limit (€0.01/€0.02) [ADM ID: M62BA304494E32ST] - 2025/10/03 23:51:47 CET [2025/10/03 17:51:47 ET]
Table 'Sirio' 6-max Seat #1 is the button
Seat 1: outshined8 (€1.89 in chips) 
Seat 2: KindRonin (€0.64 in chips) 
Seat 3: caduceus369 (€2.47 in chips) 
Seat 4: Peru91j (€2.20 in chips) 
Seat 5: Gigo373 (€0.78 in chips) 
Seat 6: Ceribelli1705 (€0.88 in chips) 
KindRonin: posts small blind €0.01
caduceus369: posts big blind €0.02
*** HOLE CARDS ***
Dealt to caduceus369 [Jc 2s]
Peru91j has timed out
Peru91j: folds 
Gigo373: calls €0.02
Ceribelli1705: calls €0.02
outshined8: folds 
KindRonin: calls €0.01
caduceus369: checks 
*** FLOP *** [5h 2c 5d]
KindRonin: checks 
caduceus369: checks 
Gigo373: checks 
Ceribelli1705: checks 
*** TURN *** [5h 2c 5d] [Ac]
KindRonin: bets €0.04
caduceus369: folds 
Gigo373: folds 
Ceribelli1705: folds 
Uncalled bet (€0.04) returned to KindRonin
KindRonin collected €0.08 from pot
KindRonin: doesn't show hand 
*** SUMMARY ***
Total pot €0.08 | Rake €0 
Board [5h 2c 5d Ac]
Seat 1: outshined8 (button) folded before Flop (didn't bet)
Seat 2: KindRonin (small blind) collected (€0.08)
Seat 3: caduceus369 (big blind) folded on the Turn
Seat 4: Peru91j folded before Flop (didn't bet)
Seat 5: Gigo373 folded on the Turn
Seat 6: Ceribelli1705 folded on the Turn



PokerStars Zoom Hand #257988311178:  Hold'em No Limit (€0.01/€0.02) [ADM ID: M62BA304494E32ST] - 2025/10/03 23:51:39 CET [2025/10/03 17:51:39 ET]
Table 'Sirio' 6-max Seat #1 is the button
Seat 1: Fengjie82 (€1.49 in chips) 
Seat 2: outshined8 (€1.90 in chips) 
Seat 3: sanvito2106 (€1.20 in chips) 
Seat 4: tigermiscio (€0.81 in chips) 
Seat 5: caduceus369 (€2.47 in chips) 
Seat 6: ADRIAN0_MEIS (€2.59 in chips) 
outshined8: posts small blind €0.01
sanvito2106: posts big blind €0.02
*** HOLE CARDS ***
Dealt to caduceus369 [2s 6h]
tigermiscio: folds 
caduceus369: folds 
ADRIAN0_MEIS: raises €0.03 to €0.05
Fengjie82: folds 
outshined8: folds 
sanvito2106: calls €0.03
*** FLOP *** [7h 9d Qc]
sanvito2106: checks 
ADRIAN0_MEIS: checks 
*** TURN *** [7h 9d Qc] [3c]
sanvito2106: bets €0.02
ADRIAN0_MEIS: calls €0.02
*** RIVER *** [7h 9d Qc 3c] [Tc]
sanvito2106: checks 
ADRIAN0_MEIS: checks 
*** SHOW DOWN ***
sanvito2106: shows [7c 8d] (a pair of Sevens)
ADRIAN0_MEIS: mucks hand 
sanvito2106 collected €0.15 from pot
*** SUMMARY ***
Total pot €0.15 | Rake €0 
Board [7h 9d Qc 3c Tc]
Seat 1: Fengjie82 (button) folded before Flop (didn't bet)
Seat 2: outshined8 (small blind) folded before Flop
Seat 3: sanvito2106 (big blind) showed [7c 8d] and won (€0.15) with a pair of Sevens
Seat 4: tigermiscio folded before Flop (didn't bet)
Seat 5: caduceus369 folded before Flop (didn't bet)
Seat 6: ADRIAN0_MEIS mucked [Ah Jd]



PokerStars Zoom Hand #257988321922:  Hold'em No Limit (€0.01/€0.02) [ADM ID: M62BA304494E32ST] - 2025/10/03 23:52:27 CET [2025/10/03 17:52:27 ET]
Table 'Sirio' 6-max Seat #1 is the button
Seat 1: maury999999 (€3.29 in chips) 
Seat 2: caduceus369 (€2.45 in chips) 
Seat 3: Sium12302 (€6.28 in chips) 
Seat 4: Gigo373 (€0.76 in chips) 
Seat 5: xxcash88 (€1.99 in chips) 
Seat 6: stevalmg (€2.04 in chips) 
caduceus369: posts small blind €0.01
Sium12302: posts big blind €0.02
*** HOLE CARDS ***
Dealt to caduceus369 [3h 9h]
Gigo373: calls €0.02
xxcash88: folds 
stevalmg: raises €0.07 to €0.09
maury999999: folds 
caduceus369: folds 
Sium12302: folds 
Gigo373: folds 
Uncalled bet (€0.07) returned to stevalmg
stevalmg collected €0.07 from pot
stevalmg: doesn't show hand 
*** SUMMARY ***
Total pot €0.07 | Rake €0 
Seat 1: maury999999 (button) folded before Flop (didn't bet)
Seat 2: caduceus369 (small blind) folded before Flop
Seat 3: Sium12302 (big blind) folded before Flop
Seat 4: Gigo373 folded before Flop
Seat 5: xxcash88 folded before Flop (didn't bet)
Seat 6: stevalmg collected (€0.07)



PokerStars Zoom Hand #257988323318:  Hold'em No Limit (€0.01/€0.02) [ADM ID: M62BA304494E32ST] - 2025/10/03 23:52:34 CET [2025/10/03 17:52:34 ET]
Table 'Sirio' 6-max Seat #1 is the button
Seat 1: caduceus369 (€2.44 in chips) 
Seat 2: CacciatoreAA (€1.47 in chips) 
Seat 3: ivano747 (€2.35 in chips) 
Seat 4: ADRIAN0_MEIS (€7.87 in chips) 
Seat 5: Gabrielefante (€3.23 in chips) 
Seat 6: Catania838 (€1.91 in chips) 
CacciatoreAA: posts small blind €0.01
ivano747: posts big blind €0.02
*** HOLE CARDS ***
Dealt to caduceus369 [8h Ac]
ADRIAN0_MEIS: folds 
Gabrielefante: folds 
Catania838: calls €0.02
caduceus369: folds 
CacciatoreAA: raises €0.16 to €0.18
ivano747: folds 
Catania838: folds 
Uncalled bet (€0.16) returned to CacciatoreAA
CacciatoreAA collected €0.06 from pot
CacciatoreAA: doesn't show hand 
*** SUMMARY ***
Total pot €0.06 | Rake €0 
Seat 1: caduceus369 (button) folded before Flop (didn't bet)
Seat 2: CacciatoreAA (small blind) collected (€0.06)
Seat 3: ivano747 (big blind) folded before Flop
Seat 4: ADRIAN0_MEIS folded before Flop (didn't bet)
Seat 5: Gabrielefante folded before Flop (didn't bet)
Seat 6: Catania838 folded before Flop



PokerStars Zoom Hand #257988326873:  Hold'em No Limit (€0.01/€0.02) [ADM ID: M62BA304494E32ST] - 2025/10/03 23:52:49 CET [2025/10/03 17:52:49 ET]
Table 'Sirio' 6-max Seat #1 is the button
Seat 1: max24428 (€1.51 in chips) 
Seat 2: maury999999 (€3.29 in chips) 
Seat 3: stfuplzudonk (€4.29 in chips) 
Seat 4: ADRIAN0_MEIS (€7.85 in chips) 
Seat 5: michy0757 (€0.69 in chips) 
Seat 6: caduceus369 (€2.44 in chips) 
maury999999: posts small blind €0.01
stfuplzudonk: posts big blind €0.02
*** HOLE CARDS ***
Dealt to caduceus369 [3h 4c]
ADRIAN0_MEIS: folds 
michy0757: raises €0.02 to €0.04
caduceus369: folds 
max24428: folds 
maury999999: folds 
stfuplzudonk: folds 
Uncalled bet (€0.02) returned to michy0757
michy0757 collected €0.05 from pot
michy0757: doesn't show hand 
*** SUMMARY ***
Total pot €0.05 | Rake €0 
Seat 1: max24428 (button) folded before Flop (didn't bet)
Seat 2: maury999999 (small blind) folded before Flop
Seat 3: stfuplzudonk (big blind) folded before Flop
Seat 4: ADRIAN0_MEIS folded before Flop (didn't bet)
Seat 5: michy0757 collected (€0.05)
Seat 6: caduceus369 folded before Flop (didn't bet)



PokerStars Zoom Hand #257988327859:  Hold'em No Limit (€0.01/€0.02) [ADM ID: M62BA304494E32ST] - 2025/10/03 23:52:54 CET [2025/10/03 17:52:54 ET]
Table 'Sirio' 6-max Seat #1 is the button
Seat 1: caduceus369 (€2.44 in chips) 
Seat 2: father2008 (€5 in chips) 
Seat 3: robertoH2O (€2.22 in chips) 
Seat 4: ivano747 (€3.82 in chips) 
Seat 5: Peru91j (€2.14 in chips) 
Seat 6: max24428 (€1.51 in chips) 
father2008: posts small blind €0.01
robertoH2O: posts big blind €0.02
*** HOLE CARDS ***
Dealt to caduceus369 [Td 3d]
ivano747: folds 
Peru91j: raises €0.04 to €0.06
max24428: calls €0.06
caduceus369: folds 
father2008: folds 
robertoH2O: calls €0.04
*** FLOP *** [Qh 5h 9s]
robertoH2O: checks 
Peru91j: checks 
max24428: checks 
*** TURN *** [Qh 5h 9s] [2c]
robertoH2O: bets €0.07
Peru91j: folds 
max24428: calls €0.07
*** RIVER *** [Qh 5h 9s 2c] [Ks]
robertoH2O: bets €0.14
max24428: calls €0.14
*** SHOW DOWN ***
robertoH2O: shows [Jd Kd] (a pair of Kings)
max24428: mucks hand 
robertoH2O collected €0.58 from pot
*** SUMMARY ***
Total pot €0.61 | Rake €0.03 
Board [Qh 5h 9s 2c Ks]
Seat 1: caduceus369 (button) folded before Flop (didn't bet)
Seat 2: father2008 (small blind) folded before Flop
Seat 3: robertoH2O (big blind) showed [Jd Kd] and won (€0.58) with a pair of Kings
Seat 4: ivano747 folded before Flop (didn't bet)
Seat 5: Peru91j folded on the Turn
Seat 6: max24428 mucked [Th Kh]



PokerStars Zoom Hand #257988329648:  Hold'em No Limit (€0.01/€0.02) [ADM ID: M62BA304494E32ST] - 2025/10/03 23:53:01 CET [2025/10/03 17:53:01 ET]
Table 'Sirio' 6-max Seat #1 is the button
Seat 1: Davi3231973 (€0.77 in chips) 
Seat 2: Sium12302 (€2 in chips) 
Seat 3: caduceus369 (€2.44 in chips) 
Seat 4: ADRIAN0_MEIS (€7.85 in chips) 
Seat 5: criptlux (€2.20 in chips) 
Seat 6: EasyToRule (€4.62 in chips) 
Sium12302: posts small blind €0.01
caduceus369: posts big blind €0.02
*** HOLE CARDS ***
Dealt to caduceus369 [2d Td]
ADRIAN0_MEIS: folds 
criptlux: folds 
EasyToRule: folds 
Davi3231973: calls €0.02
Sium12302: folds 
caduceus369: checks 
*** FLOP *** [9c 4s 5c]
caduceus369: checks 
Davi3231973: checks 
*** TURN *** [9c 4s 5c] [Ts]
caduceus369: bets €0.02
Davi3231973: folds 
Uncalled bet (€0.02) returned to caduceus369
caduceus369 collected €0.05 from pot
caduceus369: doesn't show hand 
*** SUMMARY ***
Total pot €0.05 | Rake €0 
Board [9c 4s 5c Ts]
Seat 1: Davi3231973 (button) folded on the Turn
Seat 2: Sium12302 (small blind) folded before Flop
Seat 3: caduceus369 (big blind) collected (€0.05)
Seat 4: ADRIAN0_MEIS folded before Flop (didn't bet)
Seat 5: criptlux folded before Flop (didn't bet)
Seat 6: EasyToRule folded before Flop (didn't bet)



PokerStars Zoom Hand #257988337604:  Hold'em No Limit (€0.01/€0.02) [ADM ID: M62BA304494E32ST] - 2025/10/03 23:53:37 CET [2025/10/03 17:53:37 ET]
Table 'Sirio' 6-max Seat #1 is the button
Seat 1: tigermiscio (€0.72 in chips) 
Seat 2: Peru91j (€2.01 in chips) 
Seat 3: michy0757 (€0.77 in chips) 
Seat 4: Gabrielefante (€3.20 in chips) 
Seat 5: caduceus369 (€2.47 in chips) 
Seat 6: EasyToRule (€2.58 in chips) 
Peru91j: posts small blind €0.01
michy0757: posts big blind €0.02
*** HOLE CARDS ***
Dealt to caduceus369 [Kh Jh]
Gabrielefante: folds 
caduceus369: raises €0.04 to €0.06
EasyToRule: folds 
tigermiscio: folds 
Peru91j: folds 
michy0757: calls €0.04
*** FLOP *** [8h Ah Qd]
michy0757: checks 
caduceus369: bets €0.07
michy0757: folds 
Uncalled bet (€0.07) returned to caduceus369
caduceus369 collected €0.13 from pot
caduceus369: doesn't show hand 
*** SUMMARY ***
Total pot €0.13 | Rake €0 
Board [8h Ah Qd]
Seat 1: tigermiscio (button) folded before Flop (didn't bet)
Seat 2: Peru91j (small blind) folded before Flop
Seat 3: michy0757 (big blind) folded on the Flop
Seat 4: Gabrielefante folded before Flop (didn't bet)
Seat 5: caduceus369 collected (€0.13)
Seat 6: EasyToRule folded before Flop (didn't bet)



PokerStars Zoom Hand #257988343713:  Hold'em No Limit (€0.01/€0.02) [ADM ID: M62BA304494E32ST] - 2025/10/03 23:54:03 CET [2025/10/03 17:54:03 ET]
Table 'Sirio' 6-max Seat #1 is the button
Seat 1: Witness85906 (€5.20 in chips) 
Seat 2: caduceus369 (€2.54 in chips) 
Seat 3: criptlux (€2.21 in chips) 
Seat 4: father2008 (€4.97 in chips) 
Seat 5: cap e'bomb95 (€2.28 in chips) 
Seat 6: maury999999 (€3.30 in chips) 
caduceus369: posts small blind €0.01
criptlux: posts big blind €0.02
*** HOLE CARDS ***
Dealt to caduceus369 [6s Ks]
father2008: folds 
cap e'bomb95: folds 
maury999999: folds 
Witness85906: folds 
caduceus369: folds 
Uncalled bet (€0.01) returned to criptlux
criptlux collected €0.02 from pot
criptlux: doesn't show hand 
*** SUMMARY ***
Total pot €0.02 | Rake €0 
Seat 1: Witness85906 (button) folded before Flop (didn't bet)
Seat 2: caduceus369 (small blind) folded before Flop
Seat 3: criptlux (big blind) collected (€0.02)
Seat 4: father2008 folded before Flop (didn't bet)
Seat 5: cap e'bomb95 folded before Flop (didn't bet)
Seat 6: maury999999 folded before Flop (didn't bet)



PokerStars Zoom Hand #257988348527:  Hold'em No Limit (€0.01/€0.02) [ADM ID: M62BA304494E32ST] - 2025/10/03 23:54:25 CET [2025/10/03 17:54:25 ET]
Table 'Sirio' 6-max Seat #1 is the button
Seat 1: Ceribelli1705 (€0.74 in chips) 
Seat 2: Catania838 (€2.30 in chips) 
Seat 3: criptlux (€2.34 in chips) 
Seat 4: caduceus369 (€2.53 in chips) 
Seat 5: fantaasso (€2.49 in chips) 
Seat 6: stfuplzudonk (€4.14 in chips) 
Catania838: posts small blind €0.01
criptlux: posts big blind €0.02
*** HOLE CARDS ***
Dealt to caduceus369 [6s 7s]
caduceus369: folds 
fantaasso: folds 
stfuplzudonk: raises €0.02 to €0.04
Ceribelli1705: calls €0.04
Catania838: folds 
criptlux: folds 
*** FLOP *** [Kh 8h Tc]
stfuplzudonk: bets €0.06
Ceribelli1705: folds 
Uncalled bet (€0.06) returned to stfuplzudonk
stfuplzudonk collected €0.11 from pot
stfuplzudonk: doesn't show hand 
*** SUMMARY ***
Total pot €0.11 | Rake €0 
Board [Kh 8h Tc]
Seat 1: Ceribelli1705 (button) folded on the Flop
Seat 2: Catania838 (small blind) folded before Flop
Seat 3: criptlux (big blind) folded before Flop
Seat 4: caduceus369 folded before Flop (didn't bet)
Seat 5: fantaasso folded before Flop (didn't bet)
Seat 6: stfuplzudonk collected (€0.11)



PokerStars Zoom Hand #257988349778:  Hold'em No Limit (€0.01/€0.02) [ADM ID: M62BA304494E32ST] - 2025/10/03 23:54:30 CET [2025/10/03 17:54:30 ET]
Table 'Sirio' 6-max Seat #1 is the button
Seat 1: EasyToRule (€2.52 in chips) 
Seat 2: bruciapelo (€1.42 in chips) 
Seat 3: kAllSeMPRE73 (€0.81 in chips) 
Seat 4: fantaasso (€2.49 in chips) 
Seat 5: cap e'bomb95 (€2.26 in chips) 
Seat 6: caduceus369 (€2.53 in chips) 
bruciapelo: posts small blind €0.01
kAllSeMPRE73: posts big blind €0.02
*** HOLE CARDS ***
Dealt to caduceus369 [Jc 2h]
fantaasso: folds 
cap e'bomb95: raises €0.03 to €0.05
caduceus369: folds 
EasyToRule: folds 
bruciapelo: folds 
kAllSeMPRE73: raises €0.76 to €0.81 and is all-in
cap e'bomb95: calls €0.76
*** FLOP *** [Jh 6s 4h]
*** TURN *** [Jh 6s 4h] [7s]
*** RIVER *** [Jh 6s 4h 7s] [Th]
*** SHOW DOWN ***
kAllSeMPRE73: shows [8s Qh] (high card Queen)
cap e'bomb95: shows [As Js] (a pair of Jacks)
cap e'bomb95 collected €1.55 from pot
*** SUMMARY ***
Total pot €1.63 | Rake €0.08 
Board [Jh 6s 4h 7s Th]
Seat 1: EasyToRule (button) folded before Flop (didn't bet)
Seat 2: bruciapelo (small blind) folded before Flop
Seat 3: kAllSeMPRE73 (big blind) showed [8s Qh] and lost with high card Queen
Seat 4: fantaasso folded before Flop (didn't bet)
Seat 5: cap e'bomb95 showed [As Js] and won (€1.55) with a pair of Jacks
Seat 6: caduceus369 folded before Flop (didn't bet)



PokerStars Zoom Hand #257988352674:  Hold'em No Limit (€0.01/€0.02) [ADM ID: M62BA304494E32ST] - 2025/10/03 23:54:43 CET [2025/10/03 17:54:43 ET]
Table 'Sirio' 6-max Seat #1 is the button
Seat 1: fantaasso (€2.48 in chips) 
Seat 2: macchia1010 (€0.97 in chips) 
Seat 3: CacciatoreAA (€1.49 in chips) 
Seat 4: Gigo373 (€1.23 in chips) 
Seat 5: caduceus369 (€2.53 in chips) 
Seat 6: bruciapelo (€1.41 in chips) 
macchia1010: posts small blind €0.01
CacciatoreAA: posts big blind €0.02
*** HOLE CARDS ***
Dealt to caduceus369 [7s 7h]
Gigo373: folds 
caduceus369: raises €0.04 to €0.06
bruciapelo: folds 
fantaasso: folds 
macchia1010: calls €0.05
CacciatoreAA: folds 
*** FLOP *** [3s 8d 9h]
macchia1010: checks 
caduceus369: bets €0.07
macchia1010: folds 
Uncalled bet (€0.07) returned to caduceus369
caduceus369 collected €0.14 from pot
caduceus369: doesn't show hand 
*** SUMMARY ***
Total pot €0.14 | Rake €0 
Board [3s 8d 9h]
Seat 1: fantaasso (button) folded before Flop (didn't bet)
Seat 2: macchia1010 (small blind) folded on the Flop
Seat 3: CacciatoreAA (big blind) folded before Flop
Seat 4: Gigo373 folded before Flop (didn't bet)
Seat 5: caduceus369 collected (€0.14)
Seat 6: bruciapelo folded before Flop (didn't bet)



PokerStars Zoom Hand #257988359200:  Hold'em No Limit (€0.01/€0.02) [ADM ID: M62BA304494E32ST] - 2025/10/03 23:55:16 CET [2025/10/03 17:55:16 ET]
Table 'Sirio' 6-max Seat #1 is the button
Seat 1: teicano98 (€0.82 in chips) 
Seat 2: outshined8 (€0.71 in chips) 
Seat 3: caduceus369 (€2.61 in chips) 
Seat 4: father2008 (€5 in chips) 
Seat 5: VrDmNl (€1.07 in chips) 
Seat 6: ADRIAN0_MEIS (€11.58 in chips) 
outshined8: posts small blind €0.01
caduceus369: posts big blind €0.02
*** HOLE CARDS ***
Dealt to caduceus369 [2d Qd]
father2008: folds 
VrDmNl: folds 
ADRIAN0_MEIS: folds 
teicano98: folds 
outshined8: folds 
Uncalled bet (€0.01) returned to caduceus369
caduceus369 collected €0.02 from pot
caduceus369: doesn't show hand 
*** SUMMARY ***
Total pot €0.02 | Rake €0 
Seat 1: teicano98 (button) folded before Flop (didn't bet)
Seat 2: outshined8 (small blind) folded before Flop
Seat 3: caduceus369 (big blind) collected (€0.02)
Seat 4: father2008 folded before Flop (didn't bet)
Seat 5: VrDmNl folded before Flop (didn't bet)
Seat 6: ADRIAN0_MEIS folded before Flop (didn't bet)



PokerStars Zoom Hand #257988360925:  Hold'em No Limit (€0.01/€0.02) [ADM ID: M62BA304494E32ST] - 2025/10/03 23:55:26 CET [2025/10/03 17:55:26 ET]
Table 'Sirio' 6-max Seat #1 is the button
Seat 1: caduceus369 (€2.62 in chips) 
Seat 2: neoilnervoso (€1.74 in chips) 
Seat 3: Peru91j (€2.03 in chips) 
Seat 4: Catania838 (€1.72 in chips) 
Seat 5: Sium12302 (€6.20 in chips) 
Seat 6: max24428 (€0.87 in chips) 
neoilnervoso: posts small blind €0.01
Peru91j: posts big blind €0.02
*** HOLE CARDS ***
Dealt to caduceus369 [Kc Ac]
Catania838: folds 
Sium12302: folds 
max24428: folds 
caduceus369: raises €0.04 to €0.06
neoilnervoso: folds 
Peru91j: folds 
Uncalled bet (€0.04) returned to caduceus369
caduceus369 collected €0.05 from pot
caduceus369: doesn't show hand 
*** SUMMARY ***
Total pot €0.05 | Rake €0 
Seat 1: caduceus369 (button) collected (€0.05)
Seat 2: neoilnervoso (small blind) folded before Flop
Seat 3: Peru91j (big blind) folded before Flop
Seat 4: Catania838 folded before Flop (didn't bet)
Seat 5: Sium12302 folded before Flop (didn't bet)
Seat 6: max24428 folded before Flop (didn't bet)



PokerStars Zoom Hand #257988367360:  Hold'em No Limit (€0.01/€0.02) [ADM ID: M62BA304494E32ST] - 2025/10/03 23:56:05 CET [2025/10/03 17:56:05 ET]
Table 'Sirio' 6-max Seat #1 is the button
Seat 1: ADRIAN0_MEIS (€2.30 in chips) 
Seat 2: Sium12302 (€6.20 in chips) 
Seat 3: CacciatoreAA (€1.45 in chips) 
Seat 4: stfuplzudonk (€2.07 in chips) 
Seat 5: fantaasso (€3.28 in chips) 
Seat 6: caduceus369 (€2.64 in chips) 
Sium12302: posts small blind €0.01
CacciatoreAA: posts big blind €0.02
*** HOLE CARDS ***
Dealt to caduceus369 [Ah Tc]
stfuplzudonk: folds 
fantaasso: folds 
caduceus369: raises €0.04 to €0.06
ADRIAN0_MEIS: folds 
Sium12302: folds 
CacciatoreAA: folds 
Uncalled bet (€0.04) returned to caduceus369
caduceus369 collected €0.05 from pot
caduceus369: doesn't show hand 
*** SUMMARY ***
Total pot €0.05 | Rake €0 
Seat 1: ADRIAN0_MEIS (button) folded before Flop (didn't bet)
Seat 2: Sium12302 (small blind) folded before Flop
Seat 3: CacciatoreAA (big blind) folded before Flop
Seat 4: stfuplzudonk folded before Flop (didn't bet)
Seat 5: fantaasso folded before Flop (didn't bet)
Seat 6: caduceus369 collected (€0.05)



PokerStars Zoom Hand #257988366378:  Hold'em No Limit (€0.01/€0.02) [ADM ID: M62BA304494E32ST] - 2025/10/03 23:56:00 CET [2025/10/03 17:56:00 ET]
Table 'Sirio' 6-max Seat #1 is the button
Seat 1: Adamo55222 (€1.01 in chips) 
Seat 2: bruciapelo (€1.67 in chips) 
Seat 3: fantaasso (€2.48 in chips) 
Seat 4: caduceus369 (€2.64 in chips) 
Seat 5: xxcash88 (€2 in chips) 
Seat 6: Catania838 (€2.03 in chips) 
bruciapelo: posts small blind €0.01
fantaasso: posts big blind €0.02
*** HOLE CARDS ***
Dealt to caduceus369 [9h Ad]
caduceus369: folds 
xxcash88: folds 
Catania838: folds 
Adamo55222: calls €0.02
bruciapelo: folds 
fantaasso: checks 
*** FLOP *** [Jc 6c 7h]
fantaasso: checks 
Adamo55222: checks 
*** TURN *** [Jc 6c 7h] [2s]
fantaasso: checks 
Adamo55222: checks 
*** RIVER *** [Jc 6c 7h 2s] [6d]
fantaasso: checks 
Adamo55222: checks 
*** SHOW DOWN ***
fantaasso: shows [Kh Td] (a pair of Sixes)
Adamo55222: shows [3h As] (a pair of Sixes - Ace kicker)
Adamo55222 collected €0.05 from pot
*** SUMMARY ***
Total pot €0.05 | Rake €0 
Board [Jc 6c 7h 2s 6d]
Seat 1: Adamo55222 (button) showed [3h As] and won (€0.05) with a pair of Sixes
Seat 2: bruciapelo (small blind) folded before Flop
Seat 3: fantaasso (big blind) showed [Kh Td] and lost with a pair of Sixes
Seat 4: caduceus369 folded before Flop (didn't bet)
Seat 5: xxcash88 folded before Flop (didn't bet)
Seat 6: Catania838 folded before Flop (didn't bet)



PokerStars Zoom Hand #257988364347:  Hold'em No Limit (€0.01/€0.02) [ADM ID: M62BA304494E32ST] - 2025/10/03 23:55:47 CET [2025/10/03 17:55:47 ET]
Table 'Sirio' 6-max Seat #1 is the button
Seat 1: Peru91j (€3.25 in chips) 
Seat 2: caduceus369 (€2.65 in chips) 
Seat 3: neoilnervoso (€1.73 in chips) 
Seat 4: cap e'bomb95 (€5.03 in chips) 
Seat 5: criptlux (€2.19 in chips) 
Seat 6: teicano98 (€0.92 in chips) 
caduceus369: posts small blind €0.01
neoilnervoso: posts big blind €0.02
*** HOLE CARDS ***
Dealt to caduceus369 [4d 7c]
cap e'bomb95: folds 
criptlux: folds 
teicano98: raises €0.02 to €0.04
Peru91j: calls €0.04
caduceus369: folds 
neoilnervoso: calls €0.02
*** FLOP *** [Kd 8s Jh]
neoilnervoso: checks 
teicano98: checks 
Peru91j: checks 
*** TURN *** [Kd 8s Jh] [3s]
neoilnervoso: bets €0.06
teicano98: calls €0.06
Peru91j: folds 
*** RIVER *** [Kd 8s Jh 3s] [5c]
neoilnervoso: bets €0.06
teicano98: folds 
Uncalled bet (€0.06) returned to neoilnervoso
neoilnervoso collected €0.24 from pot
neoilnervoso: doesn't show hand 
*** SUMMARY ***
Total pot €0.25 | Rake €0.01 
Board [Kd 8s Jh 3s 5c]
Seat 1: Peru91j (button) folded on the Turn
Seat 2: caduceus369 (small blind) folded before Flop
Seat 3: neoilnervoso (big blind) collected (€0.24)
Seat 4: cap e'bomb95 folded before Flop (didn't bet)
Seat 5: criptlux folded before Flop (didn't bet)
Seat 6: teicano98 folded on the River



PokerStars Zoom Hand #257988365317:  Hold'em No Limit (€0.01/€0.02) [ADM ID: M62BA304494E32ST] - 2025/10/03 23:55:53 CET [2025/10/03 17:55:53 ET]
Table 'Sirio' 6-max Seat #1 is the button
Seat 1: Sium12302 (€6.20 in chips) 
Seat 2: stfuplzudonk (€4.23 in chips) 
Seat 3: ADRIAN0_MEIS (€7.78 in chips) 
Seat 4: Davi3231973 (€0.67 in chips) 
Seat 5: caduceus369 (€2.64 in chips) 
Seat 6: trillycata (€1 in chips) 
stfuplzudonk: posts small blind €0.01
ADRIAN0_MEIS: posts big blind €0.02
*** HOLE CARDS ***
Dealt to caduceus369 [9c 8s]
Davi3231973: calls €0.02
caduceus369: folds 
trillycata: calls €0.02
Sium12302: folds 
stfuplzudonk: calls €0.01
ADRIAN0_MEIS: checks 
*** FLOP *** [Ts Ad 2h]
stfuplzudonk: checks 
ADRIAN0_MEIS: checks 
Davi3231973: checks 
trillycata: bets €0.02
stfuplzudonk: raises €0.06 to €0.08
ADRIAN0_MEIS: folds 
Davi3231973: folds 
trillycata: calls €0.06
*** TURN *** [Ts Ad 2h] [Tc]
stfuplzudonk: bets €0.02
trillycata: calls €0.02
*** RIVER *** [Ts Ad 2h Tc] [Js]
stfuplzudonk: checks 
trillycata: checks 
*** SHOW DOWN ***
stfuplzudonk: shows [Th 2c] (a full house, Tens full of Deuces)
trillycata: mucks hand 
stfuplzudonk collected €0.27 from pot
*** SUMMARY ***
Total pot €0.28 | Rake €0.01 
Board [Ts Ad 2h Tc Js]
Seat 1: Sium12302 (button) folded before Flop (didn't bet)
Seat 2: stfuplzudonk (small blind) showed [Th 2c] and won (€0.27) with a full house, Tens full of Deuces
Seat 3: ADRIAN0_MEIS (big blind) folded on the Flop
Seat 4: Davi3231973 folded on the Flop
Seat 5: caduceus369 folded before Flop (didn't bet)
Seat 6: trillycata mucked [7s 2s]



PokerStars Zoom Hand #257988371063:  Hold'em No Limit (€0.01/€0.02) [ADM ID: M62BA304494E32ST] - 2025/10/03 23:56:28 CET [2025/10/03 17:56:28 ET]
Table 'Sirio' 6-max Seat #1 is the button
Seat 1: caduceus369 (€2.67 in chips) 
Seat 2: Catania838 (€2.89 in chips) 
Seat 3: teicano98 (€1.51 in chips) 
Seat 4: Adamo55222 (€1.04 in chips) 
Seat 5: stevalmg (€2.16 in chips) 
Seat 6: Fengjie82 (€2.60 in chips) 
Catania838: posts small blind €0.01
teicano98: posts big blind €0.02
*** HOLE CARDS ***
Dealt to caduceus369 [Qs 9s]
Adamo55222: calls €0.02
stevalmg: folds 
Fengjie82: folds 
caduceus369: calls €0.02
Catania838: folds 
teicano98: checks 
*** FLOP *** [9c Th 7s]
teicano98: checks 
Adamo55222: folds 
caduceus369: bets €0.02
teicano98: calls €0.02
*** TURN *** [9c Th 7s] [2h]
teicano98: checks 
caduceus369: bets €0.02
teicano98: calls €0.02
*** RIVER *** [9c Th 7s 2h] [3h]
teicano98: checks 
caduceus369: checks 
*** SHOW DOWN ***
teicano98: shows [Jc As] (high card Ace)
caduceus369: shows [Qs 9s] (a pair of Nines)
caduceus369 collected €0.15 from pot
*** SUMMARY ***
Total pot €0.15 | Rake €0 
Board [9c Th 7s 2h 3h]
Seat 1: caduceus369 (button) showed [Qs 9s] and won (€0.15) with a pair of Nines
Seat 2: Catania838 (small blind) folded before Flop
Seat 3: teicano98 (big blind) showed [Jc As] and lost with high card Ace
Seat 4: Adamo55222 folded on the Flop
Seat 5: stevalmg folded before Flop (didn't bet)
Seat 6: Fengjie82 folded before Flop (didn't bet)



PokerStars Zoom Hand #257988380571:  Hold'em No Limit (€0.01/€0.02) [ADM ID: M62BA304494E32ST] - 2025/10/03 23:57:25 CET [2025/10/03 17:57:25 ET]
Table 'Sirio' 6-max Seat #1 is the button
Seat 1: xxcash88 (€2.08 in chips) 
Seat 2: macchia1010 (€0.45 in chips) 
Seat 3: caduceus369 (€2.76 in chips) 
Seat 4: ADRIAN0_MEIS (€10.46 in chips) 
Seat 5: Ceribelli1705 (€0.68 in chips) 
Seat 6: Rg4bthtbt (€1.77 in chips) 
macchia1010: posts small blind €0.01
caduceus369: posts big blind €0.02
*** HOLE CARDS ***
Dealt to caduceus369 [8s 6h]
ADRIAN0_MEIS: folds 
Ceribelli1705: folds 
Rg4bthtbt: calls €0.02
xxcash88: folds 
macchia1010: folds 
caduceus369: checks 
*** FLOP *** [4d Ts Ks]
caduceus369: checks 
Rg4bthtbt: checks 
*** TURN *** [4d Ts Ks] [Jh]
caduceus369: checks 
Rg4bthtbt: checks 
*** RIVER *** [4d Ts Ks Jh] [4s]
caduceus369: bets €0.02
Rg4bthtbt: folds 
Uncalled bet (€0.02) returned to caduceus369
caduceus369 collected €0.05 from pot
caduceus369: doesn't show hand 
*** SUMMARY ***
Total pot €0.05 | Rake €0 
Board [4d Ts Ks Jh 4s]
Seat 1: xxcash88 (button) folded before Flop (didn't bet)
Seat 2: macchia1010 (small blind) folded before Flop
Seat 3: caduceus369 (big blind) collected (€0.05)
Seat 4: ADRIAN0_MEIS folded before Flop (didn't bet)
Seat 5: Ceribelli1705 folded before Flop (didn't bet)
Seat 6: Rg4bthtbt folded on the River



PokerStars Zoom Hand #257988386953:  Hold'em No Limit (€0.01/€0.02) [ADM ID: M62BA304494E32ST] - 2025/10/03 23:58:02 CET [2025/10/03 17:58:02 ET]
Table 'Sirio' 6-max Seat #1 is the button
Seat 1: Sium12302 (€6.13 in chips) 
Seat 2: caduceus369 (€2.79 in chips) 
Seat 3: Adamo55222 (€1 in chips) 
Seat 4: stfuplzudonk (€4.32 in chips) 
Seat 5: Witness85906 (€5.47 in chips) 
Seat 6: stevalmg (€2.13 in chips) 
caduceus369: posts small blind €0.01
Adamo55222: posts big blind €0.02
*** HOLE CARDS ***
Dealt to caduceus369 [Ts Td]
stfuplzudonk: raises €0.02 to €0.04
Witness85906: folds 
stevalmg: folds 
Sium12302: folds 
caduceus369: raises €0.10 to €0.14
Adamo55222: calls €0.12
stfuplzudonk: calls €0.10
*** FLOP *** [3h Kc 8h]
caduceus369: checks 
Adamo55222: checks 
stfuplzudonk: checks 
*** TURN *** [3h Kc 8h] [3s]
caduceus369: bets €0.22
Adamo55222: folds 
stfuplzudonk: folds 
Uncalled bet (€0.22) returned to caduceus369
caduceus369 collected €0.40 from pot
caduceus369: doesn't show hand 
*** SUMMARY ***
Total pot €0.42 | Rake €0.02 
Board [3h Kc 8h 3s]
Seat 1: Sium12302 (button) folded before Flop (didn't bet)
Seat 2: caduceus369 (small blind) collected (€0.40)
Seat 3: Adamo55222 (big blind) folded on the Turn
Seat 4: stfuplzudonk folded on the Turn
Seat 5: Witness85906 folded before Flop (didn't bet)
Seat 6: stevalmg folded before Flop (didn't bet)



PokerStars Zoom Hand #257988394786:  Hold'em No Limit (€0.01/€0.02) [ADM ID: M62BA304494E32ST] - 2025/10/03 23:58:48 CET [2025/10/03 17:58:48 ET]
Table 'Sirio' 6-max Seat #1 is the button
Seat 1: stfuplzudonk (€4.42 in chips) 
Seat 2: trillycata (€0.85 in chips) 
Seat 3: Freddy15081988 (€0.45 in chips) 
Seat 4: caduceus369 (€3.05 in chips) 
Seat 5: Davi3231973 (€0.99 in chips) 
Seat 6: Catania838 (€2.03 in chips) 
trillycata: posts small blind €0.01
Freddy15081988: posts big blind €0.02
*** HOLE CARDS ***
Dealt to caduceus369 [Js Ac]
caduceus369: raises €0.04 to €0.06
Davi3231973: calls €0.06
Catania838: folds 
stfuplzudonk: folds 
trillycata: calls €0.05
Freddy15081988: calls €0.04
*** FLOP *** [Kd 5h 2s]
trillycata: checks 
Freddy15081988: checks 
caduceus369: checks 
Davi3231973: checks 
*** TURN *** [Kd 5h 2s] [Qh]
trillycata: bets €0.02
Freddy15081988: folds 
caduceus369: calls €0.02
Davi3231973: calls €0.02
*** RIVER *** [Kd 5h 2s Qh] [Ad]
trillycata: checks 
caduceus369: bets €0.09
Davi3231973: calls €0.09
trillycata: folds 
*** SHOW DOWN ***
caduceus369: shows [Js Ac] (a pair of Aces)
Davi3231973: mucks hand 
caduceus369 collected €0.46 from pot
*** SUMMARY ***
Total pot €0.48 | Rake €0.02 
Board [Kd 5h 2s Qh Ad]
Seat 1: stfuplzudonk (button) folded before Flop (didn't bet)
Seat 2: trillycata (small blind) folded on the River
Seat 3: Freddy15081988 (big blind) folded on the Turn
Seat 4: caduceus369 showed [Js Ac] and won (€0.46) with a pair of Aces
Seat 5: Davi3231973 mucked [Qd Jd]
Seat 6: Catania838 folded before Flop (didn't bet)



PokerStars Zoom Hand #257988409447:  Hold'em No Limit (€0.01/€0.02) [ADM ID: M62BA304494E32ST] - 2025/10/04 0:00:15 CET [2025/10/03 18:00:15 ET]
Table 'Sirio' 6-max Seat #1 is the button
Seat 1: Peru91j (€3.13 in chips) 
Seat 2: cap e'bomb95 (€5.60 in chips) 
Seat 3: Catania838 (€2.02 in chips) 
Seat 4: Fengjie82 (€2.74 in chips) 
Seat 5: criptlux (€2.16 in chips) 
Seat 6: caduceus369 (€3.34 in chips) 
cap e'bomb95: posts small blind €0.01
Catania838: posts big blind €0.02
*** HOLE CARDS ***
Dealt to caduceus369 [Ts 8c]
Fengjie82: folds 
criptlux: folds 
caduceus369: folds 
Peru91j: raises €0.04 to €0.06
cap e'bomb95: folds 
Catania838: folds 
Uncalled bet (€0.04) returned to Peru91j
Peru91j collected €0.05 from pot
Peru91j: doesn't show hand 
*** SUMMARY ***
Total pot €0.05 | Rake €0 
Seat 1: Peru91j (button) collected (€0.05)
Seat 2: cap e'bomb95 (small blind) folded before Flop
Seat 3: Catania838 (big blind) folded before Flop
Seat 4: Fengjie82 folded before Flop (didn't bet)
Seat 5: criptlux folded before Flop (didn't bet)
Seat 6: caduceus369 folded before Flop (didn't bet)



PokerStars Zoom Hand #257988410962:  Hold'em No Limit (€0.01/€0.02) [ADM ID: M62BA304494E32ST] - 2025/10/04 0:00:23 CET [2025/10/03 18:00:23 ET]
Table 'Sirio' 6-max Seat #1 is the button
Seat 1: outshined8 (€1.12 in chips) 
Seat 2: cesaretto23 (€1.91 in chips) 
Seat 3: caduceus369 (€3.34 in chips) 
Seat 4: CacciatoreAA (€3.28 in chips) 
Seat 5: Witness85906 (€5.12 in chips) 
Seat 6: macchia1010 (€0.20 in chips) 
cesaretto23: posts small blind €0.01
caduceus369: posts big blind €0.02
*** HOLE CARDS ***
Dealt to caduceus369 [Qh 6s]
CacciatoreAA: folds 
Witness85906: folds 
macchia1010: folds 
outshined8: folds 
cesaretto23: calls €0.01
caduceus369: checks 
*** FLOP *** [Ac Ah 8h]
cesaretto23: bets €0.10
caduceus369: folds 
Uncalled bet (€0.10) returned to cesaretto23
cesaretto23 collected €0.04 from pot
cesaretto23: doesn't show hand 
*** SUMMARY ***
Total pot €0.04 | Rake €0 
Board [Ac Ah 8h]
Seat 1: outshined8 (button) folded before Flop (didn't bet)
Seat 2: cesaretto23 (small blind) collected (€0.04)
Seat 3: caduceus369 (big blind) folded on the Flop
Seat 4: CacciatoreAA folded before Flop (didn't bet)
Seat 5: Witness85906 folded before Flop (didn't bet)
Seat 6: macchia1010 folded before Flop (didn't bet)



PokerStars Zoom Hand #257988407352:  Hold'em No Limit (€0.01/€0.02) [ADM ID: M62BA304494E32ST] - 2025/10/04 0:00:03 CET [2025/10/03 18:00:03 ET]
Table 'Sirio' 6-max Seat #1 is the button
Seat 1: irenuccia33 (€2.90 in chips) 
Seat 2: CacciatoreAA (€3.28 in chips) 
Seat 3: macchia1010 (€0.22 in chips) 
Seat 4: Catania838 (€1.47 in chips) 
Seat 5: caduceus369 (€3.34 in chips) 
Seat 6: ADRIAN0_MEIS (€10.50 in chips) 
CacciatoreAA: posts small blind €0.01
macchia1010: posts big blind €0.02
*** HOLE CARDS ***
Dealt to caduceus369 [As 5d]
Catania838: calls €0.02
caduceus369: folds 
ADRIAN0_MEIS: raises €0.05 to €0.07
irenuccia33 has timed out
irenuccia33: folds 
CacciatoreAA: folds 
macchia1010: folds 
Catania838: calls €0.05
*** FLOP *** [Qh 7h 7s]
Catania838: checks 
ADRIAN0_MEIS: bets €0.09
Catania838: calls €0.09
*** TURN *** [Qh 7h 7s] [3d]
Catania838: checks 
ADRIAN0_MEIS: checks 
*** RIVER *** [Qh 7h 7s 3d] [Td]
Catania838: bets €0.34
ADRIAN0_MEIS: folds 
Uncalled bet (€0.34) returned to Catania838
Catania838 collected €0.34 from pot
Catania838: doesn't show hand 
*** SUMMARY ***
Total pot €0.35 | Rake €0.01 
Board [Qh 7h 7s 3d Td]
Seat 1: irenuccia33 (button) folded before Flop (didn't bet)
Seat 2: CacciatoreAA (small blind) folded before Flop
Seat 3: macchia1010 (big blind) folded before Flop
Seat 4: Catania838 collected (€0.34)
Seat 5: caduceus369 folded before Flop (didn't bet)
Seat 6: ADRIAN0_MEIS folded on the River



PokerStars Zoom Hand #257988415954:  Hold'em No Limit (€0.01/€0.02) [ADM ID: M62BA304494E32ST] - 2025/10/04 0:00:50 CET [2025/10/03 18:00:50 ET]
Table 'Sirio' 6-max Seat #1 is the button
Seat 1: xxcash88 (€2.06 in chips) 
Seat 2: IsyP99 (€0.72 in chips) 
Seat 3: LentaM3nte (€2 in chips) 
Seat 4: caduceus369 (€3.32 in chips) 
Seat 5: Adamo55222 (€0.90 in chips) 
Seat 6: michy0757 (€1.96 in chips) 
IsyP99: posts small blind €0.01
LentaM3nte: posts big blind €0.02
*** HOLE CARDS ***
Dealt to caduceus369 [9d 2h]
caduceus369: folds 
Adamo55222: folds 
michy0757: raises €0.11 to €0.13
xxcash88: folds 
IsyP99: calls €0.12
LentaM3nte: calls €0.11
*** FLOP *** [3c 8s 4c]
IsyP99: checks 
LentaM3nte: checks 
michy0757: checks 
*** TURN *** [3c 8s 4c] [5s]
IsyP99: checks 
LentaM3nte: checks 
michy0757: checks 
*** RIVER *** [3c 8s 4c 5s] [Js]
IsyP99: bets €0.37
LentaM3nte: folds 
michy0757: folds 
Uncalled bet (€0.37) returned to IsyP99
IsyP99 collected €0.37 from pot
IsyP99: doesn't show hand 
*** SUMMARY ***
Total pot €0.39 | Rake €0.02 
Board [3c 8s 4c 5s Js]
Seat 1: xxcash88 (button) folded before Flop (didn't bet)
Seat 2: IsyP99 (small blind) collected (€0.37)
Seat 3: LentaM3nte (big blind) folded on the River
Seat 4: caduceus369 folded before Flop (didn't bet)
Seat 5: Adamo55222 folded before Flop (didn't bet)
Seat 6: michy0757 folded on the River



PokerStars Zoom Hand #257988423119:  Hold'em No Limit (€0.01/€0.02) [ADM ID: M62BA304494E32ST] - 2025/10/04 0:01:25 CET [2025/10/03 18:01:25 ET]
Table 'Sirio' 6-max Seat #1 is the button
Seat 1: caduceus369 (€3.31 in chips) 
Seat 2: LentaM3nte (€1.87 in chips) 
Seat 3: ADRIAN0_MEIS (€3.30 in chips) 
Seat 4: cap e'bomb95 (€5.39 in chips) 
Seat 5: macchia1010 (€0.40 in chips) 
Seat 6: CacciatoreAA (€3.25 in chips) 
LentaM3nte: posts small blind €0.01
ADRIAN0_MEIS: posts big blind €0.02
*** HOLE CARDS ***
Dealt to caduceus369 [4d 2h]
cap e'bomb95: folds 
macchia1010: folds 
CacciatoreAA: folds 
caduceus369: folds 
LentaM3nte: folds 
Uncalled bet (€0.01) returned to ADRIAN0_MEIS
ADRIAN0_MEIS collected €0.02 from pot
ADRIAN0_MEIS: doesn't show hand 
*** SUMMARY ***
Total pot €0.02 | Rake €0 
Seat 1: caduceus369 (button) folded before Flop (didn't bet)
Seat 2: LentaM3nte (small blind) folded before Flop
Seat 3: ADRIAN0_MEIS (big blind) collected (€0.02)
Seat 4: cap e'bomb95 folded before Flop (didn't bet)
Seat 5: macchia1010 folded before Flop (didn't bet)
Seat 6: CacciatoreAA folded before Flop (didn't bet)



PokerStars Zoom Hand #257988423971:  Hold'em No Limit (€0.01/€0.02) [ADM ID: M62BA304494E32ST] - 2025/10/04 0:01:29 CET [2025/10/03 18:01:29 ET]
Table 'Sirio' 6-max Seat #1 is the button
Seat 1: macchia1010 (€0.40 in chips) 
Seat 2: father2008 (€4.50 in chips) 
Seat 3: IsyP99 (€0.96 in chips) 
Seat 4: caduceus369 (€3.31 in chips) 
Seat 5: CacciatoreAA (€3.25 in chips) 
Seat 6: franky65124 (€1.21 in chips) 
father2008: posts small blind €0.01
IsyP99: posts big blind €0.02
*** HOLE CARDS ***
Dealt to caduceus369 [5d 9d]
caduceus369: folds 
CacciatoreAA: folds 
franky65124: calls €0.02
macchia1010: folds 
father2008: folds 
IsyP99: checks 
*** FLOP *** [Ac Js Jh]
IsyP99: checks 
franky65124: bets €0.02
IsyP99: folds 
Uncalled bet (€0.02) returned to franky65124
franky65124 collected €0.05 from pot
franky65124: doesn't show hand 
*** SUMMARY ***
Total pot €0.05 | Rake €0 
Board [Ac Js Jh]
Seat 1: macchia1010 (button) folded before Flop (didn't bet)
Seat 2: father2008 (small blind) folded before Flop
Seat 3: IsyP99 (big blind) folded on the Flop
Seat 4: caduceus369 folded before Flop (didn't bet)
Seat 5: CacciatoreAA folded before Flop (didn't bet)
Seat 6: franky65124 collected (€0.05)



PokerStars Zoom Hand #257988419653:  Hold'em No Limit (€0.01/€0.02) [ADM ID: M62BA304494E32ST] - 2025/10/04 0:01:08 CET [2025/10/03 18:01:08 ET]
Table 'Sirio' 6-max Seat #1 is the button
Seat 1: trillycata (€0.83 in chips) 
Seat 2: caduceus369 (€3.32 in chips) 
Seat 3: cap e'bomb95 (€3.93 in chips) 
Seat 4: Catania838 (€1.77 in chips) 
Seat 5: bruciapelo (€1.28 in chips) 
Seat 6: Freddy15081988 (€0.09 in chips) 
caduceus369: posts small blind €0.01
cap e'bomb95: posts big blind €0.02
*** HOLE CARDS ***
Dealt to caduceus369 [8d Kc]
Catania838: folds 
bruciapelo: raises €0.04 to €0.06
Freddy15081988: folds 
trillycata: calls €0.06
caduceus369: folds 
cap e'bomb95: calls €0.04
*** FLOP *** [Kh 4c Ts]
cap e'bomb95: checks 
bruciapelo: bets €0.18
trillycata: raises €0.54 to €0.72
cap e'bomb95: folds 
bruciapelo: folds 
Uncalled bet (€0.54) returned to trillycata
trillycata collected €0.52 from pot
trillycata: doesn't show hand 
*** SUMMARY ***
Total pot €0.55 | Rake €0.03 
Board [Kh 4c Ts]
Seat 1: trillycata (button) collected (€0.52)
Seat 2: caduceus369 (small blind) folded before Flop
Seat 3: cap e'bomb95 (big blind) folded on the Flop
Seat 4: Catania838 folded before Flop (didn't bet)
Seat 5: bruciapelo folded on the Flop
Seat 6: Freddy15081988 folded before Flop (didn't bet)



PokerStars Zoom Hand #257988426425:  Hold'em No Limit (€0.01/€0.02) [ADM ID: M62BA304494E32ST] - 2025/10/04 0:01:41 CET [2025/10/03 18:01:41 ET]
Table 'Sirio' 6-max Seat #1 is the button
Seat 1: caduceus369 (€3.31 in chips) 
Seat 2: father2008 (€5.39 in chips) 
Seat 3: CacciatoreAA (€3.24 in chips) 
Seat 4: CIKO71131 (€0.51 in chips) 
Seat 5: fantaasso (€3.45 in chips) 
Seat 6: LentaM3nte (€1.86 in chips) 
father2008: posts small blind €0.01
CacciatoreAA: posts big blind €0.02
*** HOLE CARDS ***
Dealt to caduceus369 [Jc 3s]
CIKO71131: folds 
fantaasso: folds 
LentaM3nte: folds 
caduceus369: folds 
father2008: calls €0.01
CacciatoreAA: checks 
*** FLOP *** [9s 6d 4h]
father2008: bets €0.02
CacciatoreAA: folds 
Uncalled bet (€0.02) returned to father2008
father2008 collected €0.04 from pot
father2008: doesn't show hand 
*** SUMMARY ***
Total pot €0.04 | Rake €0 
Board [9s 6d 4h]
Seat 1: caduceus369 (button) folded before Flop (didn't bet)
Seat 2: father2008 (small blind) collected (€0.04)
Seat 3: CacciatoreAA (big blind) folded on the Flop
Seat 4: CIKO71131 folded before Flop (didn't bet)
Seat 5: fantaasso folded before Flop (didn't bet)
Seat 6: LentaM3nte folded before Flop (didn't bet)



PokerStars Zoom Hand #257988425563:  Hold'em No Limit (€0.01/€0.02) [ADM ID: M62BA304494E32ST] - 2025/10/04 0:01:37 CET [2025/10/03 18:01:37 ET]
Table 'Sirio' 6-max Seat #1 is the button
Seat 1: colosso2022 (€3.25 in chips) 
Seat 2: xxcash88 (€2 in chips) 
Seat 3: macchia1010 (€0.40 in chips) 
Seat 4: fantaasso (€3.45 in chips) 
Seat 5: caduceus369 (€3.31 in chips) 
Seat 6: father2008 (€4.49 in chips) 
xxcash88: posts small blind €0.01
macchia1010: posts big blind €0.02
*** HOLE CARDS ***
Dealt to caduceus369 [4c 7c]
fantaasso: folds 
caduceus369: folds 
father2008: raises €0.05 to €0.07
colosso2022: folds 
xxcash88: folds 
macchia1010: calls €0.05
*** FLOP *** [Qh 8s Qc]
macchia1010: checks 
father2008: checks 
*** TURN *** [Qh 8s Qc] [6c]
macchia1010: bets €0.02
father2008: calls €0.02
*** RIVER *** [Qh 8s Qc 6c] [8d]
macchia1010: checks 
father2008: checks 
*** SHOW DOWN ***
macchia1010: shows [9s Jh] (two pair, Queens and Eights)
father2008: shows [Tc Jc] (two pair, Queens and Eights)
macchia1010 collected €0.09 from pot
father2008 collected €0.09 from pot
*** SUMMARY ***
Total pot €0.19 | Rake €0.01 
Board [Qh 8s Qc 6c 8d]
Seat 1: colosso2022 (button) folded before Flop (didn't bet)
Seat 2: xxcash88 (small blind) folded before Flop
Seat 3: macchia1010 (big blind) showed [9s Jh] and won (€0.09) with two pair, Queens and Eights
Seat 4: fantaasso folded before Flop (didn't bet)
Seat 5: caduceus369 folded before Flop (didn't bet)
Seat 6: father2008 showed [Tc Jc] and won (€0.09) with two pair, Queens and Eights



PokerStars Zoom Hand #257988424981:  Hold'em No Limit (€0.01/€0.02) [ADM ID: M62BA304494E32ST] - 2025/10/04 0:01:34 CET [2025/10/03 18:01:34 ET]
Table 'Sirio' 6-max Seat #1 is the button
Seat 1: LentaM3nte (€1.86 in chips) 
Seat 2: cap e'bomb95 (€5.39 in chips) 
Seat 3: robertoH2O (€2 in chips) 
Seat 4: Adamo55222 (€0.88 in chips) 
Seat 5: ADRIAN0_MEIS (€12.38 in chips) 
Seat 6: caduceus369 (€3.31 in chips) 
cap e'bomb95: posts small blind €0.01
robertoH2O: posts big blind €0.02
*** HOLE CARDS ***
Dealt to caduceus369 [2d 9d]
Adamo55222: calls €0.02
ADRIAN0_MEIS: folds 
caduceus369: folds 
LentaM3nte: folds 
cap e'bomb95: folds 
robertoH2O: checks 
*** FLOP *** [8c 7d 6s]
robertoH2O: checks 
Adamo55222: checks 
*** TURN *** [8c 7d 6s] [5h]
robertoH2O: bets €0.03
Adamo55222: calls €0.03
*** RIVER *** [8c 7d 6s 5h] [9s]
robertoH2O: checks 
Adamo55222: bets €0.14
robertoH2O: folds 
Uncalled bet (€0.14) returned to Adamo55222
Adamo55222 collected €0.11 from pot
Adamo55222: doesn't show hand 
*** SUMMARY ***
Total pot €0.11 | Rake €0 
Board [8c 7d 6s 5h 9s]
Seat 1: LentaM3nte (button) folded before Flop (didn't bet)
Seat 2: cap e'bomb95 (small blind) folded before Flop
Seat 3: robertoH2O (big blind) folded on the River
Seat 4: Adamo55222 collected (€0.11)
Seat 5: ADRIAN0_MEIS folded before Flop (didn't bet)
Seat 6: caduceus369 folded before Flop (didn't bet)



PokerStars Zoom Hand #257988428886:  Hold'em No Limit (€0.01/€0.02) [ADM ID: M62BA304494E32ST] - 2025/10/04 0:01:52 CET [2025/10/03 18:01:52 ET]
Table 'Sirio' 6-max Seat #1 is the button
Seat 1: CIKO71131 (€0.51 in chips) 
Seat 2: ADRIAN0_MEIS (€10.38 in chips) 
Seat 3: caduceus369 (€3.31 in chips) 
Seat 4: criptlux (€2.12 in chips) 
Seat 5: EasyToRule (€4.95 in chips) 
Seat 6: xxcash88 (€1.99 in chips) 
ADRIAN0_MEIS: posts small blind €0.01
caduceus369: posts big blind €0.02
*** HOLE CARDS ***
Dealt to caduceus369 [Td Kd]
criptlux: folds 
EasyToRule: folds 
xxcash88: calls €0.02
CIKO71131: calls €0.02
ADRIAN0_MEIS: folds 
caduceus369: checks 
*** FLOP *** [6d 3h Ts]
caduceus369: checks 
xxcash88: checks 
CIKO71131: checks 
*** TURN *** [6d 3h Ts] [7h]
caduceus369: bets €0.02
xxcash88: folds 
CIKO71131: calls €0.02
*** RIVER *** [6d 3h Ts 7h] [2d]
caduceus369: bets €0.13
CIKO71131: folds 
Uncalled bet (€0.13) returned to caduceus369
caduceus369 collected €0.11 from pot
caduceus369: doesn't show hand 
*** SUMMARY ***
Total pot €0.11 | Rake €0 
Board [6d 3h Ts 7h 2d]
Seat 1: CIKO71131 (button) folded on the River
Seat 2: ADRIAN0_MEIS (small blind) folded before Flop
Seat 3: caduceus369 (big blind) collected (€0.11)
Seat 4: criptlux folded before Flop (didn't bet)
Seat 5: EasyToRule folded before Flop (didn't bet)
Seat 6: xxcash88 folded on the Turn



PokerStars Zoom Hand #257988438533:  Hold'em No Limit (€0.01/€0.02) [ADM ID: M62BA304494E32ST] - 2025/10/04 0:02:36 CET [2025/10/03 18:02:36 ET]
Table 'Sirio' 6-max Seat #1 is the button
Seat 1: franky65124 (€1.21 in chips) 
Seat 2: caduceus369 (€3.38 in chips) 
Seat 3: father2008 (€5.39 in chips) 
Seat 4: macchia1010 (€0.36 in chips) 
Seat 5: Catania838 (€2.88 in chips) 
Seat 6: LentaM3nte (€1.86 in chips) 
caduceus369: posts small blind €0.01
father2008: posts big blind €0.02
*** HOLE CARDS ***
Dealt to caduceus369 [6d 6h]
macchia1010: calls €0.02
Catania838: folds 
LentaM3nte: folds 
franky65124: calls €0.02
caduceus369: calls €0.01
father2008: checks 
*** FLOP *** [6s 8c 4d]
caduceus369: checks 
father2008: checks 
macchia1010: bets €0.06
franky65124: folds 
caduceus369: calls €0.06
father2008: calls €0.06
*** TURN *** [6s 8c 4d] [7c]
caduceus369: checks 
father2008: checks 
macchia1010: bets €0.06
caduceus369: calls €0.06
father2008: folds 
*** RIVER *** [6s 8c 4d 7c] [9s]
caduceus369: bets €0.10
macchia1010: folds 
Uncalled bet (€0.10) returned to caduceus369
caduceus369 collected €0.36 from pot
caduceus369: doesn't show hand 
*** SUMMARY ***
Total pot €0.38 | Rake €0.02 
Board [6s 8c 4d 7c 9s]
Seat 1: franky65124 (button) folded on the Flop
Seat 2: caduceus369 (small blind) collected (€0.36)
Seat 3: father2008 (big blind) folded on the Turn
Seat 4: macchia1010 folded on the River
Seat 5: Catania838 folded before Flop (didn't bet)
Seat 6: LentaM3nte folded before Flop (didn't bet)



PokerStars Zoom Hand #257988459263:  Hold'em No Limit (€0.01/€0.02) [ADM ID: M62BA304494E32ST] - 2025/10/04 0:04:10 CET [2025/10/03 18:04:10 ET]
Table 'Sirio' 6-max Seat #1 is the button
Seat 1: cesaretto23 (€2.08 in chips) 
Seat 2: LentaM3nte (€2.08 in chips) 
Seat 3: criptlux (€2.27 in chips) 
Seat 4: fantaasso (€4.04 in chips) 
Seat 5: Catania838 (€1.99 in chips) 
Seat 6: caduceus369 (€3.60 in chips) 
LentaM3nte: posts small blind €0.01
criptlux: posts big blind €0.02
*** HOLE CARDS ***
Dealt to caduceus369 [Qh 4c]
fantaasso: folds 
Catania838: folds 
caduceus369: folds 
cesaretto23: folds 
LentaM3nte: folds 
Uncalled bet (€0.01) returned to criptlux
criptlux collected €0.02 from pot
criptlux: doesn't show hand 
*** SUMMARY ***
Total pot €0.02 | Rake €0 
Seat 1: cesaretto23 (button) folded before Flop (didn't bet)
Seat 2: LentaM3nte (small blind) folded before Flop
Seat 3: criptlux (big blind) collected (€0.02)
Seat 4: fantaasso folded before Flop (didn't bet)
Seat 5: Catania838 folded before Flop (didn't bet)
Seat 6: caduceus369 folded before Flop (didn't bet)



PokerStars Zoom Hand #257988460306:  Hold'em No Limit (€0.01/€0.02) [ADM ID: M62BA304494E32ST] - 2025/10/04 0:04:15 CET [2025/10/03 18:04:15 ET]
Table 'Sirio' 6-max Seat #1 is the button
Seat 1: CacciatoreAA (€3.20 in chips) 
Seat 2: fantaasso (€4.04 in chips) 
Seat 3: Fengjie82 (€2.69 in chips) 
Seat 4: caduceus369 (€3.60 in chips) 
Seat 5: EasyToRule (€5.04 in chips) 
Seat 6: robertoH2O (€2 in chips) 
fantaasso: posts small blind €0.01
Fengjie82: posts big blind €0.02
*** HOLE CARDS ***
Dealt to caduceus369 [2h 8h]
caduceus369: folds 
EasyToRule: folds 
robertoH2O: folds 
CacciatoreAA: folds 
fantaasso: folds 
Uncalled bet (€0.01) returned to Fengjie82
Fengjie82 collected €0.02 from pot
Fengjie82: doesn't show hand 
*** SUMMARY ***
Total pot €0.02 | Rake €0 
Seat 1: CacciatoreAA (button) folded before Flop (didn't bet)
Seat 2: fantaasso (small blind) folded before Flop
Seat 3: Fengjie82 (big blind) collected (€0.02)
Seat 4: caduceus369 folded before Flop (didn't bet)
Seat 5: EasyToRule folded before Flop (didn't bet)
Seat 6: robertoH2O folded before Flop (didn't bet)



PokerStars Zoom Hand #257988461514:  Hold'em No Limit (€0.01/€0.02) [ADM ID: M62BA304494E32ST] - 2025/10/04 0:04:20 CET [2025/10/03 18:04:20 ET]
Table 'Sirio' 6-max Seat #1 is the button
Seat 1: outshined8 (€1.60 in chips) 
Seat 2: neoilnervoso (€0.32 in chips) 
Seat 3: caduceus369 (€3.60 in chips) 
Seat 4: teicano98 (€1.22 in chips) 
Seat 5: cap e'bomb95 (€4.97 in chips) 
Seat 6: EasyToRule (€5.04 in chips) 
neoilnervoso: posts small blind €0.01
caduceus369: posts big blind €0.02
*** HOLE CARDS ***
Dealt to caduceus369 [2h 4h]
teicano98: folds 
cap e'bomb95: raises €0.03 to €0.05
EasyToRule: folds 
outshined8: folds 
neoilnervoso: folds 
caduceus369: calls €0.03
*** FLOP *** [3s 2d Qc]
caduceus369: checks 
cap e'bomb95: bets €0.07
caduceus369: calls €0.07
*** TURN *** [3s 2d Qc] [7d]
caduceus369: checks 
cap e'bomb95: checks 
*** RIVER *** [3s 2d Qc 7d] [Ad]
caduceus369: bets €0.04
cap e'bomb95: folds 
Uncalled bet (€0.04) returned to caduceus369
caduceus369 collected €0.24 from pot
caduceus369: doesn't show hand 
*** SUMMARY ***
Total pot €0.25 | Rake €0.01 
Board [3s 2d Qc 7d Ad]
Seat 1: outshined8 (button) folded before Flop (didn't bet)
Seat 2: neoilnervoso (small blind) folded before Flop
Seat 3: caduceus369 (big blind) collected (€0.24)
Seat 4: teicano98 folded before Flop (didn't bet)
Seat 5: cap e'bomb95 folded on the River
Seat 6: EasyToRule folded before Flop (didn't bet)



PokerStars Zoom Hand #257988472460:  Hold'em No Limit (€0.01/€0.02) [ADM ID: M62BA304494E32ST] - 2025/10/04 0:05:10 CET [2025/10/03 18:05:10 ET]
Table 'Sirio' 6-max Seat #1 is the button
Seat 1: caduceus369 (€3.72 in chips) 
Seat 2: cap e'bomb95 (€4.85 in chips) 
Seat 3: teicano98 (€1.30 in chips) 
Seat 4: Witness85906 (€4.22 in chips) 
Seat 5: Davi3231973 (€1.07 in chips) 
Seat 6: bruciapelo (€2.15 in chips) 
cap e'bomb95: posts small blind €0.01
teicano98: posts big blind €0.02
*** HOLE CARDS ***
Dealt to caduceus369 [Kc Qd]
Witness85906: folds 
Davi3231973: calls €0.02
bruciapelo: raises €0.08 to €0.10
caduceus369: folds 
cap e'bomb95: folds 
teicano98: folds 
Davi3231973: folds 
Uncalled bet (€0.08) returned to bruciapelo
bruciapelo collected €0.07 from pot
bruciapelo: doesn't show hand 
*** SUMMARY ***
Total pot €0.07 | Rake €0 
Seat 1: caduceus369 (button) folded before Flop (didn't bet)
Seat 2: cap e'bomb95 (small blind) folded before Flop
Seat 3: teicano98 (big blind) folded before Flop
Seat 4: Witness85906 folded before Flop (didn't bet)
Seat 5: Davi3231973 folded before Flop
Seat 6: bruciapelo collected (€0.07)



PokerStars Zoom Hand #257988479052:  Hold'em No Limit (€0.01/€0.02) [ADM ID: M62BA304494E32ST] - 2025/10/04 0:05:40 CET [2025/10/03 18:05:40 ET]
Table 'Sirio' 6-max Seat #1 is the button
Seat 1: Peru91j (€2.61 in chips) 
Seat 2: neoilnervoso (€0.48 in chips) 
Seat 3: father2008 (€4.31 in chips) 
Seat 4: Catania838 (€0.94 in chips) 
Seat 5: caduceus369 (€3.72 in chips) 
Seat 6: cesaretto23 (€2.01 in chips) 
neoilnervoso: posts small blind €0.01
father2008: posts big blind €0.02
*** HOLE CARDS ***
Dealt to caduceus369 [Qc Qd]
Catania838: folds 
caduceus369: raises €0.04 to €0.06
cesaretto23: folds 
Peru91j: folds 
neoilnervoso: calls €0.05
father2008: folds 
*** FLOP *** [2c 7s Ad]
neoilnervoso: checks 
caduceus369: bets €0.06
neoilnervoso: folds 
Uncalled bet (€0.06) returned to caduceus369
caduceus369 collected €0.14 from pot
caduceus369: doesn't show hand 
*** SUMMARY ***
Total pot €0.14 | Rake €0 
Board [2c 7s Ad]
Seat 1: Peru91j (button) folded before Flop (didn't bet)
Seat 2: neoilnervoso (small blind) folded on the Flop
Seat 3: father2008 (big blind) folded before Flop
Seat 4: Catania838 folded before Flop (didn't bet)
Seat 5: caduceus369 collected (€0.14)
Seat 6: cesaretto23 folded before Flop (didn't bet)



PokerStars Zoom Hand #257988476432:  Hold'em No Limit (€0.01/€0.02) [ADM ID: M62BA304494E32ST] - 2025/10/04 0:05:28 CET [2025/10/03 18:05:28 ET]
Table 'Sirio' 6-max Seat #1 is the button
Seat 1: Asganaway123 (€0.85 in chips) 
Seat 2: Peru91j (€2.75 in chips) 
Seat 3: cap e'bomb95 (€5.03 in chips) 
Seat 4: michy0757 (€1.17 in chips) 
Seat 5: EasyToRule (€2.43 in chips) 
Seat 6: caduceus369 (€3.72 in chips) 
Peru91j: posts small blind €0.01
cap e'bomb95: posts big blind €0.02
*** HOLE CARDS ***
Dealt to caduceus369 [8h Qc]
michy0757: raises €0.05 to €0.07
EasyToRule: folds 
caduceus369: folds 
Asganaway123: calls €0.07
Peru91j: folds 
cap e'bomb95: folds 
*** FLOP *** [8d 3c 8c]
michy0757: checks 
Asganaway123: bets €0.04
michy0757: calls €0.04
*** TURN *** [8d 3c 8c] [5d]
michy0757: checks 
Asganaway123: bets €0.10
michy0757: calls €0.10
*** RIVER *** [8d 3c 8c 5d] [4h]
michy0757: checks 
Asganaway123: bets €0.64 and is all-in
michy0757: folds 
Uncalled bet (€0.64) returned to Asganaway123
Asganaway123 collected €0.43 from pot
Asganaway123: doesn't show hand 
*** SUMMARY ***
Total pot €0.45 | Rake €0.02 
Board [8d 3c 8c 5d 4h]
Seat 1: Asganaway123 (button) collected (€0.43)
Seat 2: Peru91j (small blind) folded before Flop
Seat 3: cap e'bomb95 (big blind) folded before Flop
Seat 4: michy0757 folded on the River
Seat 5: EasyToRule folded before Flop (didn't bet)
Seat 6: caduceus369 folded before Flop (didn't bet)



PokerStars Zoom Hand #257988485154:  Hold'em No Limit (€0.01/€0.02) [ADM ID: M62BA304494E32ST] - 2025/10/04 0:06:08 CET [2025/10/03 18:06:08 ET]
Table 'Sirio' 6-max Seat #1 is the button
Seat 1: teicano98 (€1.26 in chips) 
Seat 2: caduceus369 (€3.80 in chips) 
Seat 3: criptlux (€2.11 in chips) 
Seat 4: cap e'bomb95 (€1.16 in chips) 
Seat 5: outshined8 (€1.26 in chips) 
Seat 6: Peru91j (€2.59 in chips) 
caduceus369: posts small blind €0.01
criptlux: posts big blind €0.02
*** HOLE CARDS ***
Dealt to caduceus369 [8s Qh]
cap e'bomb95: raises €0.03 to €0.05
outshined8: folds 
Peru91j: folds 
teicano98: folds 
caduceus369: folds 
criptlux: folds 
Uncalled bet (€0.03) returned to cap e'bomb95
cap e'bomb95 collected €0.05 from pot
cap e'bomb95: doesn't show hand 
*** SUMMARY ***
Total pot €0.05 | Rake €0 
Seat 1: teicano98 (button) folded before Flop (didn't bet)
Seat 2: caduceus369 (small blind) folded before Flop
Seat 3: criptlux (big blind) folded before Flop
Seat 4: cap e'bomb95 collected (€0.05)
Seat 5: outshined8 folded before Flop (didn't bet)
Seat 6: Peru91j folded before Flop (didn't bet)



PokerStars Zoom Hand #257988487679:  Hold'em No Limit (€0.01/€0.02) [ADM ID: M62BA304494E32ST] - 2025/10/04 0:06:19 CET [2025/10/03 18:06:19 ET]
Table 'Sirio' 6-max Seat #1 is the button
Seat 1: caduceus369 (€3.79 in chips) 
Seat 2: Meryjuventina (€0.66 in chips) 
Seat 3: Ceribelli1705 (€2.24 in chips) 
Seat 4: Catania838 (€2.92 in chips) 
Seat 5: EasyToRule (€5.19 in chips) 
Seat 6: outshined8 (€1.26 in chips) 
Meryjuventina: posts small blind €0.01
Ceribelli1705: posts big blind €0.02
*** HOLE CARDS ***
Dealt to caduceus369 [Jc 5c]
Catania838: folds 
EasyToRule: folds 
outshined8: calls €0.02
caduceus369: folds 
Meryjuventina: calls €0.01
Ceribelli1705: checks 
*** FLOP *** [6s As 6c]
Meryjuventina: bets €0.02
Ceribelli1705: raises €0.06 to €0.08
outshined8: folds 
Meryjuventina: raises €0.06 to €0.14
Ceribelli1705: raises €2.08 to €2.22 and is all-in
Meryjuventina: calls €0.50 and is all-in
Uncalled bet (€1.58) returned to Ceribelli1705
*** TURN *** [6s As 6c] [4h]
*** RIVER *** [6s As 6c 4h] [3d]
*** SHOW DOWN ***
Meryjuventina: shows [Kd Ks] (two pair, Kings and Sixes)
Ceribelli1705: shows [9d 6h] (three of a kind, Sixes)
Ceribelli1705 collected €1.27 from pot
*** SUMMARY ***
Total pot €1.34 | Rake €0.07 
Board [6s As 6c 4h 3d]
Seat 1: caduceus369 (button) folded before Flop (didn't bet)
Seat 2: Meryjuventina (small blind) showed [Kd Ks] and lost with two pair, Kings and Sixes
Seat 3: Ceribelli1705 (big blind) showed [9d 6h] and won (€1.27) with three of a kind, Sixes
Seat 4: Catania838 folded before Flop (didn't bet)
Seat 5: EasyToRule folded before Flop (didn't bet)
Seat 6: outshined8 folded on the Flop



PokerStars Zoom Hand #257988491025:  Hold'em No Limit (€0.01/€0.02) [ADM ID: M62BA304494E32ST] - 2025/10/04 0:06:34 CET [2025/10/03 18:06:34 ET]
Table 'Sirio' 6-max Seat #1 is the button
Seat 1: Catania838 (€2.91 in chips) 
Seat 2: CacciatoreAA (€3.19 in chips) 
Seat 3: caduceus369 (€3.79 in chips) 
Seat 4: outshined8 (€1.24 in chips) 
Seat 5: cap e'bomb95 (€1.18 in chips) 
Seat 6: teicano98 (€1.26 in chips) 
CacciatoreAA: posts small blind €0.01
caduceus369: posts big blind €0.02
*** HOLE CARDS ***
Dealt to caduceus369 [Kd 3h]
outshined8: folds 
cap e'bomb95: raises €0.03 to €0.05
teicano98: folds 
Catania838: folds 
CacciatoreAA: folds 
caduceus369: folds 
Uncalled bet (€0.03) returned to cap e'bomb95
cap e'bomb95 collected €0.05 from pot
cap e'bomb95: doesn't show hand 
*** SUMMARY ***
Total pot €0.05 | Rake €0 
Seat 1: Catania838 (button) folded before Flop (didn't bet)
Seat 2: CacciatoreAA (small blind) folded before Flop
Seat 3: caduceus369 (big blind) folded before Flop
Seat 4: outshined8 folded before Flop (didn't bet)
Seat 5: cap e'bomb95 collected (€0.05)
Seat 6: teicano98 folded before Flop (didn't bet)



PokerStars Zoom Hand #257988486791:  Hold'em No Limit (€0.01/€0.02) [ADM ID: M62BA304494E32ST] - 2025/10/04 0:06:15 CET [2025/10/03 18:06:15 ET]
Table 'Sirio' 6-max Seat #1 is the button
Seat 1: outshined8 (€1.26 in chips) 
Seat 2: colosso2022 (€1.80 in chips) 
Seat 3: neoilnervoso (€0.42 in chips) 
Seat 4: caduceus369 (€3.79 in chips) 
Seat 5: fantaasso (€4.24 in chips) 
Seat 6: IsyP99 (€0.64 in chips) 
colosso2022: posts small blind €0.01
neoilnervoso: posts big blind €0.02
*** HOLE CARDS ***
Dealt to caduceus369 [Kc 2c]
caduceus369: folds 
fantaasso: raises €0.04 to €0.06
IsyP99: calls €0.06
outshined8: folds 
colosso2022: calls €0.05
neoilnervoso: calls €0.04
*** FLOP *** [3d Qc Ad]
colosso2022: checks 
neoilnervoso: checks 
fantaasso: checks 
IsyP99: checks 
*** TURN *** [3d Qc Ad] [7h]
colosso2022: checks 
neoilnervoso: checks 
fantaasso: bets €0.12
IsyP99: folds 
colosso2022: folds 
neoilnervoso: folds 
Uncalled bet (€0.12) returned to fantaasso
fantaasso collected €0.23 from pot
fantaasso: doesn't show hand 
*** SUMMARY ***
Total pot €0.24 | Rake €0.01 
Board [3d Qc Ad 7h]
Seat 1: outshined8 (button) folded before Flop (didn't bet)
Seat 2: colosso2022 (small blind) folded on the Turn
Seat 3: neoilnervoso (big blind) folded on the Turn
Seat 4: caduceus369 folded before Flop (didn't bet)
Seat 5: fantaasso collected (€0.23)
Seat 6: IsyP99 folded on the Turn



PokerStars Zoom Hand #257988489410:  Hold'em No Limit (€0.01/€0.02) [ADM ID: M62BA304494E32ST] - 2025/10/04 0:06:27 CET [2025/10/03 18:06:27 ET]
Table 'Sirio' 6-max Seat #1 is the button
Seat 1: cuzzi68 (€0.96 in chips) 
Seat 2: cap e'bomb95 (€1.19 in chips) 
Seat 3: EasyToRule (€5.19 in chips) 
Seat 4: Catania838 (€1.96 in chips) 
Seat 5: caduceus369 (€3.79 in chips) 
Seat 6: stfuplzudonk (€4.12 in chips) 
cap e'bomb95: posts small blind €0.01
EasyToRule: posts big blind €0.02
*** HOLE CARDS ***
Dealt to caduceus369 [7s Th]
Catania838: calls €0.02
caduceus369: folds 
stfuplzudonk: folds 
cuzzi68: folds 
cap e'bomb95: folds 
EasyToRule: checks 
*** FLOP *** [8d 8h Ac]
EasyToRule: checks 
Catania838: checks 
*** TURN *** [8d 8h Ac] [Js]
EasyToRule: checks 
Catania838: checks 
*** RIVER *** [8d 8h Ac Js] [As]
EasyToRule: checks 
Catania838: checks 
*** SHOW DOWN ***
EasyToRule: shows [6h 2s] (two pair, Aces and Eights)
Catania838: shows [5c 3c] (two pair, Aces and Eights)
EasyToRule collected €0.03 from pot
Catania838 collected €0.02 from pot
*** SUMMARY ***
Total pot €0.05 | Rake €0 
Board [8d 8h Ac Js As]
Seat 1: cuzzi68 (button) folded before Flop (didn't bet)
Seat 2: cap e'bomb95 (small blind) folded before Flop
Seat 3: EasyToRule (big blind) showed [6h 2s] and won (€0.03) with two pair, Aces and Eights
Seat 4: Catania838 showed [5c 3c] and won (€0.02) with two pair, Aces and Eights
Seat 5: caduceus369 folded before Flop (didn't bet)
Seat 6: stfuplzudonk folded before Flop (didn't bet)



PokerStars Zoom Hand #257988498777:  Hold'em No Limit (€0.01/€0.02) [ADM ID: M62BA304494E32ST] - 2025/10/04 0:07:09 CET [2025/10/03 18:07:09 ET]
Table 'Sirio' 6-max Seat #1 is the button
Seat 1: Catania838 (€0.78 in chips) 
Seat 2: criptlux (€2.09 in chips) 
Seat 3: robertoH2O (€2.09 in chips) 
Seat 4: caduceus369 (€3.76 in chips) 
Seat 5: Witness85906 (€4.38 in chips) 
Seat 6: fantaasso (€3.32 in chips) 
criptlux: posts small blind €0.01
robertoH2O: posts big blind €0.02
*** HOLE CARDS ***
Dealt to caduceus369 [2d 7h]
caduceus369: folds 
Witness85906: raises €0.03 to €0.05
fantaasso: folds 
Catania838: raises €0.73 to €0.78 and is all-in
criptlux: folds 
robertoH2O: raises €1.31 to €2.09 and is all-in
Witness85906: folds 
Uncalled bet (€1.31) returned to robertoH2O
*** FLOP *** [As 5d Ks]
*** TURN *** [As 5d Ks] [Jc]
*** RIVER *** [As 5d Ks Jc] [7c]
*** SHOW DOWN ***
robertoH2O: shows [Kd Kc] (three of a kind, Kings)
Catania838: shows [6s 6d] (a pair of Sixes)
robertoH2O collected €1.54 from pot
*** SUMMARY ***
Total pot €1.62 | Rake €0.08 
Board [As 5d Ks Jc 7c]
Seat 1: Catania838 (button) showed [6s 6d] and lost with a pair of Sixes
Seat 2: criptlux (small blind) folded before Flop
Seat 3: robertoH2O (big blind) showed [Kd Kc] and won (€1.54) with three of a kind, Kings
Seat 4: caduceus369 folded before Flop (didn't bet)
Seat 5: Witness85906 folded before Flop
Seat 6: fantaasso folded before Flop (didn't bet)



PokerStars Zoom Hand #257988496224:  Hold'em No Limit (€0.01/€0.02) [ADM ID: M62BA304494E32ST] - 2025/10/04 0:06:57 CET [2025/10/03 18:06:57 ET]
Table 'Sirio' 6-max Seat #1 is the button
Seat 1: EasyToRule (€2.40 in chips) 
Seat 2: caduceus369 (€3.77 in chips) 
Seat 3: workman75 (€4.01 in chips) 
Seat 4: maur62 (€1.30 in chips) 
Seat 5: Meryjuventina (€0.80 in chips) 
Seat 6: stevalmg (€2 in chips) 
caduceus369: posts small blind €0.01
workman75: posts big blind €0.02
*** HOLE CARDS ***
Dealt to caduceus369 [Kc Js]
maur62: calls €0.02
Meryjuventina: calls €0.02
stevalmg: raises €0.09 to €0.11
EasyToRule: calls €0.11
caduceus369: folds 
workman75: calls €0.09
maur62: calls €0.09
Meryjuventina: calls €0.09
*** FLOP *** [2h 2s 4c]
workman75: checks 
maur62: checks 
Meryjuventina: checks 
stevalmg: bets €0.27
EasyToRule: folds 
workman75: calls €0.27
maur62: calls €0.27
Meryjuventina: folds 
*** TURN *** [2h 2s 4c] [6c]
workman75: checks 
maur62: checks 
stevalmg: checks 
*** RIVER *** [2h 2s 4c 6c] [6d]
workman75: checks 
maur62: checks 
stevalmg: checks 
*** SHOW DOWN ***
workman75: shows [4h Ah] (two pair, Sixes and Fours)
maur62: shows [5h 5c] (two pair, Sixes and Fives)
stevalmg: mucks hand 
maur62 collected €1.30 from pot
*** SUMMARY ***
Total pot €1.37 | Rake €0.07 
Board [2h 2s 4c 6c 6d]
Seat 1: EasyToRule (button) folded on the Flop
Seat 2: caduceus369 (small blind) folded before Flop
Seat 3: workman75 (big blind) showed [4h Ah] and lost with two pair, Sixes and Fours
Seat 4: maur62 showed [5h 5c] and won (€1.30) with two pair, Sixes and Fives
Seat 5: Meryjuventina folded on the Flop
Seat 6: stevalmg mucked [3s 3h]



PokerStars Zoom Hand #257988500839:  Hold'em No Limit (€0.01/€0.02) [ADM ID: M62BA304494E32ST] - 2025/10/04 0:07:18 CET [2025/10/03 18:07:18 ET]
Table 'Sirio' 6-max Seat #1 is the button
Seat 1: stfuplzudonk (€4.28 in chips) 
Seat 2: Fengjie82 (€2.54 in chips) 
Seat 3: Catania838 (€1.96 in chips) 
Seat 4: EasyToRule (€5.20 in chips) 
Seat 5: cap e'bomb95 (€4.98 in chips) 
Seat 6: caduceus369 (€3.76 in chips) 
Fengjie82: posts small blind €0.01
Catania838: posts big blind €0.02
*** HOLE CARDS ***
Dealt to caduceus369 [9h Tc]
EasyToRule: folds 
cap e'bomb95: folds 
caduceus369: folds 
stfuplzudonk: raises €0.02 to €0.04
Fengjie82: folds 
Catania838: folds 
Uncalled bet (€0.02) returned to stfuplzudonk
stfuplzudonk collected €0.05 from pot
stfuplzudonk: doesn't show hand 
*** SUMMARY ***
Total pot €0.05 | Rake €0 
Seat 1: stfuplzudonk (button) collected (€0.05)
Seat 2: Fengjie82 (small blind) folded before Flop
Seat 3: Catania838 (big blind) folded before Flop
Seat 4: EasyToRule folded before Flop (didn't bet)
Seat 5: cap e'bomb95 folded before Flop (didn't bet)
Seat 6: caduceus369 folded before Flop (didn't bet)



PokerStars Zoom Hand #257988502397:  Hold'em No Limit (€0.01/€0.02) [ADM ID: M62BA304494E32ST] - 2025/10/04 0:07:25 CET [2025/10/03 18:07:25 ET]
Table 'Sirio' 6-max Seat #1 is the button
Seat 1: criptlux (€2.08 in chips) 
Seat 2: Catania838 (€1.93 in chips) 
Seat 3: fantaasso (€3.32 in chips) 
Seat 4: cap e'bomb95 (€4.98 in chips) 
Seat 5: caduceus369 (€3.76 in chips) 
Seat 6: EasyToRule (€5.20 in chips) 
Catania838: posts small blind €0.01
fantaasso: posts big blind €0.02
*** HOLE CARDS ***
Dealt to caduceus369 [Ks Jc]
cap e'bomb95: folds 
caduceus369: raises €0.04 to €0.06
EasyToRule: folds 
criptlux: folds 
Catania838: calls €0.05
fantaasso: folds 
*** FLOP *** [Ah 6s Qs]
Catania838: checks 
caduceus369: bets €0.06
Catania838: raises €0.06 to €0.12
caduceus369: calls €0.06
*** TURN *** [Ah 6s Qs] [8s]
Catania838: checks 
caduceus369: checks 
*** RIVER *** [Ah 6s Qs 8s] [3d]
Catania838: checks 
caduceus369: checks 
*** SHOW DOWN ***
Catania838: shows [9c Ac] (a pair of Aces)
caduceus369: mucks hand 
Catania838 collected €0.36 from pot
*** SUMMARY ***
Total pot €0.38 | Rake €0.02 
Board [Ah 6s Qs 8s 3d]
Seat 1: criptlux (button) folded before Flop (didn't bet)
Seat 2: Catania838 (small blind) showed [9c Ac] and won (€0.36) with a pair of Aces
Seat 3: fantaasso (big blind) folded before Flop
Seat 4: cap e'bomb95 folded before Flop (didn't bet)
Seat 5: caduceus369 mucked [Ks Jc]
Seat 6: EasyToRule folded before Flop (didn't bet)



PokerStars Zoom Hand #257988516782:  Hold'em No Limit (€0.01/€0.02) [ADM ID: M62BA304494E32ST] - 2025/10/04 0:08:31 CET [2025/10/03 18:08:31 ET]
Table 'Sirio' 6-max Seat #1 is the button
Seat 1: cap e'bomb95 (€4.86 in chips) 
Seat 2: trillycata (€1.51 in chips) 
Seat 3: caduceus369 (€3.58 in chips) 
Seat 4: workman75 (€3.59 in chips) 
Seat 5: maur62 (€1.26 in chips) 
Seat 6: teicano98 (€0.90 in chips) 
trillycata: posts small blind €0.01
caduceus369: posts big blind €0.02
*** HOLE CARDS ***
Dealt to caduceus369 [8d 9h]
workman75: folds 
maur62: calls €0.02
teicano98: folds 
cap e'bomb95: folds 
trillycata: calls €0.01
caduceus369: checks 
*** FLOP *** [5d 8c 3c]
trillycata: bets €0.03
caduceus369: raises €0.15 to €0.18
maur62: folds 
trillycata: calls €0.15
*** TURN *** [5d 8c 3c] [Ts]
trillycata: checks 
caduceus369: bets €0.20
trillycata: folds 
Uncalled bet (€0.20) returned to caduceus369
caduceus369 collected €0.40 from pot
caduceus369: doesn't show hand 
*** SUMMARY ***
Total pot €0.42 | Rake €0.02 
Board [5d 8c 3c Ts]
Seat 1: cap e'bomb95 (button) folded before Flop (didn't bet)
Seat 2: trillycata (small blind) folded on the Turn
Seat 3: caduceus369 (big blind) collected (€0.40)
Seat 4: workman75 folded before Flop (didn't bet)
Seat 5: maur62 folded on the Flop
Seat 6: teicano98 folded before Flop (didn't bet)



PokerStars Zoom Hand #257988531743:  Hold'em No Limit (€0.01/€0.02) [ADM ID: M62BA304494E32ST] - 2025/10/04 0:09:39 CET [2025/10/03 18:09:39 ET]
Table 'Sirio' 6-max Seat #1 is the button
Seat 1: caduceus369 (€3.78 in chips) 
Seat 2: Davi3231973 (€0.96 in chips) 
Seat 3: pepenero11 (€1.26 in chips) 
Seat 4: fantaasso (€3.16 in chips) 
Seat 5: trillycata (€1.31 in chips) 
Seat 6: Meryjuventina (€1.04 in chips) 
Davi3231973: posts small blind €0.01
pepenero11: posts big blind €0.02
*** HOLE CARDS ***
Dealt to caduceus369 [Qs 9h]
fantaasso: folds 
trillycata: raises €0.04 to €0.06
Meryjuventina: calls €0.06
caduceus369: folds 
Davi3231973: folds 
pepenero11: calls €0.04
*** FLOP *** [Kc 4s Jh]
pepenero11: bets €0.18
trillycata: calls €0.18
Meryjuventina: calls €0.18
*** TURN *** [Kc 4s Jh] [Jc]
pepenero11: bets €0.06
trillycata: calls €0.06
Meryjuventina is disconnected 
Meryjuventina: folds 
*** RIVER *** [Kc 4s Jh Jc] [Tc]
pepenero11: bets €0.10
trillycata: calls €0.10
*** SHOW DOWN ***
pepenero11: shows [Jd 7s] (three of a kind, Jacks)
trillycata: mucks hand 
pepenero11 collected €1 from pot
*** SUMMARY ***
Total pot €1.05 | Rake €0.05 
Board [Kc 4s Jh Jc Tc]
Seat 1: caduceus369 (button) folded before Flop (didn't bet)
Seat 2: Davi3231973 (small blind) folded before Flop
Seat 3: pepenero11 (big blind) showed [Jd 7s] and won (€1) with three of a kind, Jacks
Seat 4: fantaasso folded before Flop (didn't bet)
Seat 5: trillycata mucked [Td Ah]
Seat 6: Meryjuventina folded on the Turn



PokerStars Zoom Hand #257988533391:  Hold'em No Limit (€0.01/€0.02) [ADM ID: M62BA304494E32ST] - 2025/10/04 0:09:47 CET [2025/10/03 18:09:47 ET]
Table 'Sirio' 6-max Seat #1 is the button
Seat 1: cesaretto23 (€1.57 in chips) 
Seat 2: criptlux (€3.68 in chips) 
Seat 3: outshined8 (€0.51 in chips) 
Seat 4: fantaasso (€4.34 in chips) 
Seat 5: caduceus369 (€3.78 in chips) 
Seat 6: IsyP99 (€1.04 in chips) 
criptlux: posts small blind €0.01
outshined8: posts big blind €0.02
*** HOLE CARDS ***
Dealt to caduceus369 [Qd Kd]
fantaasso: folds 
caduceus369: raises €0.04 to €0.06
IsyP99: calls €0.06
cesaretto23: calls €0.06
criptlux: folds 
outshined8: folds 
*** FLOP *** [8h Jd 3h]
caduceus369: checks 
IsyP99: checks 
cesaretto23: checks 
*** TURN *** [8h Jd 3h] [7d]
caduceus369: bets €0.06
IsyP99: raises €0.06 to €0.12
cesaretto23: folds 
caduceus369: calls €0.06
*** RIVER *** [8h Jd 3h 7d] [Th]
caduceus369: checks 
IsyP99: bets €0.22
caduceus369: folds 
Uncalled bet (€0.22) returned to IsyP99
IsyP99 collected €0.43 from pot
IsyP99: doesn't show hand 
*** SUMMARY ***
Total pot €0.45 | Rake €0.02 
Board [8h Jd 3h 7d Th]
Seat 1: cesaretto23 (button) folded on the Turn
Seat 2: criptlux (small blind) folded before Flop
Seat 3: outshined8 (big blind) folded before Flop
Seat 4: fantaasso folded before Flop (didn't bet)
Seat 5: caduceus369 folded on the River
Seat 6: IsyP99 collected (€0.43)



PokerStars Zoom Hand #257988549555:  Hold'em No Limit (€0.01/€0.02) [ADM ID: M62BA304494E32ST] - 2025/10/04 0:11:02 CET [2025/10/03 18:11:02 ET]
Table 'Sirio' 6-max Seat #1 is the button
Seat 1: Poetto65 (€0.79 in chips) 
Seat 2: caduceus369 (€3.60 in chips) 
Seat 3: cap e'bomb95 (€4.79 in chips) 
Seat 4: bruciapelo (€2.55 in chips) 
Seat 5: criptlux (€3.68 in chips) 
Seat 6: trillycata (€0.92 in chips) 
caduceus369: posts small blind €0.01
cap e'bomb95: posts big blind €0.02
*** HOLE CARDS ***
Dealt to caduceus369 [Jh 3c]
bruciapelo: folds 
criptlux: folds 
trillycata: raises €0.02 to €0.04
Poetto65: folds 
caduceus369: folds 
cap e'bomb95: folds 
Uncalled bet (€0.02) returned to trillycata
trillycata collected €0.05 from pot
trillycata: doesn't show hand 
*** SUMMARY ***
Total pot €0.05 | Rake €0 
Seat 1: Poetto65 (button) folded before Flop (didn't bet)
Seat 2: caduceus369 (small blind) folded before Flop
Seat 3: cap e'bomb95 (big blind) folded before Flop
Seat 4: bruciapelo folded before Flop (didn't bet)
Seat 5: criptlux folded before Flop (didn't bet)
Seat 6: trillycata collected (€0.05)



PokerStars Zoom Hand #257988555101:  Hold'em No Limit (€0.01/€0.02) [ADM ID: M62BA304494E32ST] - 2025/10/04 0:11:27 CET [2025/10/03 18:11:27 ET]
Table 'Sirio' 6-max Seat #1 is the button
Seat 1: deojking (€2.10 in chips) 
Seat 2: Witness85906 (€4.58 in chips) 
Seat 3: maur62 (€2.36 in chips) 
Seat 4: caduceus369 (€3.59 in chips) 
Seat 5: LentaM3nte (€2.15 in chips) 
Seat 6: cuzzi68 (€0.98 in chips) 
Witness85906: posts small blind €0.01
maur62: posts big blind €0.02
*** HOLE CARDS ***
Dealt to caduceus369 [7d 9s]
caduceus369: folds 
LentaM3nte: folds 
cuzzi68: folds 
deojking: folds 
Witness85906: folds 
Uncalled bet (€0.01) returned to maur62
maur62 collected €0.02 from pot
maur62: doesn't show hand 
*** SUMMARY ***
Total pot €0.02 | Rake €0 
Seat 1: deojking (button) folded before Flop (didn't bet)
Seat 2: Witness85906 (small blind) folded before Flop
Seat 3: maur62 (big blind) collected (€0.02)
Seat 4: caduceus369 folded before Flop (didn't bet)
Seat 5: LentaM3nte folded before Flop (didn't bet)
Seat 6: cuzzi68 folded before Flop (didn't bet)



PokerStars Zoom Hand #257988552979:  Hold'em No Limit (€0.01/€0.02) [ADM ID: M62BA304494E32ST] - 2025/10/04 0:11:18 CET [2025/10/03 18:11:18 ET]
Table 'Sirio' 6-max Seat #1 is the button
Seat 1: cap e'bomb95 (€1.42 in chips) 
Seat 2: deojking (€1.91 in chips) 
Seat 3: Davi3231973 (€0.85 in chips) 
Seat 4: Ceribelli1705 (€2.54 in chips) 
Seat 5: Bristol1964 (€1.11 in chips) 
Seat 6: caduceus369 (€3.59 in chips) 
deojking: posts small blind €0.01
Davi3231973: posts big blind €0.02
*** HOLE CARDS ***
Dealt to caduceus369 [2d Qd]
Ceribelli1705: calls €0.02
Bristol1964: folds 
caduceus369: folds 
cap e'bomb95: folds 
deojking: folds 
Davi3231973: checks 
*** FLOP *** [6s 5s 5c]
Davi3231973: checks 
Ceribelli1705: checks 
*** TURN *** [6s 5s 5c] [6c]
Davi3231973: checks 
Ceribelli1705: checks 
*** RIVER *** [6s 5s 5c 6c] [5d]
Davi3231973: bets €0.02
Ceribelli1705: folds 
Uncalled bet (€0.02) returned to Davi3231973
Davi3231973 collected €0.05 from pot
Davi3231973: doesn't show hand 
*** SUMMARY ***
Total pot €0.05 | Rake €0 
Board [6s 5s 5c 6c 5d]
Seat 1: cap e'bomb95 (button) folded before Flop (didn't bet)
Seat 2: deojking (small blind) folded before Flop
Seat 3: Davi3231973 (big blind) collected (€0.05)
Seat 4: Ceribelli1705 folded on the River
Seat 5: Bristol1964 folded before Flop (didn't bet)
Seat 6: caduceus369 folded before Flop (didn't bet)



PokerStars Zoom Hand #257988560974:  Hold'em No Limit (€0.01/€0.02) [ADM ID: M62BA304494E32ST] - 2025/10/04 0:11:54 CET [2025/10/03 18:11:54 ET]
Table 'Sirio' 6-max Seat #1 is the button
Seat 1: caduceus369 (€3.57 in chips) 
Seat 2: deojking (€2.08 in chips) 
Seat 3: stfuplzudonk (€1.89 in chips) 
Seat 4: Catania838 (€2.99 in chips) 
Seat 5: pepenero11 (€1.93 in chips) 
Seat 6: cap e'bomb95 (€4.76 in chips) 
deojking: posts small blind €0.01
stfuplzudonk: posts big blind €0.02
*** HOLE CARDS ***
Dealt to caduceus369 [8c Ts]
Catania838: folds 
pepenero11: raises €0.02 to €0.04
cap e'bomb95: folds 
caduceus369: folds 
deojking: folds 
stfuplzudonk: folds 
Uncalled bet (€0.02) returned to pepenero11
pepenero11 collected €0.05 from pot
pepenero11: doesn't show hand 
*** SUMMARY ***
Total pot €0.05 | Rake €0 
Seat 1: caduceus369 (button) folded before Flop (didn't bet)
Seat 2: deojking (small blind) folded before Flop
Seat 3: stfuplzudonk (big blind) folded before Flop
Seat 4: Catania838 folded before Flop (didn't bet)
Seat 5: pepenero11 collected (€0.05)
Seat 6: cap e'bomb95 folded before Flop (didn't bet)



PokerStars Zoom Hand #257988556037:  Hold'em No Limit (€0.01/€0.02) [ADM ID: M62BA304494E32ST] - 2025/10/04 0:11:31 CET [2025/10/03 18:11:31 ET]
Table 'Sirio' 6-max Seat #1 is the button
Seat 1: LentaM3nte (€2.15 in chips) 
Seat 2: cuzzi68 (€0.98 in chips) 
Seat 3: caduceus369 (€3.59 in chips) 
Seat 4: fantaasso (€4.21 in chips) 
Seat 5: deojking (€1.95 in chips) 
Seat 6: Peru91j (€2.64 in chips) 
cuzzi68: posts small blind €0.01
caduceus369: posts big blind €0.02
*** HOLE CARDS ***
Dealt to caduceus369 [7s Qh]
fantaasso: folds 
deojking: calls €0.02
Peru91j: folds 
LentaM3nte: folds 
cuzzi68: raises €0.06 to €0.08
caduceus369: folds 
deojking: calls €0.06
*** FLOP *** [7c Qd Kc]
cuzzi68: bets €0.18
deojking: calls €0.18
*** TURN *** [7c Qd Kc] [4d]
cuzzi68: bets €0.72 and is all-in
deojking: calls €0.72
*** RIVER *** [7c Qd Kc 4d] [Js]
*** SHOW DOWN ***
cuzzi68: shows [Ac Kh] (a pair of Kings)
deojking: shows [Td Kd] (a pair of Kings - lower kicker)
cuzzi68 collected €1.88 from pot
*** SUMMARY ***
Total pot €1.98 | Rake €0.10 
Board [7c Qd Kc 4d Js]
Seat 1: LentaM3nte (button) folded before Flop (didn't bet)
Seat 2: cuzzi68 (small blind) showed [Ac Kh] and won (€1.88) with a pair of Kings
Seat 3: caduceus369 (big blind) folded before Flop
Seat 4: fantaasso folded before Flop (didn't bet)
Seat 5: deojking showed [Td Kd] and lost with a pair of Kings
Seat 6: Peru91j folded before Flop (didn't bet)



PokerStars Zoom Hand #257988565318:  Hold'em No Limit (€0.01/€0.02) [ADM ID: M62BA304494E32ST] - 2025/10/04 0:12:15 CET [2025/10/03 18:12:15 ET]
Table 'Sirio' 6-max Seat #1 is the button
Seat 1: deojking (€2.07 in chips) 
Seat 2: Davi3231973 (€0.88 in chips) 
Seat 3: workman75 (€3.39 in chips) 
Seat 4: Catania838 (€1.94 in chips) 
Seat 5: EasyToRule (€2.19 in chips) 
Seat 6: caduceus369 (€3.56 in chips) 
Davi3231973: posts small blind €0.01
workman75: posts big blind €0.02
*** HOLE CARDS ***
Dealt to caduceus369 [Js Kc]
Catania838: folds 
EasyToRule: raises €0.04 to €0.06
caduceus369: folds 
deojking: folds 
Davi3231973: calls €0.05
workman75: folds 
*** FLOP *** [8h 2s 5h]
Davi3231973: checks 
EasyToRule: bets €0.05
Davi3231973: folds 
Uncalled bet (€0.05) returned to EasyToRule
EasyToRule collected €0.14 from pot
EasyToRule: doesn't show hand 
*** SUMMARY ***
Total pot €0.14 | Rake €0 
Board [8h 2s 5h]
Seat 1: deojking (button) folded before Flop (didn't bet)
Seat 2: Davi3231973 (small blind) folded on the Flop
Seat 3: workman75 (big blind) folded before Flop
Seat 4: Catania838 folded before Flop (didn't bet)
Seat 5: EasyToRule collected (€0.14)
Seat 6: caduceus369 folded before Flop (didn't bet)



PokerStars Zoom Hand #257988562292:  Hold'em No Limit (€0.01/€0.02) [ADM ID: M62BA304494E32ST] - 2025/10/04 0:12:00 CET [2025/10/03 18:12:00 ET]
Table 'Sirio' 6-max Seat #1 is the button
Seat 1: Catania838 (€2.99 in chips) 
Seat 2: caduceus369 (€3.57 in chips) 
Seat 3: maur62 (€0.25 in chips) 
Seat 4: Meryjuventina (€1.60 in chips) 
Seat 5: father2008 (€3.93 in chips) 
Seat 6: cap e'bomb95 (€5.84 in chips) 
caduceus369: posts small blind €0.01
maur62: posts big blind €0.02
*** HOLE CARDS ***
Dealt to caduceus369 [5h 7s]
Meryjuventina: calls €0.02
father2008: folds 
cap e'bomb95: folds 
Catania838: calls €0.02
caduceus369: folds 
maur62: checks 
*** FLOP *** [8s As Kd]
maur62: checks 
Meryjuventina: checks 
Catania838: checks 
*** TURN *** [8s As Kd] [Qh]
maur62: checks 
Meryjuventina: checks 
Catania838: checks 
*** RIVER *** [8s As Kd Qh] [8h]
maur62: checks 
Meryjuventina: checks 
Catania838: checks 
*** SHOW DOWN ***
maur62: shows [7h Ts] (a pair of Eights)
Meryjuventina: shows [Kc 9s] (two pair, Kings and Eights)
Catania838: mucks hand 
Meryjuventina collected €0.07 from pot
*** SUMMARY ***
Total pot €0.07 | Rake €0 
Board [8s As Kd Qh 8h]
Seat 1: Catania838 (button) mucked [6h 6s]
Seat 2: caduceus369 (small blind) folded before Flop
Seat 3: maur62 (big blind) showed [7h Ts] and lost with a pair of Eights
Seat 4: Meryjuventina showed [Kc 9s] and won (€0.07) with two pair, Kings and Eights
Seat 5: father2008 folded before Flop (didn't bet)
Seat 6: cap e'bomb95 folded before Flop (didn't bet)



PokerStars Zoom Hand #257988563846:  Hold'em No Limit (€0.01/€0.02) [ADM ID: M62BA304494E32ST] - 2025/10/04 0:12:08 CET [2025/10/03 18:12:08 ET]
Table 'Sirio' 6-max Seat #1 is the button
Seat 1: father2008 (€5.54 in chips) 
Seat 2: criptlux (€3.65 in chips) 
Seat 3: cap e'bomb95 (€4.76 in chips) 
Seat 4: deojking (€2.07 in chips) 
Seat 5: caduceus369 (€3.56 in chips) 
Seat 6: stfuplzudonk (€1.87 in chips) 
criptlux: posts small blind €0.01
cap e'bomb95: posts big blind €0.02
*** HOLE CARDS ***
Dealt to caduceus369 [3s Jh]
deojking: folds 
caduceus369: folds 
stfuplzudonk: raises €0.02 to €0.04
father2008: folds 
criptlux: calls €0.03
cap e'bomb95: folds 
*** FLOP *** [Kd 8h 2h]
criptlux: checks 
stfuplzudonk: checks 
*** TURN *** [Kd 8h 2h] [Jc]
criptlux: bets €0.08
stfuplzudonk: folds 
Uncalled bet (€0.08) returned to criptlux
criptlux collected €0.10 from pot
criptlux: doesn't show hand 
*** SUMMARY ***
Total pot €0.10 | Rake €0 
Board [Kd 8h 2h Jc]
Seat 1: father2008 (button) folded before Flop (didn't bet)
Seat 2: criptlux (small blind) collected (€0.10)
Seat 3: cap e'bomb95 (big blind) folded before Flop
Seat 4: deojking folded before Flop (didn't bet)
Seat 5: caduceus369 folded before Flop (didn't bet)
Seat 6: stfuplzudonk folded on the Turn



PokerStars Zoom Hand #257988568869:  Hold'em No Limit (€0.01/€0.02) [ADM ID: M62BA304494E32ST] - 2025/10/04 0:12:31 CET [2025/10/03 18:12:31 ET]
Table 'Sirio' 6-max Seat #1 is the button
Seat 1: Bristol1964 (€1.04 in chips) 
Seat 2: workman75 (€3.37 in chips) 
Seat 3: caduceus369 (€3.56 in chips) 
Seat 4: maur62 (€2.41 in chips) 
Seat 5: outshined8 (€0.52 in chips) 
Seat 6: Peru91j (€2.60 in chips) 
workman75: posts small blind €0.01
caduceus369: posts big blind €0.02
*** HOLE CARDS ***
Dealt to caduceus369 [8d 3d]
maur62: calls €0.02
outshined8: folds 
Peru91j: folds 
Bristol1964: calls €0.02
workman75: folds 
caduceus369: checks 
*** FLOP *** [3s Td 5c]
caduceus369: checks 
maur62: checks 
Bristol1964: checks 
*** TURN *** [3s Td 5c] [Qh]
caduceus369: bets €0.02
maur62: calls €0.02
Bristol1964: calls €0.02
*** RIVER *** [3s Td 5c Qh] [As]
caduceus369: checks 
maur62: checks 
Bristol1964: checks 
*** SHOW DOWN ***
caduceus369: shows [8d 3d] (a pair of Threes)
maur62: shows [Ad Ts] (two pair, Aces and Tens)
Bristol1964: mucks hand 
maur62 collected €0.13 from pot
*** SUMMARY ***
Total pot €0.13 | Rake €0 
Board [3s Td 5c Qh As]
Seat 1: Bristol1964 (button) mucked [8c 9s]
Seat 2: workman75 (small blind) folded before Flop
Seat 3: caduceus369 (big blind) showed [8d 3d] and lost with a pair of Threes
Seat 4: maur62 showed [Ad Ts] and won (€0.13) with two pair, Aces and Tens
Seat 5: outshined8 folded before Flop (didn't bet)
Seat 6: Peru91j folded before Flop (didn't bet)



PokerStars Zoom Hand #257988584647:  Hold'em No Limit (€0.01/€0.02) [ADM ID: M62BA304494E32ST] - 2025/10/04 0:13:44 CET [2025/10/03 18:13:44 ET]
Table 'Sirio' 6-max Seat #1 is the button
Seat 1: criptlux (€3.69 in chips) 
Seat 2: cap e'bomb95 (€4.69 in chips) 
Seat 3: Bristol1964 (€1 in chips) 
Seat 4: father2008 (€3.86 in chips) 
Seat 5: caduceus369 (€3.52 in chips) 
Seat 6: CacciatoreAA (€3.12 in chips) 
cap e'bomb95: posts small blind €0.01
Bristol1964: posts big blind €0.02
*** HOLE CARDS ***
Dealt to caduceus369 [Tc 8d]
father2008: folds 
caduceus369: folds 
CacciatoreAA: folds 
criptlux: folds 
cap e'bomb95: folds 
Uncalled bet (€0.01) returned to Bristol1964
Bristol1964 collected €0.02 from pot
Bristol1964: doesn't show hand 
*** SUMMARY ***
Total pot €0.02 | Rake €0 
Seat 1: criptlux (button) folded before Flop (didn't bet)
Seat 2: cap e'bomb95 (small blind) folded before Flop
Seat 3: Bristol1964 (big blind) collected (€0.02)
Seat 4: father2008 folded before Flop (didn't bet)
Seat 5: caduceus369 folded before Flop (didn't bet)
Seat 6: CacciatoreAA folded before Flop (didn't bet)



PokerStars Zoom Hand #257988583312:  Hold'em No Limit (€0.01/€0.02) [ADM ID: M62BA304494E32ST] - 2025/10/04 0:13:38 CET [2025/10/03 18:13:38 ET]
Table 'Sirio' 6-max Seat #1 is the button
Seat 1: fantaasso (€4.07 in chips) 
Seat 2: stfuplzudonk (€1.81 in chips) 
Seat 3: cesaretto23 (€0.60 in chips) 
Seat 4: caduceus369 (€3.52 in chips) 
Seat 5: Peru91j (€2.48 in chips) 
Seat 6: Bristol1964 (€1 in chips) 
stfuplzudonk: posts small blind €0.01
cesaretto23: posts big blind €0.02
*** HOLE CARDS ***
Dealt to caduceus369 [Tc 9d]
caduceus369: folds 
Peru91j: folds 
Bristol1964: folds 
fantaasso: folds 
stfuplzudonk: raises €0.04 to €0.06
cesaretto23: calls €0.04
*** FLOP *** [Jc 4d 5d]
stfuplzudonk: bets €0.06
cesaretto23: calls €0.06
*** TURN *** [Jc 4d 5d] [8d]
stfuplzudonk: bets €0.12
cesaretto23: calls €0.12
*** RIVER *** [Jc 4d 5d 8d] [Jh]
stfuplzudonk: checks 
cesaretto23: checks 
*** SHOW DOWN ***
stfuplzudonk: shows [As 7d] (a pair of Jacks)
cesaretto23: shows [Qd 4c] (two pair, Jacks and Fours)
cesaretto23 collected €0.46 from pot
*** SUMMARY ***
Total pot €0.48 | Rake €0.02 
Board [Jc 4d 5d 8d Jh]
Seat 1: fantaasso (button) folded before Flop (didn't bet)
Seat 2: stfuplzudonk (small blind) showed [As 7d] and lost with a pair of Jacks
Seat 3: cesaretto23 (big blind) showed [Qd 4c] and won (€0.46) with two pair, Jacks and Fours
Seat 4: caduceus369 folded before Flop (didn't bet)
Seat 5: Peru91j folded before Flop (didn't bet)
Seat 6: Bristol1964 folded before Flop (didn't bet)



PokerStars Zoom Hand #257988587957:  Hold'em No Limit (€0.01/€0.02) [ADM ID: M62BA304494E32ST] - 2025/10/04 0:13:59 CET [2025/10/03 18:13:59 ET]
Table 'Sirio' 6-max Seat #1 is the button
Seat 1: LentaM3nte (€1.51 in chips) 
Seat 2: Bristol1964 (€1.01 in chips) 
Seat 3: deojking (€1.73 in chips) 
Seat 4: stfuplzudonk (€2.97 in chips) 
Seat 5: father2008 (€5.42 in chips) 
Seat 6: caduceus369 (€3.51 in chips) 
Bristol1964: posts small blind €0.01
deojking: posts big blind €0.02
*** HOLE CARDS ***
Dealt to caduceus369 [5d 5s]
stfuplzudonk: folds 
father2008: folds 
caduceus369: calls €0.02
LentaM3nte: folds 
Bristol1964: raises €0.99 to €1.01 and is all-in
deojking: calls €0.99
caduceus369: folds 
*** FLOP *** [6s 9s Td]
*** TURN *** [6s 9s Td] [Ad]
*** RIVER *** [6s 9s Td Ad] [Tc]
*** SHOW DOWN ***
Bristol1964: shows [Qd Ah] (two pair, Aces and Tens)
deojking: shows [Jd Jc] (two pair, Jacks and Tens)
Bristol1964 collected €1.93 from pot
*** SUMMARY ***
Total pot €2.04 | Rake €0.11 
Board [6s 9s Td Ad Tc]
Seat 1: LentaM3nte (button) folded before Flop (didn't bet)
Seat 2: Bristol1964 (small blind) showed [Qd Ah] and won (€1.93) with two pair, Aces and Tens
Seat 3: deojking (big blind) showed [Jd Jc] and lost with two pair, Jacks and Tens
Seat 4: stfuplzudonk folded before Flop (didn't bet)
Seat 5: father2008 folded before Flop (didn't bet)
Seat 6: caduceus369 folded before Flop



PokerStars Zoom Hand #257988593059:  Hold'em No Limit (€0.01/€0.02) [ADM ID: M62BA304494E32ST] - 2025/10/04 0:14:23 CET [2025/10/03 18:14:23 ET]
Table 'Sirio' 6-max Seat #1 is the button
Seat 1: criptlux (€3.68 in chips) 
Seat 2: maur62 (€2.48 in chips) 
Seat 3: EasyToRule (€2.22 in chips) 
Seat 4: caduceus369 (€3.49 in chips) 
Seat 5: workman75 (€3.30 in chips) 
Seat 6: father2008 (€5.45 in chips) 
maur62: posts small blind €0.01
EasyToRule: posts big blind €0.02
*** HOLE CARDS ***
Dealt to caduceus369 [Qc 8c]
caduceus369: folds 
workman75: folds 
father2008: folds 
criptlux: folds 
maur62: folds 
Uncalled bet (€0.01) returned to EasyToRule
EasyToRule collected €0.02 from pot
EasyToRule: doesn't show hand 
*** SUMMARY ***
Total pot €0.02 | Rake €0 
Seat 1: criptlux (button) folded before Flop (didn't bet)
Seat 2: maur62 (small blind) folded before Flop
Seat 3: EasyToRule (big blind) collected (€0.02)
Seat 4: caduceus369 folded before Flop (didn't bet)
Seat 5: workman75 folded before Flop (didn't bet)
Seat 6: father2008 folded before Flop (didn't bet)



PokerStars Zoom Hand #257988595180:  Hold'em No Limit (€0.01/€0.02) [ADM ID: M62BA304494E32ST] - 2025/10/04 0:14:33 CET [2025/10/03 18:14:33 ET]
Table 'Sirio' 6-max Seat #1 is the button
Seat 1: caduceus369 (€3.49 in chips) 
Seat 2: pepenero11 (€1.93 in chips) 
Seat 3: workman75 (€3.30 in chips) 
Seat 4: Peru91j (€2.38 in chips) 
Seat 5: LentaM3nte (€1.49 in chips) 
Seat 6: outshined8 (€0.47 in chips) 
pepenero11: posts small blind €0.01
workman75: posts big blind €0.02
*** HOLE CARDS ***
Dealt to caduceus369 [9c 8h]
Peru91j: folds 
LentaM3nte: folds 
outshined8: raises €0.45 to €0.47 and is all-in
caduceus369: folds 
pepenero11: folds 
workman75: folds 
Uncalled bet (€0.45) returned to outshined8
outshined8 collected €0.05 from pot
outshined8: doesn't show hand 
*** SUMMARY ***
Total pot €0.05 | Rake €0 
Seat 1: caduceus369 (button) folded before Flop (didn't bet)
Seat 2: pepenero11 (small blind) folded before Flop
Seat 3: workman75 (big blind) folded before Flop
Seat 4: Peru91j folded before Flop (didn't bet)
Seat 5: LentaM3nte folded before Flop (didn't bet)
Seat 6: outshined8 collected (€0.05)



PokerStars Zoom Hand #257988586208:  Hold'em No Limit (€0.01/€0.02) [ADM ID: M62BA304494E32ST] - 2025/10/04 0:13:51 CET [2025/10/03 18:13:51 ET]
Table 'Sirio' 6-max Seat #1 is the button
Seat 1: cap e'bomb95 (€6.41 in chips) 
Seat 2: caduceus369 (€3.52 in chips) 
Seat 3: Davi3231973 (€0.74 in chips) 
Seat 4: deojking (€2.13 in chips) 
Seat 5: bruciapelo (€2.55 in chips) 
Seat 6: Catania838 (€3.03 in chips) 
caduceus369: posts small blind €0.01
Davi3231973: posts big blind €0.02
*** HOLE CARDS ***
Dealt to caduceus369 [2s Kh]
deojking: folds 
bruciapelo: raises €0.04 to €0.06
Catania838 has timed out
Catania838: folds 
cap e'bomb95: folds 
caduceus369: folds 
Davi3231973: folds 
Uncalled bet (€0.04) returned to bruciapelo
bruciapelo collected €0.05 from pot
bruciapelo: doesn't show hand 
*** SUMMARY ***
Total pot €0.05 | Rake €0 
Seat 1: cap e'bomb95 (button) folded before Flop (didn't bet)
Seat 2: caduceus369 (small blind) folded before Flop
Seat 3: Davi3231973 (big blind) folded before Flop
Seat 4: deojking folded before Flop (didn't bet)
Seat 5: bruciapelo collected (€0.05)
Seat 6: Catania838 folded before Flop (didn't bet)



PokerStars Zoom Hand #257988592228:  Hold'em No Limit (€0.01/€0.02) [ADM ID: M62BA304494E32ST] - 2025/10/04 0:14:19 CET [2025/10/03 18:14:19 ET]
Table 'Sirio' 6-max Seat #1 is the button
Seat 1: caduceus369 (€3.49 in chips) 
Seat 2: stfuplzudonk (€4.05 in chips) 
Seat 3: cap e'bomb95 (€4.71 in chips) 
Seat 4: Peru91j (€2.46 in chips) 
Seat 5: Asganaway123 (€1.53 in chips) 
Seat 6: workman75 (€3.30 in chips) 
stfuplzudonk: posts small blind €0.01
cap e'bomb95: posts big blind €0.02
*** HOLE CARDS ***
Dealt to caduceus369 [4s 8c]
Peru91j: raises €0.04 to €0.06
Asganaway123: calls €0.06
workman75: folds 
caduceus369: folds 
stfuplzudonk: calls €0.05
cap e'bomb95: folds 
*** FLOP *** [8s 6d 2h]
stfuplzudonk: checks 
Peru91j: checks 
Asganaway123: checks 
*** TURN *** [8s 6d 2h] [5d]
stfuplzudonk: checks 
Peru91j: checks 
Asganaway123: bets €0.08
stfuplzudonk: folds 
Peru91j: folds 
Uncalled bet (€0.08) returned to Asganaway123
Asganaway123 collected €0.19 from pot
Asganaway123: doesn't show hand 
*** SUMMARY ***
Total pot €0.20 | Rake €0.01 
Board [8s 6d 2h 5d]
Seat 1: caduceus369 (button) folded before Flop (didn't bet)
Seat 2: stfuplzudonk (small blind) folded on the Turn
Seat 3: cap e'bomb95 (big blind) folded before Flop
Seat 4: Peru91j folded on the Turn
Seat 5: Asganaway123 collected (€0.19)
Seat 6: workman75 folded before Flop (didn't bet)



PokerStars Zoom Hand #257988596039:  Hold'em No Limit (€0.01/€0.02) [ADM ID: M62BA304494E32ST] - 2025/10/04 0:14:37 CET [2025/10/03 18:14:37 ET]
Table 'Sirio' 6-max Seat #1 is the button
Seat 1: Ceribelli1705 (€3.02 in chips) 
Seat 2: deojking (€0.72 in chips) 
Seat 3: caduceus369 (€3.49 in chips) 
Seat 4: criptlux (€3.68 in chips) 
Seat 5: Peru91j (€2.38 in chips) 
Seat 6: Witness85906 (€4.66 in chips) 
deojking: posts small blind €0.01
caduceus369: posts big blind €0.02
*** HOLE CARDS ***
Dealt to caduceus369 [6d Qd]
criptlux: folds 
Peru91j: folds 
Witness85906: folds 
Ceribelli1705: folds 
deojking: calls €0.01
caduceus369: checks 
*** FLOP *** [Qc 2c 6h]
deojking: checks 
caduceus369: bets €0.02
deojking: calls €0.02
*** TURN *** [Qc 2c 6h] [Ac]
deojking: checks 
caduceus369: checks 
*** RIVER *** [Qc 2c 6h Ac] [9c]
deojking: bets €0.07
caduceus369: folds 
Uncalled bet (€0.07) returned to deojking
deojking collected €0.08 from pot
deojking: doesn't show hand 
*** SUMMARY ***
Total pot €0.08 | Rake €0 
Board [Qc 2c 6h Ac 9c]
Seat 1: Ceribelli1705 (button) folded before Flop (didn't bet)
Seat 2: deojking (small blind) collected (€0.08)
Seat 3: caduceus369 (big blind) folded on the River
Seat 4: criptlux folded before Flop (didn't bet)
Seat 5: Peru91j folded before Flop (didn't bet)
Seat 6: Witness85906 folded before Flop (didn't bet)



PokerStars Zoom Hand #257988605122:  Hold'em No Limit (€0.01/€0.02) [ADM ID: M62BA304494E32ST] - 2025/10/04 0:15:19 CET [2025/10/03 18:15:19 ET]
Table 'Sirio' 6-max Seat #1 is the button
Seat 1: deojking (€0.76 in chips) 
Seat 2: caduceus369 (€3.45 in chips) 
Seat 3: Asganaway123 (€1.66 in chips) 
Seat 4: colosso2022 (€2.04 in chips) 
Seat 5: michy0757 (€2.45 in chips) 
Seat 6: stfuplzudonk (€5.31 in chips) 
caduceus369: posts small blind €0.01
Asganaway123: posts big blind €0.02
*** HOLE CARDS ***
Dealt to caduceus369 [As 9d]
colosso2022: folds 
michy0757: raises €0.08 to €0.10
stfuplzudonk: folds 
deojking: folds 
caduceus369: folds 
Asganaway123: folds 
Uncalled bet (€0.08) returned to michy0757
michy0757 collected €0.05 from pot
michy0757: doesn't show hand 
*** SUMMARY ***
Total pot €0.05 | Rake €0 
Seat 1: deojking (button) folded before Flop (didn't bet)
Seat 2: caduceus369 (small blind) folded before Flop
Seat 3: Asganaway123 (big blind) folded before Flop
Seat 4: colosso2022 folded before Flop (didn't bet)
Seat 5: michy0757 collected (€0.05)
Seat 6: stfuplzudonk folded before Flop (didn't bet)



PokerStars Zoom Hand #257988608394:  Hold'em No Limit (€0.01/€0.02) [ADM ID: M62BA304494E32ST] - 2025/10/04 0:15:34 CET [2025/10/03 18:15:34 ET]
Table 'Sirio' 6-max Seat #1 is the button
Seat 1: maur62 (€0.16 in chips) 
Seat 2: IsyP99 (€1.28 in chips) 
Seat 3: criptlux (€1.62 in chips) 
Seat 4: cesaretto23 (€0.79 in chips) 
Seat 5: caduceus369 (€3.44 in chips) 
Seat 6: Asganaway123 (€1.64 in chips) 
IsyP99: posts small blind €0.01
criptlux: posts big blind €0.02
*** HOLE CARDS ***
Dealt to caduceus369 [8s 8d]
cesaretto23: calls €0.02
caduceus369: calls €0.02
Asganaway123: folds 
maur62: folds 
IsyP99: folds 
criptlux: checks 
*** FLOP *** [7c 8h 3d]
criptlux: checks 
cesaretto23: checks 
caduceus369: checks 
*** TURN *** [7c 8h 3d] [4s]
criptlux: checks 
cesaretto23: checks 
caduceus369: bets €0.06
criptlux: folds 
cesaretto23: folds 
Uncalled bet (€0.06) returned to caduceus369
caduceus369 collected €0.07 from pot
caduceus369: doesn't show hand 
*** SUMMARY ***
Total pot €0.07 | Rake €0 
Board [7c 8h 3d 4s]
Seat 1: maur62 (button) folded before Flop (didn't bet)
Seat 2: IsyP99 (small blind) folded before Flop
Seat 3: criptlux (big blind) folded on the Turn
Seat 4: cesaretto23 folded on the Turn
Seat 5: caduceus369 collected (€0.07)
Seat 6: Asganaway123 folded before Flop (didn't bet)



PokerStars Zoom Hand #257988617203:  Hold'em No Limit (€0.01/€0.02) [ADM ID: M62BA304494E32ST] - 2025/10/04 0:16:16 CET [2025/10/03 18:16:16 ET]
Table 'Sirio' 6-max Seat #1 is the button
Seat 1: caduceus369 (€3.49 in chips) 
Seat 2: CIKO71131 (€0.74 in chips) 
Seat 3: EasyToRule (€2.21 in chips) 
Seat 4: fantaasso (€2.89 in chips) 
Seat 5: criptlux (€1.60 in chips) 
Seat 6: deojking (€1.93 in chips) 
CIKO71131: posts small blind €0.01
EasyToRule: posts big blind €0.02
*** HOLE CARDS ***
Dealt to caduceus369 [6c Kc]
fantaasso: folds 
criptlux: folds 
deojking: raises €0.04 to €0.06
caduceus369: folds 
CIKO71131: folds 
EasyToRule: folds 
Uncalled bet (€0.04) returned to deojking
deojking collected €0.05 from pot
deojking: doesn't show hand 
*** SUMMARY ***
Total pot €0.05 | Rake €0 
Seat 1: caduceus369 (button) folded before Flop (didn't bet)
Seat 2: CIKO71131 (small blind) folded before Flop
Seat 3: EasyToRule (big blind) folded before Flop
Seat 4: fantaasso folded before Flop (didn't bet)
Seat 5: criptlux folded before Flop (didn't bet)
Seat 6: deojking collected (€0.05)



PokerStars Zoom Hand #257988620225:  Hold'em No Limit (€0.01/€0.02) [ADM ID: M62BA304494E32ST] - 2025/10/04 0:16:30 CET [2025/10/03 18:16:30 ET]
Table 'Sirio' 6-max Seat #1 is the button
Seat 1: EasyToRule (€5.10 in chips) 
Seat 2: stfuplzudonk (€5.28 in chips) 
Seat 3: Catania838 (€2.04 in chips) 
Seat 4: caduceus369 (€3.49 in chips) 
Seat 5: fantaasso (€2.89 in chips) 
Seat 6: deojking (€1.96 in chips) 
stfuplzudonk: posts small blind €0.01
Catania838: posts big blind €0.02
*** HOLE CARDS ***
Dealt to caduceus369 [Ac 8c]
caduceus369: folds 
fantaasso: folds 
deojking: folds 
EasyToRule: raises €0.03 to €0.05
stfuplzudonk: folds 
Catania838: folds 
Uncalled bet (€0.03) returned to EasyToRule
EasyToRule collected €0.05 from pot
EasyToRule: doesn't show hand 
*** SUMMARY ***
Total pot €0.05 | Rake €0 
Seat 1: EasyToRule (button) collected (€0.05)
Seat 2: stfuplzudonk (small blind) folded before Flop
Seat 3: Catania838 (big blind) folded before Flop
Seat 4: caduceus369 folded before Flop (didn't bet)
Seat 5: fantaasso folded before Flop (didn't bet)
Seat 6: deojking folded before Flop (didn't bet)



PokerStars Zoom Hand #257988618906:  Hold'em No Limit (€0.01/€0.02) [ADM ID: M62BA304494E32ST] - 2025/10/04 0:16:24 CET [2025/10/03 18:16:24 ET]
Table 'Sirio' 6-max Seat #1 is the button
Seat 1: maur62 (€2.52 in chips) 
Seat 2: criptlux (€1.60 in chips) 
Seat 3: Catania838 (€0.60 in chips) 
Seat 4: father2008 (€5.37 in chips) 
Seat 5: fantaasso (€4.19 in chips) 
Seat 6: caduceus369 (€3.49 in chips) 
criptlux: posts small blind €0.01
Catania838: posts big blind €0.02
*** HOLE CARDS ***
Dealt to caduceus369 [7d 2s]
father2008: raises €0.05 to €0.07
fantaasso: folds 
caduceus369: folds 
maur62: calls €0.07
criptlux: folds 
Catania838: folds 
*** FLOP *** [2h 4c 2c]
father2008: checks 
maur62: bets €0.02
father2008: calls €0.02
*** TURN *** [2h 4c 2c] [4h]
father2008: checks 
maur62: bets €0.02
father2008: calls €0.02
*** RIVER *** [2h 4c 2c 4h] [3c]
father2008: checks 
maur62: checks 
*** SHOW DOWN ***
father2008: shows [Jh Ad] (two pair, Fours and Deuces)
maur62: shows [Jc Jd] (two pair, Jacks and Fours)
maur62 collected €0.24 from pot
*** SUMMARY ***
Total pot €0.25 | Rake €0.01 
Board [2h 4c 2c 4h 3c]
Seat 1: maur62 (button) showed [Jc Jd] and won (€0.24) with two pair, Jacks and Fours
Seat 2: criptlux (small blind) folded before Flop
Seat 3: Catania838 (big blind) folded before Flop
Seat 4: father2008 showed [Jh Ad] and lost with two pair, Fours and Deuces
Seat 5: fantaasso folded before Flop (didn't bet)
Seat 6: caduceus369 folded before Flop (didn't bet)



PokerStars Zoom Hand #257988621538:  Hold'em No Limit (€0.01/€0.02) [ADM ID: M62BA304494E32ST] - 2025/10/04 0:16:36 CET [2025/10/03 18:16:36 ET]
Table 'Sirio' 6-max Seat #1 is the button
Seat 1: stfuplzudonk (€4.15 in chips) 
Seat 2: deojking (€1.96 in chips) 
Seat 3: KillByte00 (€2 in chips) 
Seat 4: Peru91j (€2.33 in chips) 
Seat 5: caduceus369 (€3.49 in chips) 
Seat 6: Davi3231973 (€0.77 in chips) 
deojking: posts small blind €0.01
KillByte00: posts big blind €0.02
*** HOLE CARDS ***
Dealt to caduceus369 [2d 7s]
Peru91j: folds 
caduceus369: folds 
Davi3231973: folds 
stfuplzudonk: raises €0.04 to €0.06
deojking: folds 
KillByte00: calls €0.04
*** FLOP *** [Jh 4s 6c]
KillByte00: checks 
stfuplzudonk: bets €0.07
KillByte00: folds 
Uncalled bet (€0.07) returned to stfuplzudonk
stfuplzudonk collected €0.13 from pot
stfuplzudonk: doesn't show hand 
*** SUMMARY ***
Total pot €0.13 | Rake €0 
Board [Jh 4s 6c]
Seat 1: stfuplzudonk (button) collected (€0.13)
Seat 2: deojking (small blind) folded before Flop
Seat 3: KillByte00 (big blind) folded on the Flop
Seat 4: Peru91j folded before Flop (didn't bet)
Seat 5: caduceus369 folded before Flop (didn't bet)
Seat 6: Davi3231973 folded before Flop (didn't bet)



PokerStars Zoom Hand #257988622796:  Hold'em No Limit (€0.01/€0.02) [ADM ID: M62BA304494E32ST] - 2025/10/04 0:16:42 CET [2025/10/03 18:16:42 ET]
Table 'Sirio' 6-max Seat #1 is the button
Seat 1: cesaretto23 (€0.77 in chips) 
Seat 2: Poetto65 (€0.70 in chips) 
Seat 3: Peru91j (€2.33 in chips) 
Seat 4: caduceus369 (€3.49 in chips) 
Seat 5: deojking (€1.95 in chips) 
Seat 6: Catania838 (€2.02 in chips) 
Poetto65: posts small blind €0.01
Peru91j: posts big blind €0.02
*** HOLE CARDS ***
Dealt to caduceus369 [4s 2c]
caduceus369: folds 
deojking: raises €0.04 to €0.06
Catania838: calls €0.06
cesaretto23: raises €0.71 to €0.77 and is all-in
Poetto65: folds 
Peru91j: folds 
deojking: raises €0.71 to €1.48
Catania838: folds 
Uncalled bet (€0.71) returned to deojking
*** FLOP *** [Th 8c 6s]
*** TURN *** [Th 8c 6s] [8s]
*** RIVER *** [Th 8c 6s 8s] [3h]
*** SHOW DOWN ***
deojking: shows [Ac Ks] (a pair of Eights)
cesaretto23: shows [3s 3c] (a full house, Threes full of Eights)
cesaretto23 collected €1.55 from pot
*** SUMMARY ***
Total pot €1.63 | Rake €0.08 
Board [Th 8c 6s 8s 3h]
Seat 1: cesaretto23 (button) showed [3s 3c] and won (€1.55) with a full house, Threes full of Eights
Seat 2: Poetto65 (small blind) folded before Flop
Seat 3: Peru91j (big blind) folded before Flop
Seat 4: caduceus369 folded before Flop (didn't bet)
Seat 5: deojking showed [Ac Ks] and lost with a pair of Eights
Seat 6: Catania838 folded before Flop



PokerStars Zoom Hand #257988625153:  Hold'em No Limit (€0.01/€0.02) [ADM ID: M62BA304494E32ST] - 2025/10/04 0:16:53 CET [2025/10/03 18:16:53 ET]
Table 'Sirio' 6-max Seat #1 is the button
Seat 1: EasyToRule (€2.18 in chips) 
Seat 2: Giova8427 (€0.78 in chips) 
Seat 3: caduceus369 (€3.49 in chips) 
Seat 4: stfuplzudonk (€1.66 in chips) 
Seat 5: iceangel2003 (€1.42 in chips) 
Seat 6: IsyP99 (€1.02 in chips) 
Giova8427: posts small blind €0.01
caduceus369: posts big blind €0.02
*** HOLE CARDS ***
Dealt to caduceus369 [Ac Jd]
stfuplzudonk: folds 
iceangel2003: folds 
IsyP99: calls €0.02
EasyToRule: raises €0.07 to €0.09
Giova8427: calls €0.08
caduceus369: raises €0.17 to €0.26
IsyP99: calls €0.24
EasyToRule: calls €0.17
Giova8427: calls €0.17
*** FLOP *** [9c 9h Qd]
Giova8427: checks 
caduceus369: checks 
IsyP99: checks 
EasyToRule: bets €0.48
Giova8427: folds 
caduceus369: folds 
IsyP99: folds 
Uncalled bet (€0.48) returned to EasyToRule
EasyToRule collected €0.99 from pot
EasyToRule: doesn't show hand 
*** SUMMARY ***
Total pot €1.04 | Rake €0.05 
Board [9c 9h Qd]
Seat 1: EasyToRule (button) collected (€0.99)
Seat 2: Giova8427 (small blind) folded on the Flop
Seat 3: caduceus369 (big blind) folded on the Flop
Seat 4: stfuplzudonk folded before Flop (didn't bet)
Seat 5: iceangel2003 folded before Flop (didn't bet)
Seat 6: IsyP99 folded on the Flop



PokerStars Zoom Hand #257988645939:  Hold'em No Limit (€0.01/€0.02) [ADM ID: M62BA304494E32ST] - 2025/10/04 0:18:30 CET [2025/10/03 18:18:30 ET]
Table 'Sirio' 6-max Seat #1 is the button
Seat 1: stfuplzudonk (€4.32 in chips) 
Seat 2: caduceus369 (€3.23 in chips) 
Seat 3: KillByte00 (€2.45 in chips) 
Seat 4: workman75 (€2.07 in chips) 
Seat 5: maur62 (€0.95 in chips) 
Seat 6: Catania838 (€3 in chips) 
caduceus369: posts small blind €0.01
KillByte00: posts big blind €0.02
*** HOLE CARDS ***
Dealt to caduceus369 [6c 6s]
workman75: folds 
maur62: folds 
Catania838 has timed out
Catania838: folds 
stfuplzudonk: folds 
caduceus369: calls €0.01
KillByte00: checks 
*** FLOP *** [Kd Jc 7h]
caduceus369: checks 
KillByte00: checks 
*** TURN *** [Kd Jc 7h] [2d]
caduceus369: checks 
KillByte00: checks 
*** RIVER *** [Kd Jc 7h 2d] [Jd]
caduceus369: bets €0.02
KillByte00: folds 
Uncalled bet (€0.02) returned to caduceus369
caduceus369 collected €0.04 from pot
caduceus369: doesn't show hand 
*** SUMMARY ***
Total pot €0.04 | Rake €0 
Board [Kd Jc 7h 2d Jd]
Seat 1: stfuplzudonk (button) folded before Flop (didn't bet)
Seat 2: caduceus369 (small blind) collected (€0.04)
Seat 3: KillByte00 (big blind) folded on the River
Seat 4: workman75 folded before Flop (didn't bet)
Seat 5: maur62 folded before Flop (didn't bet)
Seat 6: Catania838 folded before Flop (didn't bet)



PokerStars Zoom Hand #257988654959:  Hold'em No Limit (€0.01/€0.02) [ADM ID: M62BA304494E32ST] - 2025/10/04 0:19:12 CET [2025/10/03 18:19:12 ET]
Table 'Sirio' 6-max Seat #1 is the button
Seat 1: The clansman77 (€0.78 in chips) 
Seat 2: IsyP99 (€0.79 in chips) 
Seat 3: bruciapelo (€2.55 in chips) 
Seat 4: KillByte00 (€2.43 in chips) 
Seat 5: stfuplzudonk (€1.56 in chips) 
Seat 6: caduceus369 (€3.25 in chips) 
IsyP99: posts small blind €0.01
bruciapelo: posts big blind €0.02
*** HOLE CARDS ***
Dealt to caduceus369 [Qc 6c]
KillByte00: raises €0.03 to €0.05
stfuplzudonk: folds 
caduceus369: folds 
The clansman77: folds 
IsyP99: folds 
bruciapelo: folds 
Uncalled bet (€0.03) returned to KillByte00
KillByte00 collected €0.05 from pot
KillByte00: doesn't show hand 
*** SUMMARY ***
Total pot €0.05 | Rake €0 
Seat 1: The clansman77 (button) folded before Flop (didn't bet)
Seat 2: IsyP99 (small blind) folded before Flop
Seat 3: bruciapelo (big blind) folded before Flop
Seat 4: KillByte00 collected (€0.05)
Seat 5: stfuplzudonk folded before Flop (didn't bet)
Seat 6: caduceus369 folded before Flop (didn't bet)



PokerStars Zoom Hand #257988657950:  Hold'em No Limit (€0.01/€0.02) [ADM ID: M62BA304494E32ST] - 2025/10/04 0:19:26 CET [2025/10/03 18:19:26 ET]
Table 'Sirio' 6-max Seat #1 is the button
Seat 1: assomatto308 (€1.02 in chips) 
Seat 2: bruciapelo (€2.53 in chips) 
Seat 3: caduceus369 (€3.25 in chips) 
Seat 4: workman75 (€1.73 in chips) 
Seat 5: iceangel2003 (€1.44 in chips) 
Seat 6: cap e'bomb95 (€4.74 in chips) 
bruciapelo: posts small blind €0.01
caduceus369: posts big blind €0.02
*** HOLE CARDS ***
Dealt to caduceus369 [9h 8c]
workman75: raises €0.04 to €0.06
iceangel2003: folds 
cap e'bomb95: folds 
assomatto308: folds 
bruciapelo: folds 
caduceus369: folds 
Uncalled bet (€0.04) returned to workman75
workman75 collected €0.05 from pot
workman75: doesn't show hand 
*** SUMMARY ***
Total pot €0.05 | Rake €0 
Seat 1: assomatto308 (button) folded before Flop (didn't bet)
Seat 2: bruciapelo (small blind) folded before Flop
Seat 3: caduceus369 (big blind) folded before Flop
Seat 4: workman75 collected (€0.05)
Seat 5: iceangel2003 folded before Flop (didn't bet)
Seat 6: cap e'bomb95 folded before Flop (didn't bet)



PokerStars Zoom Hand #257988657052:  Hold'em No Limit (€0.01/€0.02) [ADM ID: M62BA304494E32ST] - 2025/10/04 0:19:22 CET [2025/10/03 18:19:22 ET]
Table 'Sirio' 6-max Seat #1 is the button
Seat 1: caduceus369 (€3.25 in chips) 
Seat 2: cap e'bomb95 (€5.97 in chips) 
Seat 3: maur62 (€1.21 in chips) 
Seat 4: Catania838 (€0.78 in chips) 
Seat 5: SKERZA (€1.91 in chips) 
Seat 6: The clansman77 (€0.77 in chips) 
cap e'bomb95: posts small blind €0.01
maur62: posts big blind €0.02
*** HOLE CARDS ***
Dealt to caduceus369 [5s Ah]
Catania838: folds 
SKERZA: raises €0.06 to €0.08
The clansman77: folds 
caduceus369: folds 
cap e'bomb95: folds 
maur62: folds 
Uncalled bet (€0.06) returned to SKERZA
SKERZA collected €0.05 from pot
SKERZA: doesn't show hand 
*** SUMMARY ***
Total pot €0.05 | Rake €0 
Seat 1: caduceus369 (button) folded before Flop (didn't bet)
Seat 2: cap e'bomb95 (small blind) folded before Flop
Seat 3: maur62 (big blind) folded before Flop
Seat 4: Catania838 folded before Flop (didn't bet)
Seat 5: SKERZA collected (€0.05)
Seat 6: The clansman77 folded before Flop (didn't bet)



PokerStars Zoom Hand #257988659241:  Hold'em No Limit (€0.01/€0.02) [ADM ID: M62BA304494E32ST] - 2025/10/04 0:19:32 CET [2025/10/03 18:19:32 ET]
Table 'Sirio' 6-max Seat #1 is the button
Seat 1: michy0757 (€2.25 in chips) 
Seat 2: Catania838 (€2.96 in chips) 
Seat 3: stfuplzudonk (€1.59 in chips) 
Seat 4: cap e'bomb95 (€5.96 in chips) 
Seat 5: assomatto308 (€1.02 in chips) 
Seat 6: caduceus369 (€3.23 in chips) 
Catania838: posts small blind €0.01
stfuplzudonk: posts big blind €0.02
*** HOLE CARDS ***
Dealt to caduceus369 [Kh Js]
cap e'bomb95: folds 
assomatto308: raises €0.05 to €0.07
caduceus369: folds 
michy0757: raises €0.17 to €0.24
Catania838: folds 
stfuplzudonk: folds 
assomatto308: calls €0.17
*** FLOP *** [3s 4h 2d]
assomatto308: bets €0.78 and is all-in
michy0757: folds 
Uncalled bet (€0.78) returned to assomatto308
assomatto308 collected €0.49 from pot
assomatto308: doesn't show hand 
*** SUMMARY ***
Total pot €0.51 | Rake €0.02 
Board [3s 4h 2d]
Seat 1: michy0757 (button) folded on the Flop
Seat 2: Catania838 (small blind) folded before Flop
Seat 3: stfuplzudonk (big blind) folded before Flop
Seat 4: cap e'bomb95 folded before Flop (didn't bet)
Seat 5: assomatto308 collected (€0.49)
Seat 6: caduceus369 folded before Flop (didn't bet)



PokerStars Zoom Hand #257988660687:  Hold'em No Limit (€0.01/€0.02) [ADM ID: M62BA304494E32ST] - 2025/10/04 0:19:39 CET [2025/10/03 18:19:39 ET]
Table 'Sirio' 6-max Seat #1 is the button
Seat 1: Asganaway123 (€1.49 in chips) 
Seat 2: caduceus369 (€3.23 in chips) 
Seat 3: Meryjuventina (€2.53 in chips) 
Seat 4: tigermiscio (€1.06 in chips) 
Seat 5: stfuplzudonk (€4.16 in chips) 
Seat 6: bruciapelo (€2.52 in chips) 
caduceus369: posts small blind €0.01
Meryjuventina: posts big blind €0.02
*** HOLE CARDS ***
Dealt to caduceus369 [6d Ad]
tigermiscio: raises €0.02 to €0.04
stfuplzudonk: folds 
bruciapelo: folds 
Asganaway123: folds 
caduceus369: folds 
Meryjuventina: calls €0.02
*** FLOP *** [Tc 4s Ks]
Meryjuventina: checks 
tigermiscio: bets €0.06
Meryjuventina: calls €0.06
*** TURN *** [Tc 4s Ks] [2h]
Meryjuventina: checks 
tigermiscio: checks 
*** RIVER *** [Tc 4s Ks 2h] [9c]
Meryjuventina: bets €0.24
tigermiscio: folds 
Uncalled bet (€0.24) returned to Meryjuventina
Meryjuventina collected €0.20 from pot
Meryjuventina: doesn't show hand 
*** SUMMARY ***
Total pot €0.21 | Rake €0.01 
Board [Tc 4s Ks 2h 9c]
Seat 1: Asganaway123 (button) folded before Flop (didn't bet)
Seat 2: caduceus369 (small blind) folded before Flop
Seat 3: Meryjuventina (big blind) collected (€0.20)
Seat 4: tigermiscio folded on the River
Seat 5: stfuplzudonk folded before Flop (didn't bet)
Seat 6: bruciapelo folded before Flop (didn't bet)



PokerStars Zoom Hand #257988668037:  Hold'em No Limit (€0.01/€0.02) [ADM ID: M62BA304494E32ST] - 2025/10/04 0:20:13 CET [2025/10/03 18:20:13 ET]
Table 'Sirio' 6-max Seat #1 is the button
Seat 1: CacciatoreAA (€2.30 in chips) 
Seat 2: father2008 (€5.08 in chips) 
Seat 3: SKERZA (€1.99 in chips) 
Seat 4: cap e'bomb95 (€5.85 in chips) 
Seat 5: Catania838 (€2.95 in chips) 
Seat 6: caduceus369 (€3.22 in chips) 
father2008: posts small blind €0.01
SKERZA: posts big blind €0.02
*** HOLE CARDS ***
Dealt to caduceus369 [5c 6c]
cap e'bomb95: folds 
Catania838: raises €0.02 to €0.04
caduceus369: folds 
CacciatoreAA: folds 
father2008: folds 
SKERZA: calls €0.02
*** FLOP *** [2s 5d Jc]
SKERZA: checks 
Catania838: bets €0.09
SKERZA: folds 
Uncalled bet (€0.09) returned to Catania838
Catania838 collected €0.09 from pot
Catania838: doesn't show hand 
*** SUMMARY ***
Total pot €0.09 | Rake €0 
Board [2s 5d Jc]
Seat 1: CacciatoreAA (button) folded before Flop (didn't bet)
Seat 2: father2008 (small blind) folded before Flop
Seat 3: SKERZA (big blind) folded on the Flop
Seat 4: cap e'bomb95 folded before Flop (didn't bet)
Seat 5: Catania838 collected (€0.09)
Seat 6: caduceus369 folded before Flop (didn't bet)



PokerStars Zoom Hand #257988664312:  Hold'em No Limit (€0.01/€0.02) [ADM ID: M62BA304494E32ST] - 2025/10/04 0:19:56 CET [2025/10/03 18:19:56 ET]
Table 'Sirio' 6-max Seat #1 is the button
Seat 1: caduceus369 (€3.22 in chips) 
Seat 2: father2008 (€4.75 in chips) 
Seat 3: The clansman77 (€0.77 in chips) 
Seat 4: fantaasso (€2.92 in chips) 
Seat 5: Asganaway123 (€1.49 in chips) 
Seat 6: stfuplzudonk (€5.71 in chips) 
father2008: posts small blind €0.01
The clansman77: posts big blind €0.02
*** HOLE CARDS ***
Dealt to caduceus369 [Qc 9d]
fantaasso: folds 
Asganaway123: folds 
stfuplzudonk: raises €0.02 to €0.04
caduceus369: folds 
father2008: folds 
The clansman77: calls €0.02
*** FLOP *** [4c Th 6h]
The clansman77: checks 
stfuplzudonk: bets €0.05
The clansman77: calls €0.05
*** TURN *** [4c Th 6h] [7c]
The clansman77: checks 
stfuplzudonk: checks 
*** RIVER *** [4c Th 6h 7c] [Qs]
The clansman77: checks 
stfuplzudonk: checks 
*** SHOW DOWN ***
The clansman77: shows [2s 6d] (a pair of Sixes)
stfuplzudonk: mucks hand 
The clansman77 collected €0.18 from pot
*** SUMMARY ***
Total pot €0.19 | Rake €0.01 
Board [4c Th 6h 7c Qs]
Seat 1: caduceus369 (button) folded before Flop (didn't bet)
Seat 2: father2008 (small blind) folded before Flop
Seat 3: The clansman77 (big blind) showed [2s 6d] and won (€0.18) with a pair of Sixes
Seat 4: fantaasso folded before Flop (didn't bet)
Seat 5: Asganaway123 folded before Flop (didn't bet)
Seat 6: stfuplzudonk mucked [Jh 4h]



PokerStars Zoom Hand #257988667201:  Hold'em No Limit (€0.01/€0.02) [ADM ID: M62BA304494E32ST] - 2025/10/04 0:20:09 CET [2025/10/03 18:20:09 ET]
Table 'Sirio' 6-max Seat #1 is the button
Seat 1: wiola3922 (€1.06 in chips) 
Seat 2: iceangel2003 (€1.55 in chips) 
Seat 3: fantaasso (€2.92 in chips) 
Seat 4: workman75 (€1.91 in chips) 
Seat 5: caduceus369 (€3.22 in chips) 
Seat 6: Catania838 (€2.95 in chips) 
iceangel2003: posts small blind €0.01
fantaasso: posts big blind €0.02
*** HOLE CARDS ***
Dealt to caduceus369 [8s Jd]
workman75: folds 
caduceus369: folds 
Catania838: folds 
wiola3922: calls €0.02
iceangel2003: calls €0.01
fantaasso: checks 
*** FLOP *** [6s 8h Ad]
iceangel2003: bets €0.03
fantaasso: folds 
wiola3922: calls €0.03
*** TURN *** [6s 8h Ad] [6h]
iceangel2003: bets €0.06
wiola3922: calls €0.06
*** RIVER *** [6s 8h Ad 6h] [Qc]
iceangel2003: bets €0.23
wiola3922: folds 
Uncalled bet (€0.23) returned to iceangel2003
iceangel2003 collected €0.23 from pot
iceangel2003: doesn't show hand 
*** SUMMARY ***
Total pot €0.24 | Rake €0.01 
Board [6s 8h Ad 6h Qc]
Seat 1: wiola3922 (button) folded on the River
Seat 2: iceangel2003 (small blind) collected (€0.23)
Seat 3: fantaasso (big blind) folded on the Flop
Seat 4: workman75 folded before Flop (didn't bet)
Seat 5: caduceus369 folded before Flop (didn't bet)
Seat 6: Catania838 folded before Flop (didn't bet)



PokerStars Zoom Hand #257988670228:  Hold'em No Limit (€0.01/€0.02) [ADM ID: M62BA304494E32ST] - 2025/10/04 0:20:23 CET [2025/10/03 18:20:23 ET]
Table 'Sirio' 6-max Seat #1 is the button
Seat 1: cap e'bomb95 (€5.84 in chips) 
Seat 2: Meryjuventina (€2.63 in chips) 
Seat 3: caduceus369 (€3.22 in chips) 
Seat 4: maur62 (€1.36 in chips) 
Seat 5: Giova8427 (€0.89 in chips) 
Seat 6: outshined8 (€0.60 in chips) 
Meryjuventina: posts small blind €0.01
caduceus369: posts big blind €0.02
*** HOLE CARDS ***
Dealt to caduceus369 [Ad 3h]
maur62: calls €0.02
Giova8427: folds 
outshined8: calls €0.02
cap e'bomb95: folds 
Meryjuventina: folds 
caduceus369: checks 
*** FLOP *** [Js Jh 7d]
caduceus369: checks 
maur62: checks 
outshined8: checks 
*** TURN *** [Js Jh 7d] [3c]
caduceus369: bets €0.02
maur62: calls €0.02
outshined8: folds 
*** RIVER *** [Js Jh 7d 3c] [5d]
caduceus369: bets €0.02
maur62: calls €0.02
*** SHOW DOWN ***
caduceus369: shows [Ad 3h] (two pair, Jacks and Threes)
maur62: shows [4d 4h] (two pair, Jacks and Fours)
maur62 collected €0.15 from pot
*** SUMMARY ***
Total pot €0.15 | Rake €0 
Board [Js Jh 7d 3c 5d]
Seat 1: cap e'bomb95 (button) folded before Flop (didn't bet)
Seat 2: Meryjuventina (small blind) folded before Flop
Seat 3: caduceus369 (big blind) showed [Ad 3h] and lost with two pair, Jacks and Threes
Seat 4: maur62 showed [4d 4h] and won (€0.15) with two pair, Jacks and Fours
Seat 5: Giova8427 folded before Flop (didn't bet)
Seat 6: outshined8 folded on the Turn



PokerStars Zoom Hand #257988688470:  Hold'em No Limit (€0.01/€0.02) [ADM ID: M62BA304494E32ST] - 2025/10/04 0:21:47 CET [2025/10/03 18:21:47 ET]
Table 'Sirio' 6-max Seat #1 is the button
Seat 1: bruciapelo (€2.42 in chips) 
Seat 2: Catania838 (€2 in chips) 
Seat 3: maur62 (€1.45 in chips) 
Seat 4: stfuplzudonk (€5.40 in chips) 
Seat 5: caduceus369 (€3.15 in chips) 
Seat 6: workman75 (€1.64 in chips) 
Catania838: posts small blind €0.01
maur62: posts big blind €0.02
*** HOLE CARDS ***
Dealt to caduceus369 [Qc 7d]
stfuplzudonk: raises €0.02 to €0.04
caduceus369: folds 
workman75: folds 
bruciapelo: folds 
Catania838: folds 
maur62: calls €0.02
*** FLOP *** [Td 9s 8d]
maur62: bets €0.02
stfuplzudonk: calls €0.02
*** TURN *** [Td 9s 8d] [6s]
maur62: bets €0.02
stfuplzudonk: calls €0.02
*** RIVER *** [Td 9s 8d 6s] [6h]
maur62: bets €0.02
stfuplzudonk: calls €0.02
*** SHOW DOWN ***
maur62: shows [9c Ac] (two pair, Nines and Sixes)
stfuplzudonk: mucks hand 
maur62 collected €0.20 from pot
*** SUMMARY ***
Total pot €0.21 | Rake €0.01 
Board [Td 9s 8d 6s 6h]
Seat 1: bruciapelo (button) folded before Flop (didn't bet)
Seat 2: Catania838 (small blind) folded before Flop
Seat 3: maur62 (big blind) showed [9c Ac] and won (€0.20) with two pair, Nines and Sixes
Seat 4: stfuplzudonk mucked [9h Js]
Seat 5: caduceus369 folded before Flop (didn't bet)
Seat 6: workman75 folded before Flop (didn't bet)



PokerStars Zoom Hand #257988692141:  Hold'em No Limit (€0.01/€0.02) [ADM ID: M62BA304494E32ST] - 2025/10/04 0:22:04 CET [2025/10/03 18:22:04 ET]
Table 'Sirio' 6-max Seat #1 is the button
Seat 1: Asganaway123 (€1.27 in chips) 
Seat 2: franck19621962 (€1.04 in chips) 
Seat 3: criptlux (€1.56 in chips) 
Seat 4: caduceus369 (€3.14 in chips) 
Seat 5: Bristol1964 (€2.42 in chips) 
Seat 6: cesaretto23 (€0.85 in chips) 
franck19621962: posts small blind €0.01
criptlux: posts big blind €0.02
*** HOLE CARDS ***
Dealt to caduceus369 [8c Ks]
caduceus369: folds 
Bristol1964: folds 
cesaretto23: raises €0.83 to €0.85 and is all-in
Asganaway123: folds 
franck19621962: folds 
criptlux: folds 
Uncalled bet (€0.83) returned to cesaretto23
cesaretto23 collected €0.05 from pot
cesaretto23: doesn't show hand 
*** SUMMARY ***
Total pot €0.05 | Rake €0 
Seat 1: Asganaway123 (button) folded before Flop (didn't bet)
Seat 2: franck19621962 (small blind) folded before Flop
Seat 3: criptlux (big blind) folded before Flop
Seat 4: caduceus369 folded before Flop (didn't bet)
Seat 5: Bristol1964 folded before Flop (didn't bet)
Seat 6: cesaretto23 collected (€0.05)



PokerStars Zoom Hand #257988687686:  Hold'em No Limit (€0.01/€0.02) [ADM ID: M62BA304494E32ST] - 2025/10/04 0:21:44 CET [2025/10/03 18:21:44 ET]
Table 'Sirio' 6-max Seat #1 is the button
Seat 1: Witness85906 (€6.06 in chips) 
Seat 2: robertoH2O (€2.03 in chips) 
Seat 3: Mabrac55 (€1.55 in chips) 
Seat 4: maur62 (€1.45 in chips) 
Seat 5: maury999999 (€2.78 in chips) 
Seat 6: caduceus369 (€3.15 in chips) 
robertoH2O: posts small blind €0.01
Mabrac55: posts big blind €0.02
*** HOLE CARDS ***
Dealt to caduceus369 [5s Ah]
maur62: folds 
maury999999: folds 
caduceus369: folds 
Witness85906: raises €0.03 to €0.05
robertoH2O: folds 
Mabrac55: calls €0.03
*** FLOP *** [4c 4h Kd]
Mabrac55: checks 
Witness85906: bets €0.04
Mabrac55: calls €0.04
*** TURN *** [4c 4h Kd] [Kh]
Mabrac55: checks 
Witness85906: checks 
*** RIVER *** [4c 4h Kd Kh] [Qh]
Mabrac55: bets €0.18
Witness85906: calls €0.18
*** SHOW DOWN ***
Mabrac55: shows [4s Qd] (a full house, Fours full of Kings)
Witness85906: mucks hand 
Mabrac55 collected €0.52 from pot
*** SUMMARY ***
Total pot €0.55 | Rake €0.03 
Board [4c 4h Kd Kh Qh]
Seat 1: Witness85906 (button) mucked [5h 3h]
Seat 2: robertoH2O (small blind) folded before Flop
Seat 3: Mabrac55 (big blind) showed [4s Qd] and won (€0.52) with a full house, Fours full of Kings
Seat 4: maur62 folded before Flop (didn't bet)
Seat 5: maury999999 folded before Flop (didn't bet)
Seat 6: caduceus369 folded before Flop (didn't bet)



PokerStars Zoom Hand #257988684738:  Hold'em No Limit (€0.01/€0.02) [ADM ID: M62BA304494E32ST] - 2025/10/04 0:21:30 CET [2025/10/03 18:21:30 ET]
Table 'Sirio' 6-max Seat #1 is the button
Seat 1: maur62 (€1.45 in chips) 
Seat 2: cap e'bomb95 (€4.58 in chips) 
Seat 3: Peru91j (€2.15 in chips) 
Seat 4: caduceus369 (€3.16 in chips) 
Seat 5: tigermiscio (€0.92 in chips) 
Seat 6: criptlux (€1.56 in chips) 
cap e'bomb95: posts small blind €0.01
Peru91j: posts big blind €0.02
*** HOLE CARDS ***
Dealt to caduceus369 [Td 5d]
caduceus369: folds 
tigermiscio: folds 
criptlux: folds 
maur62: folds 
cap e'bomb95: raises €0.03 to €0.05
Peru91j: calls €0.03
*** FLOP *** [Kd 8h 6s]
cap e'bomb95: checks 
Peru91j: checks 
*** TURN *** [Kd 8h 6s] [7h]
cap e'bomb95: bets €0.07
Peru91j: calls €0.07
*** RIVER *** [Kd 8h 6s 7h] [6c]
cap e'bomb95: bets €0.20
Peru91j: calls €0.20
*** SHOW DOWN ***
cap e'bomb95: shows [Kh Kc] (a full house, Kings full of Sixes)
Peru91j: mucks hand 
cap e'bomb95 collected €0.61 from pot
*** SUMMARY ***
Total pot €0.64 | Rake €0.03 
Board [Kd 8h 6s 7h 6c]
Seat 1: maur62 (button) folded before Flop (didn't bet)
Seat 2: cap e'bomb95 (small blind) showed [Kh Kc] and won (€0.61) with a full house, Kings full of Sixes
Seat 3: Peru91j (big blind) mucked [7d Ks]
Seat 4: caduceus369 folded before Flop (didn't bet)
Seat 5: tigermiscio folded before Flop (didn't bet)
Seat 6: criptlux folded before Flop (didn't bet)



PokerStars Zoom Hand #257988693913:  Hold'em No Limit (€0.01/€0.02) [ADM ID: M62BA304494E32ST] - 2025/10/04 0:22:12 CET [2025/10/03 18:22:12 ET]
Table 'Sirio' 6-max Seat #1 is the button
Seat 1: EasyToRule (€2.95 in chips) 
Seat 2: KillByte00 (€2.18 in chips) 
Seat 3: outshined8 (€0.64 in chips) 
Seat 4: Bristol1964 (€2.42 in chips) 
Seat 5: caduceus369 (€3.14 in chips) 
Seat 6: father2008 (€5.18 in chips) 
KillByte00: posts small blind €0.01
outshined8: posts big blind €0.02
*** HOLE CARDS ***
Dealt to caduceus369 [Jd 9h]
Bristol1964 is disconnected 
Bristol1964 has timed out while disconnected
Bristol1964: folds 
caduceus369: folds 
father2008: folds 
EasyToRule: raises €0.03 to €0.05
KillByte00: raises €0.15 to €0.20
outshined8: folds 
EasyToRule: folds 
Uncalled bet (€0.15) returned to KillByte00
KillByte00 collected €0.12 from pot
KillByte00: doesn't show hand 
*** SUMMARY ***
Total pot €0.12 | Rake €0 
Seat 1: EasyToRule (button) folded before Flop
Seat 2: KillByte00 (small blind) collected (€0.12)
Seat 3: outshined8 (big blind) folded before Flop
Seat 4: Bristol1964 folded before Flop (didn't bet)
Seat 5: caduceus369 folded before Flop (didn't bet)
Seat 6: father2008 folded before Flop (didn't bet)



PokerStars Zoom Hand #257988691511:  Hold'em No Limit (€0.01/€0.02) [ADM ID: M62BA304494E32ST] - 2025/10/04 0:22:01 CET [2025/10/03 18:22:01 ET]
Table 'Sirio' 6-max Seat #1 is the button
Seat 1: caduceus369 (€3.14 in chips) 
Seat 2: The clansman77 (€0.86 in chips) 
Seat 3: father2008 (€5.20 in chips) 
Seat 4: CacciatoreAA (€2.28 in chips) 
Seat 5: colosso2022 (€2.08 in chips) 
Seat 6: tigermiscio (€0.89 in chips) 
The clansman77: posts small blind €0.01
father2008: posts big blind €0.02
*** HOLE CARDS ***
Dealt to caduceus369 [2d Kh]
CacciatoreAA: raises €0.06 to €0.08
colosso2022: calls €0.08
tigermiscio: folds 
caduceus369: folds 
The clansman77: folds 
father2008: folds 
*** FLOP *** [9s 4h Jc]
CacciatoreAA: bets €0.18
colosso2022: calls €0.18
*** TURN *** [9s 4h Jc] [6c]
CacciatoreAA: bets €0.52
colosso2022: calls €0.52
*** RIVER *** [9s 4h Jc 6c] [3h]
CacciatoreAA: bets €1.50 and is all-in
colosso2022: folds 
Uncalled bet (€1.50) returned to CacciatoreAA
CacciatoreAA collected €1.51 from pot
CacciatoreAA: doesn't show hand 
*** SUMMARY ***
Total pot €1.59 | Rake €0.08 
Board [9s 4h Jc 6c 3h]
Seat 1: caduceus369 (button) folded before Flop (didn't bet)
Seat 2: The clansman77 (small blind) folded before Flop
Seat 3: father2008 (big blind) folded before Flop
Seat 4: CacciatoreAA collected (€1.51)
Seat 5: colosso2022 folded on the River
Seat 6: tigermiscio folded before Flop (didn't bet)



PokerStars Zoom Hand #257988690467:  Hold'em No Limit (€0.01/€0.02) [ADM ID: M62BA304494E32ST] - 2025/10/04 0:21:56 CET [2025/10/03 18:21:56 ET]
Table 'Sirio' 6-max Seat #1 is the button
Seat 1: tigermiscio (€0.89 in chips) 
Seat 2: caduceus369 (€3.15 in chips) 
Seat 3: workman75 (€1.64 in chips) 
Seat 4: TangaG44 (€2.22 in chips) 
Seat 5: stfuplzudonk (€4.18 in chips) 
Seat 6: Catania838 (€2.15 in chips) 
caduceus369: posts small blind €0.01
workman75: posts big blind €0.02
*** HOLE CARDS ***
Dealt to caduceus369 [Qc 5h]
TangaG44: calls €0.02
stfuplzudonk: calls €0.02
Catania838: calls €0.02
tigermiscio: folds 
caduceus369: folds 
workman75: raises €0.09 to €0.11
TangaG44: calls €0.09
stfuplzudonk: folds 
Catania838: calls €0.09
*** FLOP *** [6s 9h 2d]
workman75: bets €0.20
TangaG44: folds 
Catania838: calls €0.20
*** TURN *** [6s 9h 2d] [Td]
workman75: bets €0.40
Catania838: calls €0.40
*** RIVER *** [6s 9h 2d Td] [4d]
workman75: bets €0.93 and is all-in
Catania838: calls €0.93
*** SHOW DOWN ***
workman75: shows [2s Ad] (a pair of Deuces)
Catania838: shows [5s 3s] (a straight, Deuce to Six)
Catania838 collected €3.24 from pot
*** SUMMARY ***
Total pot €3.42 | Rake €0.18 
Board [6s 9h 2d Td 4d]
Seat 1: tigermiscio (button) folded before Flop (didn't bet)
Seat 2: caduceus369 (small blind) folded before Flop
Seat 3: workman75 (big blind) showed [2s Ad] and lost with a pair of Deuces
Seat 4: TangaG44 folded on the Flop
Seat 5: stfuplzudonk folded before Flop
Seat 6: Catania838 showed [5s 3s] and won (€3.24) with a straight, Deuce to Six



PokerStars Zoom Hand #257988686821:  Hold'em No Limit (€0.01/€0.02) [ADM ID: M62BA304494E32ST] - 2025/10/04 0:21:40 CET [2025/10/03 18:21:40 ET]
Table 'Sirio' 6-max Seat #1 is the button
Seat 1: workman75 (€1.64 in chips) 
Seat 2: caduceus369 (€3.16 in chips) 
Seat 3: tigermiscio (€0.92 in chips) 
Seat 4: mbeck65 (€2.11 in chips) 
Seat 5: DAMPER_KK (€1.92 in chips) 
Seat 6: EasyToRule (€4.91 in chips) 
caduceus369: posts small blind €0.01
tigermiscio: posts big blind €0.02
*** HOLE CARDS ***
Dealt to caduceus369 [5s 2d]
mbeck65: folds 
DAMPER_KK: calls €0.02
EasyToRule: raises €0.07 to €0.09
workman75: folds 
caduceus369: folds 
tigermiscio: folds 
DAMPER_KK: calls €0.07
*** FLOP *** [9d 2s 6h]
DAMPER_KK: checks 
EasyToRule: checks 
*** TURN *** [9d 2s 6h] [Jd]
DAMPER_KK: checks 
EasyToRule: bets €0.18
DAMPER_KK: raises €0.32 to €0.50
EasyToRule: calls €0.32
*** RIVER *** [9d 2s 6h Jd] [5h]
DAMPER_KK: bets €1.15
EasyToRule: calls €1.15
*** SHOW DOWN ***
DAMPER_KK: shows [Jc 9h] (two pair, Jacks and Nines)
EasyToRule: mucks hand 
DAMPER_KK collected €3.32 from pot
*** SUMMARY ***
Total pot €3.51 | Rake €0.19 
Board [9d 2s 6h Jd 5h]
Seat 1: workman75 (button) folded before Flop (didn't bet)
Seat 2: caduceus369 (small blind) folded before Flop
Seat 3: tigermiscio (big blind) folded before Flop
Seat 4: mbeck65 folded before Flop (didn't bet)
Seat 5: DAMPER_KK showed [Jc 9h] and won (€3.32) with two pair, Jacks and Nines
Seat 6: EasyToRule mucked [Ac Js]



PokerStars Zoom Hand #257988702647:  Hold'em No Limit (€0.01/€0.02) [ADM ID: M62BA304494E32ST] - 2025/10/04 0:22:53 CET [2025/10/03 18:22:53 ET]
Table 'Sirio' 6-max Seat #1 is the button
Seat 1: caduceus369 (€3.12 in chips) 
Seat 2: robertoH2O (€2.06 in chips) 
Seat 3: cap e'bomb95 (€4.87 in chips) 
Seat 4: KillByte00 (€2.25 in chips) 
Seat 5: Catania838 (€1.14 in chips) 
Seat 6: Witness85906 (€5.76 in chips) 
robertoH2O: posts small blind €0.01
cap e'bomb95: posts big blind €0.02
*** HOLE CARDS ***
Dealt to caduceus369 [Qc Jc]
KillByte00: folds 
Catania838: folds 
Witness85906: folds 
caduceus369: raises €0.04 to €0.06
robertoH2O: folds 
cap e'bomb95: folds 
Uncalled bet (€0.04) returned to caduceus369
caduceus369 collected €0.05 from pot
caduceus369: doesn't show hand 
*** SUMMARY ***
Total pot €0.05 | Rake €0 
Seat 1: caduceus369 (button) collected (€0.05)
Seat 2: robertoH2O (small blind) folded before Flop
Seat 3: cap e'bomb95 (big blind) folded before Flop
Seat 4: KillByte00 folded before Flop (didn't bet)
Seat 5: Catania838 folded before Flop (didn't bet)
Seat 6: Witness85906 folded before Flop (didn't bet)



PokerStars Zoom Hand #257988696795:  Hold'em No Limit (€0.01/€0.02) [ADM ID: M62BA304494E32ST] - 2025/10/04 0:22:25 CET [2025/10/03 18:22:25 ET]
Table 'Sirio' 6-max Seat #1 is the button
Seat 1: stfuplzudonk (€4.16 in chips) 
Seat 2: pepenero11 (€1.59 in chips) 
Seat 3: caduceus369 (€3.14 in chips) 
Seat 4: trillycata (€0.70 in chips) 
Seat 5: KillByte00 (€3.18 in chips) 
Seat 6: Asganaway123 (€1.26 in chips) 
pepenero11: posts small blind €0.01
caduceus369: posts big blind €0.02
*** HOLE CARDS ***
Dealt to caduceus369 [2c 8s]
trillycata: folds 
KillByte00: raises €0.03 to €0.05
Asganaway123: folds 
stfuplzudonk: folds 
pepenero11: calls €0.04
caduceus369: folds 
*** FLOP *** [3s 4c Qc]
pepenero11: bets €0.02
KillByte00: calls €0.02
*** TURN *** [3s 4c Qc] [3c]
pepenero11: bets €0.04
KillByte00: calls €0.04
*** RIVER *** [3s 4c Qc 3c] [8d]
pepenero11: bets €0.12
KillByte00: raises €2.95 to €3.07 and is all-in
pepenero11: folds 
Uncalled bet (€2.95) returned to KillByte00
KillByte00 collected €0.46 from pot
KillByte00: doesn't show hand 
*** SUMMARY ***
Total pot €0.48 | Rake €0.02 
Board [3s 4c Qc 3c 8d]
Seat 1: stfuplzudonk (button) folded before Flop (didn't bet)
Seat 2: pepenero11 (small blind) folded on the River
Seat 3: caduceus369 (big blind) folded before Flop
Seat 4: trillycata folded before Flop (didn't bet)
Seat 5: KillByte00 collected (€0.46)
Seat 6: Asganaway123 folded before Flop (didn't bet)



PokerStars Zoom Hand #257988700915:  Hold'em No Limit (€0.01/€0.02) [ADM ID: M62BA304494E32ST] - 2025/10/04 0:22:45 CET [2025/10/03 18:22:45 ET]
Table 'Sirio' 6-max Seat #1 is the button
Seat 1: Catania838 (€1.14 in chips) 
Seat 2: Witness85906 (€5.77 in chips) 
Seat 3: CacciatoreAA (€3 in chips) 
Seat 4: caduceus369 (€3.12 in chips) 
Seat 5: Giova8427 (€0.17 in chips) 
Seat 6: The clansman77 (€0.79 in chips) 
Witness85906: posts small blind €0.01
CacciatoreAA: posts big blind €0.02
*** HOLE CARDS ***
Dealt to caduceus369 [9h 5h]
caduceus369: folds 
Giova8427: folds 
The clansman77: calls €0.02
Catania838: folds 
Witness85906: folds 
CacciatoreAA: checks 
*** FLOP *** [2d Js 6h]
CacciatoreAA: checks 
The clansman77: checks 
*** TURN *** [2d Js 6h] [5c]
CacciatoreAA: bets €0.05
The clansman77: calls €0.05
*** RIVER *** [2d Js 6h 5c] [Ac]
CacciatoreAA: checks 
The clansman77: bets €0.08
CacciatoreAA: calls €0.08
*** SHOW DOWN ***
The clansman77: shows [7h 8h] (high card Ace)
CacciatoreAA: shows [Ts Jh] (a pair of Jacks)
CacciatoreAA collected €0.30 from pot
*** SUMMARY ***
Total pot €0.31 | Rake €0.01 
Board [2d Js 6h 5c Ac]
Seat 1: Catania838 (button) folded before Flop (didn't bet)
Seat 2: Witness85906 (small blind) folded before Flop
Seat 3: CacciatoreAA (big blind) showed [Ts Jh] and won (€0.30) with a pair of Jacks
Seat 4: caduceus369 folded before Flop (didn't bet)
Seat 5: Giova8427 folded before Flop (didn't bet)
Seat 6: The clansman77 showed [7h 8h] and lost with high card Ace



PokerStars Zoom Hand #257988705657:  Hold'em No Limit (€0.01/€0.02) [ADM ID: M62BA304494E32ST] - 2025/10/04 0:23:07 CET [2025/10/03 18:23:07 ET]
Table 'Sirio' 6-max Seat #1 is the button
Seat 1: wiola3922 (€0.88 in chips) 
Seat 2: caduceus369 (€3.15 in chips) 
Seat 3: criptlux (€1.53 in chips) 
Seat 4: father2008 (€4.98 in chips) 
Seat 5: cap e'bomb95 (€0.99 in chips) 
Seat 6: outshined8 (€0.69 in chips) 
caduceus369: posts small blind €0.01
criptlux: posts big blind €0.02
*** HOLE CARDS ***
Dealt to caduceus369 [Ts Qc]
father2008: folds 
cap e'bomb95: folds 
outshined8: folds 
wiola3922: folds 
caduceus369: calls €0.01
criptlux: checks 
*** FLOP *** [Qh 2d Qd]
caduceus369: checks 
criptlux: checks 
*** TURN *** [Qh 2d Qd] [Ad]
caduceus369: checks 
criptlux: checks 
*** RIVER *** [Qh 2d Qd Ad] [2c]
caduceus369: bets €0.10
criptlux: calls €0.10
*** SHOW DOWN ***
caduceus369: shows [Ts Qc] (a full house, Queens full of Deuces)
criptlux: mucks hand 
caduceus369 collected €0.23 from pot
*** SUMMARY ***
Total pot €0.24 | Rake €0.01 
Board [Qh 2d Qd Ad 2c]
Seat 1: wiola3922 (button) folded before Flop (didn't bet)
Seat 2: caduceus369 (small blind) showed [Ts Qc] and won (€0.23) with a full house, Queens full of Deuces
Seat 3: criptlux (big blind) mucked [2s Ks]
Seat 4: father2008 folded before Flop (didn't bet)
Seat 5: cap e'bomb95 folded before Flop (didn't bet)
Seat 6: outshined8 folded before Flop (didn't bet)



PokerStars Zoom Hand #257988714356:  Hold'em No Limit (€0.01/€0.02) [ADM ID: M62BA304494E32ST] - 2025/10/04 0:23:47 CET [2025/10/03 18:23:47 ET]
Table 'Sirio' 6-max Seat #1 is the button
Seat 1: cap e'bomb95 (€4.84 in chips) 
Seat 2: KillByte00 (€3.39 in chips) 
Seat 3: stevalmg (€2.76 in chips) 
Seat 4: Catania838 (€1.11 in chips) 
Seat 5: cuzzi68 (€1.80 in chips) 
Seat 6: caduceus369 (€3.26 in chips) 
KillByte00: posts small blind €0.01
stevalmg: posts big blind €0.02
*** HOLE CARDS ***
Dealt to caduceus369 [Kh Jc]
Catania838: folds 
cuzzi68: raises €0.02 to €0.04
caduceus369: calls €0.04
cap e'bomb95: folds 
KillByte00: folds 
stevalmg: folds 
*** FLOP *** [9c 2d 4d]
cuzzi68: checks 
caduceus369: checks 
*** TURN *** [9c 2d 4d] [6s]
cuzzi68: checks 
caduceus369: bets €0.04
cuzzi68: calls €0.04
*** RIVER *** [9c 2d 4d 6s] [Kd]
cuzzi68: checks 
caduceus369: bets €0.11
cuzzi68: folds 
Uncalled bet (€0.11) returned to caduceus369
caduceus369 collected €0.18 from pot
caduceus369: doesn't show hand 
*** SUMMARY ***
Total pot €0.19 | Rake €0.01 
Board [9c 2d 4d 6s Kd]
Seat 1: cap e'bomb95 (button) folded before Flop (didn't bet)
Seat 2: KillByte00 (small blind) folded before Flop
Seat 3: stevalmg (big blind) folded before Flop
Seat 4: Catania838 folded before Flop (didn't bet)
Seat 5: cuzzi68 folded on the River
Seat 6: caduceus369 collected (€0.18)



PokerStars Zoom Hand #257988728873:  Hold'em No Limit (€0.01/€0.02) [ADM ID: M62BA304494E32ST] - 2025/10/04 0:24:53 CET [2025/10/03 18:24:53 ET]
Table 'Sirio' 6-max Seat #1 is the button
Seat 1: Peru91j (€2 in chips) 
Seat 2: Asganaway123 (€2.13 in chips) 
Seat 3: caduceus369 (€3.36 in chips) 
Seat 4: cuzzi68 (€1.72 in chips) 
Seat 5: tigermiscio (€1.10 in chips) 
Seat 6: cap e'bomb95 (€0.99 in chips) 
Asganaway123: posts small blind €0.01
caduceus369: posts big blind €0.02
*** HOLE CARDS ***
Dealt to caduceus369 [Ks Ts]
cuzzi68: folds 
tigermiscio: folds 
cap e'bomb95: folds 
Peru91j: folds 
Asganaway123: folds 
Uncalled bet (€0.01) returned to caduceus369
caduceus369 collected €0.02 from pot
caduceus369: doesn't show hand 
*** SUMMARY ***
Total pot €0.02 | Rake €0 
Seat 1: Peru91j (button) folded before Flop (didn't bet)
Seat 2: Asganaway123 (small blind) folded before Flop
Seat 3: caduceus369 (big blind) collected (€0.02)
Seat 4: cuzzi68 folded before Flop (didn't bet)
Seat 5: tigermiscio folded before Flop (didn't bet)
Seat 6: cap e'bomb95 folded before Flop (didn't bet)



PokerStars Zoom Hand #257988732411:  Hold'em No Limit (€0.01/€0.02) [ADM ID: M62BA304494E32ST] - 2025/10/04 0:25:09 CET [2025/10/03 18:25:09 ET]
Table 'Sirio' 6-max Seat #1 is the button
Seat 1: Asganaway123 (€2.12 in chips) 
Seat 2: SKERZA (€1.74 in chips) 
Seat 3: Meryjuventina (€1.93 in chips) 
Seat 4: caduceus369 (€3.37 in chips) 
Seat 5: iceangel2003 (€2.16 in chips) 
Seat 6: Bristol1964 (€1.47 in chips) 
SKERZA: posts small blind €0.01
Meryjuventina: posts big blind €0.02
*** HOLE CARDS ***
Dealt to caduceus369 [3h 8s]
caduceus369: folds 
iceangel2003: folds 
Bristol1964: folds 
Asganaway123: folds 
SKERZA: folds 
Uncalled bet (€0.01) returned to Meryjuventina
Meryjuventina collected €0.02 from pot
Meryjuventina: doesn't show hand 
*** SUMMARY ***
Total pot €0.02 | Rake €0 
Seat 1: Asganaway123 (button) folded before Flop (didn't bet)
Seat 2: SKERZA (small blind) folded before Flop
Seat 3: Meryjuventina (big blind) collected (€0.02)
Seat 4: caduceus369 folded before Flop (didn't bet)
Seat 5: iceangel2003 folded before Flop (didn't bet)
Seat 6: Bristol1964 folded before Flop (didn't bet)



PokerStars Zoom Hand #257988733379:  Hold'em No Limit (€0.01/€0.02) [ADM ID: M62BA304494E32ST] - 2025/10/04 0:25:14 CET [2025/10/03 18:25:14 ET]
Table 'Sirio' 6-max Seat #1 is the button
Seat 1: Bristol1964 (€1.47 in chips) 
Seat 2: iceangel2003 (€2.16 in chips) 
Seat 3: cap e'bomb95 (€0.99 in chips) 
Seat 4: SKERZA (€1.73 in chips) 
Seat 5: stevalmg (€2.68 in chips) 
Seat 6: caduceus369 (€3.37 in chips) 
iceangel2003: posts small blind €0.01
cap e'bomb95: posts big blind €0.02
*** HOLE CARDS ***
Dealt to caduceus369 [Ac 7d]
SKERZA: raises €0.03 to €0.05
stevalmg: raises €0.13 to €0.18
caduceus369: folds 
Bristol1964: folds 
iceangel2003: folds 
cap e'bomb95: folds 
SKERZA: folds 
Uncalled bet (€0.13) returned to stevalmg
stevalmg collected €0.13 from pot
stevalmg: doesn't show hand 
*** SUMMARY ***
Total pot €0.13 | Rake €0 
Seat 1: Bristol1964 (button) folded before Flop (didn't bet)
Seat 2: iceangel2003 (small blind) folded before Flop
Seat 3: cap e'bomb95 (big blind) folded before Flop
Seat 4: SKERZA folded before Flop
Seat 5: stevalmg collected (€0.13)
Seat 6: caduceus369 folded before Flop (didn't bet)



PokerStars Zoom Hand #257988731756:  Hold'em No Limit (€0.01/€0.02) [ADM ID: M62BA304494E32ST] - 2025/10/04 0:25:06 CET [2025/10/03 18:25:06 ET]
Table 'Sirio' 6-max Seat #1 is the button
Seat 1: cap e'bomb95 (€4.95 in chips) 
Seat 2: Witness85906 (€6.18 in chips) 
Seat 3: stfuplzudonk (€2.66 in chips) 
Seat 4: robertoH2O (€2 in chips) 
Seat 5: caduceus369 (€3.37 in chips) 
Seat 6: cuzzi68 (€1.72 in chips) 
Witness85906: posts small blind €0.01
stfuplzudonk: posts big blind €0.02
*** HOLE CARDS ***
Dealt to caduceus369 [6s Ks]
robertoH2O: folds 
caduceus369: folds 
cuzzi68: folds 
cap e'bomb95: raises €0.03 to €0.05
Witness85906: folds 
stfuplzudonk: raises €0.13 to €0.18
cap e'bomb95: calls €0.13
*** FLOP *** [9s 3s 6h]
stfuplzudonk: bets €0.20
cap e'bomb95: folds 
Uncalled bet (€0.20) returned to stfuplzudonk
stfuplzudonk collected €0.35 from pot
stfuplzudonk: doesn't show hand 
*** SUMMARY ***
Total pot €0.37 | Rake €0.02 
Board [9s 3s 6h]
Seat 1: cap e'bomb95 (button) folded on the Flop
Seat 2: Witness85906 (small blind) folded before Flop
Seat 3: stfuplzudonk (big blind) collected (€0.35)
Seat 4: robertoH2O folded before Flop (didn't bet)
Seat 5: caduceus369 folded before Flop (didn't bet)
Seat 6: cuzzi68 folded before Flop (didn't bet)



PokerStars Zoom Hand #257988735537:  Hold'em No Limit (€0.01/€0.02) [ADM ID: M62BA304494E32ST] - 2025/10/04 0:25:23 CET [2025/10/03 18:25:23 ET]
Table 'Sirio' 6-max Seat #1 is the button
Seat 1: caduceus369 (€3.37 in chips) 
Seat 2: stfuplzudonk (€3.49 in chips) 
Seat 3: EasyToRule (€3.91 in chips) 
Seat 4: Peru91j (€2 in chips) 
Seat 5: criptlux (€3.65 in chips) 
Seat 6: iceangel2003 (€2.15 in chips) 
stfuplzudonk: posts small blind €0.01
EasyToRule: posts big blind €0.02
*** HOLE CARDS ***
Dealt to caduceus369 [3d 7c]
Peru91j: folds 
criptlux: folds 
iceangel2003: folds 
caduceus369: folds 
stfuplzudonk: folds 
Uncalled bet (€0.01) returned to EasyToRule
EasyToRule collected €0.02 from pot
EasyToRule: doesn't show hand 
*** SUMMARY ***
Total pot €0.02 | Rake €0 
Seat 1: caduceus369 (button) folded before Flop (didn't bet)
Seat 2: stfuplzudonk (small blind) folded before Flop
Seat 3: EasyToRule (big blind) collected (€0.02)
Seat 4: Peru91j folded before Flop (didn't bet)
Seat 5: criptlux folded before Flop (didn't bet)
Seat 6: iceangel2003 folded before Flop (didn't bet)



PokerStars Zoom Hand #257988737024:  Hold'em No Limit (€0.01/€0.02) [ADM ID: M62BA304494E32ST] - 2025/10/04 0:25:30 CET [2025/10/03 18:25:30 ET]
Table 'Sirio' 6-max Seat #1 is the button
Seat 1: franck19621962 (€1.14 in chips) 
Seat 2: criptlux (€3.65 in chips) 
Seat 3: SKERZA (€1.68 in chips) 
Seat 4: caduceus369 (€3.37 in chips) 
Seat 5: 0inthemoney (€2.72 in chips) 
Seat 6: cap e'bomb95 (€4.77 in chips) 
criptlux: posts small blind €0.01
SKERZA: posts big blind €0.02
*** HOLE CARDS ***
Dealt to caduceus369 [As 2s]
caduceus369: folds 
0inthemoney: folds 
cap e'bomb95: raises €0.03 to €0.05
franck19621962: folds 
criptlux: folds 
SKERZA: calls €0.03
*** FLOP *** [Ac 3c 4h]
SKERZA: bets €0.06
cap e'bomb95: folds 
Uncalled bet (€0.06) returned to SKERZA
SKERZA collected €0.11 from pot
SKERZA: doesn't show hand 
*** SUMMARY ***
Total pot €0.11 | Rake €0 
Board [Ac 3c 4h]
Seat 1: franck19621962 (button) folded before Flop (didn't bet)
Seat 2: criptlux (small blind) folded before Flop
Seat 3: SKERZA (big blind) collected (€0.11)
Seat 4: caduceus369 folded before Flop (didn't bet)
Seat 5: 0inthemoney folded before Flop (didn't bet)
Seat 6: cap e'bomb95 folded on the Flop



PokerStars Zoom Hand #257988740849:  Hold'em No Limit (€0.01/€0.02) [ADM ID: M62BA304494E32ST] - 2025/10/04 0:25:47 CET [2025/10/03 18:25:47 ET]
Table 'Sirio' 6-max Seat #1 is the button
Seat 1: criptlux (€3.64 in chips) 
Seat 2: caduceus369 (€3.35 in chips) 
Seat 3: stfuplzudonk (€3.48 in chips) 
Seat 4: tigermiscio (€1.13 in chips) 
Seat 5: cap e'bomb95 (€0.97 in chips) 
Seat 6: robertoH2O (€2.02 in chips) 
caduceus369: posts small blind €0.01
stfuplzudonk: posts big blind €0.02
*** HOLE CARDS ***
Dealt to caduceus369 [Ac 8h]
tigermiscio: folds 
cap e'bomb95: folds 
robertoH2O: folds 
criptlux: folds 
caduceus369: folds 
Uncalled bet (€0.01) returned to stfuplzudonk
stfuplzudonk collected €0.02 from pot
stfuplzudonk: doesn't show hand 
*** SUMMARY ***
Total pot €0.02 | Rake €0 
Seat 1: criptlux (button) folded before Flop (didn't bet)
Seat 2: caduceus369 (small blind) folded before Flop
Seat 3: stfuplzudonk (big blind) collected (€0.02)
Seat 4: tigermiscio folded before Flop (didn't bet)
Seat 5: cap e'bomb95 folded before Flop (didn't bet)
Seat 6: robertoH2O folded before Flop (didn't bet)



PokerStars Zoom Hand #257988743518:  Hold'em No Limit (€0.01/€0.02) [ADM ID: M62BA304494E32ST] - 2025/10/04 0:25:59 CET [2025/10/03 18:25:59 ET]
Table 'Sirio' 6-max Seat #1 is the button
Seat 1: caduceus369 (€3.34 in chips) 
Seat 2: criptlux (€1.36 in chips) 
Seat 3: iceangel2003 (€3.27 in chips) 
Seat 4: cap e'bomb95 (€4.72 in chips) 
Seat 5: fantaasso (€4.51 in chips) 
Seat 6: Witness85906 (€6.09 in chips) 
criptlux: posts small blind €0.01
iceangel2003: posts big blind €0.02
*** HOLE CARDS ***
Dealt to caduceus369 [8c 2d]
cap e'bomb95: folds 
fantaasso: folds 
Witness85906: folds 
caduceus369: folds 
criptlux: folds 
Uncalled bet (€0.01) returned to iceangel2003
iceangel2003 collected €0.02 from pot
iceangel2003: doesn't show hand 
*** SUMMARY ***
Total pot €0.02 | Rake €0 
Seat 1: caduceus369 (button) folded before Flop (didn't bet)
Seat 2: criptlux (small blind) folded before Flop
Seat 3: iceangel2003 (big blind) collected (€0.02)
Seat 4: cap e'bomb95 folded before Flop (didn't bet)
Seat 5: fantaasso folded before Flop (didn't bet)
Seat 6: Witness85906 folded before Flop (didn't bet)



PokerStars Zoom Hand #257988746672:  Hold'em No Limit (€0.01/€0.02) [ADM ID: M62BA304494E32ST] - 2025/10/04 0:26:14 CET [2025/10/03 18:26:14 ET]
Table 'Sirio' 6-max Seat #1 is the button
Seat 1: fantaasso (€2.63 in chips) 
Seat 2: cap e'bomb95 (€0.95 in chips) 
Seat 3: stfuplzudonk (€4.51 in chips) 
Seat 4: Peru91j (€2 in chips) 
Seat 5: tigermiscio (€1.10 in chips) 
Seat 6: caduceus369 (€3.34 in chips) 
cap e'bomb95: posts small blind €0.01
stfuplzudonk: posts big blind €0.02
*** HOLE CARDS ***
Dealt to caduceus369 [5d 6s]
Peru91j: raises €0.04 to €0.06
tigermiscio: folds 
caduceus369: folds 
fantaasso: folds 
cap e'bomb95: folds 
stfuplzudonk: folds 
Uncalled bet (€0.04) returned to Peru91j
Peru91j collected €0.05 from pot
Peru91j: doesn't show hand 
*** SUMMARY ***
Total pot €0.05 | Rake €0 
Seat 1: fantaasso (button) folded before Flop (didn't bet)
Seat 2: cap e'bomb95 (small blind) folded before Flop
Seat 3: stfuplzudonk (big blind) folded before Flop
Seat 4: Peru91j collected (€0.05)
Seat 5: tigermiscio folded before Flop (didn't bet)
Seat 6: caduceus369 folded before Flop (didn't bet)



PokerStars Zoom Hand #257988738063:  Hold'em No Limit (€0.01/€0.02) [ADM ID: M62BA304494E32ST] - 2025/10/04 0:25:35 CET [2025/10/03 18:25:35 ET]
Table 'Sirio' 6-max Seat #1 is the button
Seat 1: cap e'bomb95 (€0.97 in chips) 
Seat 2: Catania838 (€1.40 in chips) 
Seat 3: caduceus369 (€3.37 in chips) 
Seat 4: outshined8 (€0.63 in chips) 
Seat 5: bruciapelo (€2.96 in chips) 
Seat 6: stfuplzudonk (€3.48 in chips) 
Catania838: posts small blind €0.01
caduceus369: posts big blind €0.02
*** HOLE CARDS ***
Dealt to caduceus369 [5c 4h]
outshined8: folds 
bruciapelo: raises €0.04 to €0.06
stfuplzudonk: folds 
cap e'bomb95: folds 
Catania838: calls €0.05
caduceus369: folds 
*** FLOP *** [Ah 4c Qh]
Catania838: checks 
bruciapelo: bets €0.07
Catania838: folds 
Uncalled bet (€0.07) returned to bruciapelo
bruciapelo collected €0.14 from pot
bruciapelo: doesn't show hand 
*** SUMMARY ***
Total pot €0.14 | Rake €0 
Board [Ah 4c Qh]
Seat 1: cap e'bomb95 (button) folded before Flop (didn't bet)
Seat 2: Catania838 (small blind) folded on the Flop
Seat 3: caduceus369 (big blind) folded before Flop
Seat 4: outshined8 folded before Flop (didn't bet)
Seat 5: bruciapelo collected (€0.14)
Seat 6: stfuplzudonk folded before Flop (didn't bet)



PokerStars Zoom Hand #257988744950:  Hold'em No Limit (€0.01/€0.02) [ADM ID: M62BA304494E32ST] - 2025/10/04 0:26:06 CET [2025/10/03 18:26:06 ET]
Table 'Sirio' 6-max Seat #1 is the button
Seat 1: 0inthemoney (€2.69 in chips) 
Seat 2: CIKO71131 (€0.72 in chips) 
Seat 3: cap e'bomb95 (€4.72 in chips) 
Seat 4: stfuplzudonk (€4.51 in chips) 
Seat 5: caduceus369 (€3.34 in chips) 
Seat 6: fantaasso (€4.51 in chips) 
CIKO71131: posts small blind €0.01
cap e'bomb95: posts big blind €0.02
*** HOLE CARDS ***
Dealt to caduceus369 [4c 6h]
stfuplzudonk: folds 
caduceus369: folds 
fantaasso: folds 
0inthemoney: raises €0.05 to €0.07
CIKO71131: calls €0.06
cap e'bomb95: folds 
*** FLOP *** [Ts Jc 4s]
CIKO71131: checks 
0inthemoney: checks 
*** TURN *** [Ts Jc 4s] [2s]
CIKO71131: checks 
0inthemoney: checks 
*** RIVER *** [Ts Jc 4s 2s] [6d]
CIKO71131: checks 
0inthemoney: checks 
*** SHOW DOWN ***
CIKO71131: shows [3d 3c] (a pair of Threes)
0inthemoney: mucks hand 
CIKO71131 collected €0.16 from pot
*** SUMMARY ***
Total pot €0.16 | Rake €0 
Board [Ts Jc 4s 2s 6d]
Seat 1: 0inthemoney (button) mucked [9d Ac]
Seat 2: CIKO71131 (small blind) showed [3d 3c] and won (€0.16) with a pair of Threes
Seat 3: cap e'bomb95 (big blind) folded before Flop
Seat 4: stfuplzudonk folded before Flop (didn't bet)
Seat 5: caduceus369 folded before Flop (didn't bet)
Seat 6: fantaasso folded before Flop (didn't bet)



PokerStars Zoom Hand #257988747889:  Hold'em No Limit (€0.01/€0.02) [ADM ID: M62BA304494E32ST] - 2025/10/04 0:26:20 CET [2025/10/03 18:26:20 ET]
Table 'Sirio' 6-max Seat #1 is the button
Seat 1: cap e'bomb95 (€0.94 in chips) 
Seat 2: criptlux (€3.62 in chips) 
Seat 3: caduceus369 (€3.34 in chips) 
Seat 4: Poetto65 (€0.97 in chips) 
Seat 5: KillByte00 (€2 in chips) 
Seat 6: Catania838 (€2.13 in chips) 
criptlux: posts small blind €0.01
caduceus369: posts big blind €0.02
*** HOLE CARDS ***
Dealt to caduceus369 [Kc Th]
Poetto65: folds 
KillByte00: folds 
Catania838: folds 
cap e'bomb95: raises €0.03 to €0.05
criptlux: folds 
caduceus369: calls €0.03
*** FLOP *** [6s Td 8s]
caduceus369: checks 
cap e'bomb95: checks 
*** TURN *** [6s Td 8s] [Jc]
caduceus369: bets €0.04
cap e'bomb95: calls €0.04
*** RIVER *** [6s Td 8s Jc] [Jh]
caduceus369: bets €0.11
cap e'bomb95: folds 
Uncalled bet (€0.11) returned to caduceus369
caduceus369 collected €0.18 from pot
caduceus369: doesn't show hand 
*** SUMMARY ***
Total pot €0.19 | Rake €0.01 
Board [6s Td 8s Jc Jh]
Seat 1: cap e'bomb95 (button) folded on the River
Seat 2: criptlux (small blind) folded before Flop
Seat 3: caduceus369 (big blind) collected (€0.18)
Seat 4: Poetto65 folded before Flop (didn't bet)
Seat 5: KillByte00 folded before Flop (didn't bet)
Seat 6: Catania838 folded before Flop (didn't bet)



PokerStars Zoom Hand #257988763340:  Hold'em No Limit (€0.01/€0.02) [ADM ID: M62BA304494E32ST] - 2025/10/04 0:27:31 CET [2025/10/03 18:27:31 ET]
Table 'Sirio' 6-max Seat #1 is the button
Seat 1: caduceus369 (€3.43 in chips) 
Seat 2: EasyToRule (€3.90 in chips) 
Seat 3: bruciapelo (€3.12 in chips) 
Seat 4: cap e'bomb95 (€0.85 in chips) 
Seat 5: stfuplzudonk (€4.49 in chips) 
Seat 6: franck19621962 (€1.66 in chips) 
EasyToRule: posts small blind €0.01
bruciapelo: posts big blind €0.02
*** HOLE CARDS ***
Dealt to caduceus369 [As 6s]
cap e'bomb95: folds 
stfuplzudonk: raises €0.04 to €0.06
franck19621962: folds 
caduceus369: calls €0.06
EasyToRule: calls €0.05
bruciapelo: calls €0.04
*** FLOP *** [Ac Ah 9c]
EasyToRule: checks 
bruciapelo: checks 
stfuplzudonk: checks 
caduceus369: bets €0.02
EasyToRule: folds 
bruciapelo: folds 
stfuplzudonk: folds 
Uncalled bet (€0.02) returned to caduceus369
caduceus369 collected €0.23 from pot
caduceus369: doesn't show hand 
*** SUMMARY ***
Total pot €0.24 | Rake €0.01 
Board [Ac Ah 9c]
Seat 1: caduceus369 (button) collected (€0.23)
Seat 2: EasyToRule (small blind) folded on the Flop
Seat 3: bruciapelo (big blind) folded on the Flop
Seat 4: cap e'bomb95 folded before Flop (didn't bet)
Seat 5: stfuplzudonk folded on the Flop
Seat 6: franck19621962 folded before Flop (didn't bet)



PokerStars Zoom Hand #257988773807:  Hold'em No Limit (€0.01/€0.02) [ADM ID: M62BA304494E32ST] - 2025/10/04 0:28:19 CET [2025/10/03 18:28:19 ET]
Table 'Sirio' 6-max Seat #1 is the button
Seat 1: CacciatoreAA (€3.34 in chips) 
Seat 2: caduceus369 (€3.60 in chips) 
Seat 3: Catania838 (€1.33 in chips) 
Seat 4: Mabrac55 (€2.04 in chips) 
Seat 5: father2008 (€5.40 in chips) 
Seat 6: amandaknox (€1.98 in chips) 
caduceus369: posts small blind €0.01
Catania838: posts big blind €0.02
*** HOLE CARDS ***
Dealt to caduceus369 [6c 8c]
Mabrac55: folds 
father2008: folds 
amandaknox: raises €0.04 to €0.06
CacciatoreAA: folds 
caduceus369: folds 
Catania838: folds 
Uncalled bet (€0.04) returned to amandaknox
amandaknox collected €0.05 from pot
amandaknox: doesn't show hand 
*** SUMMARY ***
Total pot €0.05 | Rake €0 
Seat 1: CacciatoreAA (button) folded before Flop (didn't bet)
Seat 2: caduceus369 (small blind) folded before Flop
Seat 3: Catania838 (big blind) folded before Flop
Seat 4: Mabrac55 folded before Flop (didn't bet)
Seat 5: father2008 folded before Flop (didn't bet)
Seat 6: amandaknox collected (€0.05)



PokerStars Zoom Hand #257988775699:  Hold'em No Limit (€0.01/€0.02) [ADM ID: M62BA304494E32ST] - 2025/10/04 0:28:28 CET [2025/10/03 18:28:28 ET]
Table 'Sirio' 6-max Seat #1 is the button
Seat 1: franck19621962 (€1.75 in chips) 
Seat 2: Peru91j (€2 in chips) 
Seat 3: father2008 (€5.40 in chips) 
Seat 4: stfuplzudonk (€3.36 in chips) 
Seat 5: caduceus369 (€3.59 in chips) 
Seat 6: Catania838 (€1.31 in chips) 
Peru91j: posts small blind €0.01
father2008: posts big blind €0.02
*** HOLE CARDS ***
Dealt to caduceus369 [2s 7s]
stfuplzudonk: folds 
caduceus369: folds 
Catania838: folds 
franck19621962: calls €0.02
Peru91j: folds 
father2008: checks 
*** FLOP *** [3h 5h 8c]
father2008: checks 
franck19621962: bets €0.04
father2008: folds 
Uncalled bet (€0.04) returned to franck19621962
franck19621962 collected €0.05 from pot
franck19621962: doesn't show hand 
*** SUMMARY ***
Total pot €0.05 | Rake €0 
Board [3h 5h 8c]
Seat 1: franck19621962 (button) collected (€0.05)
Seat 2: Peru91j (small blind) folded before Flop
Seat 3: father2008 (big blind) folded on the Flop
Seat 4: stfuplzudonk folded before Flop (didn't bet)
Seat 5: caduceus369 folded before Flop (didn't bet)
Seat 6: Catania838 folded before Flop (didn't bet)



PokerStars Zoom Hand #257988776984:  Hold'em No Limit (€0.01/€0.02) [ADM ID: M62BA304494E32ST] - 2025/10/04 0:28:34 CET [2025/10/03 18:28:34 ET]
Table 'Sirio' 6-max Seat #1 is the button
Seat 1: SCOTTISHE (€0.62 in chips) 
Seat 2: KillByte00 (€2.01 in chips) 
Seat 3: fantaasso (€3.19 in chips) 
Seat 4: Asganaway123 (€1.40 in chips) 
Seat 5: caduceus369 (€3.59 in chips) 
Seat 6: Peru91j (€2 in chips) 
KillByte00: posts small blind €0.01
fantaasso: posts big blind €0.02
*** HOLE CARDS ***
Dealt to caduceus369 [5s 3d]
Asganaway123: folds 
caduceus369: folds 
Peru91j: folds 
SCOTTISHE: calls €0.02
KillByte00: folds 
fantaasso: checks 
*** FLOP *** [2c Ac 5d]
fantaasso: checks 
SCOTTISHE: bets €0.02
fantaasso: folds 
Uncalled bet (€0.02) returned to SCOTTISHE
SCOTTISHE collected €0.05 from pot
SCOTTISHE: doesn't show hand 
*** SUMMARY ***
Total pot €0.05 | Rake €0 
Board [2c Ac 5d]
Seat 1: SCOTTISHE (button) collected (€0.05)
Seat 2: KillByte00 (small blind) folded before Flop
Seat 3: fantaasso (big blind) folded on the Flop
Seat 4: Asganaway123 folded before Flop (didn't bet)
Seat 5: caduceus369 folded before Flop (didn't bet)
Seat 6: Peru91j folded before Flop (didn't bet)



PokerStars Zoom Hand #257988778092:  Hold'em No Limit (€0.01/€0.02) [ADM ID: M62BA304494E32ST] - 2025/10/04 0:28:39 CET [2025/10/03 18:28:39 ET]
Table 'Sirio' 6-max Seat #1 is the button
Seat 1: Catania838 (€1.31 in chips) 
Seat 2: Giampon78 (€1.96 in chips) 
Seat 3: caduceus369 (€3.59 in chips) 
Seat 4: robertoH2O (€2.30 in chips) 
Seat 5: tigermiscio (€1.03 in chips) 
Seat 6: Asganaway123 (€1.40 in chips) 
Giampon78: posts small blind €0.01
caduceus369: posts big blind €0.02
*** HOLE CARDS ***
Dealt to caduceus369 [8h 3h]
robertoH2O: folds 
tigermiscio: calls €0.02
Asganaway123: folds 
Catania838: raises €0.04 to €0.06
Giampon78: folds 
caduceus369: folds 
tigermiscio: calls €0.04
*** FLOP *** [Th 2d 9s]
tigermiscio: checks 
Catania838: bets €0.08
tigermiscio: calls €0.08
*** TURN *** [Th 2d 9s] [Jh]
tigermiscio: checks 
Catania838: checks 
*** RIVER *** [Th 2d 9s Jh] [Ts]
tigermiscio: bets €0.15
Catania838: raises €0.60 to €0.75
tigermiscio: calls €0.60
*** SHOW DOWN ***
Catania838: shows [Qs Kd] (a straight, Nine to King)
tigermiscio: mucks hand 
Catania838 collected €1.72 from pot
*** SUMMARY ***
Total pot €1.81 | Rake €0.09 
Board [Th 2d 9s Jh Ts]
Seat 1: Catania838 (button) showed [Qs Kd] and won (€1.72) with a straight, Nine to King
Seat 2: Giampon78 (small blind) folded before Flop
Seat 3: caduceus369 (big blind) folded before Flop
Seat 4: robertoH2O folded before Flop (didn't bet)
Seat 5: tigermiscio mucked [Ad Tc]
Seat 6: Asganaway123 folded before Flop (didn't bet)



PokerStars Zoom Hand #257988780499:  Hold'em No Limit (€0.01/€0.02) [ADM ID: M62BA304494E32ST] - 2025/10/04 0:28:50 CET [2025/10/03 18:28:50 ET]
Table 'Sirio' 6-max Seat #1 is the button
Seat 1: KillByte00 (€2 in chips) 
Seat 2: criptlux (€3.55 in chips) 
Seat 3: franck19621962 (€1.78 in chips) 
Seat 4: EasyToRule (€3.17 in chips) 
Seat 5: fantaasso (€4.38 in chips) 
Seat 6: caduceus369 (€3.57 in chips) 
criptlux: posts small blind €0.01
franck19621962: posts big blind €0.02
*** HOLE CARDS ***
Dealt to caduceus369 [4c 4d]
EasyToRule: folds 
fantaasso: folds 
caduceus369: calls €0.02
KillByte00: folds 
criptlux: calls €0.01
franck19621962: checks 
*** FLOP *** [2d 2s Qd]
criptlux: checks 
franck19621962: bets €0.06
caduceus369: folds 
criptlux: folds 
Uncalled bet (€0.06) returned to franck19621962
franck19621962 collected €0.06 from pot
franck19621962: doesn't show hand 
*** SUMMARY ***
Total pot €0.06 | Rake €0 
Board [2d 2s Qd]
Seat 1: KillByte00 (button) folded before Flop (didn't bet)
Seat 2: criptlux (small blind) folded on the Flop
Seat 3: franck19621962 (big blind) collected (€0.06)
Seat 4: EasyToRule folded before Flop (didn't bet)
Seat 5: fantaasso folded before Flop (didn't bet)
Seat 6: caduceus369 folded on the Flop



PokerStars Zoom Hand #257988787390:  Hold'em No Limit (€0.01/€0.02) [ADM ID: M62BA304494E32ST] - 2025/10/04 0:29:23 CET [2025/10/03 18:29:23 ET]
Table 'Sirio' 6-max Seat #1 is the button
Seat 1: cap e'bomb95 (€0.94 in chips) 
Seat 2: caduceus369 (€3.55 in chips) 
Seat 3: pepenero11 (€0.68 in chips) 
Seat 4: TangaG44 (€1.12 in chips) 
Seat 5: criptlux (€3.53 in chips) 
Seat 6: stfuplzudonk (€4.38 in chips) 
caduceus369: posts small blind €0.01
pepenero11: posts big blind €0.02
*** HOLE CARDS ***
Dealt to caduceus369 [Td 3h]
TangaG44: calls €0.02
criptlux: folds 
stfuplzudonk: calls €0.02
cap e'bomb95: folds 
caduceus369: folds 
pepenero11: checks 
*** FLOP *** [Qs 3s Th]
pepenero11: checks 
TangaG44: checks 
stfuplzudonk: checks 
*** TURN *** [Qs 3s Th] [Kc]
pepenero11: checks 
TangaG44: checks 
stfuplzudonk: checks 
*** RIVER *** [Qs 3s Th Kc] [Tc]
pepenero11: checks 
TangaG44: checks 
stfuplzudonk: checks 
*** SHOW DOWN ***
pepenero11: shows [5c 2c] (a pair of Tens)
TangaG44: shows [4h 8h] (a pair of Tens - King+Queen+Eight kicker)
stfuplzudonk: shows [6d Ah] (a pair of Tens - Ace kicker)
stfuplzudonk collected €0.07 from pot
*** SUMMARY ***
Total pot €0.07 | Rake €0 
Board [Qs 3s Th Kc Tc]
Seat 1: cap e'bomb95 (button) folded before Flop (didn't bet)
Seat 2: caduceus369 (small blind) folded before Flop
Seat 3: pepenero11 (big blind) showed [5c 2c] and lost with a pair of Tens
Seat 4: TangaG44 showed [4h 8h] and lost with a pair of Tens
Seat 5: criptlux folded before Flop (didn't bet)
Seat 6: stfuplzudonk showed [6d Ah] and won (€0.07) with a pair of Tens



PokerStars Zoom Hand #257988788698:  Hold'em No Limit (€0.01/€0.02) [ADM ID: M62BA304494E32ST] - 2025/10/04 0:29:30 CET [2025/10/03 18:29:30 ET]
Table 'Sirio' 6-max Seat #1 is the button
Seat 1: cap e'bomb95 (€4.97 in chips) 
Seat 2: Meryjuventina (€3 in chips) 
Seat 3: EasyToRule (€3.72 in chips) 
Seat 4: iceangel2003 (€3.60 in chips) 
Seat 5: Catania838 (€3.80 in chips) 
Seat 6: caduceus369 (€3.54 in chips) 
Meryjuventina: posts small blind €0.01
EasyToRule: posts big blind €0.02
*** HOLE CARDS ***
Dealt to caduceus369 [5c Td]
iceangel2003: calls €0.02
Catania838: folds 
caduceus369: folds 
cap e'bomb95: folds 
Meryjuventina: folds 
EasyToRule: raises €0.10 to €0.12
iceangel2003: calls €0.10
*** FLOP *** [3d Qc Kh]
EasyToRule: bets €0.05
iceangel2003: calls €0.05
*** TURN *** [3d Qc Kh] [3s]
EasyToRule: bets €0.03
iceangel2003: raises €0.40 to €0.43
EasyToRule: folds 
Uncalled bet (€0.40) returned to iceangel2003
iceangel2003 collected €0.39 from pot
iceangel2003: doesn't show hand 
*** SUMMARY ***
Total pot €0.41 | Rake €0.02 
Board [3d Qc Kh 3s]
Seat 1: cap e'bomb95 (button) folded before Flop (didn't bet)
Seat 2: Meryjuventina (small blind) folded before Flop
Seat 3: EasyToRule (big blind) folded on the Turn
Seat 4: iceangel2003 collected (€0.39)
Seat 5: Catania838 folded before Flop (didn't bet)
Seat 6: caduceus369 folded before Flop (didn't bet)



PokerStars Zoom Hand #257988798641:  Hold'em No Limit (€0.01/€0.02) [ADM ID: M62BA304494E32ST] - 2025/10/04 0:30:17 CET [2025/10/03 18:30:17 ET]
Table 'Sirio' 6-max Seat #1 is the button
Seat 1: caduceus369 (€3.52 in chips) 
Seat 2: 0inthemoney (€2.72 in chips) 
Seat 3: robertoH2O (€2.36 in chips) 
Seat 4: stfuplzudonk (€4.43 in chips) 
Seat 5: pepenero11 (€0.66 in chips) 
Seat 6: Catania838 (€2 in chips) 
0inthemoney: posts small blind €0.01
robertoH2O: posts big blind €0.02
*** HOLE CARDS ***
Dealt to caduceus369 [Ts Qc]
stfuplzudonk: folds 
pepenero11: raises €0.02 to €0.04
Catania838: folds 
caduceus369: folds 
0inthemoney: folds 
robertoH2O: folds 
Uncalled bet (€0.02) returned to pepenero11
pepenero11 collected €0.05 from pot
pepenero11: doesn't show hand 
*** SUMMARY ***
Total pot €0.05 | Rake €0 
Seat 1: caduceus369 (button) folded before Flop (didn't bet)
Seat 2: 0inthemoney (small blind) folded before Flop
Seat 3: robertoH2O (big blind) folded before Flop
Seat 4: stfuplzudonk folded before Flop (didn't bet)
Seat 5: pepenero11 collected (€0.05)
Seat 6: Catania838 folded before Flop (didn't bet)



PokerStars Zoom Hand #257988789957:  Hold'em No Limit (€0.01/€0.02) [ADM ID: M62BA304494E32ST] - 2025/10/04 0:29:36 CET [2025/10/03 18:29:36 ET]
Table 'Sirio' 6-max Seat #1 is the button
Seat 1: caduceus369 (€3.54 in chips) 
Seat 2: Witness85906 (€5.64 in chips) 
Seat 3: Catania838 (€2.14 in chips) 
Seat 4: cuzzi68 (€1.55 in chips) 
Seat 5: robertoH2O (€2.37 in chips) 
Seat 6: franck19621962 (€1.82 in chips) 
Witness85906: posts small blind €0.01
Catania838: posts big blind €0.02
*** HOLE CARDS ***
Dealt to caduceus369 [Qc Ts]
cuzzi68: calls €0.02
robertoH2O: folds 
franck19621962: folds 
caduceus369: calls €0.02
Witness85906: raises €0.08 to €0.10
Catania838: folds 
cuzzi68: calls €0.08
caduceus369: folds 
*** FLOP *** [6c 9h 9c]
Witness85906: checks 
cuzzi68: checks 
*** TURN *** [6c 9h 9c] [Qd]
Witness85906: checks 
cuzzi68: bets €0.06
Witness85906: calls €0.06
*** RIVER *** [6c 9h 9c Qd] [9s]
Witness85906: checks 
cuzzi68: bets €0.10
Witness85906: calls €0.10
*** SHOW DOWN ***
cuzzi68: shows [Kd Qs] (a full house, Nines full of Queens)
Witness85906: mucks hand 
cuzzi68 collected €0.53 from pot
*** SUMMARY ***
Total pot €0.56 | Rake €0.03 
Board [6c 9h 9c Qd 9s]
Seat 1: caduceus369 (button) folded before Flop
Seat 2: Witness85906 (small blind) mucked [3d 3s]
Seat 3: Catania838 (big blind) folded before Flop
Seat 4: cuzzi68 showed [Kd Qs] and won (€0.53) with a full house, Nines full of Queens
Seat 5: robertoH2O folded before Flop (didn't bet)
Seat 6: franck19621962 folded before Flop (didn't bet)



PokerStars Zoom Hand #257988797822:  Hold'em No Limit (€0.01/€0.02) [ADM ID: M62BA304494E32ST] - 2025/10/04 0:30:13 CET [2025/10/03 18:30:13 ET]
Table 'Sirio' 6-max Seat #1 is the button
Seat 1: stfuplzudonk (€2.45 in chips) 
Seat 2: wiola3922 (€0.77 in chips) 
Seat 3: cap e'bomb95 (€4.92 in chips) 
Seat 4: Catania838 (€3.95 in chips) 
Seat 5: caduceus369 (€3.52 in chips) 
Seat 6: robertoH2O (€2.36 in chips) 
wiola3922: posts small blind €0.01
cap e'bomb95: posts big blind €0.02
*** HOLE CARDS ***
Dealt to caduceus369 [8s Kd]
Catania838: calls €0.02
caduceus369: folds 
robertoH2O: folds 
stfuplzudonk: calls €0.02
wiola3922: calls €0.01
cap e'bomb95: checks 
*** FLOP *** [Kc 4c 5d]
wiola3922: checks 
cap e'bomb95: checks 
Catania838: bets €0.04
stfuplzudonk: folds 
wiola3922: folds 
cap e'bomb95: calls €0.04
*** TURN *** [Kc 4c 5d] [6s]
cap e'bomb95: checks 
Catania838: checks 
*** RIVER *** [Kc 4c 5d 6s] [Qh]
cap e'bomb95: checks 
Catania838: checks 
*** SHOW DOWN ***
cap e'bomb95: shows [8c 2c] (high card King)
Catania838: shows [Th Ah] (high card Ace)
Catania838 collected €0.16 from pot
*** SUMMARY ***
Total pot €0.16 | Rake €0 
Board [Kc 4c 5d 6s Qh]
Seat 1: stfuplzudonk (button) folded on the Flop
Seat 2: wiola3922 (small blind) folded on the Flop
Seat 3: cap e'bomb95 (big blind) showed [8c 2c] and lost with high card King
Seat 4: Catania838 showed [Th Ah] and won (€0.16) with high card Ace
Seat 5: caduceus369 folded before Flop (didn't bet)
Seat 6: robertoH2O folded before Flop (didn't bet)



PokerStars Zoom Hand #257988801615:  Hold'em No Limit (€0.01/€0.02) [ADM ID: M62BA304494E32ST] - 2025/10/04 0:30:31 CET [2025/10/03 18:30:31 ET]
Table 'Sirio' 6-max Seat #1 is the button
Seat 1: EasyToRule (€3.15 in chips) 
Seat 2: Catania838 (€2.12 in chips) 
Seat 3: caduceus369 (€3.52 in chips) 
Seat 4: cap e'bomb95 (€4.74 in chips) 
Seat 5: Peru91j (€2.02 in chips) 
Seat 6: amandaknox (€2.11 in chips) 
Catania838: posts small blind €0.01
caduceus369: posts big blind €0.02
*** HOLE CARDS ***
Dealt to caduceus369 [Qh 9d]
cap e'bomb95: folds 
Peru91j: folds 
amandaknox: folds 
EasyToRule: raises €0.03 to €0.05
Catania838: folds 
caduceus369: calls €0.03
*** FLOP *** [Jd Qc 3h]
caduceus369: bets €0.02
EasyToRule: raises €0.06 to €0.08
caduceus369: calls €0.06
*** TURN *** [Jd Qc 3h] [9h]
caduceus369: checks 
EasyToRule: bets €0.26
caduceus369: raises €0.36 to €0.62
EasyToRule: raises €1.18 to €1.80
caduceus369: calls €1.18
*** RIVER *** [Jd Qc 3h 9h] [Kd]
caduceus369: checks 
EasyToRule: bets €1.22 and is all-in
caduceus369: calls €1.22
*** SHOW DOWN ***
EasyToRule: shows [Td Kh] (a straight, Nine to King)
caduceus369: shows [Qh 9d] (two pair, Queens and Nines)
EasyToRule collected €5.97 from pot
*** SUMMARY ***
Total pot €6.31 | Rake €0.34 
Board [Jd Qc 3h 9h Kd]
Seat 1: EasyToRule (button) showed [Td Kh] and won (€5.97) with a straight, Nine to King
Seat 2: Catania838 (small blind) folded before Flop
Seat 3: caduceus369 (big blind) showed [Qh 9d] and lost with two pair, Queens and Nines
Seat 4: cap e'bomb95 folded before Flop (didn't bet)
Seat 5: Peru91j folded before Flop (didn't bet)
Seat 6: amandaknox folded before Flop (didn't bet)



PokerStars Zoom Hand #257988827599:  Hold'em No Limit (€0.01/€0.02) [ADM ID: M62BA304494E32ST] - 2025/10/04 0:32:34 CET [2025/10/03 18:32:34 ET]
Table 'Sirio' 6-max Seat #1 is the button
Seat 1: colosso2022 (€1.82 in chips) 
Seat 2: robertoH2O (€2 in chips) 
Seat 3: stfuplzudonk (€3.25 in chips) 
Seat 4: EasyToRule (€5.97 in chips) 
Seat 5: caduceus369 (€0.37 in chips) 
Seat 6: Colaredss (€2.16 in chips) 
robertoH2O: posts small blind €0.01
stfuplzudonk: posts big blind €0.02
*** HOLE CARDS ***
Dealt to caduceus369 [7h 5d]
EasyToRule: raises €0.04 to €0.06
caduceus369 has timed out
caduceus369: folds 
Colaredss: folds 
colosso2022: folds 
robertoH2O: folds 
stfuplzudonk: calls €0.04
*** FLOP *** [Kc 2d 9c]
stfuplzudonk: checks 
EasyToRule: checks 
*** TURN *** [Kc 2d 9c] [6h]
stfuplzudonk: checks 
EasyToRule: checks 
*** RIVER *** [Kc 2d 9c 6h] [9h]
stfuplzudonk: bets €0.07
EasyToRule: folds 
Uncalled bet (€0.07) returned to stfuplzudonk
stfuplzudonk collected €0.13 from pot
stfuplzudonk: doesn't show hand 
*** SUMMARY ***
Total pot €0.13 | Rake €0 
Board [Kc 2d 9c 6h 9h]
Seat 1: colosso2022 (button) folded before Flop (didn't bet)
Seat 2: robertoH2O (small blind) folded before Flop
Seat 3: stfuplzudonk (big blind) collected (€0.13)
Seat 4: EasyToRule folded on the River
Seat 5: caduceus369 folded before Flop (didn't bet)
Seat 6: Colaredss folded before Flop (didn't bet)



