PokerStars Zoom Hand #257957743485:  Hold'em No Limit (€0.01/€0.02) [ADM ID: M62BA304494E32ST] - 2025/10/01 14:27:36 CET [2025/10/01 8:27:36 ET]
Table 'Sirio' 6-max Seat #1 is the button
Seat 1: cap e'bomb95 (€2.35 in chips) 
Seat 2: Qogg (€3.02 in chips) 
Seat 3: caduceus369 (€2 in chips) 
Seat 4: cagliari59 (€1.73 in chips) 
Seat 5: OMGWOLFX (€4 in chips) 
Seat 6: yisai (€1.34 in chips) 
Qogg: posts small blind €0.01
caduceus369: posts big blind €0.02
*** HOLE CARDS ***
Dealt to caduceus369 [8d 3h]
cagliari59: folds 
OMGWOLFX: folds 
yisai: folds 
cap e'bomb95: folds 
Qogg: folds 
Uncalled bet (€0.01) returned to caduceus369
caduceus369 collected €0.02 from pot
caduceus369: doesn't show hand 
*** SUMMARY ***
Total pot €0.02 | Rake €0 
Seat 1: cap e'bomb95 (button) folded before Flop (didn't bet)
Seat 2: Qogg (small blind) folded before Flop
Seat 3: caduceus369 (big blind) collected (€0.02)
Seat 4: cagliari59 folded before Flop (didn't bet)
Seat 5: OMGWOLFX folded before Flop (didn't bet)
Seat 6: yisai folded before Flop (didn't bet)



PokerStars Zoom Hand #257957744538:  Hold'em No Limit (€0.01/€0.02) [ADM ID: M62BA304494E32ST] - 2025/10/01 14:27:45 CET [2025/10/01 8:27:45 ET]
Table 'Sirio' 6-max Seat #1 is the button
Seat 1: Poonte (€2.08 in chips) 
Seat 2: Fengjie82 (€2.81 in chips) 
Seat 3: NoveDiCuori9 (€1.99 in chips) 
Seat 4: Qogg (€2 in chips) 
Seat 5: OMGWOLFX (€2.26 in chips) 
Seat 6: caduceus369 (€2.01 in chips) 
Fengjie82: posts small blind €0.01
NoveDiCuori9: posts big blind €0.02
*** HOLE CARDS ***
Dealt to caduceus369 [Qd Jd]
Qogg: folds 
OMGWOLFX: folds 
caduceus369: calls €0.02
Poonte: folds 
Fengjie82: folds 
NoveDiCuori9: checks 
*** FLOP *** [3s 2s 3c]
NoveDiCuori9: checks 
caduceus369: bets €0.02
NoveDiCuori9: folds 
Uncalled bet (€0.02) returned to caduceus369
caduceus369 collected €0.05 from pot
caduceus369: doesn't show hand 
*** SUMMARY ***
Total pot €0.05 | Rake €0 
Board [3s 2s 3c]
Seat 1: Poonte (button) folded before Flop (didn't bet)
Seat 2: Fengjie82 (small blind) folded before Flop
Seat 3: NoveDiCuori9 (big blind) folded on the Flop
Seat 4: Qogg folded before Flop (didn't bet)
Seat 5: OMGWOLFX folded before Flop (didn't bet)
Seat 6: caduceus369 collected (€0.05)



PokerStars Zoom Hand #257957747086:  Hold'em No Limit (€0.01/€0.02) [ADM ID: M62BA304494E32ST] - 2025/10/01 14:28:06 CET [2025/10/01 8:28:06 ET]
Table 'Sirio' 6-max Seat #1 is the button
Seat 1: TheKing.1969 (€2.90 in chips) 
Seat 2: caduceus369 (€2.04 in chips) 
Seat 3: Qogg (€5.09 in chips) 
Seat 4: yisai (€1.32 in chips) 
Seat 5: cap e'bomb95 (€4.24 in chips) 
Seat 6: Catania838 (€1.47 in chips) 
caduceus369: posts small blind €0.01
Qogg: posts big blind €0.02
*** HOLE CARDS ***
Dealt to caduceus369 [7d Ah]
yisai: folds 
cap e'bomb95: raises €0.03 to €0.05
Catania838: calls €0.05
TheKing.1969: calls €0.05
caduceus369: folds 
Qogg: folds 
*** FLOP *** [3s 5c 9h]
cap e'bomb95: checks 
Catania838: checks 
TheKing.1969: bets €0.16
cap e'bomb95: folds 
Catania838: folds 
Uncalled bet (€0.16) returned to TheKing.1969
TheKing.1969 collected €0.18 from pot
TheKing.1969: doesn't show hand 
*** SUMMARY ***
Total pot €0.18 | Rake €0 
Board [3s 5c 9h]
Seat 1: TheKing.1969 (button) collected (€0.18)
Seat 2: caduceus369 (small blind) folded before Flop
Seat 3: Qogg (big blind) folded before Flop
Seat 4: yisai folded before Flop (didn't bet)
Seat 5: cap e'bomb95 folded on the Flop
Seat 6: Catania838 folded on the Flop



PokerStars Zoom Hand #257957749183:  Hold'em No Limit (€0.01/€0.02) [ADM ID: M62BA304494E32ST] - 2025/10/01 14:28:23 CET [2025/10/01 8:28:23 ET]
Table 'Sirio' 6-max Seat #1 is the button
Seat 1: caduceus369 (€2.03 in chips) 
Seat 2: ghosto69 (€1.34 in chips) 
Seat 3: OMGWOLFX (€4 in chips) 
Seat 4: giocrouch (€1.94 in chips) 
Seat 5: TheKing.1969 (€2.18 in chips) 
Seat 6: THE_CLOWN_74 (€2.43 in chips) 
ghosto69: posts small blind €0.01
OMGWOLFX: posts big blind €0.02
*** HOLE CARDS ***
Dealt to caduceus369 [As Ts]
giocrouch: raises €0.03 to €0.05
TheKing.1969: folds 
THE_CLOWN_74: folds 
caduceus369: calls €0.05
ghosto69: calls €0.04
OMGWOLFX: folds 
*** FLOP *** [6h 6d Qh]
ghosto69: checks 
giocrouch: checks 
caduceus369: checks 
*** TURN *** [6h 6d Qh] [6c]
ghosto69: checks 
giocrouch: checks 
caduceus369: bets €0.04
ghosto69: calls €0.04
giocrouch: calls €0.04
*** RIVER *** [6h 6d Qh 6c] [Tc]
ghosto69: bets €0.09
giocrouch: folds 
caduceus369: calls €0.09
*** SHOW DOWN ***
ghosto69: shows [Js Td] (a full house, Sixes full of Tens)
caduceus369: shows [As Ts] (a full house, Sixes full of Tens)
ghosto69 collected €0.23 from pot
caduceus369 collected €0.22 from pot
*** SUMMARY ***
Total pot €0.47 | Rake €0.02 
Board [6h 6d Qh 6c Tc]
Seat 1: caduceus369 (button) showed [As Ts] and won (€0.22) with a full house, Sixes full of Tens
Seat 2: ghosto69 (small blind) showed [Js Td] and won (€0.23) with a full house, Sixes full of Tens
Seat 3: OMGWOLFX (big blind) folded before Flop
Seat 4: giocrouch folded on the River
Seat 5: TheKing.1969 folded before Flop (didn't bet)
Seat 6: THE_CLOWN_74 folded before Flop (didn't bet)



PokerStars Zoom Hand #257957759474:  Hold'em No Limit (€0.01/€0.02) [ADM ID: M62BA304494E32ST] - 2025/10/01 14:29:49 CET [2025/10/01 8:29:49 ET]
Table 'Sirio' 6-max Seat #1 is the button
Seat 1: OMGWOLFX (€3.91 in chips) 
Seat 2: Catania838 (€1.38 in chips) 
Seat 3: caduceus369 (€2.07 in chips) 
Seat 4: THE_CLOWN_74 (€2.03 in chips) 
Seat 5: monsterc99 (€0.63 in chips) 
Seat 6: sipa66 (€2.47 in chips) 
Catania838: posts small blind €0.01
caduceus369: posts big blind €0.02
*** HOLE CARDS ***
Dealt to caduceus369 [3c Kh]
THE_CLOWN_74: folds 
monsterc99: folds 
sipa66: folds 
OMGWOLFX: folds 
Catania838: raises €0.02 to €0.04
caduceus369: folds 
Uncalled bet (€0.02) returned to Catania838
Catania838 collected €0.04 from pot
Catania838: doesn't show hand 
*** SUMMARY ***
Total pot €0.04 | Rake €0 
Seat 1: OMGWOLFX (button) folded before Flop (didn't bet)
Seat 2: Catania838 (small blind) collected (€0.04)
Seat 3: caduceus369 (big blind) folded before Flop
Seat 4: THE_CLOWN_74 folded before Flop (didn't bet)
Seat 5: monsterc99 folded before Flop (didn't bet)
Seat 6: sipa66 folded before Flop (didn't bet)



PokerStars Zoom Hand #257957758389:  Hold'em No Limit (€0.01/€0.02) [ADM ID: M62BA304494E32ST] - 2025/10/01 14:29:39 CET [2025/10/01 8:29:39 ET]
Table 'Sirio' 6-max Seat #1 is the button
Seat 1: buscofan (€2.41 in chips) 
Seat 2: Qogg (€5.04 in chips) 
Seat 3: THE_CLOWN_74 (€2.51 in chips) 
Seat 4: MathMassacreX (€1.91 in chips) 
Seat 5: caduceus369 (€2.07 in chips) 
Seat 6: ghosto69 (€1.39 in chips) 
Qogg: posts small blind €0.01
THE_CLOWN_74: posts big blind €0.02
*** HOLE CARDS ***
Dealt to caduceus369 [Ks 9h]
MathMassacreX: folds 
caduceus369: folds 
ghosto69: raises €0.04 to €0.06
buscofan: calls €0.06
Qogg: folds 
THE_CLOWN_74: folds 
*** FLOP *** [3s Th 2d]
ghosto69: bets €0.05
buscofan: calls €0.05
*** TURN *** [3s Th 2d] [2c]
ghosto69: checks 
buscofan: bets €0.10
ghosto69: calls €0.10
*** RIVER *** [3s Th 2d 2c] [4d]
ghosto69: checks 
buscofan: bets €0.18
ghosto69: folds 
Uncalled bet (€0.18) returned to buscofan
buscofan collected €0.43 from pot
buscofan: doesn't show hand 
*** SUMMARY ***
Total pot €0.45 | Rake €0.02 
Board [3s Th 2d 2c 4d]
Seat 1: buscofan (button) collected (€0.43)
Seat 2: Qogg (small blind) folded before Flop
Seat 3: THE_CLOWN_74 (big blind) folded before Flop
Seat 4: MathMassacreX folded before Flop (didn't bet)
Seat 5: caduceus369 folded before Flop (didn't bet)
Seat 6: ghosto69 folded on the River



PokerStars Zoom Hand #257957762362:  Hold'em No Limit (€0.01/€0.02) [ADM ID: M62BA304494E32ST] - 2025/10/01 14:30:12 CET [2025/10/01 8:30:12 ET]
Table 'Sirio' 6-max Seat #1 is the button
Seat 1: Qogg (€3.01 in chips) 
Seat 2: sipa66 (€2.36 in chips) 
Seat 3: TheKing.1969 (€3.08 in chips) 
Seat 4: caduceus369 (€2.05 in chips) 
Seat 5: gigysk (€1.93 in chips) 
Seat 6: yisai (€1.21 in chips) 
sipa66: posts small blind €0.01
TheKing.1969: posts big blind €0.02
*** HOLE CARDS ***
Dealt to caduceus369 [6s Jd]
caduceus369: folds 
gigysk: folds 
yisai: raises €0.05 to €0.07
Qogg: folds 
sipa66: folds 
TheKing.1969: calls €0.05
*** FLOP *** [3d 6c 2s]
TheKing.1969: checks 
yisai: bets €0.10
TheKing.1969: calls €0.10
*** TURN *** [3d 6c 2s] [5s]
TheKing.1969: checks 
yisai: bets €0.15
TheKing.1969: raises €2.76 to €2.91 and is all-in
yisai: folds 
Uncalled bet (€2.76) returned to TheKing.1969
TheKing.1969 collected €0.62 from pot
TheKing.1969: doesn't show hand 
*** SUMMARY ***
Total pot €0.65 | Rake €0.03 
Board [3d 6c 2s 5s]
Seat 1: Qogg (button) folded before Flop (didn't bet)
Seat 2: sipa66 (small blind) folded before Flop
Seat 3: TheKing.1969 (big blind) collected (€0.62)
Seat 4: caduceus369 folded before Flop (didn't bet)
Seat 5: gigysk folded before Flop (didn't bet)
Seat 6: yisai folded on the Turn



PokerStars Zoom Hand #257957761617:  Hold'em No Limit (€0.01/€0.02) [ADM ID: M62BA304494E32ST] - 2025/10/01 14:30:06 CET [2025/10/01 8:30:06 ET]
Table 'Sirio' 6-max Seat #1 is the button
Seat 1: MathMassacreX (€1.89 in chips) 
Seat 2: TheKing.1969 (€2.08 in chips) 
Seat 3: THE_CLOWN_74 (€2.02 in chips) 
Seat 4: cagliari59 (€1.97 in chips) 
Seat 5: caduceus369 (€2.05 in chips) 
Seat 6: Qogg (€5.03 in chips) 
TheKing.1969: posts small blind €0.01
THE_CLOWN_74: posts big blind €0.02
*** HOLE CARDS ***
Dealt to caduceus369 [9d Ah]
cagliari59: raises €0.05 to €0.07
caduceus369: folds 
Qogg: calls €0.07
MathMassacreX: calls €0.07
TheKing.1969: folds 
THE_CLOWN_74: folds 
*** FLOP *** [Ks 7s 6s]
cagliari59: bets €0.08
Qogg: folds 
MathMassacreX: calls €0.08
*** TURN *** [Ks 7s 6s] [Qh]
cagliari59: checks 
MathMassacreX: bets €0.22
cagliari59: folds 
Uncalled bet (€0.22) returned to MathMassacreX
MathMassacreX collected €0.38 from pot
MathMassacreX: doesn't show hand 
*** SUMMARY ***
Total pot €0.40 | Rake €0.02 
Board [Ks 7s 6s Qh]
Seat 1: MathMassacreX (button) collected (€0.38)
Seat 2: TheKing.1969 (small blind) folded before Flop
Seat 3: THE_CLOWN_74 (big blind) folded before Flop
Seat 4: cagliari59 folded on the Turn
Seat 5: caduceus369 folded before Flop (didn't bet)
Seat 6: Qogg folded on the Flop



PokerStars Zoom Hand #257957766661:  Hold'em No Limit (€0.01/€0.02) [ADM ID: M62BA304494E32ST] - 2025/10/01 14:30:46 CET [2025/10/01 8:30:46 ET]
Table 'Sirio' 6-max Seat #1 is the button
Seat 1: TheKing.1969 (€3.38 in chips) 
Seat 2: Catania838 (€1.39 in chips) 
Seat 3: caduceus369 (€2.02 in chips) 
Seat 4: giocrouch (€2.60 in chips) 
Seat 5: cap e'bomb95 (€2.43 in chips) 
Seat 6: ghosto69 (€1.17 in chips) 
Catania838: posts small blind €0.01
caduceus369: posts big blind €0.02
*** HOLE CARDS ***
Dealt to caduceus369 [Kd 5d]
giocrouch: folds 
cap e'bomb95: folds 
ghosto69: folds 
TheKing.1969: folds 
Catania838: folds 
Uncalled bet (€0.01) returned to caduceus369
caduceus369 collected €0.02 from pot
caduceus369: doesn't show hand 
*** SUMMARY ***
Total pot €0.02 | Rake €0 
Seat 1: TheKing.1969 (button) folded before Flop (didn't bet)
Seat 2: Catania838 (small blind) folded before Flop
Seat 3: caduceus369 (big blind) collected (€0.02)
Seat 4: giocrouch folded before Flop (didn't bet)
Seat 5: cap e'bomb95 folded before Flop (didn't bet)
Seat 6: ghosto69 folded before Flop (didn't bet)



PokerStars Zoom Hand #257957762992:  Hold'em No Limit (€0.01/€0.02) [ADM ID: M62BA304494E32ST] - 2025/10/01 14:30:17 CET [2025/10/01 8:30:17 ET]
Table 'Sirio' 6-max Seat #1 is the button
Seat 1: caduceus369 (€2.05 in chips) 
Seat 2: TheKing.1969 (€2.13 in chips) 
Seat 3: Qogg (€2 in chips) 
Seat 4: OMGWOLFX (€3.90 in chips) 
Seat 5: ghosto69 (€2.26 in chips) 
Seat 6: duemmebike (€2.24 in chips) 
TheKing.1969: posts small blind €0.01
Qogg: posts big blind €0.02
*** HOLE CARDS ***
Dealt to caduceus369 [2d 2s]
OMGWOLFX: folds 
ghosto69: folds 
duemmebike: calls €0.02
caduceus369: calls €0.02
TheKing.1969: calls €0.01
Qogg: checks 
*** FLOP *** [9c Jh Th]
TheKing.1969: checks 
Qogg: bets €0.06
duemmebike: calls €0.06
caduceus369: folds 
TheKing.1969: calls €0.06
*** TURN *** [9c Jh Th] [3c]
TheKing.1969: checks 
Qogg: bets €0.18
duemmebike: folds 
TheKing.1969: calls €0.18
*** RIVER *** [9c Jh Th 3c] [Qc]
TheKing.1969: checks 
Qogg: checks 
*** SHOW DOWN ***
TheKing.1969: shows [Ah 3h] (a pair of Threes)
Qogg: shows [Jc 9s] (two pair, Jacks and Nines)
Qogg collected €0.59 from pot
*** SUMMARY ***
Total pot €0.62 | Rake €0.03 
Board [9c Jh Th 3c Qc]
Seat 1: caduceus369 (button) folded on the Flop
Seat 2: TheKing.1969 (small blind) showed [Ah 3h] and lost with a pair of Threes
Seat 3: Qogg (big blind) showed [Jc 9s] and won (€0.59) with two pair, Jacks and Nines
Seat 4: OMGWOLFX folded before Flop (didn't bet)
Seat 5: ghosto69 folded before Flop (didn't bet)
Seat 6: duemmebike folded on the Turn



PokerStars Zoom Hand #257957765482:  Hold'em No Limit (€0.01/€0.02) [ADM ID: M62BA304494E32ST] - 2025/10/01 14:30:37 CET [2025/10/01 8:30:37 ET]
Table 'Sirio' 6-max Seat #1 is the button
Seat 1: francovirde (€3.61 in chips) 
Seat 2: caduceus369 (€2.03 in chips) 
Seat 3: Catania838 (€1.41 in chips) 
Seat 4: sipa66 (€2.20 in chips) 
Seat 5: cap e'bomb95 (€4.49 in chips) 
Seat 6: buscofan (€2.63 in chips) 
caduceus369: posts small blind €0.01
Catania838: posts big blind €0.02
*** HOLE CARDS ***
Dealt to caduceus369 [Jd 2c]
sipa66: folds 
cap e'bomb95: folds 
buscofan: raises €0.04 to €0.06
francovirde: raises €3.55 to €3.61 and is all-in
caduceus369: folds 
Catania838: folds 
buscofan: folds 
Uncalled bet (€3.55) returned to francovirde
francovirde collected €0.15 from pot
francovirde: doesn't show hand 
*** SUMMARY ***
Total pot €0.15 | Rake €0 
Seat 1: francovirde (button) collected (€0.15)
Seat 2: caduceus369 (small blind) folded before Flop
Seat 3: Catania838 (big blind) folded before Flop
Seat 4: sipa66 folded before Flop (didn't bet)
Seat 5: cap e'bomb95 folded before Flop (didn't bet)
Seat 6: buscofan folded before Flop



PokerStars Zoom Hand #257957766011:  Hold'em No Limit (€0.01/€0.02) [ADM ID: M62BA304494E32ST] - 2025/10/01 14:30:41 CET [2025/10/01 8:30:41 ET]
Table 'Sirio' 6-max Seat #1 is the button
Seat 1: TheKing.1969 (€2.87 in chips) 
Seat 2: cap e'bomb95 (€4.49 in chips) 
Seat 3: Qogg (€3.01 in chips) 
Seat 4: THE_CLOWN_74 (€2 in chips) 
Seat 5: ghosto69 (€1.17 in chips) 
Seat 6: caduceus369 (€2.02 in chips) 
cap e'bomb95: posts small blind €0.01
Qogg: posts big blind €0.02
*** HOLE CARDS ***
Dealt to caduceus369 [7h As]
THE_CLOWN_74: raises €0.06 to €0.08
ghosto69: folds 
caduceus369: folds 
TheKing.1969: folds 
cap e'bomb95: calls €0.07
Qogg: folds 
*** FLOP *** [Ah 4d 3s]
cap e'bomb95: checks 
THE_CLOWN_74: bets €0.09
cap e'bomb95: folds 
Uncalled bet (€0.09) returned to THE_CLOWN_74
THE_CLOWN_74 collected €0.18 from pot
THE_CLOWN_74: doesn't show hand 
*** SUMMARY ***
Total pot €0.18 | Rake €0 
Board [Ah 4d 3s]
Seat 1: TheKing.1969 (button) folded before Flop (didn't bet)
Seat 2: cap e'bomb95 (small blind) folded on the Flop
Seat 3: Qogg (big blind) folded before Flop
Seat 4: THE_CLOWN_74 collected (€0.18)
Seat 5: ghosto69 folded before Flop (didn't bet)
Seat 6: caduceus369 folded before Flop (didn't bet)



PokerStars Zoom Hand #257957768148:  Hold'em No Limit (€0.01/€0.02) [ADM ID: M62BA304494E32ST] - 2025/10/01 14:30:58 CET [2025/10/01 8:30:58 ET]
Table 'Sirio' 6-max Seat #1 is the button
Seat 1: THE_CLOWN_74 (€2.05 in chips) 
Seat 2: Qogg (€2.99 in chips) 
Seat 3: Pasdum57 (€1.50 in chips) 
Seat 4: TheKing.1969 (€3.38 in chips) 
Seat 5: caduceus369 (€2.03 in chips) 
Seat 6: KOBRAJOE (€1.98 in chips) 
Qogg: posts small blind €0.01
Pasdum57: posts big blind €0.02
*** HOLE CARDS ***
Dealt to caduceus369 [5c Jh]
TheKing.1969: folds 
caduceus369: folds 
KOBRAJOE: folds 
THE_CLOWN_74: folds 
Qogg: folds 
Uncalled bet (€0.01) returned to Pasdum57
Pasdum57 collected €0.02 from pot
Pasdum57: doesn't show hand 
*** SUMMARY ***
Total pot €0.02 | Rake €0 
Seat 1: THE_CLOWN_74 (button) folded before Flop (didn't bet)
Seat 2: Qogg (small blind) folded before Flop
Seat 3: Pasdum57 (big blind) collected (€0.02)
Seat 4: TheKing.1969 folded before Flop (didn't bet)
Seat 5: caduceus369 folded before Flop (didn't bet)
Seat 6: KOBRAJOE folded before Flop (didn't bet)



PokerStars Zoom Hand #257957768728:  Hold'em No Limit (€0.01/€0.02) [ADM ID: M62BA304494E32ST] - 2025/10/01 14:31:03 CET [2025/10/01 8:31:03 ET]
Table 'Sirio' 6-max Seat #1 is the button
Seat 1: caduceus369 (€2.03 in chips) 
Seat 2: KOBRAJOE (€1.98 in chips) 
Seat 3: sipa66 (€2.29 in chips) 
Seat 4: TheKing.1969 (€3.38 in chips) 
Seat 5: THE_CLOWN_74 (€2.05 in chips) 
Seat 6: duemmebike (€2.17 in chips) 
KOBRAJOE: posts small blind €0.01
sipa66: posts big blind €0.02
*** HOLE CARDS ***
Dealt to caduceus369 [7h 5s]
TheKing.1969: folds 
THE_CLOWN_74: folds 
duemmebike: folds 
caduceus369: folds 
KOBRAJOE: calls €0.01
sipa66: raises €0.04 to €0.06
KOBRAJOE: folds 
Uncalled bet (€0.04) returned to sipa66
sipa66 collected €0.04 from pot
sipa66: doesn't show hand 
*** SUMMARY ***
Total pot €0.04 | Rake €0 
Seat 1: caduceus369 (button) folded before Flop (didn't bet)
Seat 2: KOBRAJOE (small blind) folded before Flop
Seat 3: sipa66 (big blind) collected (€0.04)
Seat 4: TheKing.1969 folded before Flop (didn't bet)
Seat 5: THE_CLOWN_74 folded before Flop (didn't bet)
Seat 6: duemmebike folded before Flop (didn't bet)



PokerStars Zoom Hand #257957770215:  Hold'em No Limit (€0.01/€0.02) [ADM ID: M62BA304494E32ST] - 2025/10/01 14:31:15 CET [2025/10/01 8:31:15 ET]
Table 'Sirio' 6-max Seat #1 is the button
Seat 1: monsterc99 (€0.63 in chips) 
Seat 2: yisai (€3.14 in chips) 
Seat 3: caduceus369 (€2.02 in chips) 
Seat 4: Qogg (€2.33 in chips) 
Seat 5: francovirde (€3.68 in chips) 
Seat 6: Fengjie82 (€2.97 in chips) 
yisai: posts small blind €0.01
caduceus369: posts big blind €0.02
*** HOLE CARDS ***
Dealt to caduceus369 [6s 9h]
Qogg: folds 
francovirde: folds 
Fengjie82: raises €0.02 to €0.04
monsterc99: folds 
yisai: calls €0.03
caduceus369: folds 
*** FLOP *** [7d 4s 5s]
yisai: bets €0.10
Fengjie82: folds 
Uncalled bet (€0.10) returned to yisai
yisai collected €0.10 from pot
yisai: doesn't show hand 
*** SUMMARY ***
Total pot €0.10 | Rake €0 
Board [7d 4s 5s]
Seat 1: monsterc99 (button) folded before Flop (didn't bet)
Seat 2: yisai (small blind) collected (€0.10)
Seat 3: caduceus369 (big blind) folded before Flop
Seat 4: Qogg folded before Flop (didn't bet)
Seat 5: francovirde folded before Flop (didn't bet)
Seat 6: Fengjie82 folded on the Flop



PokerStars Zoom Hand #257957769106:  Hold'em No Limit (€0.01/€0.02) [ADM ID: M62BA304494E32ST] - 2025/10/01 14:31:06 CET [2025/10/01 8:31:06 ET]
Table 'Sirio' 6-max Seat #1 is the button
Seat 1: Qogg (€2.98 in chips) 
Seat 2: caduceus369 (€2.03 in chips) 
Seat 3: francovirde (€3.70 in chips) 
Seat 4: cap e'bomb95 (€2.44 in chips) 
Seat 5: TurboMuletto (€2.01 in chips) 
Seat 6: Catania838 (€1.38 in chips) 
caduceus369: posts small blind €0.01
francovirde: posts big blind €0.02
*** HOLE CARDS ***
Dealt to caduceus369 [3c 7h]
cap e'bomb95: raises €0.03 to €0.05
TurboMuletto: folds 
Catania838: calls €0.05
Qogg: folds 
caduceus369: folds 
francovirde: folds 
*** FLOP *** [8c 2d 7c]
cap e'bomb95: bets €0.09
Catania838: folds 
Uncalled bet (€0.09) returned to cap e'bomb95
cap e'bomb95 collected €0.13 from pot
cap e'bomb95: doesn't show hand 
*** SUMMARY ***
Total pot €0.13 | Rake €0 
Board [8c 2d 7c]
Seat 1: Qogg (button) folded before Flop (didn't bet)
Seat 2: caduceus369 (small blind) folded before Flop
Seat 3: francovirde (big blind) folded before Flop
Seat 4: cap e'bomb95 collected (€0.13)
Seat 5: TurboMuletto folded before Flop (didn't bet)
Seat 6: Catania838 folded on the Flop



PokerStars Zoom Hand #257957769556:  Hold'em No Limit (€0.01/€0.02) [ADM ID: M62BA304494E32ST] - 2025/10/01 14:31:10 CET [2025/10/01 8:31:10 ET]
Table 'Sirio' 6-max Seat #1 is the button
Seat 1: Zeppoliathor (€0.49 in chips) 
Seat 2: TheKing.1969 (€3.38 in chips) 
Seat 3: OMGWOLFX (€3.63 in chips) 
Seat 4: THE_CLOWN_74 (€2.51 in chips) 
Seat 5: ghosto69 (€1.97 in chips) 
Seat 6: caduceus369 (€2.02 in chips) 
TheKing.1969: posts small blind €0.01
OMGWOLFX: posts big blind €0.02
*** HOLE CARDS ***
Dealt to caduceus369 [7h 9c]
THE_CLOWN_74: folds 
ghosto69: folds 
caduceus369: folds 
Zeppoliathor: raises €0.02 to €0.04
TheKing.1969: raises €0.12 to €0.16
OMGWOLFX: folds 
Zeppoliathor: calls €0.12
*** FLOP *** [Ts 5c 9d]
TheKing.1969: bets €0.37
Zeppoliathor: folds 
Uncalled bet (€0.37) returned to TheKing.1969
TheKing.1969 collected €0.33 from pot
TheKing.1969: doesn't show hand 
*** SUMMARY ***
Total pot €0.34 | Rake €0.01 
Board [Ts 5c 9d]
Seat 1: Zeppoliathor (button) folded on the Flop
Seat 2: TheKing.1969 (small blind) collected (€0.33)
Seat 3: OMGWOLFX (big blind) folded before Flop
Seat 4: THE_CLOWN_74 folded before Flop (didn't bet)
Seat 5: ghosto69 folded before Flop (didn't bet)
Seat 6: caduceus369 folded before Flop (didn't bet)



PokerStars Zoom Hand #257957772656:  Hold'em No Limit (€0.01/€0.02) [ADM ID: M62BA304494E32ST] - 2025/10/01 14:31:35 CET [2025/10/01 8:31:35 ET]
Table 'Sirio' 6-max Seat #1 is the button
Seat 1: caduceus369 (€2 in chips) 
Seat 2: OMGWOLFX (€4 in chips) 
Seat 3: Poonte (€2.03 in chips) 
Seat 4: sipa66 (€2.17 in chips) 
Seat 5: Fengjie82 (€2.93 in chips) 
Seat 6: yisai (€3.20 in chips) 
OMGWOLFX: posts small blind €0.01
Poonte: posts big blind €0.02
*** HOLE CARDS ***
Dealt to caduceus369 [6c 5h]
sipa66: folds 
Fengjie82: folds 
yisai: folds 
caduceus369: folds 
OMGWOLFX: raises €0.04 to €0.06
Poonte: folds 
Uncalled bet (€0.04) returned to OMGWOLFX
OMGWOLFX collected €0.04 from pot
OMGWOLFX: doesn't show hand 
*** SUMMARY ***
Total pot €0.04 | Rake €0 
Seat 1: caduceus369 (button) folded before Flop (didn't bet)
Seat 2: OMGWOLFX (small blind) collected (€0.04)
Seat 3: Poonte (big blind) folded before Flop
Seat 4: sipa66 folded before Flop (didn't bet)
Seat 5: Fengjie82 folded before Flop (didn't bet)
Seat 6: yisai folded before Flop (didn't bet)



PokerStars Zoom Hand #257957772068:  Hold'em No Limit (€0.01/€0.02) [ADM ID: M62BA304494E32ST] - 2025/10/01 14:31:30 CET [2025/10/01 8:31:30 ET]
Table 'Sirio' 6-max Seat #1 is the button
Seat 1: THE_CLOWN_74 (€2.02 in chips) 
Seat 2: TheKing.1969 (€2.92 in chips) 
Seat 3: mrniceseed (€1.26 in chips) 
Seat 4: caduceus369 (€2 in chips) 
Seat 5: TOROLAI (€3.50 in chips) 
Seat 6: gigysk (€1.90 in chips) 
TheKing.1969: posts small blind €0.01
mrniceseed: posts big blind €0.02
*** HOLE CARDS ***
Dealt to caduceus369 [6s 5h]
caduceus369: folds 
TOROLAI has timed out
TOROLAI: folds 
gigysk: folds 
THE_CLOWN_74: folds 
TheKing.1969: folds 
Uncalled bet (€0.01) returned to mrniceseed
mrniceseed collected €0.02 from pot
mrniceseed: doesn't show hand 
*** SUMMARY ***
Total pot €0.02 | Rake €0 
Seat 1: THE_CLOWN_74 (button) folded before Flop (didn't bet)
Seat 2: TheKing.1969 (small blind) folded before Flop
Seat 3: mrniceseed (big blind) collected (€0.02)
Seat 4: caduceus369 folded before Flop (didn't bet)
Seat 5: TOROLAI folded before Flop (didn't bet)
Seat 6: gigysk folded before Flop (didn't bet)



PokerStars Zoom Hand #257957771298:  Hold'em No Limit (€0.01/€0.02) [ADM ID: M62BA304494E32ST] - 2025/10/01 14:31:24 CET [2025/10/01 8:31:24 ET]
Table 'Sirio' 6-max Seat #1 is the button
Seat 1: sipa66 (€2.31 in chips) 
Seat 2: THE_CLOWN_74 (€2.03 in chips) 
Seat 3: OMGWOLFX (€2.67 in chips) 
Seat 4: caduceus369 (€2 in chips) 
Seat 5: monsterc99 (€0.63 in chips) 
Seat 6: giocrouch (€1.90 in chips) 
THE_CLOWN_74: posts small blind €0.01
OMGWOLFX: posts big blind €0.02
*** HOLE CARDS ***
Dealt to caduceus369 [Td 2c]
caduceus369: folds 
monsterc99: raises €0.04 to €0.06
giocrouch: folds 
sipa66: raises €0.15 to €0.21
THE_CLOWN_74: folds 
OMGWOLFX: folds 
monsterc99: calls €0.15
*** FLOP *** [8c 5c 6h]
monsterc99: checks 
sipa66: bets €0.54
monsterc99: calls €0.42 and is all-in
Uncalled bet (€0.12) returned to sipa66
*** TURN *** [8c 5c 6h] [4h]
*** RIVER *** [8c 5c 6h 4h] [Ac]
*** SHOW DOWN ***
monsterc99: shows [Kh Ad] (a pair of Aces)
sipa66: shows [Jd Ks] (high card Ace)
monsterc99 collected €1.22 from pot
*** SUMMARY ***
Total pot €1.29 | Rake €0.07 
Board [8c 5c 6h 4h Ac]
Seat 1: sipa66 (button) showed [Jd Ks] and lost with high card Ace
Seat 2: THE_CLOWN_74 (small blind) folded before Flop
Seat 3: OMGWOLFX (big blind) folded before Flop
Seat 4: caduceus369 folded before Flop (didn't bet)
Seat 5: monsterc99 showed [Kh Ad] and won (€1.22) with a pair of Aces
Seat 6: giocrouch folded before Flop (didn't bet)



PokerStars Zoom Hand #257957773551:  Hold'em No Limit (€0.01/€0.02) [ADM ID: M62BA304494E32ST] - 2025/10/01 14:31:42 CET [2025/10/01 8:31:42 ET]
Table 'Sirio' 6-max Seat #1 is the button
Seat 1: Pasdum57 (€1.45 in chips) 
Seat 2: caduceus369 (€2 in chips) 
Seat 3: THE_CLOWN_74 (€2.50 in chips) 
Seat 4: NoveDiCuori9 (€2.14 in chips) 
Seat 5: cap e'bomb95 (€4.35 in chips) 
Seat 6: OMGWOLFX (€2.65 in chips) 
caduceus369: posts small blind €0.01
THE_CLOWN_74: posts big blind €0.02
*** HOLE CARDS ***
Dealt to caduceus369 [8c Jd]
NoveDiCuori9: folds 
cap e'bomb95: folds 
OMGWOLFX: raises €0.04 to €0.06
Pasdum57: folds 
caduceus369: folds 
THE_CLOWN_74: raises €0.12 to €0.18
OMGWOLFX: folds 
Uncalled bet (€0.12) returned to THE_CLOWN_74
THE_CLOWN_74 collected €0.13 from pot
THE_CLOWN_74: doesn't show hand 
*** SUMMARY ***
Total pot €0.13 | Rake €0 
Seat 1: Pasdum57 (button) folded before Flop (didn't bet)
Seat 2: caduceus369 (small blind) folded before Flop
Seat 3: THE_CLOWN_74 (big blind) collected (€0.13)
Seat 4: NoveDiCuori9 folded before Flop (didn't bet)
Seat 5: cap e'bomb95 folded before Flop (didn't bet)
Seat 6: OMGWOLFX folded before Flop



PokerStars Zoom Hand #257957774843:  Hold'em No Limit (€0.01/€0.02) [ADM ID: M62BA304494E32ST] - 2025/10/01 14:31:52 CET [2025/10/01 8:31:52 ET]
Table 'Sirio' 6-max Seat #1 is the button
Seat 1: Qogg (€2.55 in chips) 
Seat 2: TheKing.1969 (€1.96 in chips) 
Seat 3: TurboMuletto (€1.89 in chips) 
Seat 4: NoveDiCuori9 (€2.14 in chips) 
Seat 5: OMGWOLFX (€4.02 in chips) 
Seat 6: caduceus369 (€1.99 in chips) 
TheKing.1969: posts small blind €0.01
TurboMuletto: posts big blind €0.02
*** HOLE CARDS ***
Dealt to caduceus369 [7s 6s]
NoveDiCuori9: folds 
OMGWOLFX: raises €0.04 to €0.06
caduceus369: calls €0.06
Qogg: raises €0.18 to €0.24
TheKing.1969: folds 
TurboMuletto: folds 
OMGWOLFX: folds 
caduceus369: folds 
Uncalled bet (€0.18) returned to Qogg
Qogg collected €0.21 from pot
Qogg: doesn't show hand 
*** SUMMARY ***
Total pot €0.21 | Rake €0 
Seat 1: Qogg (button) collected (€0.21)
Seat 2: TheKing.1969 (small blind) folded before Flop
Seat 3: TurboMuletto (big blind) folded before Flop
Seat 4: NoveDiCuori9 folded before Flop (didn't bet)
Seat 5: OMGWOLFX folded before Flop
Seat 6: caduceus369 folded before Flop



PokerStars Zoom Hand #257957784465:  Hold'em No Limit (€0.01/€0.02) [ADM ID: M62BA304494E32ST] - 2025/10/01 14:33:08 CET [2025/10/01 8:33:08 ET]
Table 'Sirio' 6-max Seat #1 is the button
Seat 1: caduceus369 (€1.93 in chips) 
Seat 2: sipa66 (€2.65 in chips) 
Seat 3: TheKing.1969 (€2.18 in chips) 
Seat 4: monsterc99 (€1.25 in chips) 
Seat 5: mrniceseed (€1.30 in chips) 
Seat 6: Poonte (€2 in chips) 
sipa66: posts small blind €0.01
TheKing.1969: posts big blind €0.02
*** HOLE CARDS ***
Dealt to caduceus369 [8c Js]
monsterc99: folds 
mrniceseed: folds 
Poonte: calls €0.02
caduceus369: folds 
sipa66: folds 
TheKing.1969: checks 
*** FLOP *** [3c 8d 5s]
TheKing.1969: checks 
Poonte: checks 
*** TURN *** [3c 8d 5s] [Qs]
TheKing.1969: checks 
Poonte: checks 
*** RIVER *** [3c 8d 5s Qs] [7d]
TheKing.1969: checks 
Poonte: checks 
*** SHOW DOWN ***
TheKing.1969: shows [Ah Ts] (high card Ace)
Poonte: mucks hand 
TheKing.1969 collected €0.05 from pot
*** SUMMARY ***
Total pot €0.05 | Rake €0 
Board [3c 8d 5s Qs 7d]
Seat 1: caduceus369 (button) folded before Flop (didn't bet)
Seat 2: sipa66 (small blind) folded before Flop
Seat 3: TheKing.1969 (big blind) showed [Ah Ts] and won (€0.05) with high card Ace
Seat 4: monsterc99 folded before Flop (didn't bet)
Seat 5: mrniceseed folded before Flop (didn't bet)
Seat 6: Poonte mucked [Ad 9d]



PokerStars Zoom Hand #257957785618:  Hold'em No Limit (€0.01/€0.02) [ADM ID: M62BA304494E32ST] - 2025/10/01 14:33:17 CET [2025/10/01 8:33:17 ET]
Table 'Sirio' 6-max Seat #1 is the button
Seat 1: giocrouch (€1.95 in chips) 
Seat 2: THE_CLOWN_74 (€2.51 in chips) 
Seat 3: duemmebike (€2.24 in chips) 
Seat 4: ghosto69 (€1.12 in chips) 
Seat 5: caduceus369 (€1.93 in chips) 
Seat 6: sipa66 (€2.64 in chips) 
THE_CLOWN_74: posts small blind €0.01
duemmebike: posts big blind €0.02
*** HOLE CARDS ***
Dealt to caduceus369 [8c Kc]
ghosto69: folds 
caduceus369: calls €0.02
sipa66: raises €0.04 to €0.06
giocrouch: folds 
THE_CLOWN_74: folds 
duemmebike: folds 
caduceus369: calls €0.04
*** FLOP *** [4d 7d Jc]
caduceus369: checks 
sipa66: bets €0.11
caduceus369: folds 
Uncalled bet (€0.11) returned to sipa66
sipa66 collected €0.15 from pot
sipa66: doesn't show hand 
*** SUMMARY ***
Total pot €0.15 | Rake €0 
Board [4d 7d Jc]
Seat 1: giocrouch (button) folded before Flop (didn't bet)
Seat 2: THE_CLOWN_74 (small blind) folded before Flop
Seat 3: duemmebike (big blind) folded before Flop
Seat 4: ghosto69 folded before Flop (didn't bet)
Seat 5: caduceus369 folded on the Flop
Seat 6: sipa66 collected (€0.15)



PokerStars Zoom Hand #257957792706:  Hold'em No Limit (€0.01/€0.02) [ADM ID: M62BA304494E32ST] - 2025/10/01 14:34:14 CET [2025/10/01 8:34:14 ET]
Table 'Sirio' 6-max Seat #1 is the button
Seat 1: TheKing.1969 (€4.93 in chips) 
Seat 2: caduceus369 (€1.85 in chips) 
Seat 3: NoveDiCuori9 (€2.20 in chips) 
Seat 4: francovirde (€3.59 in chips) 
Seat 5: Pasdum57 (€1.35 in chips) 
Seat 6: cagliari59 (€2.03 in chips) 
caduceus369: posts small blind €0.01
NoveDiCuori9: posts big blind €0.02
*** HOLE CARDS ***
Dealt to caduceus369 [3s 3d]
francovirde: folds 
Pasdum57: folds 
cagliari59: folds 
TheKing.1969: folds 
caduceus369: calls €0.01
NoveDiCuori9: checks 
*** FLOP *** [7d 8h Ts]
caduceus369: bets €0.02
NoveDiCuori9: calls €0.02
*** TURN *** [7d 8h Ts] [6s]
caduceus369: checks 
NoveDiCuori9: checks 
*** RIVER *** [7d 8h Ts 6s] [9s]
caduceus369: bets €0.02
NoveDiCuori9: calls €0.02
*** SHOW DOWN ***
caduceus369: shows [3s 3d] (a straight, Six to Ten)
NoveDiCuori9: shows [4c 8d] (a straight, Six to Ten)
caduceus369 collected €0.06 from pot
NoveDiCuori9 collected €0.06 from pot
*** SUMMARY ***
Total pot €0.12 | Rake €0 
Board [7d 8h Ts 6s 9s]
Seat 1: TheKing.1969 (button) folded before Flop (didn't bet)
Seat 2: caduceus369 (small blind) showed [3s 3d] and won (€0.06) with a straight, Six to Ten
Seat 3: NoveDiCuori9 (big blind) showed [4c 8d] and won (€0.06) with a straight, Six to Ten
Seat 4: francovirde folded before Flop (didn't bet)
Seat 5: Pasdum57 folded before Flop (didn't bet)
Seat 6: cagliari59 folded before Flop (didn't bet)



PokerStars Zoom Hand #257957790875:  Hold'em No Limit (€0.01/€0.02) [ADM ID: M62BA304494E32ST] - 2025/10/01 14:33:59 CET [2025/10/01 8:33:59 ET]
Table 'Sirio' 6-max Seat #1 is the button
Seat 1: giocrouch (€2.59 in chips) 
Seat 2: OMGWOLFX (€2.13 in chips) 
Seat 3: caduceus369 (€1.87 in chips) 
Seat 4: Catania838 (€2.65 in chips) 
Seat 5: sipa66 (€2.73 in chips) 
Seat 6: MathMassacreX (€2.80 in chips) 
OMGWOLFX: posts small blind €0.01
caduceus369: posts big blind €0.02
*** HOLE CARDS ***
Dealt to caduceus369 [Js 5c]
Catania838: folds 
sipa66: folds 
MathMassacreX: folds 
giocrouch: raises €0.03 to €0.05
OMGWOLFX: calls €0.04
caduceus369: folds 
*** FLOP *** [8s Td 5h]
OMGWOLFX: bets €0.08
giocrouch: calls €0.08
*** TURN *** [8s Td 5h] [4s]
OMGWOLFX: bets €0.14
giocrouch: calls €0.14
*** RIVER *** [8s Td 5h 4s] [Kd]
OMGWOLFX: checks 
giocrouch: checks 
*** SHOW DOWN ***
OMGWOLFX: shows [Ad Th] (a pair of Tens)
giocrouch: mucks hand 
OMGWOLFX collected €0.53 from pot
*** SUMMARY ***
Total pot €0.56 | Rake €0.03 
Board [8s Td 5h 4s Kd]
Seat 1: giocrouch (button) mucked [6h Ah]
Seat 2: OMGWOLFX (small blind) showed [Ad Th] and won (€0.53) with a pair of Tens
Seat 3: caduceus369 (big blind) folded before Flop
Seat 4: Catania838 folded before Flop (didn't bet)
Seat 5: sipa66 folded before Flop (didn't bet)
Seat 6: MathMassacreX folded before Flop (didn't bet)



PokerStars Zoom Hand #257957796091:  Hold'em No Limit (€0.01/€0.02) [ADM ID: M62BA304494E32ST] - 2025/10/01 14:34:40 CET [2025/10/01 8:34:40 ET]
Table 'Sirio' 6-max Seat #1 is the button
Seat 1: NoveDiCuori9 (€2.20 in chips) 
Seat 2: sipa66 (€1.98 in chips) 
Seat 3: ghosto69 (€2.05 in chips) 
Seat 4: THE_CLOWN_74 (€2.51 in chips) 
Seat 5: OMGWOLFX (€2.06 in chips) 
Seat 6: caduceus369 (€1.85 in chips) 
sipa66: posts small blind €0.01
ghosto69: posts big blind €0.02
*** HOLE CARDS ***
Dealt to caduceus369 [9s 6h]
THE_CLOWN_74: folds 
OMGWOLFX: folds 
caduceus369: folds 
NoveDiCuori9: raises €0.04 to €0.06
sipa66: folds 
ghosto69: folds 
Uncalled bet (€0.04) returned to NoveDiCuori9
NoveDiCuori9 collected €0.05 from pot
NoveDiCuori9: doesn't show hand 
*** SUMMARY ***
Total pot €0.05 | Rake €0 
Seat 1: NoveDiCuori9 (button) collected (€0.05)
Seat 2: sipa66 (small blind) folded before Flop
Seat 3: ghosto69 (big blind) folded before Flop
Seat 4: THE_CLOWN_74 folded before Flop (didn't bet)
Seat 5: OMGWOLFX folded before Flop (didn't bet)
Seat 6: caduceus369 folded before Flop (didn't bet)



PokerStars Zoom Hand #257957796749:  Hold'em No Limit (€0.01/€0.02) [ADM ID: M62BA304494E32ST] - 2025/10/01 14:34:45 CET [2025/10/01 8:34:45 ET]
Table 'Sirio' 6-max Seat #1 is the button
Seat 1: OMGWOLFX (€2.06 in chips) 
Seat 2: dagliaddosso (€2.03 in chips) 
Seat 3: ghosto69 (€1.76 in chips) 
Seat 4: caduceus369 (€1.85 in chips) 
Seat 5: yisai (€3.33 in chips) 
Seat 6: monsterc99 (€1.26 in chips) 
dagliaddosso: posts small blind €0.01
ghosto69: posts big blind €0.02
*** HOLE CARDS ***
Dealt to caduceus369 [8h Jd]
caduceus369: folds 
yisai: folds 
monsterc99: folds 
OMGWOLFX: raises €0.04 to €0.06
dagliaddosso: folds 
ghosto69: folds 
Uncalled bet (€0.04) returned to OMGWOLFX
OMGWOLFX collected €0.05 from pot
OMGWOLFX: doesn't show hand 
*** SUMMARY ***
Total pot €0.05 | Rake €0 
Seat 1: OMGWOLFX (button) collected (€0.05)
Seat 2: dagliaddosso (small blind) folded before Flop
Seat 3: ghosto69 (big blind) folded before Flop
Seat 4: caduceus369 folded before Flop (didn't bet)
Seat 5: yisai folded before Flop (didn't bet)
Seat 6: monsterc99 folded before Flop (didn't bet)



PokerStars Zoom Hand #257957798255:  Hold'em No Limit (€0.01/€0.02) [ADM ID: M62BA304494E32ST] - 2025/10/01 14:34:57 CET [2025/10/01 8:34:57 ET]
Table 'Sirio' 6-max Seat #1 is the button
Seat 1: Catania838 (€2.57 in chips) 
Seat 2: TurboMuletto (€1.86 in chips) 
Seat 3: KOBRAJOE (€2.04 in chips) 
Seat 4: TheKing.1969 (€2.21 in chips) 
Seat 5: caduceus369 (€1.85 in chips) 
Seat 6: OMGWOLFX (€3.89 in chips) 
TurboMuletto: posts small blind €0.01
KOBRAJOE: posts big blind €0.02
*** HOLE CARDS ***
Dealt to caduceus369 [Td Jc]
TheKing.1969: folds 
caduceus369: folds 
OMGWOLFX: folds 
Catania838: folds 
TurboMuletto: calls €0.01
KOBRAJOE: checks 
*** FLOP *** [Qc Ts Js]
TurboMuletto: checks 
KOBRAJOE: bets €0.02
TurboMuletto: folds 
Uncalled bet (€0.02) returned to KOBRAJOE
KOBRAJOE collected €0.04 from pot
KOBRAJOE: doesn't show hand 
*** SUMMARY ***
Total pot €0.04 | Rake €0 
Board [Qc Ts Js]
Seat 1: Catania838 (button) folded before Flop (didn't bet)
Seat 2: TurboMuletto (small blind) folded on the Flop
Seat 3: KOBRAJOE (big blind) collected (€0.04)
Seat 4: TheKing.1969 folded before Flop (didn't bet)
Seat 5: caduceus369 folded before Flop (didn't bet)
Seat 6: OMGWOLFX folded before Flop (didn't bet)



PokerStars Zoom Hand #257957798903:  Hold'em No Limit (€0.01/€0.02) [ADM ID: M62BA304494E32ST] - 2025/10/01 14:35:02 CET [2025/10/01 8:35:02 ET]
Table 'Sirio' 6-max Seat #1 is the button
Seat 1: caduceus369 (€1.85 in chips) 
Seat 2: yisai (€2.47 in chips) 
Seat 3: zicky78.r (€2 in chips) 
Seat 4: TheKing.1969 (€2.17 in chips) 
Seat 5: MathMassacreX (€2.85 in chips) 
Seat 6: OMGWOLFX (€2.39 in chips) 
yisai: posts small blind €0.01
zicky78.r: posts big blind €0.02
*** HOLE CARDS ***
Dealt to caduceus369 [Qd Qs]
TheKing.1969: folds 
MathMassacreX: raises €0.05 to €0.07
OMGWOLFX: folds 
caduceus369: raises €0.13 to €0.20
yisai: folds 
zicky78.r: calls €0.18
MathMassacreX: folds 
*** FLOP *** [4d Kd Qh]
zicky78.r: checks 
caduceus369: bets €0.12
zicky78.r: folds 
Uncalled bet (€0.12) returned to caduceus369
caduceus369 collected €0.46 from pot
caduceus369: doesn't show hand 
*** SUMMARY ***
Total pot €0.48 | Rake €0.02 
Board [4d Kd Qh]
Seat 1: caduceus369 (button) collected (€0.46)
Seat 2: yisai (small blind) folded before Flop
Seat 3: zicky78.r (big blind) folded on the Flop
Seat 4: TheKing.1969 folded before Flop (didn't bet)
Seat 5: MathMassacreX folded before Flop
Seat 6: OMGWOLFX folded before Flop (didn't bet)



PokerStars Zoom Hand #257957804110:  Hold'em No Limit (€0.01/€0.02) [ADM ID: M62BA304494E32ST] - 2025/10/01 14:35:43 CET [2025/10/01 8:35:43 ET]
Table 'Sirio' 6-max Seat #1 is the button
Seat 1: sipa66 (€1.90 in chips) 
Seat 2: OMGWOLFX (€3.92 in chips) 
Seat 3: zicky78.r (€2 in chips) 
Seat 4: giocrouch (€2.30 in chips) 
Seat 5: caduceus369 (€2.11 in chips) 
Seat 6: Quelle128 (€0.34 in chips) 
OMGWOLFX: posts small blind €0.01
zicky78.r: posts big blind €0.02
*** HOLE CARDS ***
Dealt to caduceus369 [5c Kd]
giocrouch: folds 
caduceus369: folds 
Quelle128: calls €0.02
sipa66: raises €0.04 to €0.06
OMGWOLFX: folds 
zicky78.r: folds 
Quelle128: calls €0.04
*** FLOP *** [Tc Jc Qs]
Quelle128: checks 
sipa66: bets €0.04
Quelle128: calls €0.04
*** TURN *** [Tc Jc Qs] [5d]
Quelle128: checks 
sipa66: checks 
*** RIVER *** [Tc Jc Qs 5d] [6s]
Quelle128: checks 
sipa66: checks 
*** SHOW DOWN ***
Quelle128: shows [3s 3c] (a pair of Threes)
sipa66: mucks hand 
Quelle128 collected €0.22 from pot
*** SUMMARY ***
Total pot €0.23 | Rake €0.01 
Board [Tc Jc Qs 5d 6s]
Seat 1: sipa66 (button) mucked [4s Ks]
Seat 2: OMGWOLFX (small blind) folded before Flop
Seat 3: zicky78.r (big blind) folded before Flop
Seat 4: giocrouch folded before Flop (didn't bet)
Seat 5: caduceus369 folded before Flop (didn't bet)
Seat 6: Quelle128 showed [3s 3c] and won (€0.22) with a pair of Threes



PokerStars Zoom Hand #257957804948:  Hold'em No Limit (€0.01/€0.02) [ADM ID: M62BA304494E32ST] - 2025/10/01 14:35:49 CET [2025/10/01 8:35:49 ET]
Table 'Sirio' 6-max Seat #1 is the button
Seat 1: Pasdum57 (€1.16 in chips) 
Seat 2: Poonte (€2.12 in chips) 
Seat 3: caduceus369 (€2.11 in chips) 
Seat 4: francovirde (€2.31 in chips) 
Seat 5: ghosto69 (€1.37 in chips) 
Seat 6: giocrouch (€2.30 in chips) 
Poonte: posts small blind €0.01
caduceus369: posts big blind €0.02
*** HOLE CARDS ***
Dealt to caduceus369 [5d 9d]
francovirde: folds 
ghosto69: folds 
giocrouch: folds 
Pasdum57: calls €0.02
Poonte: folds 
caduceus369: checks 
*** FLOP *** [3d Js 5h]
caduceus369: bets €0.02
Pasdum57: folds 
Uncalled bet (€0.02) returned to caduceus369
caduceus369 collected €0.05 from pot
caduceus369: doesn't show hand 
*** SUMMARY ***
Total pot €0.05 | Rake €0 
Board [3d Js 5h]
Seat 1: Pasdum57 (button) folded on the Flop
Seat 2: Poonte (small blind) folded before Flop
Seat 3: caduceus369 (big blind) collected (€0.05)
Seat 4: francovirde folded before Flop (didn't bet)
Seat 5: ghosto69 folded before Flop (didn't bet)
Seat 6: giocrouch folded before Flop (didn't bet)



PokerStars Zoom Hand #257957803625:  Hold'em No Limit (€0.01/€0.02) [ADM ID: M62BA304494E32ST] - 2025/10/01 14:35:39 CET [2025/10/01 8:35:39 ET]
Table 'Sirio' 6-max Seat #1 is the button
Seat 1: cap e'bomb95 (€3.32 in chips) 
Seat 2: zicky78.r (€2 in chips) 
Seat 3: sipa66 (€1.84 in chips) 
Seat 4: caduceus369 (€2.11 in chips) 
Seat 5: OMGWOLFX (€3.92 in chips) 
Seat 6: giocrouch (€1.66 in chips) 
zicky78.r: posts small blind €0.01
sipa66: posts big blind €0.02
*** HOLE CARDS ***
Dealt to caduceus369 [5h 6d]
caduceus369: folds 
OMGWOLFX: folds 
giocrouch: folds 
cap e'bomb95: folds 
zicky78.r: calls €0.01
sipa66: checks 
*** FLOP *** [9c 3h 4h]
zicky78.r: checks 
sipa66: bets €0.02
zicky78.r: calls €0.02
*** TURN *** [9c 3h 4h] [Jd]
zicky78.r: checks 
sipa66: bets €0.06
zicky78.r: calls €0.06
*** RIVER *** [9c 3h 4h Jd] [8s]
zicky78.r: checks 
sipa66: bets €0.24
zicky78.r: folds 
Uncalled bet (€0.24) returned to sipa66
sipa66 collected €0.19 from pot
sipa66: doesn't show hand 
*** SUMMARY ***
Total pot €0.20 | Rake €0.01 
Board [9c 3h 4h Jd 8s]
Seat 1: cap e'bomb95 (button) folded before Flop (didn't bet)
Seat 2: zicky78.r (small blind) folded on the River
Seat 3: sipa66 (big blind) collected (€0.19)
Seat 4: caduceus369 folded before Flop (didn't bet)
Seat 5: OMGWOLFX folded before Flop (didn't bet)
Seat 6: giocrouch folded before Flop (didn't bet)



PokerStars Zoom Hand #257957809382:  Hold'em No Limit (€0.01/€0.02) [ADM ID: M62BA304494E32ST] - 2025/10/01 14:36:25 CET [2025/10/01 8:36:25 ET]
Table 'Sirio' 6-max Seat #1 is the button
Seat 1: KOBRAJOE (€1.79 in chips) 
Seat 2: caduceus369 (€2.14 in chips) 
Seat 3: TurboMuletto (€1.81 in chips) 
Seat 4: Quelle128 (€0.46 in chips) 
Seat 5: Catania838 (€2.11 in chips) 
Seat 6: gs0097 (€0.82 in chips) 
caduceus369: posts small blind €0.01
TurboMuletto: posts big blind €0.02
*** HOLE CARDS ***
Dealt to caduceus369 [Kd Kh]
Quelle128: folds 
Catania838: folds 
gs0097: folds 
KOBRAJOE: folds 
caduceus369: calls €0.01
TurboMuletto: checks 
*** FLOP *** [7s 6d Td]
caduceus369: checks 
TurboMuletto: checks 
*** TURN *** [7s 6d Td] [7h]
caduceus369: bets €0.04
TurboMuletto: folds 
Uncalled bet (€0.04) returned to caduceus369
caduceus369 collected €0.04 from pot
caduceus369: doesn't show hand 
*** SUMMARY ***
Total pot €0.04 | Rake €0 
Board [7s 6d Td 7h]
Seat 1: KOBRAJOE (button) folded before Flop (didn't bet)
Seat 2: caduceus369 (small blind) collected (€0.04)
Seat 3: TurboMuletto (big blind) folded on the Turn
Seat 4: Quelle128 folded before Flop (didn't bet)
Seat 5: Catania838 folded before Flop (didn't bet)
Seat 6: gs0097 folded before Flop (didn't bet)



PokerStars Zoom Hand #257957812523:  Hold'em No Limit (€0.01/€0.02) [ADM ID: M62BA304494E32ST] - 2025/10/01 14:36:49 CET [2025/10/01 8:36:49 ET]
Table 'Sirio' 6-max Seat #1 is the button
Seat 1: Catania838 (€2.10 in chips) 
Seat 2: OMGWOLFX (€2.01 in chips) 
Seat 3: zicky78.r (€2 in chips) 
Seat 4: sipa66 (€1.78 in chips) 
Seat 5: francovirde (€2.38 in chips) 
Seat 6: caduceus369 (€2.16 in chips) 
OMGWOLFX: posts small blind €0.01
zicky78.r: posts big blind €0.02
*** HOLE CARDS ***
Dealt to caduceus369 [As Tc]
sipa66: folds 
francovirde: folds 
caduceus369: raises €0.02 to €0.04
Catania838: folds 
OMGWOLFX: folds 
zicky78.r: folds 
Uncalled bet (€0.02) returned to caduceus369
caduceus369 collected €0.05 from pot
caduceus369: doesn't show hand 
*** SUMMARY ***
Total pot €0.05 | Rake €0 
Seat 1: Catania838 (button) folded before Flop (didn't bet)
Seat 2: OMGWOLFX (small blind) folded before Flop
Seat 3: zicky78.r (big blind) folded before Flop
Seat 4: sipa66 folded before Flop (didn't bet)
Seat 5: francovirde folded before Flop (didn't bet)
Seat 6: caduceus369 collected (€0.05)



PokerStars Zoom Hand #257957816240:  Hold'em No Limit (€0.01/€0.02) [ADM ID: M62BA304494E32ST] - 2025/10/01 14:37:18 CET [2025/10/01 8:37:18 ET]
Table 'Sirio' 6-max Seat #1 is the button
Seat 1: zicky78.r (€2.26 in chips) 
Seat 2: ghosto69 (€1.58 in chips) 
Seat 3: gs0097 (€0.82 in chips) 
Seat 4: caduceus369 (€2.19 in chips) 
Seat 5: sipa66 (€1.91 in chips) 
Seat 6: OMGWOLFX (€3.53 in chips) 
ghosto69: posts small blind €0.01
gs0097: posts big blind €0.02
*** HOLE CARDS ***
Dealt to caduceus369 [7h Kd]
caduceus369: folds 
sipa66: folds 
OMGWOLFX: folds 
zicky78.r: raises €0.05 to €0.07
ghosto69: folds 
gs0097: folds 
Uncalled bet (€0.05) returned to zicky78.r
zicky78.r collected €0.05 from pot
zicky78.r: doesn't show hand 
*** SUMMARY ***
Total pot €0.05 | Rake €0 
Seat 1: zicky78.r (button) collected (€0.05)
Seat 2: ghosto69 (small blind) folded before Flop
Seat 3: gs0097 (big blind) folded before Flop
Seat 4: caduceus369 folded before Flop (didn't bet)
Seat 5: sipa66 folded before Flop (didn't bet)
Seat 6: OMGWOLFX folded before Flop (didn't bet)



PokerStars Zoom Hand #257957816635:  Hold'em No Limit (€0.01/€0.02) [ADM ID: M62BA304494E32ST] - 2025/10/01 14:37:21 CET [2025/10/01 8:37:21 ET]
Table 'Sirio' 6-max Seat #1 is the button
Seat 1: zicky78.r (€2 in chips) 
Seat 2: Catania838 (€2.55 in chips) 
Seat 3: caduceus369 (€2.19 in chips) 
Seat 4: cap e'bomb95 (€3.59 in chips) 
Seat 5: mrniceseed (€1.34 in chips) 
Seat 6: giocrouch (€2.26 in chips) 
Catania838: posts small blind €0.01
caduceus369: posts big blind €0.02
*** HOLE CARDS ***
Dealt to caduceus369 [4s 8c]
cap e'bomb95: folds 
mrniceseed: calls €0.02
giocrouch: folds 
zicky78.r: folds 
Catania838: calls €0.01
caduceus369: checks 
*** FLOP *** [3h 4d 4c]
Catania838: checks 
caduceus369: bets €0.06
mrniceseed: folds 
Catania838: folds 
Uncalled bet (€0.06) returned to caduceus369
caduceus369 collected €0.06 from pot
caduceus369: doesn't show hand 
*** SUMMARY ***
Total pot €0.06 | Rake €0 
Board [3h 4d 4c]
Seat 1: zicky78.r (button) folded before Flop (didn't bet)
Seat 2: Catania838 (small blind) folded on the Flop
Seat 3: caduceus369 (big blind) collected (€0.06)
Seat 4: cap e'bomb95 folded before Flop (didn't bet)
Seat 5: mrniceseed folded on the Flop
Seat 6: giocrouch folded before Flop (didn't bet)



PokerStars Zoom Hand #257957821730:  Hold'em No Limit (€0.01/€0.02) [ADM ID: M62BA304494E32ST] - 2025/10/01 14:38:01 CET [2025/10/01 8:38:01 ET]
Table 'Sirio' 6-max Seat #1 is the button
Seat 1: caduceus369 (€2.23 in chips) 
Seat 2: lamessolame (€1.32 in chips) 
Seat 3: Lapedonia0426 (€1.27 in chips) 
Seat 4: OMGWOLFX (€3.86 in chips) 
Seat 5: ghosto69 (€1.96 in chips) 
Seat 6: zicky78.r (€2.29 in chips) 
lamessolame: posts small blind €0.01
Lapedonia0426: posts big blind €0.02
*** HOLE CARDS ***
Dealt to caduceus369 [Qc Jh]
OMGWOLFX: raises €0.04 to €0.06
ghosto69: folds 
zicky78.r: folds 
caduceus369: folds 
lamessolame: folds 
Lapedonia0426: folds 
Uncalled bet (€0.04) returned to OMGWOLFX
OMGWOLFX collected €0.05 from pot
OMGWOLFX: doesn't show hand 
*** SUMMARY ***
Total pot €0.05 | Rake €0 
Seat 1: caduceus369 (button) folded before Flop (didn't bet)
Seat 2: lamessolame (small blind) folded before Flop
Seat 3: Lapedonia0426 (big blind) folded before Flop
Seat 4: OMGWOLFX collected (€0.05)
Seat 5: ghosto69 folded before Flop (didn't bet)
Seat 6: zicky78.r folded before Flop (didn't bet)



PokerStars Zoom Hand #257957823482:  Hold'em No Limit (€0.01/€0.02) [ADM ID: M62BA304494E32ST] - 2025/10/01 14:38:14 CET [2025/10/01 8:38:14 ET]
Table 'Sirio' 6-max Seat #1 is the button
Seat 1: lamessolame (€1.31 in chips) 
Seat 2: caduceus369 (€2.23 in chips) 
Seat 3: cap e'bomb95 (€4.06 in chips) 
Seat 4: TurboMuletto (€1.77 in chips) 
Seat 5: OMGWOLFX (€2 in chips) 
Seat 6: KOBRAJOE (€1.76 in chips) 
caduceus369: posts small blind €0.01
cap e'bomb95: posts big blind €0.02
*** HOLE CARDS ***
Dealt to caduceus369 [Js Kd]
TurboMuletto: folds 
OMGWOLFX: raises €0.04 to €0.06
KOBRAJOE: folds 
lamessolame: folds 
caduceus369: folds 
cap e'bomb95: folds 
Uncalled bet (€0.04) returned to OMGWOLFX
OMGWOLFX collected €0.05 from pot
OMGWOLFX: doesn't show hand 
*** SUMMARY ***
Total pot €0.05 | Rake €0 
Seat 1: lamessolame (button) folded before Flop (didn't bet)
Seat 2: caduceus369 (small blind) folded before Flop
Seat 3: cap e'bomb95 (big blind) folded before Flop
Seat 4: TurboMuletto folded before Flop (didn't bet)
Seat 5: OMGWOLFX collected (€0.05)
Seat 6: KOBRAJOE folded before Flop (didn't bet)



PokerStars Zoom Hand #257957824667:  Hold'em No Limit (€0.01/€0.02) [ADM ID: M62BA304494E32ST] - 2025/10/01 14:38:23 CET [2025/10/01 8:38:23 ET]
Table 'Sirio' 6-max Seat #1 is the button
Seat 1: zicky78.r (€2.26 in chips) 
Seat 2: cap e'bomb95 (€4.04 in chips) 
Seat 3: gs0097 (€0.78 in chips) 
Seat 4: lamessolame (€1.31 in chips) 
Seat 5: TurboMuletto (€1.77 in chips) 
Seat 6: caduceus369 (€2.22 in chips) 
cap e'bomb95: posts small blind €0.01
gs0097: posts big blind €0.02
*** HOLE CARDS ***
Dealt to caduceus369 [Jc 5c]
lamessolame: folds 
TurboMuletto: raises €0.04 to €0.06
caduceus369: folds 
zicky78.r: folds 
cap e'bomb95: folds 
gs0097: folds 
Uncalled bet (€0.04) returned to TurboMuletto
TurboMuletto collected €0.05 from pot
TurboMuletto: doesn't show hand 
*** SUMMARY ***
Total pot €0.05 | Rake €0 
Seat 1: zicky78.r (button) folded before Flop (didn't bet)
Seat 2: cap e'bomb95 (small blind) folded before Flop
Seat 3: gs0097 (big blind) folded before Flop
Seat 4: lamessolame folded before Flop (didn't bet)
Seat 5: TurboMuletto collected (€0.05)
Seat 6: caduceus369 folded before Flop (didn't bet)



PokerStars Zoom Hand #257957825405:  Hold'em No Limit (€0.01/€0.02) [ADM ID: M62BA304494E32ST] - 2025/10/01 14:38:29 CET [2025/10/01 8:38:29 ET]
Table 'Sirio' 6-max Seat #1 is the button
Seat 1: cap e'bomb95 (€4.03 in chips) 
Seat 2: mattya69 (€2 in chips) 
Seat 3: monsterc99 (€0.80 in chips) 
Seat 4: zicky78.r (€2.26 in chips) 
Seat 5: caduceus369 (€2.22 in chips) 
Seat 6: OMGWOLFX (€2.25 in chips) 
mattya69: posts small blind €0.01
monsterc99: posts big blind €0.02
*** HOLE CARDS ***
Dealt to caduceus369 [6s 9h]
zicky78.r: folds 
caduceus369: folds 
OMGWOLFX: folds 
cap e'bomb95: folds 
mattya69: raises €0.04 to €0.06
monsterc99: folds 
Uncalled bet (€0.04) returned to mattya69
mattya69 collected €0.04 from pot
mattya69: doesn't show hand 
*** SUMMARY ***
Total pot €0.04 | Rake €0 
Seat 1: cap e'bomb95 (button) folded before Flop (didn't bet)
Seat 2: mattya69 (small blind) collected (€0.04)
Seat 3: monsterc99 (big blind) folded before Flop
Seat 4: zicky78.r folded before Flop (didn't bet)
Seat 5: caduceus369 folded before Flop (didn't bet)
Seat 6: OMGWOLFX folded before Flop (didn't bet)



PokerStars Zoom Hand #257957826108:  Hold'em No Limit (€0.01/€0.02) [ADM ID: M62BA304494E32ST] - 2025/10/01 14:38:34 CET [2025/10/01 8:38:34 ET]
Table 'Sirio' 6-max Seat #1 is the button
Seat 1: caduceus369 (€2.22 in chips) 
Seat 2: OMGWOLFX (€2.25 in chips) 
Seat 3: eudefumi (€1.50 in chips) 
Seat 4: francovirde (€2.72 in chips) 
Seat 5: cap e'bomb95 (€4.03 in chips) 
Seat 6: sipa66 (€2.35 in chips) 
OMGWOLFX: posts small blind €0.01
eudefumi: posts big blind €0.02
*** HOLE CARDS ***
Dealt to caduceus369 [Qd Qh]
francovirde: folds 
cap e'bomb95: folds 
sipa66: folds 
caduceus369: raises €0.02 to €0.04
OMGWOLFX: folds 
eudefumi: folds 
Uncalled bet (€0.02) returned to caduceus369
caduceus369 collected €0.05 from pot
caduceus369: doesn't show hand 
*** SUMMARY ***
Total pot €0.05 | Rake €0 
Seat 1: caduceus369 (button) collected (€0.05)
Seat 2: OMGWOLFX (small blind) folded before Flop
Seat 3: eudefumi (big blind) folded before Flop
Seat 4: francovirde folded before Flop (didn't bet)
Seat 5: cap e'bomb95 folded before Flop (didn't bet)
Seat 6: sipa66 folded before Flop (didn't bet)



PokerStars Zoom Hand #257957832852:  Hold'em No Limit (€0.01/€0.02) [ADM ID: M62BA304494E32ST] - 2025/10/01 14:39:26 CET [2025/10/01 8:39:26 ET]
Table 'Sirio' 6-max Seat #1 is the button
Seat 1: zicky78.r (€2.22 in chips) 
Seat 2: OMGWOLFX (€3.93 in chips) 
Seat 3: Hope7075 (€2.08 in chips) 
Seat 4: giocrouch (€2.12 in chips) 
Seat 5: NoveDiCuori9 (€2.13 in chips) 
Seat 6: caduceus369 (€2.23 in chips) 
OMGWOLFX: posts small blind €0.01
Hope7075: posts big blind €0.02
*** HOLE CARDS ***
Dealt to caduceus369 [3s Ad]
giocrouch: folds 
NoveDiCuori9: folds 
caduceus369: folds 
zicky78.r: folds 
OMGWOLFX: folds 
Uncalled bet (€0.01) returned to Hope7075
Hope7075 collected €0.02 from pot
Hope7075: doesn't show hand 
*** SUMMARY ***
Total pot €0.02 | Rake €0 
Seat 1: zicky78.r (button) folded before Flop (didn't bet)
Seat 2: OMGWOLFX (small blind) folded before Flop
Seat 3: Hope7075 (big blind) collected (€0.02)
Seat 4: giocrouch folded before Flop (didn't bet)
Seat 5: NoveDiCuori9 folded before Flop (didn't bet)
Seat 6: caduceus369 folded before Flop (didn't bet)



PokerStars Zoom Hand #257957831364:  Hold'em No Limit (€0.01/€0.02) [ADM ID: M62BA304494E32ST] - 2025/10/01 14:39:15 CET [2025/10/01 8:39:15 ET]
Table 'Sirio' 6-max Seat #1 is the button
Seat 1: Catania838 (€2.08 in chips) 
Seat 2: KOBRAJOE (€1.79 in chips) 
Seat 3: caduceus369 (€2.25 in chips) 
Seat 4: eudefumi (€1.48 in chips) 
Seat 5: cagliari59 (€1.96 in chips) 
Seat 6: zicky78.r (€2.23 in chips) 
KOBRAJOE: posts small blind €0.01
caduceus369: posts big blind €0.02
*** HOLE CARDS ***
Dealt to caduceus369 [2s Kh]
eudefumi: folds 
cagliari59: raises €0.02 to €0.04
zicky78.r: folds 
Catania838: folds 
KOBRAJOE: calls €0.03
caduceus369: folds 
*** FLOP *** [5h Ac 5s]
KOBRAJOE: bets €0.02
cagliari59: calls €0.02
*** TURN *** [5h Ac 5s] [As]
KOBRAJOE: bets €0.02
cagliari59: calls €0.02
*** RIVER *** [5h Ac 5s As] [4s]
KOBRAJOE: bets €0.02
cagliari59: calls €0.02
*** SHOW DOWN ***
KOBRAJOE: shows [8c Qh] (two pair, Aces and Fives)
cagliari59: shows [Kc Tc] (two pair, Aces and Fives - King kicker)
cagliari59 collected €0.21 from pot
*** SUMMARY ***
Total pot €0.22 | Rake €0.01 
Board [5h Ac 5s As 4s]
Seat 1: Catania838 (button) folded before Flop (didn't bet)
Seat 2: KOBRAJOE (small blind) showed [8c Qh] and lost with two pair, Aces and Fives
Seat 3: caduceus369 (big blind) folded before Flop
Seat 4: eudefumi folded before Flop (didn't bet)
Seat 5: cagliari59 showed [Kc Tc] and won (€0.21) with two pair, Aces and Fives
Seat 6: zicky78.r folded before Flop (didn't bet)



PokerStars Zoom Hand #257957834130:  Hold'em No Limit (€0.01/€0.02) [ADM ID: M62BA304494E32ST] - 2025/10/01 14:39:36 CET [2025/10/01 8:39:36 ET]
Table 'Sirio' 6-max Seat #1 is the button
Seat 1: lampo201 (€1.48 in chips) 
Seat 2: caduceus369 (€2.23 in chips) 
Seat 3: zicky78.r (€2.22 in chips) 
Seat 4: OMGWOLFX (€3.44 in chips) 
Seat 5: NoveDiCuori9 (€2.13 in chips) 
Seat 6: lamessolame (€1.06 in chips) 
caduceus369: posts small blind €0.01
zicky78.r: posts big blind €0.02
*** HOLE CARDS ***
Dealt to caduceus369 [Kd Kh]
OMGWOLFX: folds 
NoveDiCuori9: folds 
lamessolame: raises €0.05 to €0.07
lampo201: folds 
caduceus369: raises €0.19 to €0.26
zicky78.r: folds 
lamessolame: calls €0.19
*** FLOP *** [4c 9c Kc]
caduceus369: checks 
lamessolame: bets €0.26
caduceus369: raises €0.26 to €0.52
lamessolame: folds 
Uncalled bet (€0.26) returned to caduceus369
caduceus369 collected €1.01 from pot
caduceus369: doesn't show hand 
*** SUMMARY ***
Total pot €1.06 | Rake €0.05 
Board [4c 9c Kc]
Seat 1: lampo201 (button) folded before Flop (didn't bet)
Seat 2: caduceus369 (small blind) collected (€1.01)
Seat 3: zicky78.r (big blind) folded before Flop
Seat 4: OMGWOLFX folded before Flop (didn't bet)
Seat 5: NoveDiCuori9 folded before Flop (didn't bet)
Seat 6: lamessolame folded on the Flop



PokerStars Zoom Hand #257957830367:  Hold'em No Limit (€0.01/€0.02) [ADM ID: M62BA304494E32ST] - 2025/10/01 14:39:07 CET [2025/10/01 8:39:07 ET]
Table 'Sirio' 6-max Seat #1 is the button
Seat 1: zicky78.r (€2.08 in chips) 
Seat 2: sipa66 (€2.35 in chips) 
Seat 3: giocrouch (€1.33 in chips) 
Seat 4: caduceus369 (€2.25 in chips) 
Seat 5: Pasdum57 (€1.21 in chips) 
Seat 6: Catania838 (€2.68 in chips) 
sipa66: posts small blind €0.01
giocrouch: posts big blind €0.02
*** HOLE CARDS ***
Dealt to caduceus369 [Ks 5s]
caduceus369: folds 
Pasdum57: calls €0.02
Catania838: folds 
zicky78.r: raises €0.05 to €0.07
sipa66: folds 
giocrouch: calls €0.05
Pasdum57: calls €0.05
*** FLOP *** [8c 7h 2h]
giocrouch: checks 
Pasdum57: checks 
zicky78.r: checks 
*** TURN *** [8c 7h 2h] [Qc]
giocrouch: checks 
Pasdum57: bets €0.21
zicky78.r: folds 
giocrouch: raises €1.05 to €1.26 and is all-in
Pasdum57: calls €0.93 and is all-in
Uncalled bet (€0.12) returned to giocrouch
*** RIVER *** [8c 7h 2h Qc] [4h]
*** SHOW DOWN ***
giocrouch: shows [Qs Jh] (a pair of Queens)
Pasdum57: shows [7d Qd] (two pair, Queens and Sevens)
Pasdum57 collected €2.37 from pot
*** SUMMARY ***
Total pot €2.50 | Rake €0.13 
Board [8c 7h 2h Qc 4h]
Seat 1: zicky78.r (button) folded on the Turn
Seat 2: sipa66 (small blind) folded before Flop
Seat 3: giocrouch (big blind) showed [Qs Jh] and lost with a pair of Queens
Seat 4: caduceus369 folded before Flop (didn't bet)
Seat 5: Pasdum57 showed [7d Qd] and won (€2.37) with two pair, Queens and Sevens
Seat 6: Catania838 folded before Flop (didn't bet)



PokerStars Zoom Hand #257957838320:  Hold'em No Limit (€0.01/€0.02) [ADM ID: M62BA304494E32ST] - 2025/10/01 14:40:09 CET [2025/10/01 8:40:09 ET]
Table 'Sirio' 6-max Seat #1 is the button
Seat 1: sipa66 (€2 in chips) 
Seat 2: Catania838 (€2.65 in chips) 
Seat 3: mattya69 (€2.20 in chips) 
Seat 4: ghosto69 (€1.86 in chips) 
Seat 5: caduceus369 (€2.72 in chips) 
Seat 6: gs0097 (€0.76 in chips) 
Catania838: posts small blind €0.01
mattya69: posts big blind €0.02
*** HOLE CARDS ***
Dealt to caduceus369 [3c 2h]
ghosto69: folds 
caduceus369: folds 
gs0097: folds 
sipa66: folds 
Catania838: calls €0.01
mattya69: checks 
*** FLOP *** [Th Jh Jd]
Catania838: bets €0.02
mattya69: calls €0.02
*** TURN *** [Th Jh Jd] [As]
Catania838: bets €0.02
mattya69: calls €0.02
*** RIVER *** [Th Jh Jd As] [Js]
Catania838: bets €0.02
mattya69: calls €0.02
*** SHOW DOWN ***
Catania838: shows [Ts Ks] (a full house, Jacks full of Tens)
mattya69: shows [8d Tc] (a full house, Jacks full of Tens)
Catania838 collected €0.08 from pot
mattya69 collected €0.08 from pot
*** SUMMARY ***
Total pot €0.16 | Rake €0 
Board [Th Jh Jd As Js]
Seat 1: sipa66 (button) folded before Flop (didn't bet)
Seat 2: Catania838 (small blind) showed [Ts Ks] and won (€0.08) with a full house, Jacks full of Tens
Seat 3: mattya69 (big blind) showed [8d Tc] and won (€0.08) with a full house, Jacks full of Tens
Seat 4: ghosto69 folded before Flop (didn't bet)
Seat 5: caduceus369 folded before Flop (didn't bet)
Seat 6: gs0097 folded before Flop (didn't bet)



PokerStars Zoom Hand #257957839960:  Hold'em No Limit (€0.01/€0.02) [ADM ID: M62BA304494E32ST] - 2025/10/01 14:40:21 CET [2025/10/01 8:40:21 ET]
Table 'Sirio' 6-max Seat #1 is the button
Seat 1: cagliari59 (€2.03 in chips) 
Seat 2: sipa66 (€1.79 in chips) 
Seat 3: Pasdum57 (€2.37 in chips) 
Seat 4: caduceus369 (€2.72 in chips) 
Seat 5: ghosto69 (€1.67 in chips) 
Seat 6: lampo201 (€1.58 in chips) 
sipa66: posts small blind €0.01
Pasdum57: posts big blind €0.02
*** HOLE CARDS ***
Dealt to caduceus369 [Kd 9s]
caduceus369: folds 
ghosto69: folds 
lampo201: folds 
cagliari59: raises €0.02 to €0.04
sipa66: folds 
Pasdum57: calls €0.02
*** FLOP *** [Tc 4d 8s]
Pasdum57: checks 
cagliari59: checks 
*** TURN *** [Tc 4d 8s] [8c]
Pasdum57: checks 
cagliari59: checks 
*** RIVER *** [Tc 4d 8s 8c] [6h]
Pasdum57: bets €0.09
cagliari59: folds 
Uncalled bet (€0.09) returned to Pasdum57
Pasdum57 collected €0.09 from pot
Pasdum57: doesn't show hand 
*** SUMMARY ***
Total pot €0.09 | Rake €0 
Board [Tc 4d 8s 8c 6h]
Seat 1: cagliari59 (button) folded on the River
Seat 2: sipa66 (small blind) folded before Flop
Seat 3: Pasdum57 (big blind) collected (€0.09)
Seat 4: caduceus369 folded before Flop (didn't bet)
Seat 5: ghosto69 folded before Flop (didn't bet)
Seat 6: lampo201 folded before Flop (didn't bet)



PokerStars Zoom Hand #257957843172:  Hold'em No Limit (€0.01/€0.02) [ADM ID: M62BA304494E32ST] - 2025/10/01 14:40:46 CET [2025/10/01 8:40:46 ET]
Table 'Sirio' 6-max Seat #1 is the button
Seat 1: TOROLAI (€3.44 in chips) 
Seat 2: caduceus369 (€2.70 in chips) 
Seat 3: sipa66 (€1.78 in chips) 
Seat 4: lamessolame (€0.68 in chips) 
Seat 5: ghosto69 (€2.08 in chips) 
Seat 6: gigysk (€1.96 in chips) 
caduceus369: posts small blind €0.01
sipa66: posts big blind €0.02
*** HOLE CARDS ***
Dealt to caduceus369 [5d 2s]
lamessolame: folds 
ghosto69: folds 
gigysk: folds 
TOROLAI: folds 
caduceus369: folds 
Uncalled bet (€0.01) returned to sipa66
sipa66 collected €0.02 from pot
sipa66: doesn't show hand 
*** SUMMARY ***
Total pot €0.02 | Rake €0 
Seat 1: TOROLAI (button) folded before Flop (didn't bet)
Seat 2: caduceus369 (small blind) folded before Flop
Seat 3: sipa66 (big blind) collected (€0.02)
Seat 4: lamessolame folded before Flop (didn't bet)
Seat 5: ghosto69 folded before Flop (didn't bet)
Seat 6: gigysk folded before Flop (didn't bet)



PokerStars Zoom Hand #257957840798:  Hold'em No Limit (€0.01/€0.02) [ADM ID: M62BA304494E32ST] - 2025/10/01 14:40:28 CET [2025/10/01 8:40:28 ET]
Table 'Sirio' 6-max Seat #1 is the button
Seat 1: caduceus369 (€2.72 in chips) 
Seat 2: Quelle128 (€1.15 in chips) 
Seat 3: mrniceseed (€3.56 in chips) 
Seat 4: OMGWOLFX (€2 in chips) 
Seat 5: gs0097 (€0.76 in chips) 
Seat 6: sipa66 (€2 in chips) 
Quelle128: posts small blind €0.01
mrniceseed: posts big blind €0.02
*** HOLE CARDS ***
Dealt to caduceus369 [7c 6h]
OMGWOLFX: folds 
gs0097: folds 
sipa66: folds 
caduceus369: folds 
Quelle128: calls €0.01
mrniceseed: checks 
*** FLOP *** [2s Js Qs]
Quelle128: checks 
mrniceseed: bets €0.02
Quelle128: folds 
Uncalled bet (€0.02) returned to mrniceseed
mrniceseed collected €0.04 from pot
mrniceseed: doesn't show hand 
*** SUMMARY ***
Total pot €0.04 | Rake €0 
Board [2s Js Qs]
Seat 1: caduceus369 (button) folded before Flop (didn't bet)
Seat 2: Quelle128 (small blind) folded on the Flop
Seat 3: mrniceseed (big blind) collected (€0.04)
Seat 4: OMGWOLFX folded before Flop (didn't bet)
Seat 5: gs0097 folded before Flop (didn't bet)
Seat 6: sipa66 folded before Flop (didn't bet)



PokerStars Zoom Hand #257957841612:  Hold'em No Limit (€0.01/€0.02) [ADM ID: M62BA304494E32ST] - 2025/10/01 14:40:34 CET [2025/10/01 8:40:34 ET]
Table 'Sirio' 6-max Seat #1 is the button
Seat 1: Lapedonia0426 (€1.19 in chips) 
Seat 2: OMGWOLFX (€2.06 in chips) 
Seat 3: caduceus369 (€2.72 in chips) 
Seat 4: MathMassacreX (€2.45 in chips) 
Seat 5: Poonte (€2.29 in chips) 
Seat 6: zicky78.r (€2 in chips) 
OMGWOLFX: posts small blind €0.01
caduceus369: posts big blind €0.02
*** HOLE CARDS ***
Dealt to caduceus369 [Jh 4h]
MathMassacreX: raises €0.05 to €0.07
Poonte: calls €0.07
zicky78.r: folds 
Lapedonia0426: folds 
OMGWOLFX: folds 
caduceus369: folds 
*** FLOP *** [5d Qh Ts]
MathMassacreX: checks 
Poonte: bets €0.09
MathMassacreX: calls €0.09
*** TURN *** [5d Qh Ts] [Qc]
MathMassacreX: checks 
Poonte: bets €0.17
MathMassacreX: folds 
Uncalled bet (€0.17) returned to Poonte
Poonte collected €0.34 from pot
Poonte: doesn't show hand 
*** SUMMARY ***
Total pot €0.35 | Rake €0.01 
Board [5d Qh Ts Qc]
Seat 1: Lapedonia0426 (button) folded before Flop (didn't bet)
Seat 2: OMGWOLFX (small blind) folded before Flop
Seat 3: caduceus369 (big blind) folded before Flop
Seat 4: MathMassacreX folded on the Turn
Seat 5: Poonte collected (€0.34)
Seat 6: zicky78.r folded before Flop (didn't bet)



PokerStars Zoom Hand #257957843791:  Hold'em No Limit (€0.01/€0.02) [ADM ID: M62BA304494E32ST] - 2025/10/01 14:40:51 CET [2025/10/01 8:40:51 ET]
Table 'Sirio' 6-max Seat #1 is the button
Seat 1: giocrouch (€1.99 in chips) 
Seat 2: lampo201 (€1.59 in chips) 
Seat 3: lamessolame (€0.68 in chips) 
Seat 4: TOROLAI (€3.44 in chips) 
Seat 5: caduceus369 (€2.69 in chips) 
Seat 6: pylonstrip (€4.74 in chips) 
lampo201: posts small blind €0.01
lamessolame: posts big blind €0.02
*** HOLE CARDS ***
Dealt to caduceus369 [3h 4d]
TOROLAI: folds 
caduceus369: folds 
pylonstrip: folds 
giocrouch: folds 
lampo201: calls €0.01
lamessolame: checks 
*** FLOP *** [Ah 6s Kc]
lampo201: bets €0.02
lamessolame: folds 
Uncalled bet (€0.02) returned to lampo201
lampo201 collected €0.04 from pot
lampo201: doesn't show hand 
*** SUMMARY ***
Total pot €0.04 | Rake €0 
Board [Ah 6s Kc]
Seat 1: giocrouch (button) folded before Flop (didn't bet)
Seat 2: lampo201 (small blind) collected (€0.04)
Seat 3: lamessolame (big blind) folded on the Flop
Seat 4: TOROLAI folded before Flop (didn't bet)
Seat 5: caduceus369 folded before Flop (didn't bet)
Seat 6: pylonstrip folded before Flop (didn't bet)



PokerStars Zoom Hand #257957839110:  Hold'em No Limit (€0.01/€0.02) [ADM ID: M62BA304494E32ST] - 2025/10/01 14:40:15 CET [2025/10/01 8:40:15 ET]
Table 'Sirio' 6-max Seat #1 is the button
Seat 1: gs0097 (€0.76 in chips) 
Seat 2: eudefumi (€1.42 in chips) 
Seat 3: cap e'bomb95 (€3.80 in chips) 
Seat 4: giocrouch (€2.43 in chips) 
Seat 5: pylonstrip (€4.75 in chips) 
Seat 6: caduceus369 (€2.72 in chips) 
eudefumi: posts small blind €0.01
cap e'bomb95: posts big blind €0.02
*** HOLE CARDS ***
Dealt to caduceus369 [2s Kd]
giocrouch: folds 
pylonstrip: folds 
caduceus369: folds 
gs0097: folds 
eudefumi: calls €0.01
cap e'bomb95: checks 
*** FLOP *** [3h 8c 5h]
eudefumi: checks 
cap e'bomb95: checks 
*** TURN *** [3h 8c 5h] [Jd]
eudefumi: checks 
cap e'bomb95: checks 
*** RIVER *** [3h 8c 5h Jd] [9d]
eudefumi: checks 
cap e'bomb95: checks 
*** SHOW DOWN ***
eudefumi: shows [4s Qd] (high card Queen)
cap e'bomb95: shows [Ks 2d] (high card King)
cap e'bomb95 collected €0.04 from pot
*** SUMMARY ***
Total pot €0.04 | Rake €0 
Board [3h 8c 5h Jd 9d]
Seat 1: gs0097 (button) folded before Flop (didn't bet)
Seat 2: eudefumi (small blind) showed [4s Qd] and lost with high card Queen
Seat 3: cap e'bomb95 (big blind) showed [Ks 2d] and won (€0.04) with high card King
Seat 4: giocrouch folded before Flop (didn't bet)
Seat 5: pylonstrip folded before Flop (didn't bet)
Seat 6: caduceus369 folded before Flop (didn't bet)



PokerStars Zoom Hand #257957844704:  Hold'em No Limit (€0.01/€0.02) [ADM ID: M62BA304494E32ST] - 2025/10/01 14:40:58 CET [2025/10/01 8:40:58 ET]
Table 'Sirio' 6-max Seat #1 is the button
Seat 1: caduceus369 (€2.69 in chips) 
Seat 2: Pasdum57 (€2.42 in chips) 
Seat 3: giocrouch (€1.99 in chips) 
Seat 4: monsterc99 (€0.83 in chips) 
Seat 5: mattya69 (€2.19 in chips) 
Seat 6: OMGWOLFX (€2 in chips) 
Pasdum57: posts small blind €0.01
giocrouch: posts big blind €0.02
*** HOLE CARDS ***
Dealt to caduceus369 [Td 5d]
monsterc99: folds 
mattya69: folds 
OMGWOLFX: folds 
caduceus369: folds 
Pasdum57: raises €0.02 to €0.04
giocrouch: folds 
Uncalled bet (€0.02) returned to Pasdum57
Pasdum57 collected €0.04 from pot
Pasdum57: doesn't show hand 
*** SUMMARY ***
Total pot €0.04 | Rake €0 
Seat 1: caduceus369 (button) folded before Flop (didn't bet)
Seat 2: Pasdum57 (small blind) collected (€0.04)
Seat 3: giocrouch (big blind) folded before Flop
Seat 4: monsterc99 folded before Flop (didn't bet)
Seat 5: mattya69 folded before Flop (didn't bet)
Seat 6: OMGWOLFX folded before Flop (didn't bet)



PokerStars Zoom Hand #257957845769:  Hold'em No Limit (€0.01/€0.02) [ADM ID: M62BA304494E32ST] - 2025/10/01 14:41:06 CET [2025/10/01 8:41:06 ET]
Table 'Sirio' 6-max Seat #1 is the button
Seat 1: gs0097 (€0.73 in chips) 
Seat 2: mattya69 (€2.17 in chips) 
Seat 3: sipa66 (€2.03 in chips) 
Seat 4: ghosto69 (€2.08 in chips) 
Seat 5: caduceus369 (€2.69 in chips) 
Seat 6: TurboMuletto (€1.73 in chips) 
mattya69: posts small blind €0.01
sipa66: posts big blind €0.02
*** HOLE CARDS ***
Dealt to caduceus369 [Qd 8c]
ghosto69: raises €0.04 to €0.06
caduceus369: folds 
TurboMuletto: folds 
gs0097: folds 
mattya69: folds 
sipa66: folds 
Uncalled bet (€0.04) returned to ghosto69
ghosto69 collected €0.05 from pot
ghosto69: doesn't show hand 
*** SUMMARY ***
Total pot €0.05 | Rake €0 
Seat 1: gs0097 (button) folded before Flop (didn't bet)
Seat 2: mattya69 (small blind) folded before Flop
Seat 3: sipa66 (big blind) folded before Flop
Seat 4: ghosto69 collected (€0.05)
Seat 5: caduceus369 folded before Flop (didn't bet)
Seat 6: TurboMuletto folded before Flop (didn't bet)



PokerStars Zoom Hand #257957846829:  Hold'em No Limit (€0.01/€0.02) [ADM ID: M62BA304494E32ST] - 2025/10/01 14:41:14 CET [2025/10/01 8:41:14 ET]
Table 'Sirio' 6-max Seat #1 is the button
Seat 1: lampo201 (€1.61 in chips) 
Seat 2: pylonstrip (€4.72 in chips) 
Seat 3: caduceus369 (€2.69 in chips) 
Seat 4: mrniceseed (€3.58 in chips) 
Seat 5: giocrouch (€1.97 in chips) 
Seat 6: cap e'bomb95 (€3.82 in chips) 
pylonstrip: posts small blind €0.01
caduceus369: posts big blind €0.02
*** HOLE CARDS ***
Dealt to caduceus369 [5c 4s]
mrniceseed: folds 
giocrouch: folds 
cap e'bomb95: folds 
lampo201: folds 
pylonstrip: folds 
Uncalled bet (€0.01) returned to caduceus369
caduceus369 collected €0.02 from pot
caduceus369: doesn't show hand 
*** SUMMARY ***
Total pot €0.02 | Rake €0 
Seat 1: lampo201 (button) folded before Flop (didn't bet)
Seat 2: pylonstrip (small blind) folded before Flop
Seat 3: caduceus369 (big blind) collected (€0.02)
Seat 4: mrniceseed folded before Flop (didn't bet)
Seat 5: giocrouch folded before Flop (didn't bet)
Seat 6: cap e'bomb95 folded before Flop (didn't bet)



PokerStars Zoom Hand #257957848814:  Hold'em No Limit (€0.01/€0.02) [ADM ID: M62BA304494E32ST] - 2025/10/01 14:41:29 CET [2025/10/01 8:41:29 ET]
Table 'Sirio' 6-max Seat #1 is the button
Seat 1: lamessolame (€0.68 in chips) 
Seat 2: caduceus369 (€2.70 in chips) 
Seat 3: ghosto69 (€2.11 in chips) 
Seat 4: Catania838 (€2.05 in chips) 
Seat 5: Lapedonia0426 (€1.12 in chips) 
Seat 6: cap e'bomb95 (€3.82 in chips) 
caduceus369: posts small blind €0.01
ghosto69: posts big blind €0.02
*** HOLE CARDS ***
Dealt to caduceus369 [9h 5s]
Catania838: folds 
Lapedonia0426: folds 
cap e'bomb95: folds 
lamessolame: folds 
caduceus369: folds 
Uncalled bet (€0.01) returned to ghosto69
ghosto69 collected €0.02 from pot
ghosto69: doesn't show hand 
*** SUMMARY ***
Total pot €0.02 | Rake €0 
Seat 1: lamessolame (button) folded before Flop (didn't bet)
Seat 2: caduceus369 (small blind) folded before Flop
Seat 3: ghosto69 (big blind) collected (€0.02)
Seat 4: Catania838 folded before Flop (didn't bet)
Seat 5: Lapedonia0426 folded before Flop (didn't bet)
Seat 6: cap e'bomb95 folded before Flop (didn't bet)



PokerStars Zoom Hand #257957849714:  Hold'em No Limit (€0.01/€0.02) [ADM ID: M62BA304494E32ST] - 2025/10/01 14:41:36 CET [2025/10/01 8:41:36 ET]
Table 'Sirio' 6-max Seat #1 is the button
Seat 1: NoveDiCuori9 (€2.53 in chips) 
Seat 2: Catania838 (€2.05 in chips) 
Seat 3: mattya69 (€2.19 in chips) 
Seat 4: sipa66 (€1.76 in chips) 
Seat 5: pylonstrip (€4.71 in chips) 
Seat 6: caduceus369 (€2.69 in chips) 
Catania838: posts small blind €0.01
mattya69: posts big blind €0.02
*** HOLE CARDS ***
Dealt to caduceus369 [Qs Js]
sipa66: folds 
pylonstrip: folds 
caduceus369: raises €0.02 to €0.04
NoveDiCuori9: raises €0.10 to €0.14
Catania838: folds 
mattya69: raises €0.20 to €0.34
caduceus369: folds 
NoveDiCuori9: calls €0.20
*** FLOP *** [5d 2c 8c]
mattya69: bets €0.38
NoveDiCuori9: folds 
Uncalled bet (€0.38) returned to mattya69
mattya69 collected €0.69 from pot
mattya69: doesn't show hand 
*** SUMMARY ***
Total pot €0.73 | Rake €0.04 
Board [5d 2c 8c]
Seat 1: NoveDiCuori9 (button) folded on the Flop
Seat 2: Catania838 (small blind) folded before Flop
Seat 3: mattya69 (big blind) collected (€0.69)
Seat 4: sipa66 folded before Flop (didn't bet)
Seat 5: pylonstrip folded before Flop (didn't bet)
Seat 6: caduceus369 folded before Flop



PokerStars Zoom Hand #257957855509:  Hold'em No Limit (€0.01/€0.02) [ADM ID: M62BA304494E32ST] - 2025/10/01 14:42:20 CET [2025/10/01 8:42:20 ET]
Table 'Sirio' 6-max Seat #1 is the button
Seat 1: THE_CLOWN_74 (€2 in chips) 
Seat 2: ghosto69 (€0.95 in chips) 
Seat 3: OMGWOLFX (€3.38 in chips) 
Seat 4: caduceus369 (€2.65 in chips) 
Seat 5: TOROLAI (€1.39 in chips) 
Seat 6: giocrouch (€2.18 in chips) 
ghosto69: posts small blind €0.01
OMGWOLFX: posts big blind €0.02
*** HOLE CARDS ***
Dealt to caduceus369 [3d 4c]
caduceus369: folds 
TOROLAI: raises €0.04 to €0.06
giocrouch: folds 
THE_CLOWN_74: folds 
ghosto69: folds 
OMGWOLFX: folds 
Uncalled bet (€0.04) returned to TOROLAI
TOROLAI collected €0.05 from pot
TOROLAI: doesn't show hand 
*** SUMMARY ***
Total pot €0.05 | Rake €0 
Seat 1: THE_CLOWN_74 (button) folded before Flop (didn't bet)
Seat 2: ghosto69 (small blind) folded before Flop
Seat 3: OMGWOLFX (big blind) folded before Flop
Seat 4: caduceus369 folded before Flop (didn't bet)
Seat 5: TOROLAI collected (€0.05)
Seat 6: giocrouch folded before Flop (didn't bet)



PokerStars Zoom Hand #257957856215:  Hold'em No Limit (€0.01/€0.02) [ADM ID: M62BA304494E32ST] - 2025/10/01 14:42:26 CET [2025/10/01 8:42:26 ET]
Table 'Sirio' 6-max Seat #1 is the button
Seat 1: OMGWOLFX (€3.36 in chips) 
Seat 2: monsterc99 (€0.79 in chips) 
Seat 3: ghosto69 (€0.94 in chips) 
Seat 4: NoveDiCuori9 (€2.19 in chips) 
Seat 5: caduceus369 (€2.65 in chips) 
Seat 6: mattya69 (€2.21 in chips) 
monsterc99: posts small blind €0.01
ghosto69: posts big blind €0.02
*** HOLE CARDS ***
Dealt to caduceus369 [Js 6c]
NoveDiCuori9: calls €0.02
caduceus369: folds 
mattya69: folds 
OMGWOLFX: folds 
monsterc99: folds 
ghosto69: checks 
*** FLOP *** [6s 4c Th]
ghosto69: checks 
NoveDiCuori9: checks 
*** TURN *** [6s 4c Th] [2h]
ghosto69: checks 
NoveDiCuori9: checks 
*** RIVER *** [6s 4c Th 2h] [6d]
ghosto69: checks 
NoveDiCuori9: checks 
*** SHOW DOWN ***
ghosto69: shows [Qs 3d] (a pair of Sixes)
NoveDiCuori9: shows [8h Ks] (a pair of Sixes - King kicker)
NoveDiCuori9 collected €0.05 from pot
*** SUMMARY ***
Total pot €0.05 | Rake €0 
Board [6s 4c Th 2h 6d]
Seat 1: OMGWOLFX (button) folded before Flop (didn't bet)
Seat 2: monsterc99 (small blind) folded before Flop
Seat 3: ghosto69 (big blind) showed [Qs 3d] and lost with a pair of Sixes
Seat 4: NoveDiCuori9 showed [8h Ks] and won (€0.05) with a pair of Sixes
Seat 5: caduceus369 folded before Flop (didn't bet)
Seat 6: mattya69 folded before Flop (didn't bet)



PokerStars Zoom Hand #257957857186:  Hold'em No Limit (€0.01/€0.02) [ADM ID: M62BA304494E32ST] - 2025/10/01 14:42:34 CET [2025/10/01 8:42:34 ET]
Table 'Sirio' 6-max Seat #1 is the button
Seat 1: caduceus369 (€2.65 in chips) 
Seat 2: pokerhellas (€1.48 in chips) 
Seat 3: TOROLAI (€1.42 in chips) 
Seat 4: cap e'bomb95 (€3.77 in chips) 
Seat 5: Pasdum57 (€2.28 in chips) 
Seat 6: THE_CLOWN_74 (€2.03 in chips) 
pokerhellas: posts small blind €0.01
TOROLAI: posts big blind €0.02
*** HOLE CARDS ***
Dealt to caduceus369 [Qs 5s]
cap e'bomb95: folds 
Pasdum57: calls €0.02
THE_CLOWN_74: folds 
caduceus369: folds 
pokerhellas: folds 
TOROLAI: checks 
*** FLOP *** [Jd Qd 5h]
TOROLAI: checks 
Pasdum57: checks 
*** TURN *** [Jd Qd 5h] [6d]
TOROLAI: checks 
Pasdum57: checks 
*** RIVER *** [Jd Qd 5h 6d] [7d]
TOROLAI: checks 
Pasdum57: checks 
*** SHOW DOWN ***
TOROLAI: shows [As 4s] (high card Ace)
Pasdum57: shows [Qh Th] (a pair of Queens)
Pasdum57 collected €0.05 from pot
*** SUMMARY ***
Total pot €0.05 | Rake €0 
Board [Jd Qd 5h 6d 7d]
Seat 1: caduceus369 (button) folded before Flop (didn't bet)
Seat 2: pokerhellas (small blind) folded before Flop
Seat 3: TOROLAI (big blind) showed [As 4s] and lost with high card Ace
Seat 4: cap e'bomb95 folded before Flop (didn't bet)
Seat 5: Pasdum57 showed [Qh Th] and won (€0.05) with a pair of Queens
Seat 6: THE_CLOWN_74 folded before Flop (didn't bet)



PokerStars Zoom Hand #257957858954:  Hold'em No Limit (€0.01/€0.02) [ADM ID: M62BA304494E32ST] - 2025/10/01 14:42:47 CET [2025/10/01 8:42:47 ET]
Table 'Sirio' 6-max Seat #1 is the button
Seat 1: mrniceseed (€3.55 in chips) 
Seat 2: mattya69 (€2.21 in chips) 
Seat 3: THE_CLOWN_74 (€2.03 in chips) 
Seat 4: caduceus369 (€2.65 in chips) 
Seat 5: OMGWOLFX (€3.36 in chips) 
Seat 6: pokerhellas (€1.47 in chips) 
mattya69: posts small blind €0.01
THE_CLOWN_74: posts big blind €0.02
*** HOLE CARDS ***
Dealt to caduceus369 [9h Jh]
caduceus369: folds 
OMGWOLFX: folds 
pokerhellas: raises €0.02 to €0.04
mrniceseed: folds 
mattya69: folds 
THE_CLOWN_74: folds 
Uncalled bet (€0.02) returned to pokerhellas
pokerhellas collected €0.05 from pot
pokerhellas: doesn't show hand 
*** SUMMARY ***
Total pot €0.05 | Rake €0 
Seat 1: mrniceseed (button) folded before Flop (didn't bet)
Seat 2: mattya69 (small blind) folded before Flop
Seat 3: THE_CLOWN_74 (big blind) folded before Flop
Seat 4: caduceus369 folded before Flop (didn't bet)
Seat 5: OMGWOLFX folded before Flop (didn't bet)
Seat 6: pokerhellas collected (€0.05)



PokerStars Zoom Hand #257957859759:  Hold'em No Limit (€0.01/€0.02) [ADM ID: M62BA304494E32ST] - 2025/10/01 14:42:54 CET [2025/10/01 8:42:54 ET]
Table 'Sirio' 6-max Seat #1 is the button
Seat 1: ghosto69 (€2.27 in chips) 
Seat 2: caduceus369 (€2.65 in chips) 
Seat 3: cap e'bomb95 (€1.81 in chips) 
Seat 4: giocrouch (€2.12 in chips) 
Seat 5: Quelle128 (€0.57 in chips) 
Seat 6: mrniceseed (€3.55 in chips) 
caduceus369: posts small blind €0.01
cap e'bomb95: posts big blind €0.02
*** HOLE CARDS ***
Dealt to caduceus369 [9c 3h]
giocrouch: folds 
Quelle128: folds 
mrniceseed: calls €0.02
ghosto69: folds 
caduceus369: folds 
cap e'bomb95: checks 
*** FLOP *** [Th Ah Ac]
cap e'bomb95: checks 
mrniceseed: checks 
*** TURN *** [Th Ah Ac] [9h]
cap e'bomb95: checks 
mrniceseed: checks 
*** RIVER *** [Th Ah Ac 9h] [4c]
cap e'bomb95: checks 
mrniceseed: checks 
*** SHOW DOWN ***
cap e'bomb95: shows [7h Ts] (two pair, Aces and Tens)
mrniceseed: mucks hand 
cap e'bomb95 collected €0.05 from pot
*** SUMMARY ***
Total pot €0.05 | Rake €0 
Board [Th Ah Ac 9h 4c]
Seat 1: ghosto69 (button) folded before Flop (didn't bet)
Seat 2: caduceus369 (small blind) folded before Flop
Seat 3: cap e'bomb95 (big blind) showed [7h Ts] and won (€0.05) with two pair, Aces and Tens
Seat 4: giocrouch folded before Flop (didn't bet)
Seat 5: Quelle128 folded before Flop (didn't bet)
Seat 6: mrniceseed mucked [Kd 7d]



PokerStars Zoom Hand #257957860455:  Hold'em No Limit (€0.01/€0.02) [ADM ID: M62BA304494E32ST] - 2025/10/01 14:42:59 CET [2025/10/01 8:42:59 ET]
Table 'Sirio' 6-max Seat #1 is the button
Seat 1: sipa66 (€2.08 in chips) 
Seat 2: lampo201 (€1.48 in chips) 
Seat 3: caduceus369 (€2.64 in chips) 
Seat 4: OMGWOLFX (€3.36 in chips) 
Seat 5: giocrouch (€2.12 in chips) 
Seat 6: THE_CLOWN_74 (€2 in chips) 
lampo201: posts small blind €0.01
caduceus369: posts big blind €0.02
*** HOLE CARDS ***
Dealt to caduceus369 [Ks 5d]
OMGWOLFX: folds 
giocrouch: folds 
THE_CLOWN_74: folds 
sipa66: folds 
lampo201: calls €0.01
caduceus369: checks 
*** FLOP *** [Kh 9h 7c]
lampo201: checks 
caduceus369: checks 
*** TURN *** [Kh 9h 7c] [6h]
lampo201: checks 
caduceus369: bets €0.02
lampo201: calls €0.02
*** RIVER *** [Kh 9h 7c 6h] [4h]
lampo201: checks 
caduceus369: checks 
*** SHOW DOWN ***
lampo201: shows [Ac 3c] (high card Ace)
caduceus369: shows [Ks 5d] (a pair of Kings)
caduceus369 collected €0.08 from pot
*** SUMMARY ***
Total pot €0.08 | Rake €0 
Board [Kh 9h 7c 6h 4h]
Seat 1: sipa66 (button) folded before Flop (didn't bet)
Seat 2: lampo201 (small blind) showed [Ac 3c] and lost with high card Ace
Seat 3: caduceus369 (big blind) showed [Ks 5d] and won (€0.08) with a pair of Kings
Seat 4: OMGWOLFX folded before Flop (didn't bet)
Seat 5: giocrouch folded before Flop (didn't bet)
Seat 6: THE_CLOWN_74 folded before Flop (didn't bet)



PokerStars Zoom Hand #257957865696:  Hold'em No Limit (€0.01/€0.02) [ADM ID: M62BA304494E32ST] - 2025/10/01 14:43:39 CET [2025/10/01 8:43:39 ET]
Table 'Sirio' 6-max Seat #1 is the button
Seat 1: lampo201 (€1.44 in chips) 
Seat 2: francovirde (€2.97 in chips) 
Seat 3: giocrouch (€1.90 in chips) 
Seat 4: Catania838 (€1.94 in chips) 
Seat 5: THE_CLOWN_74 (€2 in chips) 
Seat 6: caduceus369 (€2.68 in chips) 
francovirde: posts small blind €0.01
giocrouch: posts big blind €0.02
*** HOLE CARDS ***
Dealt to caduceus369 [9d 8h]
Catania838: folds 
THE_CLOWN_74: folds 
caduceus369: folds 
lampo201: folds 
francovirde: folds 
Uncalled bet (€0.01) returned to giocrouch
giocrouch collected €0.02 from pot
giocrouch: doesn't show hand 
*** SUMMARY ***
Total pot €0.02 | Rake €0 
Seat 1: lampo201 (button) folded before Flop (didn't bet)
Seat 2: francovirde (small blind) folded before Flop
Seat 3: giocrouch (big blind) collected (€0.02)
Seat 4: Catania838 folded before Flop (didn't bet)
Seat 5: THE_CLOWN_74 folded before Flop (didn't bet)
Seat 6: caduceus369 folded before Flop (didn't bet)



PokerStars Zoom Hand #257957866541:  Hold'em No Limit (€0.01/€0.02) [ADM ID: M62BA304494E32ST] - 2025/10/01 14:43:46 CET [2025/10/01 8:43:46 ET]
Table 'Sirio' 6-max Seat #1 is the button
Seat 1: caduceus369 (€2.68 in chips) 
Seat 2: sipa66 (€2.06 in chips) 
Seat 3: francovirde (€2.96 in chips) 
Seat 4: lampo201 (€1.44 in chips) 
Seat 5: ghosto69 (€1.56 in chips) 
Seat 6: THE_CLOWN_74 (€2 in chips) 
sipa66: posts small blind €0.01
francovirde: posts big blind €0.02
*** HOLE CARDS ***
Dealt to caduceus369 [Qd 3d]
lampo201: folds 
ghosto69: folds 
THE_CLOWN_74: folds 
caduceus369: folds 
sipa66: folds 
Uncalled bet (€0.01) returned to francovirde
francovirde collected €0.02 from pot
francovirde: doesn't show hand 
*** SUMMARY ***
Total pot €0.02 | Rake €0 
Seat 1: caduceus369 (button) folded before Flop (didn't bet)
Seat 2: sipa66 (small blind) folded before Flop
Seat 3: francovirde (big blind) collected (€0.02)
Seat 4: lampo201 folded before Flop (didn't bet)
Seat 5: ghosto69 folded before Flop (didn't bet)
Seat 6: THE_CLOWN_74 folded before Flop (didn't bet)



PokerStars Zoom Hand #257957868231:  Hold'em No Limit (€0.01/€0.02) [ADM ID: M62BA304494E32ST] - 2025/10/01 14:43:59 CET [2025/10/01 8:43:59 ET]
Table 'Sirio' 6-max Seat #1 is the button
Seat 1: THE_CLOWN_74 (€2 in chips) 
Seat 2: mattya69 (€2.38 in chips) 
Seat 3: cap e'bomb95 (€4.36 in chips) 
Seat 4: gs0097 (€0.61 in chips) 
Seat 5: caduceus369 (€2.68 in chips) 
Seat 6: ghosto69 (€1.56 in chips) 
mattya69: posts small blind €0.01
cap e'bomb95: posts big blind €0.02
*** HOLE CARDS ***
Dealt to caduceus369 [Tc 9c]
gs0097: folds 
caduceus369: calls €0.02
ghosto69: folds 
THE_CLOWN_74: folds 
mattya69: folds 
cap e'bomb95: checks 
*** FLOP *** [9h 4h 4s]
cap e'bomb95: checks 
caduceus369: bets €0.02
cap e'bomb95: folds 
Uncalled bet (€0.02) returned to caduceus369
caduceus369 collected €0.05 from pot
caduceus369: doesn't show hand 
*** SUMMARY ***
Total pot €0.05 | Rake €0 
Board [9h 4h 4s]
Seat 1: THE_CLOWN_74 (button) folded before Flop (didn't bet)
Seat 2: mattya69 (small blind) folded before Flop
Seat 3: cap e'bomb95 (big blind) folded on the Flop
Seat 4: gs0097 folded before Flop (didn't bet)
Seat 5: caduceus369 collected (€0.05)
Seat 6: ghosto69 folded before Flop (didn't bet)



PokerStars Zoom Hand #257957873935:  Hold'em No Limit (€0.01/€0.02) [ADM ID: M62BA304494E32ST] - 2025/10/01 14:44:43 CET [2025/10/01 8:44:43 ET]
Table 'Sirio' 6-max Seat #1 is the button
Seat 1: cap e'bomb95 (€4.33 in chips) 
Seat 2: Abatefaria1976 (€1.77 in chips) 
Seat 3: caduceus369 (€2.71 in chips) 
Seat 4: NoveDiCuori9 (€2.02 in chips) 
Seat 5: mattya69 (€2.44 in chips) 
Seat 6: francovirde (€3 in chips) 
Abatefaria1976: posts small blind €0.01
caduceus369: posts big blind €0.02
*** HOLE CARDS ***
Dealt to caduceus369 [As 9d]
NoveDiCuori9: folds 
mattya69: folds 
francovirde: folds 
cap e'bomb95: folds 
Abatefaria1976: folds 
Uncalled bet (€0.01) returned to caduceus369
caduceus369 collected €0.02 from pot
caduceus369: doesn't show hand 
*** SUMMARY ***
Total pot €0.02 | Rake €0 
Seat 1: cap e'bomb95 (button) folded before Flop (didn't bet)
Seat 2: Abatefaria1976 (small blind) folded before Flop
Seat 3: caduceus369 (big blind) collected (€0.02)
Seat 4: NoveDiCuori9 folded before Flop (didn't bet)
Seat 5: mattya69 folded before Flop (didn't bet)
Seat 6: francovirde folded before Flop (didn't bet)



PokerStars Zoom Hand #257957872053:  Hold'em No Limit (€0.01/€0.02) [ADM ID: M62BA304494E32ST] - 2025/10/01 14:44:28 CET [2025/10/01 8:44:28 ET]
Table 'Sirio' 6-max Seat #1 is the button
Seat 1: XXSergioXXX (€0.72 in chips) 
Seat 2: gs0097 (€0.59 in chips) 
Seat 3: THE_CLOWN_74 (€2.03 in chips) 
Seat 4: sipa66 (€2.58 in chips) 
Seat 5: cap e'bomb95 (€1.81 in chips) 
Seat 6: caduceus369 (€2.71 in chips) 
gs0097: posts small blind €0.01
THE_CLOWN_74: posts big blind €0.02
*** HOLE CARDS ***
Dealt to caduceus369 [4s Ad]
sipa66: folds 
cap e'bomb95: folds 
caduceus369: folds 
XXSergioXXX: calls €0.02
gs0097: folds 
THE_CLOWN_74: checks 
*** FLOP *** [6d 9c 6h]
THE_CLOWN_74: bets €0.04
XXSergioXXX: calls €0.04
*** TURN *** [6d 9c 6h] [7c]
THE_CLOWN_74: bets €0.10
XXSergioXXX: calls €0.10
*** RIVER *** [6d 9c 6h 7c] [8h]
THE_CLOWN_74: bets €0.11
XXSergioXXX: calls €0.11
*** SHOW DOWN ***
THE_CLOWN_74: shows [6c Th] (a straight, Six to Ten)
XXSergioXXX: mucks hand 
THE_CLOWN_74 collected €0.52 from pot
*** SUMMARY ***
Total pot €0.55 | Rake €0.03 
Board [6d 9c 6h 7c 8h]
Seat 1: XXSergioXXX (button) mucked [9d Qh]
Seat 2: gs0097 (small blind) folded before Flop
Seat 3: THE_CLOWN_74 (big blind) showed [6c Th] and won (€0.52) with a straight, Six to Ten
Seat 4: sipa66 folded before Flop (didn't bet)
Seat 5: cap e'bomb95 folded before Flop (didn't bet)
Seat 6: caduceus369 folded before Flop (didn't bet)



PokerStars Zoom Hand #257957872772:  Hold'em No Limit (€0.01/€0.02) [ADM ID: M62BA304494E32ST] - 2025/10/01 14:44:34 CET [2025/10/01 8:44:34 ET]
Table 'Sirio' 6-max Seat #1 is the button
Seat 1: sipa66 (€2.58 in chips) 
Seat 2: cap e'bomb95 (€1.81 in chips) 
Seat 3: Pasdum57 (€2.51 in chips) 
Seat 4: caduceus369 (€2.71 in chips) 
Seat 5: OMGWOLFX (€6.13 in chips) 
Seat 6: pylonstrip (€4.59 in chips) 
cap e'bomb95: posts small blind €0.01
Pasdum57: posts big blind €0.02
*** HOLE CARDS ***
Dealt to caduceus369 [Ks Qd]
caduceus369: folds 
OMGWOLFX: folds 
pylonstrip: folds 
sipa66: raises €0.04 to €0.06
cap e'bomb95: folds 
Pasdum57: calls €0.04
*** FLOP *** [5s Qs 2c]
Pasdum57: checks 
sipa66: checks 
*** TURN *** [5s Qs 2c] [5d]
Pasdum57: checks 
sipa66: checks 
*** RIVER *** [5s Qs 2c 5d] [Kd]
Pasdum57: checks 
sipa66: bets €0.09
Pasdum57: folds 
Uncalled bet (€0.09) returned to sipa66
sipa66 collected €0.13 from pot
sipa66: doesn't show hand 
*** SUMMARY ***
Total pot €0.13 | Rake €0 
Board [5s Qs 2c 5d Kd]
Seat 1: sipa66 (button) collected (€0.13)
Seat 2: cap e'bomb95 (small blind) folded before Flop
Seat 3: Pasdum57 (big blind) folded on the River
Seat 4: caduceus369 folded before Flop (didn't bet)
Seat 5: OMGWOLFX folded before Flop (didn't bet)
Seat 6: pylonstrip folded before Flop (didn't bet)



PokerStars Zoom Hand #257957875797:  Hold'em No Limit (€0.01/€0.02) [ADM ID: M62BA304494E32ST] - 2025/10/01 14:44:57 CET [2025/10/01 8:44:57 ET]
Table 'Sirio' 6-max Seat #1 is the button
Seat 1: THE_CLOWN_74 (€3.35 in chips) 
Seat 2: caduceus369 (€2.72 in chips) 
Seat 3: Catania838 (€1.90 in chips) 
Seat 4: ghosto69 (€1.61 in chips) 
Seat 5: pylonstrip (€4.57 in chips) 
Seat 6: lamessolame (€1.08 in chips) 
caduceus369: posts small blind €0.01
Catania838: posts big blind €0.02
*** HOLE CARDS ***
Dealt to caduceus369 [Jh Jc]
ghosto69: folds 
pylonstrip: folds 
lamessolame: folds 
THE_CLOWN_74: folds 
caduceus369: calls €0.01
Catania838: checks 
*** FLOP *** [6h 8h 2d]
caduceus369: bets €0.02
Catania838: raises €0.02 to €0.04
caduceus369: calls €0.02
*** TURN *** [6h 8h 2d] [3c]
caduceus369: checks 
Catania838: bets €0.04
caduceus369: calls €0.04
*** RIVER *** [6h 8h 2d 3c] [9h]
caduceus369: bets €0.08
Catania838: calls €0.08
*** SHOW DOWN ***
caduceus369: shows [Jh Jc] (a pair of Jacks)
Catania838: mucks hand 
caduceus369 collected €0.35 from pot
*** SUMMARY ***
Total pot €0.36 | Rake €0.01 
Board [6h 8h 2d 3c 9h]
Seat 1: THE_CLOWN_74 (button) folded before Flop (didn't bet)
Seat 2: caduceus369 (small blind) showed [Jh Jc] and won (€0.35) with a pair of Jacks
Seat 3: Catania838 (big blind) mucked [Qs 8d]
Seat 4: ghosto69 folded before Flop (didn't bet)
Seat 5: pylonstrip folded before Flop (didn't bet)
Seat 6: lamessolame folded before Flop (didn't bet)



PokerStars Zoom Hand #257957882585:  Hold'em No Limit (€0.01/€0.02) [ADM ID: M62BA304494E32ST] - 2025/10/01 14:45:50 CET [2025/10/01 8:45:50 ET]
Table 'Sirio' 6-max Seat #1 is the button
Seat 1: THE_CLOWN_74 (€2.27 in chips) 
Seat 2: francovirde (€3.01 in chips) 
Seat 3: OMGWOLFX (€3.50 in chips) 
Seat 4: gs0097 (€0.55 in chips) 
Seat 5: caduceus369 (€2.89 in chips) 
Seat 6: Catania838 (€1.72 in chips) 
francovirde: posts small blind €0.01
OMGWOLFX: posts big blind €0.02
*** HOLE CARDS ***
Dealt to caduceus369 [Ks 9h]
gs0097: calls €0.02
caduceus369: folds 
Catania838: folds 
THE_CLOWN_74: folds 
francovirde: folds 
OMGWOLFX: checks 
*** FLOP *** [Kh 4h 4d]
OMGWOLFX: bets €0.02
gs0097: folds 
Uncalled bet (€0.02) returned to OMGWOLFX
OMGWOLFX collected €0.05 from pot
OMGWOLFX: doesn't show hand 
*** SUMMARY ***
Total pot €0.05 | Rake €0 
Board [Kh 4h 4d]
Seat 1: THE_CLOWN_74 (button) folded before Flop (didn't bet)
Seat 2: francovirde (small blind) folded before Flop
Seat 3: OMGWOLFX (big blind) collected (€0.05)
Seat 4: gs0097 folded on the Flop
Seat 5: caduceus369 folded before Flop (didn't bet)
Seat 6: Catania838 folded before Flop (didn't bet)



PokerStars Zoom Hand #257957883657:  Hold'em No Limit (€0.01/€0.02) [ADM ID: M62BA304494E32ST] - 2025/10/01 14:45:59 CET [2025/10/01 8:45:59 ET]
Table 'Sirio' 6-max Seat #1 is the button
Seat 1: caduceus369 (€2.89 in chips) 
Seat 2: Grifo546 (€1.98 in chips) 
Seat 3: Quelle128 (€0.22 in chips) 
Seat 4: OMGWOLFX (€6.19 in chips) 
Seat 5: THE_CLOWN_74 (€2 in chips) 
Seat 6: lampo201 (€1.86 in chips) 
Grifo546: posts small blind €0.01
Quelle128: posts big blind €0.02
*** HOLE CARDS ***
Dealt to caduceus369 [Kc 3s]
OMGWOLFX: folds 
THE_CLOWN_74: folds 
lampo201: raises €0.06 to €0.08
caduceus369: folds 
Grifo546: calls €0.07
Quelle128: folds 
*** FLOP *** [Kd As Ac]
Grifo546: checks 
lampo201: bets €0.08
Grifo546: folds 
Uncalled bet (€0.08) returned to lampo201
lampo201 collected €0.18 from pot
lampo201: doesn't show hand 
*** SUMMARY ***
Total pot €0.18 | Rake €0 
Board [Kd As Ac]
Seat 1: caduceus369 (button) folded before Flop (didn't bet)
Seat 2: Grifo546 (small blind) folded on the Flop
Seat 3: Quelle128 (big blind) folded before Flop
Seat 4: OMGWOLFX folded before Flop (didn't bet)
Seat 5: THE_CLOWN_74 folded before Flop (didn't bet)
Seat 6: lampo201 collected (€0.18)



PokerStars Zoom Hand #257957884471:  Hold'em No Limit (€0.01/€0.02) [ADM ID: M62BA304494E32ST] - 2025/10/01 14:46:05 CET [2025/10/01 8:46:05 ET]
Table 'Sirio' 6-max Seat #1 is the button
Seat 1: ghosto69 (€2.04 in chips) 
Seat 2: THE_CLOWN_74 (€2.27 in chips) 
Seat 3: sipa66 (€1.88 in chips) 
Seat 4: caduceus369 (€2.89 in chips) 
Seat 5: TOROLAI (€2.36 in chips) 
Seat 6: pokerhellas (€1.44 in chips) 
THE_CLOWN_74: posts small blind €0.01
sipa66: posts big blind €0.02
*** HOLE CARDS ***
Dealt to caduceus369 [6h Js]
caduceus369: folds 
TOROLAI: folds 
pokerhellas: raises €0.03 to €0.05
ghosto69: calls €0.05
THE_CLOWN_74: folds 
sipa66: calls €0.03
*** FLOP *** [Kc 7d 9c]
sipa66: checks 
pokerhellas: checks 
ghosto69: bets €0.05
sipa66: folds 
pokerhellas: folds 
Uncalled bet (€0.05) returned to ghosto69
ghosto69 collected €0.16 from pot
ghosto69: doesn't show hand 
*** SUMMARY ***
Total pot €0.16 | Rake €0 
Board [Kc 7d 9c]
Seat 1: ghosto69 (button) collected (€0.16)
Seat 2: THE_CLOWN_74 (small blind) folded before Flop
Seat 3: sipa66 (big blind) folded on the Flop
Seat 4: caduceus369 folded before Flop (didn't bet)
Seat 5: TOROLAI folded before Flop (didn't bet)
Seat 6: pokerhellas folded on the Flop



PokerStars Zoom Hand #257957884958:  Hold'em No Limit (€0.01/€0.02) [ADM ID: M62BA304494E32ST] - 2025/10/01 14:46:09 CET [2025/10/01 8:46:09 ET]
Table 'Sirio' 6-max Seat #1 is the button
Seat 1: lucpri (€2 in chips) 
Seat 2: cap e'bomb95 (€4.40 in chips) 
Seat 3: caduceus369 (€2.89 in chips) 
Seat 4: Catania838 (€1.72 in chips) 
Seat 5: monsterc99 (€0.92 in chips) 
Seat 6: natoSkEtCh (€1.66 in chips) 
cap e'bomb95: posts small blind €0.01
caduceus369: posts big blind €0.02
*** HOLE CARDS ***
Dealt to caduceus369 [3h Qc]
Catania838 is disconnected 
Catania838 has timed out while disconnected
Catania838: folds 
monsterc99: calls €0.02
natoSkEtCh: folds 
lucpri: calls €0.02
cap e'bomb95: folds 
caduceus369: checks 
*** FLOP *** [Qs Ah Kd]
caduceus369: checks 
monsterc99: bets €0.04
lucpri: folds 
caduceus369: folds 
Uncalled bet (€0.04) returned to monsterc99
monsterc99 collected €0.07 from pot
monsterc99: doesn't show hand 
*** SUMMARY ***
Total pot €0.07 | Rake €0 
Board [Qs Ah Kd]
Seat 1: lucpri (button) folded on the Flop
Seat 2: cap e'bomb95 (small blind) folded before Flop
Seat 3: caduceus369 (big blind) folded on the Flop
Seat 4: Catania838 folded before Flop (didn't bet)
Seat 5: monsterc99 collected (€0.07)
Seat 6: natoSkEtCh folded before Flop (didn't bet)



PokerStars Zoom Hand #257957895372:  Hold'em No Limit (€0.01/€0.02) [ADM ID: M62BA304494E32ST] - 2025/10/01 14:47:32 CET [2025/10/01 8:47:32 ET]
Table 'Sirio' 6-max Seat #1 is the button
Seat 1: gigysk (€1.74 in chips) 
Seat 2: AntonioKrakka (€1.98 in chips) 
Seat 3: ghosto69 (€1.85 in chips) 
Seat 4: sipa66 (€2.52 in chips) 
Seat 5: mrniceseed (€4.19 in chips) 
Seat 6: caduceus369 (€2.87 in chips) 
AntonioKrakka: posts small blind €0.01
ghosto69: posts big blind €0.02
*** HOLE CARDS ***
Dealt to caduceus369 [3c 7s]
sipa66: folds 
mrniceseed: folds 
caduceus369: folds 
gigysk: folds 
AntonioKrakka: calls €0.01
ghosto69: checks 
*** FLOP *** [Ad 6c Jd]
AntonioKrakka: checks 
ghosto69: bets €0.02
AntonioKrakka: folds 
Uncalled bet (€0.02) returned to ghosto69
ghosto69 collected €0.04 from pot
ghosto69: doesn't show hand 
*** SUMMARY ***
Total pot €0.04 | Rake €0 
Board [Ad 6c Jd]
Seat 1: gigysk (button) folded before Flop (didn't bet)
Seat 2: AntonioKrakka (small blind) folded on the Flop
Seat 3: ghosto69 (big blind) collected (€0.04)
Seat 4: sipa66 folded before Flop (didn't bet)
Seat 5: mrniceseed folded before Flop (didn't bet)
Seat 6: caduceus369 folded before Flop (didn't bet)



PokerStars Zoom Hand #257957897762:  Hold'em No Limit (€0.01/€0.02) [ADM ID: M62BA304494E32ST] - 2025/10/01 14:47:51 CET [2025/10/01 8:47:51 ET]
Table 'Sirio' 6-max Seat #1 is the button
Seat 1: AntonioKrakka (€1.97 in chips) 
Seat 2: TOROLAI (€2.44 in chips) 
Seat 3: lampo201 (€1.71 in chips) 
Seat 4: caduceus369 (€2.86 in chips) 
Seat 5: gigysk (€1.73 in chips) 
Seat 6: cap e'bomb95 (€1.22 in chips) 
TOROLAI: posts small blind €0.01
lampo201: posts big blind €0.02
*** HOLE CARDS ***
Dealt to caduceus369 [4h Ts]
caduceus369: folds 
gigysk: folds 
cap e'bomb95: raises €0.03 to €0.05
AntonioKrakka: folds 
TOROLAI: folds 
lampo201: folds 
Uncalled bet (€0.03) returned to cap e'bomb95
cap e'bomb95 collected €0.05 from pot
cap e'bomb95: doesn't show hand 
*** SUMMARY ***
Total pot €0.05 | Rake €0 
Seat 1: AntonioKrakka (button) folded before Flop (didn't bet)
Seat 2: TOROLAI (small blind) folded before Flop
Seat 3: lampo201 (big blind) folded before Flop
Seat 4: caduceus369 folded before Flop (didn't bet)
Seat 5: gigysk folded before Flop (didn't bet)
Seat 6: cap e'bomb95 collected (€0.05)



PokerStars Zoom Hand #257957896074:  Hold'em No Limit (€0.01/€0.02) [ADM ID: M62BA304494E32ST] - 2025/10/01 14:47:37 CET [2025/10/01 8:47:37 ET]
Table 'Sirio' 6-max Seat #1 is the button
Seat 1: lamessolame (€0.75 in chips) 
Seat 2: caduceus369 (€2.87 in chips) 
Seat 3: mattya69 (€5.86 in chips) 
Seat 4: THE_CLOWN_74 (€2.27 in chips) 
Seat 5: Pasdum57 (€2.42 in chips) 
Seat 6: sipa66 (€2.52 in chips) 
caduceus369: posts small blind €0.01
mattya69: posts big blind €0.02
*** HOLE CARDS ***
Dealt to caduceus369 [2s Td]
THE_CLOWN_74: folds 
Pasdum57: calls €0.02
sipa66: raises €0.04 to €0.06
lamessolame: folds 
caduceus369: folds 
mattya69: calls €0.04
Pasdum57: calls €0.04
*** FLOP *** [5s Kh 8h]
mattya69: checks 
Pasdum57: checks 
sipa66: bets €0.10
mattya69: folds 
Pasdum57: folds 
Uncalled bet (€0.10) returned to sipa66
sipa66 collected €0.18 from pot
sipa66: doesn't show hand 
*** SUMMARY ***
Total pot €0.19 | Rake €0.01 
Board [5s Kh 8h]
Seat 1: lamessolame (button) folded before Flop (didn't bet)
Seat 2: caduceus369 (small blind) folded before Flop
Seat 3: mattya69 (big blind) folded on the Flop
Seat 4: THE_CLOWN_74 folded before Flop (didn't bet)
Seat 5: Pasdum57 folded on the Flop
Seat 6: sipa66 collected (€0.18)



PokerStars Zoom Hand #257957898788:  Hold'em No Limit (€0.01/€0.02) [ADM ID: M62BA304494E32ST] - 2025/10/01 14:48:00 CET [2025/10/01 8:48:00 ET]
Table 'Sirio' 6-max Seat #1 is the button
Seat 1: ghosto69 (€1.87 in chips) 
Seat 2: sipa66 (€2.44 in chips) 
Seat 3: TOROLAI (€2.43 in chips) 
Seat 4: caduceus369 (€2.86 in chips) 
Seat 5: Zlat12322 (€0.66 in chips) 
Seat 6: gigysk (€1.73 in chips) 
sipa66: posts small blind €0.01
TOROLAI: posts big blind €0.02
*** HOLE CARDS ***
Dealt to caduceus369 [6h Qh]
caduceus369: folds 
Zlat12322: raises €0.08 to €0.10
gigysk: folds 
ghosto69: folds 
sipa66: folds 
TOROLAI: folds 
Uncalled bet (€0.08) returned to Zlat12322
Zlat12322 collected €0.05 from pot
Zlat12322: doesn't show hand 
*** SUMMARY ***
Total pot €0.05 | Rake €0 
Seat 1: ghosto69 (button) folded before Flop (didn't bet)
Seat 2: sipa66 (small blind) folded before Flop
Seat 3: TOROLAI (big blind) folded before Flop
Seat 4: caduceus369 folded before Flop (didn't bet)
Seat 5: Zlat12322 collected (€0.05)
Seat 6: gigysk folded before Flop (didn't bet)



PokerStars Zoom Hand #257957896723:  Hold'em No Limit (€0.01/€0.02) [ADM ID: M62BA304494E32ST] - 2025/10/01 14:47:43 CET [2025/10/01 8:47:43 ET]
Table 'Sirio' 6-max Seat #1 is the button
Seat 1: caduceus369 (€2.86 in chips) 
Seat 2: lamessolame (€0.75 in chips) 
Seat 3: ghosto69 (€2.15 in chips) 
Seat 4: cap e'bomb95 (€1.22 in chips) 
Seat 5: TOROLAI (€2.44 in chips) 
Seat 6: Grifo546 (€1.85 in chips) 
lamessolame: posts small blind €0.01
ghosto69: posts big blind €0.02
*** HOLE CARDS ***
Dealt to caduceus369 [3h 7c]
cap e'bomb95: folds 
TOROLAI: folds 
Grifo546: raises €0.04 to €0.06
caduceus369: folds 
lamessolame: raises €0.14 to €0.20
ghosto69: calls €0.18
Grifo546: calls €0.14
*** FLOP *** [8s 8d Jd]
lamessolame: bets €0.55 and is all-in
ghosto69: calls €0.55
Grifo546: folds 
*** TURN *** [8s 8d Jd] [Kh]
*** RIVER *** [8s 8d Jd Kh] [Th]
*** SHOW DOWN ***
lamessolame: shows [Ah 2d] (a pair of Eights)
ghosto69: shows [Kd Ks] (a full house, Kings full of Eights)
ghosto69 collected €1.61 from pot
*** SUMMARY ***
Total pot €1.70 | Rake €0.09 
Board [8s 8d Jd Kh Th]
Seat 1: caduceus369 (button) folded before Flop (didn't bet)
Seat 2: lamessolame (small blind) showed [Ah 2d] and lost with a pair of Eights
Seat 3: ghosto69 (big blind) showed [Kd Ks] and won (€1.61) with a full house, Kings full of Eights
Seat 4: cap e'bomb95 folded before Flop (didn't bet)
Seat 5: TOROLAI folded before Flop (didn't bet)
Seat 6: Grifo546 folded on the Flop



PokerStars Zoom Hand #257957899304:  Hold'em No Limit (€0.01/€0.02) [ADM ID: M62BA304494E32ST] - 2025/10/01 14:48:04 CET [2025/10/01 8:48:04 ET]
Table 'Sirio' 6-max Seat #1 is the button
Seat 1: mrniceseed (€4.17 in chips) 
Seat 2: mattya69 (€5.80 in chips) 
Seat 3: caduceus369 (€2.86 in chips) 
Seat 4: pokerhellas (€1.40 in chips) 
Seat 5: sipa66 (€2.43 in chips) 
Seat 6: AntonioKrakka (€1.97 in chips) 
mattya69: posts small blind €0.01
caduceus369: posts big blind €0.02
*** HOLE CARDS ***
Dealt to caduceus369 [Jc 5c]
pokerhellas: folds 
sipa66: folds 
AntonioKrakka: folds 
mrniceseed: calls €0.02
mattya69: folds 
caduceus369: checks 
*** FLOP *** [8h 4s 3h]
caduceus369: checks 
mrniceseed: checks 
*** TURN *** [8h 4s 3h] [Kd]
caduceus369: checks 
mrniceseed: checks 
*** RIVER *** [8h 4s 3h Kd] [5d]
caduceus369: bets €0.02
mrniceseed: folds 
Uncalled bet (€0.02) returned to caduceus369
caduceus369 collected €0.05 from pot
caduceus369: doesn't show hand 
*** SUMMARY ***
Total pot €0.05 | Rake €0 
Board [8h 4s 3h Kd 5d]
Seat 1: mrniceseed (button) folded on the River
Seat 2: mattya69 (small blind) folded before Flop
Seat 3: caduceus369 (big blind) collected (€0.05)
Seat 4: pokerhellas folded before Flop (didn't bet)
Seat 5: sipa66 folded before Flop (didn't bet)
Seat 6: AntonioKrakka folded before Flop (didn't bet)



PokerStars Zoom Hand #257957903037:  Hold'em No Limit (€0.01/€0.02) [ADM ID: M62BA304494E32ST] - 2025/10/01 14:48:34 CET [2025/10/01 8:48:34 ET]
Table 'Sirio' 6-max Seat #1 is the button
Seat 1: TOROLAI (€2.41 in chips) 
Seat 2: caduceus369 (€2.89 in chips) 
Seat 3: MathMassacreX (€2.47 in chips) 
Seat 4: dagliaddosso (€2.09 in chips) 
Seat 5: cap e'bomb95 (€4.26 in chips) 
Seat 6: AntonioKrakka (€2.18 in chips) 
caduceus369: posts small blind €0.01
MathMassacreX: posts big blind €0.02
*** HOLE CARDS ***
Dealt to caduceus369 [8h Kh]
dagliaddosso has timed out
dagliaddosso: folds 
cap e'bomb95: folds 
AntonioKrakka: folds 
TOROLAI: folds 
caduceus369: calls €0.01
MathMassacreX: checks 
*** FLOP *** [7h Qd 4s]
caduceus369: bets €0.02
MathMassacreX: calls €0.02
*** TURN *** [7h Qd 4s] [8c]
caduceus369: checks 
MathMassacreX: checks 
*** RIVER *** [7h Qd 4s 8c] [Jh]
caduceus369: bets €0.02
MathMassacreX: folds 
Uncalled bet (€0.02) returned to caduceus369
caduceus369 collected €0.08 from pot
caduceus369: doesn't show hand 
*** SUMMARY ***
Total pot €0.08 | Rake €0 
Board [7h Qd 4s 8c Jh]
Seat 1: TOROLAI (button) folded before Flop (didn't bet)
Seat 2: caduceus369 (small blind) collected (€0.08)
Seat 3: MathMassacreX (big blind) folded on the River
Seat 4: dagliaddosso folded before Flop (didn't bet)
Seat 5: cap e'bomb95 folded before Flop (didn't bet)
Seat 6: AntonioKrakka folded before Flop (didn't bet)



PokerStars Zoom Hand #257957906859:  Hold'em No Limit (€0.01/€0.02) [ADM ID: M62BA304494E32ST] - 2025/10/01 14:49:05 CET [2025/10/01 8:49:05 ET]
Table 'Sirio' 6-max Seat #1 is the button
Seat 1: caduceus369 (€2.93 in chips) 
Seat 2: Kboy242 (€1.85 in chips) 
Seat 3: THE_CLOWN_74 (€2 in chips) 
Seat 4: Emm3B1 (€1.29 in chips) 
Seat 5: francovirde (€2.51 in chips) 
Seat 6: Pasdum57 (€2.42 in chips) 
Kboy242: posts small blind €0.01
THE_CLOWN_74: posts big blind €0.02
*** HOLE CARDS ***
Dealt to caduceus369 [4s 5s]
Emm3B1: folds 
francovirde: folds 
Pasdum57: folds 
caduceus369: raises €0.02 to €0.04
Kboy242: folds 
THE_CLOWN_74: calls €0.02
*** FLOP *** [Qd 6h 3h]
THE_CLOWN_74: bets €0.07
caduceus369: calls €0.07
*** TURN *** [Qd 6h 3h] [8h]
THE_CLOWN_74: bets €0.17
caduceus369: folds 
Uncalled bet (€0.17) returned to THE_CLOWN_74
THE_CLOWN_74 collected €0.22 from pot
THE_CLOWN_74: doesn't show hand 
*** SUMMARY ***
Total pot €0.23 | Rake €0.01 
Board [Qd 6h 3h 8h]
Seat 1: caduceus369 (button) folded on the Turn
Seat 2: Kboy242 (small blind) folded before Flop
Seat 3: THE_CLOWN_74 (big blind) collected (€0.22)
Seat 4: Emm3B1 folded before Flop (didn't bet)
Seat 5: francovirde folded before Flop (didn't bet)
Seat 6: Pasdum57 folded before Flop (didn't bet)



PokerStars Zoom Hand #257957912983:  Hold'em No Limit (€0.01/€0.02) [ADM ID: M62BA304494E32ST] - 2025/10/01 14:49:54 CET [2025/10/01 8:49:54 ET]
Table 'Sirio' 6-max Seat #1 is the button
Seat 1: Emm3B1 (€1.35 in chips) 
Seat 2: cap e'bomb95 (€4.11 in chips) 
Seat 3: OMGWOLFX (€4.24 in chips) 
Seat 4: TOROLAI (€2.39 in chips) 
Seat 5: caduceus369 (€2.82 in chips) 
Seat 6: mattya69 (€3.62 in chips) 
cap e'bomb95: posts small blind €0.01
OMGWOLFX: posts big blind €0.02
*** HOLE CARDS ***
Dealt to caduceus369 [Qh 5s]
TOROLAI: folds 
caduceus369: folds 
mattya69: raises €0.04 to €0.06
Emm3B1: folds 
cap e'bomb95: folds 
OMGWOLFX: folds 
Uncalled bet (€0.04) returned to mattya69
mattya69 collected €0.05 from pot
mattya69: doesn't show hand 
*** SUMMARY ***
Total pot €0.05 | Rake €0 
Seat 1: Emm3B1 (button) folded before Flop (didn't bet)
Seat 2: cap e'bomb95 (small blind) folded before Flop
Seat 3: OMGWOLFX (big blind) folded before Flop
Seat 4: TOROLAI folded before Flop (didn't bet)
Seat 5: caduceus369 folded before Flop (didn't bet)
Seat 6: mattya69 collected (€0.05)



PokerStars Zoom Hand #257957913814:  Hold'em No Limit (€0.01/€0.02) [ADM ID: M62BA304494E32ST] - 2025/10/01 14:50:00 CET [2025/10/01 8:50:00 ET]
Table 'Sirio' 6-max Seat #1 is the button
Seat 1: cap e'bomb95 (€4.10 in chips) 
Seat 2: OMGWOLFX (€5.91 in chips) 
Seat 3: caduceus369 (€2.82 in chips) 
Seat 4: gs0097 (€0.49 in chips) 
Seat 5: Grifo546 (€1.48 in chips) 
Seat 6: Abatefaria1976 (€1.71 in chips) 
OMGWOLFX: posts small blind €0.01
caduceus369: posts big blind €0.02
*** HOLE CARDS ***
Dealt to caduceus369 [4h 6d]
gs0097: folds 
Grifo546: folds 
Abatefaria1976: folds 
cap e'bomb95: folds 
OMGWOLFX: folds 
Uncalled bet (€0.01) returned to caduceus369
caduceus369 collected €0.02 from pot
caduceus369: doesn't show hand 
*** SUMMARY ***
Total pot €0.02 | Rake €0 
Seat 1: cap e'bomb95 (button) folded before Flop (didn't bet)
Seat 2: OMGWOLFX (small blind) folded before Flop
Seat 3: caduceus369 (big blind) collected (€0.02)
Seat 4: gs0097 folded before Flop (didn't bet)
Seat 5: Grifo546 folded before Flop (didn't bet)
Seat 6: Abatefaria1976 folded before Flop (didn't bet)



PokerStars Zoom Hand #257957913420:  Hold'em No Limit (€0.01/€0.02) [ADM ID: M62BA304494E32ST] - 2025/10/01 14:49:57 CET [2025/10/01 8:49:57 ET]
Table 'Sirio' 6-max Seat #1 is the button
Seat 1: TOROLAI (€2.39 in chips) 
Seat 2: francovirde (€2.49 in chips) 
Seat 3: AntonioKrakka (€2.08 in chips) 
Seat 4: caduceus369 (€2.82 in chips) 
Seat 5: OMGWOLFX (€4.04 in chips) 
Seat 6: THE_CLOWN_74 (€2 in chips) 
francovirde: posts small blind €0.01
AntonioKrakka: posts big blind €0.02
*** HOLE CARDS ***
Dealt to caduceus369 [5d Ac]
caduceus369: folds 
OMGWOLFX: folds 
THE_CLOWN_74: raises €0.03 to €0.05
TOROLAI: folds 
francovirde: folds 
AntonioKrakka: calls €0.03
*** FLOP *** [As Qs Jh]
AntonioKrakka: checks 
THE_CLOWN_74: checks 
*** TURN *** [As Qs Jh] [8c]
AntonioKrakka: bets €0.06
THE_CLOWN_74: folds 
Uncalled bet (€0.06) returned to AntonioKrakka
AntonioKrakka collected €0.11 from pot
AntonioKrakka: doesn't show hand 
*** SUMMARY ***
Total pot €0.11 | Rake €0 
Board [As Qs Jh 8c]
Seat 1: TOROLAI (button) folded before Flop (didn't bet)
Seat 2: francovirde (small blind) folded before Flop
Seat 3: AntonioKrakka (big blind) collected (€0.11)
Seat 4: caduceus369 folded before Flop (didn't bet)
Seat 5: OMGWOLFX folded before Flop (didn't bet)
Seat 6: THE_CLOWN_74 folded on the Turn



PokerStars Zoom Hand #257957912433:  Hold'em No Limit (€0.01/€0.02) [ADM ID: M62BA304494E32ST] - 2025/10/01 14:49:49 CET [2025/10/01 8:49:49 ET]
Table 'Sirio' 6-max Seat #1 is the button
Seat 1: AntonioKrakka (€2 in chips) 
Seat 2: eudefumi (€1.31 in chips) 
Seat 3: Abatefaria1976 (€1.73 in chips) 
Seat 4: natoSkEtCh (€1.30 in chips) 
Seat 5: caduceus369 (€2.82 in chips) 
Seat 6: ghosto69 (€3.16 in chips) 
eudefumi: posts small blind €0.01
Abatefaria1976: posts big blind €0.02
*** HOLE CARDS ***
Dealt to caduceus369 [Ks 9d]
natoSkEtCh: raises €0.02 to €0.04
caduceus369: folds 
ghosto69: folds 
AntonioKrakka: folds 
eudefumi: calls €0.03
Abatefaria1976: folds 
*** FLOP *** [8d 3s 6s]
eudefumi: checks 
natoSkEtCh: bets €0.05
eudefumi: calls €0.05
*** TURN *** [8d 3s 6s] [Ah]
eudefumi: checks 
natoSkEtCh: checks 
*** RIVER *** [8d 3s 6s Ah] [2c]
eudefumi: checks 
natoSkEtCh: bets €0.08
eudefumi: calls €0.08
*** SHOW DOWN ***
natoSkEtCh: shows [2d 3d] (two pair, Threes and Deuces)
eudefumi: mucks hand 
natoSkEtCh collected €0.35 from pot
*** SUMMARY ***
Total pot €0.36 | Rake €0.01 
Board [8d 3s 6s Ah 2c]
Seat 1: AntonioKrakka (button) folded before Flop (didn't bet)
Seat 2: eudefumi (small blind) mucked [Kc 6h]
Seat 3: Abatefaria1976 (big blind) folded before Flop
Seat 4: natoSkEtCh showed [2d 3d] and won (€0.35) with two pair, Threes and Deuces
Seat 5: caduceus369 folded before Flop (didn't bet)
Seat 6: ghosto69 folded before Flop (didn't bet)



PokerStars Zoom Hand #257957911281:  Hold'em No Limit (€0.01/€0.02) [ADM ID: M62BA304494E32ST] - 2025/10/01 14:49:40 CET [2025/10/01 8:49:40 ET]
Table 'Sirio' 6-max Seat #1 is the button
Seat 1: gs0097 (€0.49 in chips) 
Seat 2: MathMassacreX (€2.42 in chips) 
Seat 3: ghosto69 (€1.94 in chips) 
Seat 4: Quelle128 (€0.62 in chips) 
Seat 5: mattya69 (€5.57 in chips) 
Seat 6: caduceus369 (€2.82 in chips) 
MathMassacreX: posts small blind €0.01
ghosto69: posts big blind €0.02
*** HOLE CARDS ***
Dealt to caduceus369 [Ac 4s]
Quelle128: calls €0.02
mattya69: folds 
caduceus369: folds 
gs0097 has timed out
gs0097: folds 
MathMassacreX: folds 
ghosto69: checks 
*** FLOP *** [Qs Qd 2s]
ghosto69: checks 
Quelle128: checks 
*** TURN *** [Qs Qd 2s] [Td]
ghosto69: checks 
Quelle128: checks 
*** RIVER *** [Qs Qd 2s Td] [8d]
ghosto69: checks 
Quelle128: checks 
*** SHOW DOWN ***
ghosto69: shows [3c Kd] (a pair of Queens)
Quelle128: shows [7d Kc] (a pair of Queens)
ghosto69 collected €0.03 from pot
Quelle128 collected €0.02 from pot
*** SUMMARY ***
Total pot €0.05 | Rake €0 
Board [Qs Qd 2s Td 8d]
Seat 1: gs0097 (button) folded before Flop (didn't bet)
Seat 2: MathMassacreX (small blind) folded before Flop
Seat 3: ghosto69 (big blind) showed [3c Kd] and won (€0.03) with a pair of Queens
Seat 4: Quelle128 showed [7d Kc] and won (€0.02) with a pair of Queens
Seat 5: mattya69 folded before Flop (didn't bet)
Seat 6: caduceus369 folded before Flop (didn't bet)



PokerStars Zoom Hand #257957915213:  Hold'em No Limit (€0.01/€0.02) [ADM ID: M62BA304494E32ST] - 2025/10/01 14:50:11 CET [2025/10/01 8:50:11 ET]
Table 'Sirio' 6-max Seat #1 is the button
Seat 1: caduceus369 (€2.83 in chips) 
Seat 2: gigysk (€1.65 in chips) 
Seat 3: AntonioKrakka (€2 in chips) 
Seat 4: ghosto69 (€3.16 in chips) 
Seat 5: cap e'bomb95 (€4.10 in chips) 
Seat 6: Grifo546 (€1.46 in chips) 
gigysk: posts small blind €0.01
AntonioKrakka: posts big blind €0.02
*** HOLE CARDS ***
Dealt to caduceus369 [Th Jd]
ghosto69: folds 
cap e'bomb95: folds 
Grifo546: folds 
caduceus369: raises €0.02 to €0.04
gigysk: calls €0.03
AntonioKrakka: folds 
*** FLOP *** [3c Kh Qc]
gigysk: checks 
caduceus369: bets €0.04
gigysk: calls €0.04
*** TURN *** [3c Kh Qc] [6h]
gigysk: checks 
caduceus369: checks 
*** RIVER *** [3c Kh Qc 6h] [7c]
gigysk: bets €0.18
caduceus369: folds 
Uncalled bet (€0.18) returned to gigysk
gigysk collected €0.18 from pot
gigysk: doesn't show hand 
*** SUMMARY ***
Total pot €0.18 | Rake €0 
Board [3c Kh Qc 6h 7c]
Seat 1: caduceus369 (button) folded on the River
Seat 2: gigysk (small blind) collected (€0.18)
Seat 3: AntonioKrakka (big blind) folded before Flop
Seat 4: ghosto69 folded before Flop (didn't bet)
Seat 5: cap e'bomb95 folded before Flop (didn't bet)
Seat 6: Grifo546 folded before Flop (didn't bet)



PokerStars Zoom Hand #257957920760:  Hold'em No Limit (€0.01/€0.02) [ADM ID: M62BA304494E32ST] - 2025/10/01 14:50:55 CET [2025/10/01 8:50:55 ET]
Table 'Sirio' 6-max Seat #1 is the button
Seat 1: Kboy242 (€2 in chips) 
Seat 2: caduceus369 (€2.75 in chips) 
Seat 3: pylonstrip (€2 in chips) 
Seat 4: ghosto69 (€2.03 in chips) 
Seat 5: colosso2022 (€0.77 in chips) 
Seat 6: MathMassacreX (€2.54 in chips) 
caduceus369: posts small blind €0.01
pylonstrip: posts big blind €0.02
*** HOLE CARDS ***
Dealt to caduceus369 [2d 8s]
ghosto69: folds 
colosso2022: folds 
MathMassacreX: folds 
Kboy242: folds 
caduceus369: folds 
Uncalled bet (€0.01) returned to pylonstrip
pylonstrip collected €0.02 from pot
pylonstrip: doesn't show hand 
*** SUMMARY ***
Total pot €0.02 | Rake €0 
Seat 1: Kboy242 (button) folded before Flop (didn't bet)
Seat 2: caduceus369 (small blind) folded before Flop
Seat 3: pylonstrip (big blind) collected (€0.02)
Seat 4: ghosto69 folded before Flop (didn't bet)
Seat 5: colosso2022 folded before Flop (didn't bet)
Seat 6: MathMassacreX folded before Flop (didn't bet)



PokerStars Zoom Hand #257957922106:  Hold'em No Limit (€0.01/€0.02) [ADM ID: M62BA304494E32ST] - 2025/10/01 14:51:06 CET [2025/10/01 8:51:06 ET]
Table 'Sirio' 6-max Seat #1 is the button
Seat 1: OMGWOLFX (€3.10 in chips) 
Seat 2: cap e'bomb95 (€4.04 in chips) 
Seat 3: AntonioKrakka (€1.45 in chips) 
Seat 4: Abatefaria1976 (€0.69 in chips) 
Seat 5: caduceus369 (€2.74 in chips) 
Seat 6: mattya69 (€5.41 in chips) 
cap e'bomb95: posts small blind €0.01
AntonioKrakka: posts big blind €0.02
*** HOLE CARDS ***
Dealt to caduceus369 [Js 9h]
Abatefaria1976: folds 
caduceus369: folds 
mattya69: folds 
OMGWOLFX: folds 
cap e'bomb95: folds 
Uncalled bet (€0.01) returned to AntonioKrakka
AntonioKrakka collected €0.02 from pot
AntonioKrakka: doesn't show hand 
*** SUMMARY ***
Total pot €0.02 | Rake €0 
Seat 1: OMGWOLFX (button) folded before Flop (didn't bet)
Seat 2: cap e'bomb95 (small blind) folded before Flop
Seat 3: AntonioKrakka (big blind) collected (€0.02)
Seat 4: Abatefaria1976 folded before Flop (didn't bet)
Seat 5: caduceus369 folded before Flop (didn't bet)
Seat 6: mattya69 folded before Flop (didn't bet)



PokerStars Zoom Hand #257957924741:  Hold'em No Limit (€0.01/€0.02) [ADM ID: M62BA304494E32ST] - 2025/10/01 14:51:27 CET [2025/10/01 8:51:27 ET]
Table 'Sirio' 6-max Seat #1 is the button
Seat 1: AntonioKrakka (€1.46 in chips) 
Seat 2: OMGWOLFX (€3.95 in chips) 
Seat 3: THE_CLOWN_74 (€2.16 in chips) 
Seat 4: TOROLAI (€2.30 in chips) 
Seat 5: Abatefaria1976 (€0.68 in chips) 
Seat 6: caduceus369 (€2.72 in chips) 
OMGWOLFX: posts small blind €0.01
THE_CLOWN_74: posts big blind €0.02
*** HOLE CARDS ***
Dealt to caduceus369 [Ac 2h]
TOROLAI: folds 
Abatefaria1976: folds 
caduceus369: folds 
AntonioKrakka: folds 
OMGWOLFX: raises €0.04 to €0.06
THE_CLOWN_74: folds 
Uncalled bet (€0.04) returned to OMGWOLFX
OMGWOLFX collected €0.04 from pot
OMGWOLFX: doesn't show hand 
*** SUMMARY ***
Total pot €0.04 | Rake €0 
Seat 1: AntonioKrakka (button) folded before Flop (didn't bet)
Seat 2: OMGWOLFX (small blind) collected (€0.04)
Seat 3: THE_CLOWN_74 (big blind) folded before Flop
Seat 4: TOROLAI folded before Flop (didn't bet)
Seat 5: Abatefaria1976 folded before Flop (didn't bet)
Seat 6: caduceus369 folded before Flop (didn't bet)



PokerStars Zoom Hand #257957923112:  Hold'em No Limit (€0.01/€0.02) [ADM ID: M62BA304494E32ST] - 2025/10/01 14:51:14 CET [2025/10/01 8:51:14 ET]
Table 'Sirio' 6-max Seat #1 is the button
Seat 1: Abatefaria1976 (€0.68 in chips) 
Seat 2: OMGWOLFX (€5.85 in chips) 
Seat 3: caduceus369 (€2.74 in chips) 
Seat 4: AntonioKrakka (€2.14 in chips) 
Seat 5: MathMassacreX (€2.54 in chips) 
Seat 6: Emm3B1 (€1.80 in chips) 
OMGWOLFX: posts small blind €0.01
caduceus369: posts big blind €0.02
*** HOLE CARDS ***
Dealt to caduceus369 [7c Js]
AntonioKrakka: folds 
MathMassacreX: folds 
Emm3B1: raises €0.04 to €0.06
Abatefaria1976: folds 
OMGWOLFX: calls €0.05
caduceus369: folds 
*** FLOP *** [6s 6h Tc]
OMGWOLFX: bets €0.07
Emm3B1: folds 
Uncalled bet (€0.07) returned to OMGWOLFX
OMGWOLFX collected €0.14 from pot
OMGWOLFX: doesn't show hand 
*** SUMMARY ***
Total pot €0.14 | Rake €0 
Board [6s 6h Tc]
Seat 1: Abatefaria1976 (button) folded before Flop (didn't bet)
Seat 2: OMGWOLFX (small blind) collected (€0.14)
Seat 3: caduceus369 (big blind) folded before Flop
Seat 4: AntonioKrakka folded before Flop (didn't bet)
Seat 5: MathMassacreX folded before Flop (didn't bet)
Seat 6: Emm3B1 folded on the Flop



PokerStars Zoom Hand #257957921539:  Hold'em No Limit (€0.01/€0.02) [ADM ID: M62BA304494E32ST] - 2025/10/01 14:51:01 CET [2025/10/01 8:51:01 ET]
Table 'Sirio' 6-max Seat #1 is the button
Seat 1: ValenTom25 (€1.28 in chips) 
Seat 2: mattya69 (€5.42 in chips) 
Seat 3: colosso2022 (€0.77 in chips) 
Seat 4: AntonioKrakka (€1.45 in chips) 
Seat 5: THE_CLOWN_74 (€2.16 in chips) 
Seat 6: caduceus369 (€2.74 in chips) 
mattya69: posts small blind €0.01
colosso2022: posts big blind €0.02
*** HOLE CARDS ***
Dealt to caduceus369 [2s Th]
AntonioKrakka: folds 
THE_CLOWN_74 has timed out
THE_CLOWN_74: folds 
caduceus369: folds 
ValenTom25: calls €0.02
mattya69: folds 
colosso2022: checks 
*** FLOP *** [6c 9d 3c]
colosso2022: checks 
ValenTom25: checks 
*** TURN *** [6c 9d 3c] [Jd]
colosso2022: checks 
ValenTom25: bets €0.03
colosso2022: calls €0.03
*** RIVER *** [6c 9d 3c Jd] [7s]
colosso2022: bets €0.06
ValenTom25: folds 
Uncalled bet (€0.06) returned to colosso2022
colosso2022 collected €0.11 from pot
colosso2022: doesn't show hand 
*** SUMMARY ***
Total pot €0.11 | Rake €0 
Board [6c 9d 3c Jd 7s]
Seat 1: ValenTom25 (button) folded on the River
Seat 2: mattya69 (small blind) folded before Flop
Seat 3: colosso2022 (big blind) collected (€0.11)
Seat 4: AntonioKrakka folded before Flop (didn't bet)
Seat 5: THE_CLOWN_74 folded before Flop (didn't bet)
Seat 6: caduceus369 folded before Flop (didn't bet)



PokerStars Zoom Hand #257957922688:  Hold'em No Limit (€0.01/€0.02) [ADM ID: M62BA304494E32ST] - 2025/10/01 14:51:10 CET [2025/10/01 8:51:10 ET]
Table 'Sirio' 6-max Seat #1 is the button
Seat 1: Grifo546 (€1.37 in chips) 
Seat 2: Abatefaria1976 (€0.69 in chips) 
Seat 3: Amos434 (€1.50 in chips) 
Seat 4: caduceus369 (€2.74 in chips) 
Seat 5: eudefumi (€1.04 in chips) 
Seat 6: cap e'bomb95 (€4.03 in chips) 
Abatefaria1976: posts small blind €0.01
Amos434: posts big blind €0.02
*** HOLE CARDS ***
Dealt to caduceus369 [Th 9s]
caduceus369: folds 
eudefumi: raises €0.06 to €0.08
cap e'bomb95: folds 
Grifo546: calls €0.08
Abatefaria1976: folds 
Amos434: calls €0.06
*** FLOP *** [8s Jc 9d]
Amos434: checks 
eudefumi: bets €0.08
Grifo546: calls €0.08
Amos434: calls €0.08
*** TURN *** [8s Jc 9d] [3c]
Amos434: checks 
eudefumi: checks 
Grifo546: checks 
*** RIVER *** [8s Jc 9d 3c] [Js]
Amos434: checks 
eudefumi: checks 
Grifo546: checks 
*** SHOW DOWN ***
Amos434: shows [Qs 9h] (two pair, Jacks and Nines)
eudefumi: mucks hand 
Grifo546: mucks hand 
Amos434 collected €0.47 from pot
*** SUMMARY ***
Total pot €0.49 | Rake €0.02 
Board [8s Jc 9d 3c Js]
Seat 1: Grifo546 (button) mucked [7s 5s]
Seat 2: Abatefaria1976 (small blind) folded before Flop
Seat 3: Amos434 (big blind) showed [Qs 9h] and won (€0.47) with two pair, Jacks and Nines
Seat 4: caduceus369 folded before Flop (didn't bet)
Seat 5: eudefumi mucked [5h 6h]
Seat 6: cap e'bomb95 folded before Flop (didn't bet)



PokerStars Zoom Hand #257957925394:  Hold'em No Limit (€0.01/€0.02) [ADM ID: M62BA304494E32ST] - 2025/10/01 14:51:32 CET [2025/10/01 8:51:32 ET]
Table 'Sirio' 6-max Seat #1 is the button
Seat 1: francovirde (€2.39 in chips) 
Seat 2: caduceus369 (€2.72 in chips) 
Seat 3: lucpri (€1.93 in chips) 
Seat 4: TOROLAI (€2.30 in chips) 
Seat 5: lampo201 (€2.26 in chips) 
Seat 6: OMGWOLFX (€3.11 in chips) 
caduceus369: posts small blind €0.01
lucpri: posts big blind €0.02
*** HOLE CARDS ***
Dealt to caduceus369 [As Kh]
TOROLAI: folds 
lampo201: calls €0.02
OMGWOLFX: folds 
francovirde: folds 
caduceus369: raises €0.06 to €0.08
lucpri: folds 
lampo201: calls €0.06
*** FLOP *** [Kd Jc 9s]
caduceus369: checks 
lampo201: bets €0.06
caduceus369: raises €0.12 to €0.18
lampo201: calls €0.12
*** TURN *** [Kd Jc 9s] [8c]
caduceus369: checks 
lampo201: checks 
*** RIVER *** [Kd Jc 9s 8c] [6s]
caduceus369: bets €0.26
lampo201: calls €0.26
*** SHOW DOWN ***
caduceus369: shows [As Kh] (a pair of Kings)
lampo201: mucks hand 
caduceus369 collected €1.01 from pot
*** SUMMARY ***
Total pot €1.06 | Rake €0.05 
Board [Kd Jc 9s 8c 6s]
Seat 1: francovirde (button) folded before Flop (didn't bet)
Seat 2: caduceus369 (small blind) showed [As Kh] and won (€1.01) with a pair of Kings
Seat 3: lucpri (big blind) folded before Flop
Seat 4: TOROLAI folded before Flop (didn't bet)
Seat 5: lampo201 mucked [Ts Jh]
Seat 6: OMGWOLFX folded before Flop (didn't bet)



PokerStars Zoom Hand #257957935306:  Hold'em No Limit (€0.01/€0.02) [ADM ID: M62BA304494E32ST] - 2025/10/01 14:52:51 CET [2025/10/01 8:52:51 ET]
Table 'Sirio' 6-max Seat #1 is the button
Seat 1: THE_CLOWN_74 (€2.21 in chips) 
Seat 2: lucpri (€1.93 in chips) 
Seat 3: Quelle128 (€0.54 in chips) 
Seat 4: sipa66 (€2.29 in chips) 
Seat 5: caduceus369 (€3.21 in chips) 
Seat 6: ghosto69 (€2.55 in chips) 
lucpri: posts small blind €0.01
Quelle128: posts big blind €0.02
*** HOLE CARDS ***
Dealt to caduceus369 [9s 7s]
sipa66: folds 
caduceus369: folds 
ghosto69: folds 
THE_CLOWN_74: folds 
lucpri: calls €0.01
Quelle128: checks 
*** FLOP *** [7h 2c Kd]
lucpri: checks 
Quelle128: checks 
*** TURN *** [7h 2c Kd] [2s]
lucpri: bets €0.02
Quelle128: folds 
Uncalled bet (€0.02) returned to lucpri
lucpri collected €0.04 from pot
lucpri: doesn't show hand 
*** SUMMARY ***
Total pot €0.04 | Rake €0 
Board [7h 2c Kd 2s]
Seat 1: THE_CLOWN_74 (button) folded before Flop (didn't bet)
Seat 2: lucpri (small blind) collected (€0.04)
Seat 3: Quelle128 (big blind) folded on the Turn
Seat 4: sipa66 folded before Flop (didn't bet)
Seat 5: caduceus369 folded before Flop (didn't bet)
Seat 6: ghosto69 folded before Flop (didn't bet)



PokerStars Zoom Hand #257957939002:  Hold'em No Limit (€0.01/€0.02) [ADM ID: M62BA304494E32ST] - 2025/10/01 14:53:20 CET [2025/10/01 8:53:20 ET]
Table 'Sirio' 6-max Seat #1 is the button
Seat 1: caduceus369 (€3.21 in chips) 
Seat 2: sipa66 (€4.08 in chips) 
Seat 3: lucpri (€1.95 in chips) 
Seat 4: Amos434 (€1.81 in chips) 
Seat 5: THE_CLOWN_74 (€2.16 in chips) 
Seat 6: gs0097 (€0.71 in chips) 
sipa66: posts small blind €0.01
lucpri: posts big blind €0.02
*** HOLE CARDS ***
Dealt to caduceus369 [Td Tc]
Amos434: folds 
THE_CLOWN_74: folds 
gs0097: folds 
caduceus369: raises €0.02 to €0.04
sipa66: folds 
lucpri: folds 
Uncalled bet (€0.02) returned to caduceus369
caduceus369 collected €0.05 from pot
caduceus369: doesn't show hand 
*** SUMMARY ***
Total pot €0.05 | Rake €0 
Seat 1: caduceus369 (button) collected (€0.05)
Seat 2: sipa66 (small blind) folded before Flop
Seat 3: lucpri (big blind) folded before Flop
Seat 4: Amos434 folded before Flop (didn't bet)
Seat 5: THE_CLOWN_74 folded before Flop (didn't bet)
Seat 6: gs0097 folded before Flop (didn't bet)



PokerStars Zoom Hand #257957941261:  Hold'em No Limit (€0.01/€0.02) [ADM ID: M62BA304494E32ST] - 2025/10/01 14:53:38 CET [2025/10/01 8:53:38 ET]
Table 'Sirio' 6-max Seat #1 is the button
Seat 1: dagliaddosso (€2.12 in chips) 
Seat 2: francovirde (€1.52 in chips) 
Seat 3: THE_CLOWN_74 (€2.16 in chips) 
Seat 4: gs0097 (€0.71 in chips) 
Seat 5: mattya69 (€3.41 in chips) 
Seat 6: caduceus369 (€3.24 in chips) 
francovirde: posts small blind €0.01
THE_CLOWN_74: posts big blind €0.02
*** HOLE CARDS ***
Dealt to caduceus369 [7s As]
gs0097: folds 
mattya69: raises €0.04 to €0.06
caduceus369: folds 
dagliaddosso: folds 
francovirde: folds 
THE_CLOWN_74: folds 
Uncalled bet (€0.04) returned to mattya69
mattya69 collected €0.05 from pot
mattya69: doesn't show hand 
*** SUMMARY ***
Total pot €0.05 | Rake €0 
Seat 1: dagliaddosso (button) folded before Flop (didn't bet)
Seat 2: francovirde (small blind) folded before Flop
Seat 3: THE_CLOWN_74 (big blind) folded before Flop
Seat 4: gs0097 folded before Flop (didn't bet)
Seat 5: mattya69 collected (€0.05)
Seat 6: caduceus369 folded before Flop (didn't bet)



PokerStars Zoom Hand #257957942833:  Hold'em No Limit (€0.01/€0.02) [ADM ID: M62BA304494E32ST] - 2025/10/01 14:53:50 CET [2025/10/01 8:53:50 ET]
Table 'Sirio' 6-max Seat #1 is the button
Seat 1: TIZZOTTO (€1.68 in chips) 
Seat 2: zlat11 (€1 in chips) 
Seat 3: caduceus369 (€3.24 in chips) 
Seat 4: dagliaddosso (€2.12 in chips) 
Seat 5: OMGWOLFX (€5.92 in chips) 
Seat 6: ValenTom25 (€1.42 in chips) 
zlat11: posts small blind €0.01
caduceus369: posts big blind €0.02
*** HOLE CARDS ***
Dealt to caduceus369 [Qd 6d]
dagliaddosso: folds 
OMGWOLFX: folds 
ValenTom25: calls €0.02
TIZZOTTO: raises €0.07 to €0.09
zlat11: raises €0.22 to €0.31
caduceus369: folds 
ValenTom25: folds 
TIZZOTTO: raises €1.37 to €1.68 and is all-in
zlat11: calls €0.69 and is all-in
Uncalled bet (€0.68) returned to TIZZOTTO
*** FLOP *** [4c 8s 3s]
*** TURN *** [4c 8s 3s] [4h]
*** RIVER *** [4c 8s 3s 4h] [Qc]
*** SHOW DOWN ***
zlat11: shows [Ac As] (two pair, Aces and Fours)
TIZZOTTO: shows [Ah Qs] (two pair, Queens and Fours)
zlat11 collected €1.93 from pot
*** SUMMARY ***
Total pot €2.04 | Rake €0.11 
Board [4c 8s 3s 4h Qc]
Seat 1: TIZZOTTO (button) showed [Ah Qs] and lost with two pair, Queens and Fours
Seat 2: zlat11 (small blind) showed [Ac As] and won (€1.93) with two pair, Aces and Fours
Seat 3: caduceus369 (big blind) folded before Flop
Seat 4: dagliaddosso folded before Flop (didn't bet)
Seat 5: OMGWOLFX folded before Flop (didn't bet)
Seat 6: ValenTom25 folded before Flop



PokerStars Zoom Hand #257957942442:  Hold'em No Limit (€0.01/€0.02) [ADM ID: M62BA304494E32ST] - 2025/10/01 14:53:47 CET [2025/10/01 8:53:47 ET]
Table 'Sirio' 6-max Seat #1 is the button
Seat 1: Kboy242 (€2.37 in chips) 
Seat 2: cagliari59 (€2.87 in chips) 
Seat 3: dank792 (€0.80 in chips) 
Seat 4: eudefumi (€0.68 in chips) 
Seat 5: caduceus369 (€3.24 in chips) 
Seat 6: zlat11 (€1 in chips) 
cagliari59: posts small blind €0.01
dank792: posts big blind €0.02
*** HOLE CARDS ***
Dealt to caduceus369 [9s 3d]
eudefumi: raises €0.08 to €0.10
caduceus369: folds 
zlat11: folds 
Kboy242: folds 
cagliari59: calls €0.09
dank792: calls €0.08
*** FLOP *** [7s 9d 8d]
cagliari59: checks 
dank792: bets €0.02
eudefumi: raises €0.20 to €0.22
cagliari59: calls €0.22
dank792: calls €0.20
*** TURN *** [7s 9d 8d] [4s]
cagliari59: checks 
dank792: checks 
eudefumi: bets €0.36 and is all-in
cagliari59: folds 
dank792: folds 
Uncalled bet (€0.36) returned to eudefumi
eudefumi collected €0.91 from pot
eudefumi: doesn't show hand 
*** SUMMARY ***
Total pot €0.96 | Rake €0.05 
Board [7s 9d 8d 4s]
Seat 1: Kboy242 (button) folded before Flop (didn't bet)
Seat 2: cagliari59 (small blind) folded on the Turn
Seat 3: dank792 (big blind) folded on the Turn
Seat 4: eudefumi collected (€0.91)
Seat 5: caduceus369 folded before Flop (didn't bet)
Seat 6: zlat11 folded before Flop (didn't bet)



PokerStars Zoom Hand #257957945124:  Hold'em No Limit (€0.01/€0.02) [ADM ID: M62BA304494E32ST] - 2025/10/01 14:54:08 CET [2025/10/01 8:54:08 ET]
Table 'Sirio' 6-max Seat #1 is the button
Seat 1: francovirde (€1.52 in chips) 
Seat 2: OMGWOLFX (€4.16 in chips) 
Seat 3: ghosto69 (€2.49 in chips) 
Seat 4: caduceus369 (€3.22 in chips) 
Seat 5: pylonstrip (€2.35 in chips) 
Seat 6: AntonioKrakka (€1.94 in chips) 
OMGWOLFX: posts small blind €0.01
ghosto69: posts big blind €0.02
*** HOLE CARDS ***
Dealt to caduceus369 [8h Kc]
caduceus369: folds 
pylonstrip: raises €0.02 to €0.04
AntonioKrakka: raises €0.11 to €0.15
francovirde: folds 
OMGWOLFX: calls €0.14
ghosto69: folds 
pylonstrip: raises €2.20 to €2.35 and is all-in
AntonioKrakka: calls €1.79 and is all-in
OMGWOLFX: folds 
Uncalled bet (€0.41) returned to pylonstrip
*** FLOP *** [5d 2d 9s]
*** TURN *** [5d 2d 9s] [8d]
*** RIVER *** [5d 2d 9s 8d] [7h]
*** SHOW DOWN ***
pylonstrip: shows [Ks Kd] (a pair of Kings)
AntonioKrakka: shows [Qd As] (high card Ace)
pylonstrip collected €3.83 from pot
*** SUMMARY ***
Total pot €4.05 | Rake €0.22 
Board [5d 2d 9s 8d 7h]
Seat 1: francovirde (button) folded before Flop (didn't bet)
Seat 2: OMGWOLFX (small blind) folded before Flop
Seat 3: ghosto69 (big blind) folded before Flop
Seat 4: caduceus369 folded before Flop (didn't bet)
Seat 5: pylonstrip showed [Ks Kd] and won (€3.83) with a pair of Kings
Seat 6: AntonioKrakka showed [Qd As] and lost with high card Ace



PokerStars Zoom Hand #257957947483:  Hold'em No Limit (€0.01/€0.02) [ADM ID: M62BA304494E32ST] - 2025/10/01 14:54:26 CET [2025/10/01 8:54:26 ET]
Table 'Sirio' 6-max Seat #1 is the button
Seat 1: PokerSimo1 (€1.55 in chips) 
Seat 2: Amos434 (€1.86 in chips) 
Seat 3: OMGWOLFX (€5.92 in chips) 
Seat 4: caduceus369 (€3.21 in chips) 
Seat 5: THE_CLOWN_74 (€2.13 in chips) 
Seat 6: Grifo546 (€1.38 in chips) 
Amos434: posts small blind €0.01
OMGWOLFX: posts big blind €0.02
*** HOLE CARDS ***
Dealt to caduceus369 [9h 7h]
caduceus369: folds 
THE_CLOWN_74: folds 
Grifo546: raises €0.04 to €0.06
PokerSimo1: folds 
Amos434: folds 
OMGWOLFX: folds 
Uncalled bet (€0.04) returned to Grifo546
Grifo546 collected €0.05 from pot
Grifo546: doesn't show hand 
*** SUMMARY ***
Total pot €0.05 | Rake €0 
Seat 1: PokerSimo1 (button) folded before Flop (didn't bet)
Seat 2: Amos434 (small blind) folded before Flop
Seat 3: OMGWOLFX (big blind) folded before Flop
Seat 4: caduceus369 folded before Flop (didn't bet)
Seat 5: THE_CLOWN_74 folded before Flop (didn't bet)
Seat 6: Grifo546 collected (€0.05)



PokerStars Zoom Hand #257957946077:  Hold'em No Limit (€0.01/€0.02) [ADM ID: M62BA304494E32ST] - 2025/10/01 14:54:15 CET [2025/10/01 8:54:15 ET]
Table 'Sirio' 6-max Seat #1 is the button
Seat 1: caduceus369 (€3.21 in chips) 
Seat 2: ghosto69 (€2.23 in chips) 
Seat 3: sipa66 (€3.66 in chips) 
Seat 4: PokerSimo1 (€1.55 in chips) 
Seat 5: THE_CLOWN_74 (€2.10 in chips) 
Seat 6: Pasdum57 (€2.14 in chips) 
ghosto69: posts small blind €0.01
sipa66: posts big blind €0.02
*** HOLE CARDS ***
Dealt to caduceus369 [Tc 5c]
PokerSimo1: folds 
THE_CLOWN_74: folds 
Pasdum57: calls €0.02
caduceus369: folds 
ghosto69: raises €0.04 to €0.06
sipa66: folds 
Pasdum57: calls €0.04
*** FLOP *** [Ts 6s 2s]
ghosto69: bets €0.05
Pasdum57: folds 
Uncalled bet (€0.05) returned to ghosto69
ghosto69 collected €0.14 from pot
ghosto69: doesn't show hand 
*** SUMMARY ***
Total pot €0.14 | Rake €0 
Board [Ts 6s 2s]
Seat 1: caduceus369 (button) folded before Flop (didn't bet)
Seat 2: ghosto69 (small blind) collected (€0.14)
Seat 3: sipa66 (big blind) folded before Flop
Seat 4: PokerSimo1 folded before Flop (didn't bet)
Seat 5: THE_CLOWN_74 folded before Flop (didn't bet)
Seat 6: Pasdum57 folded on the Flop



PokerStars Zoom Hand #257957945681:  Hold'em No Limit (€0.01/€0.02) [ADM ID: M62BA304494E32ST] - 2025/10/01 14:54:12 CET [2025/10/01 8:54:12 ET]
Table 'Sirio' 6-max Seat #1 is the button
Seat 1: pokerhellas (€1.25 in chips) 
Seat 2: caduceus369 (€3.22 in chips) 
Seat 3: OMGWOLFX (€3.14 in chips) 
Seat 4: Quelle128 (€0.88 in chips) 
Seat 5: ValenTom25 (€1.40 in chips) 
Seat 6: THE_CLOWN_74 (€2.10 in chips) 
caduceus369: posts small blind €0.01
OMGWOLFX: posts big blind €0.02
*** HOLE CARDS ***
Dealt to caduceus369 [9c 2h]
Quelle128: calls €0.02
ValenTom25: calls €0.02
THE_CLOWN_74: folds 
pokerhellas: raises €0.10 to €0.12
caduceus369: folds 
OMGWOLFX: calls €0.10
Quelle128: calls €0.10
ValenTom25: calls €0.10
*** FLOP *** [5d 7h 3c]
OMGWOLFX: checks 
Quelle128: checks 
ValenTom25: checks 
pokerhellas: checks 
*** TURN *** [5d 7h 3c] [9s]
OMGWOLFX: bets €0.24
Quelle128: folds 
ValenTom25: folds 
pokerhellas: folds 
Uncalled bet (€0.24) returned to OMGWOLFX
OMGWOLFX collected €0.47 from pot
OMGWOLFX: doesn't show hand 
*** SUMMARY ***
Total pot €0.49 | Rake €0.02 
Board [5d 7h 3c 9s]
Seat 1: pokerhellas (button) folded on the Turn
Seat 2: caduceus369 (small blind) folded before Flop
Seat 3: OMGWOLFX (big blind) collected (€0.47)
Seat 4: Quelle128 folded on the Turn
Seat 5: ValenTom25 folded on the Turn
Seat 6: THE_CLOWN_74 folded before Flop (didn't bet)



PokerStars Zoom Hand #257957948092:  Hold'em No Limit (€0.01/€0.02) [ADM ID: M62BA304494E32ST] - 2025/10/01 14:54:31 CET [2025/10/01 8:54:31 ET]
Table 'Sirio' 6-max Seat #1 is the button
Seat 1: THE_CLOWN_74 (€2.10 in chips) 
Seat 2: Kboy242 (€2.31 in chips) 
Seat 3: zlat11 (€1.93 in chips) 
Seat 4: caduceus369 (€3.21 in chips) 
Seat 5: TIZZOTTO (€0.68 in chips) 
Seat 6: lampo201 (€2.05 in chips) 
Kboy242: posts small blind €0.01
zlat11: posts big blind €0.02
*** HOLE CARDS ***
Dealt to caduceus369 [8c 3s]
caduceus369: folds 
TIZZOTTO: raises €0.05 to €0.07
lampo201: folds 
THE_CLOWN_74: folds 
Kboy242: folds 
zlat11: raises €0.23 to €0.30
TIZZOTTO: calls €0.23
*** FLOP *** [Kh 5c Jc]
zlat11: checks 
TIZZOTTO: bets €0.38 and is all-in
zlat11: folds 
Uncalled bet (€0.38) returned to TIZZOTTO
TIZZOTTO collected €0.58 from pot
TIZZOTTO: doesn't show hand 
*** SUMMARY ***
Total pot €0.61 | Rake €0.03 
Board [Kh 5c Jc]
Seat 1: THE_CLOWN_74 (button) folded before Flop (didn't bet)
Seat 2: Kboy242 (small blind) folded before Flop
Seat 3: zlat11 (big blind) folded on the Flop
Seat 4: caduceus369 folded before Flop (didn't bet)
Seat 5: TIZZOTTO collected (€0.58)
Seat 6: lampo201 folded before Flop (didn't bet)



PokerStars Zoom Hand #257957952259:  Hold'em No Limit (€0.01/€0.02) [ADM ID: M62BA304494E32ST] - 2025/10/01 14:55:04 CET [2025/10/01 8:55:04 ET]
Table 'Sirio' 6-max Seat #1 is the button
Seat 1: sipa66 (€2.17 in chips) 
Seat 2: caduceus369 (€3.19 in chips) 
Seat 3: TIZZOTTO (€0.96 in chips) 
Seat 4: Amos434 (€1.85 in chips) 
Seat 5: OMGWOLFX (€3.49 in chips) 
Seat 6: zlat11 (€1.63 in chips) 
caduceus369: posts small blind €0.01
TIZZOTTO: posts big blind €0.02
*** HOLE CARDS ***
Dealt to caduceus369 [6d 8c]
Amos434: folds 
OMGWOLFX: folds 
zlat11: raises €0.07 to €0.09
sipa66: folds 
caduceus369: folds 
TIZZOTTO: folds 
Uncalled bet (€0.07) returned to zlat11
zlat11 collected €0.05 from pot
zlat11: doesn't show hand 
*** SUMMARY ***
Total pot €0.05 | Rake €0 
Seat 1: sipa66 (button) folded before Flop (didn't bet)
Seat 2: caduceus369 (small blind) folded before Flop
Seat 3: TIZZOTTO (big blind) folded before Flop
Seat 4: Amos434 folded before Flop (didn't bet)
Seat 5: OMGWOLFX folded before Flop (didn't bet)
Seat 6: zlat11 collected (€0.05)



PokerStars Zoom Hand #257957949247:  Hold'em No Limit (€0.01/€0.02) [ADM ID: M62BA304494E32ST] - 2025/10/01 14:54:40 CET [2025/10/01 8:54:40 ET]
Table 'Sirio' 6-max Seat #1 is the button
Seat 1: OMGWOLFX (€4.01 in chips) 
Seat 2: gs0097 (€0.66 in chips) 
Seat 3: caduceus369 (€3.21 in chips) 
Seat 4: lampo201 (€2.05 in chips) 
Seat 5: sipa66 (€2.47 in chips) 
Seat 6: Emm3B1 (€1.77 in chips) 
gs0097: posts small blind €0.01
caduceus369: posts big blind €0.02
*** HOLE CARDS ***
Dealt to caduceus369 [6c 5s]
lampo201: raises €0.02 to €0.04
sipa66: folds 
Emm3B1: raises €0.07 to €0.11
OMGWOLFX: folds 
gs0097: folds 
caduceus369: folds 
lampo201: calls €0.07
*** FLOP *** [Tc 9c Kc]
lampo201: checks 
Emm3B1: checks 
*** TURN *** [Tc 9c Kc] [6h]
lampo201: bets €0.24
Emm3B1: calls €0.24
*** RIVER *** [Tc 9c Kc 6h] [3c]
lampo201: bets €0.06
Emm3B1: calls €0.06
*** SHOW DOWN ***
lampo201: shows [7d 8d] (a straight, Six to Ten)
Emm3B1: mucks hand 
lampo201 collected €0.81 from pot
*** SUMMARY ***
Total pot €0.85 | Rake €0.04 
Board [Tc 9c Kc 6h 3c]
Seat 1: OMGWOLFX (button) folded before Flop (didn't bet)
Seat 2: gs0097 (small blind) folded before Flop
Seat 3: caduceus369 (big blind) folded before Flop
Seat 4: lampo201 showed [7d 8d] and won (€0.81) with a straight, Six to Ten
Seat 5: sipa66 folded before Flop (didn't bet)
Seat 6: Emm3B1 mucked [Ah Ks]



PokerStars Zoom Hand #257957954065:  Hold'em No Limit (€0.01/€0.02) [ADM ID: M62BA304494E32ST] - 2025/10/01 14:55:18 CET [2025/10/01 8:55:18 ET]
Table 'Sirio' 6-max Seat #1 is the button
Seat 1: lucpri (€1.92 in chips) 
Seat 2: THE_CLOWN_74 (€3.98 in chips) 
Seat 3: pylonstrip (€4.28 in chips) 
Seat 4: OMGWOLFX (€3.49 in chips) 
Seat 5: caduceus369 (€3.18 in chips) 
Seat 6: mrniceseed (€4.27 in chips) 
THE_CLOWN_74: posts small blind €0.01
pylonstrip: posts big blind €0.02
*** HOLE CARDS ***
Dealt to caduceus369 [4h Tc]
OMGWOLFX: folds 
caduceus369: folds 
mrniceseed: folds 
lucpri: folds 
THE_CLOWN_74: raises €0.03 to €0.05
pylonstrip: folds 
Uncalled bet (€0.03) returned to THE_CLOWN_74
THE_CLOWN_74 collected €0.04 from pot
THE_CLOWN_74: doesn't show hand 
*** SUMMARY ***
Total pot €0.04 | Rake €0 
Seat 1: lucpri (button) folded before Flop (didn't bet)
Seat 2: THE_CLOWN_74 (small blind) collected (€0.04)
Seat 3: pylonstrip (big blind) folded before Flop
Seat 4: OMGWOLFX folded before Flop (didn't bet)
Seat 5: caduceus369 folded before Flop (didn't bet)
Seat 6: mrniceseed folded before Flop (didn't bet)



PokerStars Zoom Hand #257957948754:  Hold'em No Limit (€0.01/€0.02) [ADM ID: M62BA304494E32ST] - 2025/10/01 14:54:36 CET [2025/10/01 8:54:36 ET]
Table 'Sirio' 6-max Seat #1 is the button
Seat 1: THE_CLOWN_74 (€2.13 in chips) 
Seat 2: dank792 (€0.48 in chips) 
Seat 3: 0BeaLoris (€1.20 in chips) 
Seat 4: lucpri (€1.95 in chips) 
Seat 5: mattya69 (€3.46 in chips) 
Seat 6: caduceus369 (€3.21 in chips) 
dank792: posts small blind €0.01
0BeaLoris: posts big blind €0.02
*** HOLE CARDS ***
Dealt to caduceus369 [Tc 4h]
dank792 is disconnected 
lucpri: folds 
mattya69: raises €0.04 to €0.06
caduceus369: folds 
THE_CLOWN_74: folds 
dank792 has timed out while disconnected
dank792: folds 
0BeaLoris: calls €0.04
*** FLOP *** [6d 3h 3c]
0BeaLoris: checks 
mattya69: bets €0.03
0BeaLoris: calls €0.03
*** TURN *** [6d 3h 3c] [2h]
0BeaLoris: checks 
mattya69: bets €0.14
0BeaLoris: calls €0.14
*** RIVER *** [6d 3h 3c 2h] [5h]
0BeaLoris: checks 
mattya69: bets €0.02
0BeaLoris: calls €0.02
*** SHOW DOWN ***
mattya69: shows [Jh Kh] (a flush, King high)
0BeaLoris: mucks hand 
mattya69 collected €0.49 from pot
*** SUMMARY ***
Total pot €0.51 | Rake €0.02 
Board [6d 3h 3c 2h 5h]
Seat 1: THE_CLOWN_74 (button) folded before Flop (didn't bet)
Seat 2: dank792 (small blind) folded before Flop
Seat 3: 0BeaLoris (big blind) mucked [Qd As]
Seat 4: lucpri folded before Flop (didn't bet)
Seat 5: mattya69 showed [Jh Kh] and won (€0.49) with a flush, King high
Seat 6: caduceus369 folded before Flop (didn't bet)



PokerStars Zoom Hand #257957954371:  Hold'em No Limit (€0.01/€0.02) [ADM ID: M62BA304494E32ST] - 2025/10/01 14:55:22 CET [2025/10/01 8:55:22 ET]
Table 'Sirio' 6-max Seat #1 is the button
Seat 1: zlat11 (€1.66 in chips) 
Seat 2: THE_CLOWN_74 (€2.41 in chips) 
Seat 3: pokerhellas (€1.12 in chips) 
Seat 4: mrniceseed (€4.27 in chips) 
Seat 5: sipa66 (€2.17 in chips) 
Seat 6: caduceus369 (€3.18 in chips) 
THE_CLOWN_74: posts small blind €0.01
pokerhellas: posts big blind €0.02
*** HOLE CARDS ***
Dealt to caduceus369 [5s 5h]
mrniceseed: calls €0.02
sipa66: folds 
caduceus369: calls €0.02
zlat11: raises €0.11 to €0.13
THE_CLOWN_74: folds 
pokerhellas: folds 
mrniceseed: calls €0.11
caduceus369: folds 
*** FLOP *** [As Kc 9c]
mrniceseed: checks 
zlat11: bets €0.30
mrniceseed: folds 
Uncalled bet (€0.30) returned to zlat11
zlat11 collected €0.30 from pot
zlat11: doesn't show hand 
*** SUMMARY ***
Total pot €0.31 | Rake €0.01 
Board [As Kc 9c]
Seat 1: zlat11 (button) collected (€0.30)
Seat 2: THE_CLOWN_74 (small blind) folded before Flop
Seat 3: pokerhellas (big blind) folded before Flop
Seat 4: mrniceseed folded on the Flop
Seat 5: sipa66 folded before Flop (didn't bet)
Seat 6: caduceus369 folded before Flop



PokerStars Zoom Hand #257957953756:  Hold'em No Limit (€0.01/€0.02) [ADM ID: M62BA304494E32ST] - 2025/10/01 14:55:16 CET [2025/10/01 8:55:16 ET]
Table 'Sirio' 6-max Seat #1 is the button
Seat 1: caduceus369 (€3.18 in chips) 
Seat 2: pylonstrip (€4.29 in chips) 
Seat 3: ghosto69 (€2.31 in chips) 
Seat 4: colosso2022 (€0.91 in chips) 
Seat 5: Quelle128 (€0.75 in chips) 
Seat 6: Pasdum57 (€2.09 in chips) 
pylonstrip: posts small blind €0.01
ghosto69: posts big blind €0.02
*** HOLE CARDS ***
Dealt to caduceus369 [5d 3c]
colosso2022: calls €0.02
Quelle128: folds 
Pasdum57: raises €0.02 to €0.04
caduceus369: folds 
pylonstrip: folds 
ghosto69: raises €0.02 to €0.06
colosso2022: calls €0.04
Pasdum57: calls €0.02
*** FLOP *** [7d Ah Qh]
ghosto69: checks 
colosso2022: checks 
Pasdum57: bets €0.18
ghosto69: folds 
colosso2022: folds 
Uncalled bet (€0.18) returned to Pasdum57
Pasdum57 collected €0.18 from pot
Pasdum57: doesn't show hand 
*** SUMMARY ***
Total pot €0.19 | Rake €0.01 
Board [7d Ah Qh]
Seat 1: caduceus369 (button) folded before Flop (didn't bet)
Seat 2: pylonstrip (small blind) folded before Flop
Seat 3: ghosto69 (big blind) folded on the Flop
Seat 4: colosso2022 folded on the Flop
Seat 5: Quelle128 folded before Flop (didn't bet)
Seat 6: Pasdum57 collected (€0.18)



PokerStars Zoom Hand #257957957890:  Hold'em No Limit (€0.01/€0.02) [ADM ID: M62BA304494E32ST] - 2025/10/01 14:55:57 CET [2025/10/01 8:55:57 ET]
Table 'Sirio' 6-max Seat #1 is the button
Seat 1: francovirde (€2.10 in chips) 
Seat 2: TOROLAI (€1.97 in chips) 
Seat 3: caduceus369 (€3.16 in chips) 
Seat 4: eudefumi (€1.30 in chips) 
Seat 5: OMGWOLFX (€5.75 in chips) 
Seat 6: ghosto69 (€2.25 in chips) 
TOROLAI: posts small blind €0.01
caduceus369: posts big blind €0.02
*** HOLE CARDS ***
Dealt to caduceus369 [Tc 7c]
eudefumi: raises €0.06 to €0.08
OMGWOLFX: folds 
ghosto69: folds 
francovirde: folds 
TOROLAI: folds 
caduceus369: folds 
Uncalled bet (€0.06) returned to eudefumi
eudefumi collected €0.05 from pot
eudefumi: doesn't show hand 
*** SUMMARY ***
Total pot €0.05 | Rake €0 
Seat 1: francovirde (button) folded before Flop (didn't bet)
Seat 2: TOROLAI (small blind) folded before Flop
Seat 3: caduceus369 (big blind) folded before Flop
Seat 4: eudefumi collected (€0.05)
Seat 5: OMGWOLFX folded before Flop (didn't bet)
Seat 6: ghosto69 folded before Flop (didn't bet)



PokerStars Zoom Hand #257957957257:  Hold'em No Limit (€0.01/€0.02) [ADM ID: M62BA304494E32ST] - 2025/10/01 14:55:50 CET [2025/10/01 8:55:50 ET]
Table 'Sirio' 6-max Seat #1 is the button
Seat 1: PokerSimo1 (€1.96 in chips) 
Seat 2: Amos434 (€2 in chips) 
Seat 3: mrniceseed (€4.14 in chips) 
Seat 4: mattya69 (€3.69 in chips) 
Seat 5: caduceus369 (€3.16 in chips) 
Seat 6: lampo201 (€2.45 in chips) 
Amos434: posts small blind €0.01
mrniceseed: posts big blind €0.02
*** HOLE CARDS ***
Dealt to caduceus369 [2d Jc]
mattya69: folds 
caduceus369: folds 
lampo201: folds 
PokerSimo1: calls €0.02
Amos434: calls €0.01
mrniceseed: checks 
*** FLOP *** [3d 4c Kc]
Amos434: checks 
mrniceseed: checks 
PokerSimo1: checks 
*** TURN *** [3d 4c Kc] [Th]
Amos434: checks 
mrniceseed: checks 
PokerSimo1: bets €0.08
Amos434: calls €0.08
mrniceseed: folds 
*** RIVER *** [3d 4c Kc Th] [7c]
Amos434: checks 
PokerSimo1: checks 
*** SHOW DOWN ***
Amos434: shows [Jh Ts] (a pair of Tens)
PokerSimo1: mucks hand 
Amos434 collected €0.21 from pot
*** SUMMARY ***
Total pot €0.22 | Rake €0.01 
Board [3d 4c Kc Th 7c]
Seat 1: PokerSimo1 (button) mucked [Js As]
Seat 2: Amos434 (small blind) showed [Jh Ts] and won (€0.21) with a pair of Tens
Seat 3: mrniceseed (big blind) folded on the Turn
Seat 4: mattya69 folded before Flop (didn't bet)
Seat 5: caduceus369 folded before Flop (didn't bet)
Seat 6: lampo201 folded before Flop (didn't bet)



PokerStars Zoom Hand #257957961525:  Hold'em No Limit (€0.01/€0.02) [ADM ID: M62BA304494E32ST] - 2025/10/01 14:56:33 CET [2025/10/01 8:56:33 ET]
Table 'Sirio' 6-max Seat #1 is the button
Seat 1: ghosto69 (€2.66 in chips) 
Seat 2: OMGWOLFX (€5.51 in chips) 
Seat 3: eudefumi (€1.33 in chips) 
Seat 4: caduceus369 (€3.13 in chips) 
Seat 5: mrniceseed (€4.12 in chips) 
Seat 6: mattya69 (€4.79 in chips) 
OMGWOLFX: posts small blind €0.01
eudefumi: posts big blind €0.02
*** HOLE CARDS ***
Dealt to caduceus369 [Ts 2h]
caduceus369: folds 
mrniceseed: calls €0.02
mattya69: folds 
ghosto69: folds 
OMGWOLFX: folds 
eudefumi: raises €0.08 to €0.10
mrniceseed: calls €0.08
*** FLOP *** [Th Kc 4s]
eudefumi: checks 
mrniceseed: checks 
*** TURN *** [Th Kc 4s] [Jh]
eudefumi: checks 
mrniceseed: checks 
*** RIVER *** [Th Kc 4s Jh] [7h]
eudefumi: checks 
mrniceseed: checks 
*** SHOW DOWN ***
eudefumi: shows [6c 6h] (a pair of Sixes)
mrniceseed: mucks hand 
eudefumi collected €0.20 from pot
*** SUMMARY ***
Total pot €0.21 | Rake €0.01 
Board [Th Kc 4s Jh 7h]
Seat 1: ghosto69 (button) folded before Flop (didn't bet)
Seat 2: OMGWOLFX (small blind) folded before Flop
Seat 3: eudefumi (big blind) showed [6c 6h] and won (€0.20) with a pair of Sixes
Seat 4: caduceus369 folded before Flop (didn't bet)
Seat 5: mrniceseed mucked [8c Ac]
Seat 6: mattya69 folded before Flop (didn't bet)



PokerStars Zoom Hand #257957960937:  Hold'em No Limit (€0.01/€0.02) [ADM ID: M62BA304494E32ST] - 2025/10/01 14:56:27 CET [2025/10/01 8:56:27 ET]
Table 'Sirio' 6-max Seat #1 is the button
Seat 1: sipa66 (€2.22 in chips) 
Seat 2: caduceus369 (€3.14 in chips) 
Seat 3: THE_CLOWN_74 (€2 in chips) 
Seat 4: OMGWOLFX (€5.75 in chips) 
Seat 5: zlat11 (€1.79 in chips) 
Seat 6: colosso2022 (€0.81 in chips) 
caduceus369: posts small blind €0.01
THE_CLOWN_74: posts big blind €0.02
*** HOLE CARDS ***
Dealt to caduceus369 [4s 9d]
OMGWOLFX: folds 
zlat11: folds 
colosso2022: calls €0.02
sipa66: raises €0.04 to €0.06
caduceus369: folds 
THE_CLOWN_74: folds 
colosso2022: raises €0.04 to €0.10
sipa66: calls €0.04
*** FLOP *** [2s 7s 2h]
colosso2022: bets €0.22
sipa66: folds 
Uncalled bet (€0.22) returned to colosso2022
colosso2022 collected €0.22 from pot
colosso2022: doesn't show hand 
*** SUMMARY ***
Total pot €0.23 | Rake €0.01 
Board [2s 7s 2h]
Seat 1: sipa66 (button) folded on the Flop
Seat 2: caduceus369 (small blind) folded before Flop
Seat 3: THE_CLOWN_74 (big blind) folded before Flop
Seat 4: OMGWOLFX folded before Flop (didn't bet)
Seat 5: zlat11 folded before Flop (didn't bet)
Seat 6: colosso2022 collected (€0.22)



PokerStars Zoom Hand #257957962561:  Hold'em No Limit (€0.01/€0.02) [ADM ID: M62BA304494E32ST] - 2025/10/01 14:56:43 CET [2025/10/01 8:56:43 ET]
Table 'Sirio' 6-max Seat #1 is the button
Seat 1: caduceus369 (€3.13 in chips) 
Seat 2: Quelle128 (€0.73 in chips) 
Seat 3: OMGWOLFX (€5.75 in chips) 
Seat 4: ghosto69 (€2.66 in chips) 
Seat 5: lampo201 (€2.47 in chips) 
Seat 6: gs0097 (€0.78 in chips) 
Quelle128: posts small blind €0.01
OMGWOLFX: posts big blind €0.02
*** HOLE CARDS ***
Dealt to caduceus369 [3h 3s]
ghosto69: folds 
lampo201: folds 
gs0097: calls €0.02
caduceus369: calls €0.02
Quelle128: calls €0.01
OMGWOLFX: checks 
*** FLOP *** [9d Qh Kd]
Quelle128: checks 
OMGWOLFX: checks 
gs0097: bets €0.04
caduceus369: folds 
Quelle128: folds 
OMGWOLFX: folds 
Uncalled bet (€0.04) returned to gs0097
gs0097 collected €0.08 from pot
gs0097: doesn't show hand 
*** SUMMARY ***
Total pot €0.08 | Rake €0 
Board [9d Qh Kd]
Seat 1: caduceus369 (button) folded on the Flop
Seat 2: Quelle128 (small blind) folded on the Flop
Seat 3: OMGWOLFX (big blind) folded on the Flop
Seat 4: ghosto69 folded before Flop (didn't bet)
Seat 5: lampo201 folded before Flop (didn't bet)
Seat 6: gs0097 collected (€0.08)



PokerStars Zoom Hand #257957967003:  Hold'em No Limit (€0.01/€0.02) [ADM ID: M62BA304494E32ST] - 2025/10/01 14:57:25 CET [2025/10/01 8:57:25 ET]
Table 'Sirio' 6-max Seat #1 is the button
Seat 1: ghosto69 (€2.34 in chips) 
Seat 2: Catania838 (€1.49 in chips) 
Seat 3: Quelle128 (€0.71 in chips) 
Seat 4: pokerhellas (€1.20 in chips) 
Seat 5: sipa66 (€2.25 in chips) 
Seat 6: caduceus369 (€3.11 in chips) 
Catania838: posts small blind €0.01
Quelle128: posts big blind €0.02
*** HOLE CARDS ***
Dealt to caduceus369 [5h 5s]
pokerhellas: folds 
sipa66: raises €0.04 to €0.06
caduceus369: folds 
ghosto69: folds 
Catania838: folds 
Quelle128: calls €0.04
*** FLOP *** [Ah Jc Ad]
Quelle128: checks 
sipa66: checks 
*** TURN *** [Ah Jc Ad] [9d]
Quelle128: checks 
sipa66: bets €0.04
Quelle128: folds 
Uncalled bet (€0.04) returned to sipa66
sipa66 collected €0.13 from pot
sipa66: doesn't show hand 
*** SUMMARY ***
Total pot €0.13 | Rake €0 
Board [Ah Jc Ad 9d]
Seat 1: ghosto69 (button) folded before Flop (didn't bet)
Seat 2: Catania838 (small blind) folded before Flop
Seat 3: Quelle128 (big blind) folded on the Turn
Seat 4: pokerhellas folded before Flop (didn't bet)
Seat 5: sipa66 collected (€0.13)
Seat 6: caduceus369 folded before Flop (didn't bet)



PokerStars Zoom Hand #257957968754:  Hold'em No Limit (€0.01/€0.02) [ADM ID: M62BA304494E32ST] - 2025/10/01 14:57:42 CET [2025/10/01 8:57:42 ET]
Table 'Sirio' 6-max Seat #1 is the button
Seat 1: lucpri (€2 in chips) 
Seat 2: Grifo546 (€1.06 in chips) 
Seat 3: caduceus369 (€3.11 in chips) 
Seat 4: zlat11 (€1.77 in chips) 
Seat 5: mattya69 (€4.78 in chips) 
Seat 6: sipa66 (€3.31 in chips) 
Grifo546: posts small blind €0.01
caduceus369: posts big blind €0.02
*** HOLE CARDS ***
Dealt to caduceus369 [3s 8s]
zlat11: folds 
mattya69: folds 
sipa66: raises €0.04 to €0.06
lucpri: folds 
Grifo546: folds 
caduceus369: folds 
Uncalled bet (€0.04) returned to sipa66
sipa66 collected €0.05 from pot
sipa66: doesn't show hand 
*** SUMMARY ***
Total pot €0.05 | Rake €0 
Seat 1: lucpri (button) folded before Flop (didn't bet)
Seat 2: Grifo546 (small blind) folded before Flop
Seat 3: caduceus369 (big blind) folded before Flop
Seat 4: zlat11 folded before Flop (didn't bet)
Seat 5: mattya69 folded before Flop (didn't bet)
Seat 6: sipa66 collected (€0.05)



PokerStars Zoom Hand #257957968338:  Hold'em No Limit (€0.01/€0.02) [ADM ID: M62BA304494E32ST] - 2025/10/01 14:57:38 CET [2025/10/01 8:57:38 ET]
Table 'Sirio' 6-max Seat #1 is the button
Seat 1: zlat11 (€1.77 in chips) 
Seat 2: THE_CLOWN_74 (€2 in chips) 
Seat 3: pokerhellas (€1.20 in chips) 
Seat 4: caduceus369 (€3.11 in chips) 
Seat 5: ghosto69 (€2.34 in chips) 
Seat 6: Grifo546 (€1.06 in chips) 
THE_CLOWN_74: posts small blind €0.01
pokerhellas: posts big blind €0.02
*** HOLE CARDS ***
Dealt to caduceus369 [Th 9s]
caduceus369: folds 
ghosto69: folds 
Grifo546: folds 
zlat11: folds 
THE_CLOWN_74: raises €0.03 to €0.05
pokerhellas: calls €0.03
*** FLOP *** [2d Ad As]
THE_CLOWN_74: checks 
pokerhellas: checks 
*** TURN *** [2d Ad As] [2s]
THE_CLOWN_74: checks 
pokerhellas: checks 
*** RIVER *** [2d Ad As 2s] [Ah]
THE_CLOWN_74: checks 
pokerhellas: checks 
*** SHOW DOWN ***
THE_CLOWN_74: shows [7c 8c] (a full house, Aces full of Deuces)
pokerhellas: shows [Jc Qh] (a full house, Aces full of Deuces)
THE_CLOWN_74 collected €0.05 from pot
pokerhellas collected €0.05 from pot
*** SUMMARY ***
Total pot €0.10 | Rake €0 
Board [2d Ad As 2s Ah]
Seat 1: zlat11 (button) folded before Flop (didn't bet)
Seat 2: THE_CLOWN_74 (small blind) showed [7c 8c] and won (€0.05) with a full house, Aces full of Deuces
Seat 3: pokerhellas (big blind) showed [Jc Qh] and won (€0.05) with a full house, Aces full of Deuces
Seat 4: caduceus369 folded before Flop (didn't bet)
Seat 5: ghosto69 folded before Flop (didn't bet)
Seat 6: Grifo546 folded before Flop (didn't bet)



PokerStars Zoom Hand #257957971077:  Hold'em No Limit (€0.01/€0.02) [ADM ID: M62BA304494E32ST] - 2025/10/01 14:58:04 CET [2025/10/01 8:58:04 ET]
Table 'Sirio' 6-max Seat #1 is the button
Seat 1: THE_CLOWN_74 (€2.02 in chips) 
Seat 2: caduceus369 (€3.09 in chips) 
Seat 3: Catania838 (€1.43 in chips) 
Seat 4: pokerhellas (€1.20 in chips) 
Seat 5: sipa66 (€2.70 in chips) 
Seat 6: mrniceseed (€3.68 in chips) 
caduceus369: posts small blind €0.01
Catania838: posts big blind €0.02
*** HOLE CARDS ***
Dealt to caduceus369 [7c 8s]
pokerhellas: raises €0.03 to €0.05
sipa66: folds 
mrniceseed: folds 
THE_CLOWN_74: folds 
caduceus369: folds 
Catania838: folds 
Uncalled bet (€0.03) returned to pokerhellas
pokerhellas collected €0.05 from pot
pokerhellas: doesn't show hand 
*** SUMMARY ***
Total pot €0.05 | Rake €0 
Seat 1: THE_CLOWN_74 (button) folded before Flop (didn't bet)
Seat 2: caduceus369 (small blind) folded before Flop
Seat 3: Catania838 (big blind) folded before Flop
Seat 4: pokerhellas collected (€0.05)
Seat 5: sipa66 folded before Flop (didn't bet)
Seat 6: mrniceseed folded before Flop (didn't bet)



PokerStars Zoom Hand #257957970362:  Hold'em No Limit (€0.01/€0.02) [ADM ID: M62BA304494E32ST] - 2025/10/01 14:57:58 CET [2025/10/01 8:57:58 ET]
Table 'Sirio' 6-max Seat #1 is the button
Seat 1: caduceus369 (€3.09 in chips) 
Seat 2: cino63 (€1.46 in chips) 
Seat 3: eudefumi (€1.44 in chips) 
Seat 4: ValenTom25 (€1.70 in chips) 
Seat 5: sipa66 (€2.70 in chips) 
Seat 6: OMGWOLFX (€5.79 in chips) 
cino63: posts small blind €0.01
eudefumi: posts big blind €0.02
*** HOLE CARDS ***
Dealt to caduceus369 [5h 3c]
ValenTom25: folds 
sipa66: folds 
OMGWOLFX: folds 
caduceus369: folds 
cino63: calls €0.01
eudefumi: checks 
*** FLOP *** [6d 9s 2s]
cino63: bets €0.08
eudefumi: calls €0.08
*** TURN *** [6d 9s 2s] [4d]
cino63: bets €0.20
eudefumi: folds 
Uncalled bet (€0.20) returned to cino63
cino63 collected €0.19 from pot
cino63: doesn't show hand 
*** SUMMARY ***
Total pot €0.20 | Rake €0.01 
Board [6d 9s 2s 4d]
Seat 1: caduceus369 (button) folded before Flop (didn't bet)
Seat 2: cino63 (small blind) collected (€0.19)
Seat 3: eudefumi (big blind) folded on the Turn
Seat 4: ValenTom25 folded before Flop (didn't bet)
Seat 5: sipa66 folded before Flop (didn't bet)
Seat 6: OMGWOLFX folded before Flop (didn't bet)



PokerStars Zoom Hand #257957971624:  Hold'em No Limit (€0.01/€0.02) [ADM ID: M62BA304494E32ST] - 2025/10/01 14:58:10 CET [2025/10/01 8:58:10 ET]
Table 'Sirio' 6-max Seat #1 is the button
Seat 1: Catania838 (€2.15 in chips) 
Seat 2: OMGWOLFX (€3.53 in chips) 
Seat 3: ValenTom25 (€1.69 in chips) 
Seat 4: THE_CLOWN_74 (€2.02 in chips) 
Seat 5: caduceus369 (€3.08 in chips) 
Seat 6: TIZZOTTO (€1.27 in chips) 
OMGWOLFX: posts small blind €0.01
ValenTom25: posts big blind €0.02
*** HOLE CARDS ***
Dealt to caduceus369 [6h Kd]
THE_CLOWN_74 has timed out
THE_CLOWN_74: folds 
caduceus369: folds 
TIZZOTTO: calls €0.02
Catania838: folds 
OMGWOLFX: raises €0.04 to €0.06
ValenTom25: folds 
TIZZOTTO: calls €0.04
*** FLOP *** [Ah 8c 3c]
OMGWOLFX: bets €0.07
TIZZOTTO: folds 
Uncalled bet (€0.07) returned to OMGWOLFX
OMGWOLFX collected €0.14 from pot
OMGWOLFX: doesn't show hand 
*** SUMMARY ***
Total pot €0.14 | Rake €0 
Board [Ah 8c 3c]
Seat 1: Catania838 (button) folded before Flop (didn't bet)
Seat 2: OMGWOLFX (small blind) collected (€0.14)
Seat 3: ValenTom25 (big blind) folded before Flop
Seat 4: THE_CLOWN_74 folded before Flop (didn't bet)
Seat 5: caduceus369 folded before Flop (didn't bet)
Seat 6: TIZZOTTO folded on the Flop



PokerStars Zoom Hand #257957972290:  Hold'em No Limit (€0.01/€0.02) [ADM ID: M62BA304494E32ST] - 2025/10/01 14:58:16 CET [2025/10/01 8:58:16 ET]
Table 'Sirio' 6-max Seat #1 is the button
Seat 1: sipa66 (€2.70 in chips) 
Seat 2: zlat11 (€1.73 in chips) 
Seat 3: gs0097 (€0.81 in chips) 
Seat 4: mrniceseed (€3.67 in chips) 
Seat 5: Catania838 (€1.41 in chips) 
Seat 6: caduceus369 (€3.08 in chips) 
zlat11: posts small blind €0.01
gs0097: posts big blind €0.02
*** HOLE CARDS ***
Dealt to caduceus369 [Ac 9c]
mrniceseed: folds 
Catania838: folds 
caduceus369: raises €0.02 to €0.04
sipa66: folds 
zlat11: raises €0.02 to €0.06
gs0097: folds 
caduceus369: calls €0.02
*** FLOP *** [7h 8c 5c]
zlat11: bets €0.09
caduceus369: raises €0.17 to €0.26
zlat11: calls €0.17
*** TURN *** [7h 8c 5c] [Kd]
zlat11: checks 
caduceus369: bets €0.24
zlat11: folds 
Uncalled bet (€0.24) returned to caduceus369
caduceus369 collected €0.63 from pot
caduceus369: doesn't show hand 
*** SUMMARY ***
Total pot €0.66 | Rake €0.03 
Board [7h 8c 5c Kd]
Seat 1: sipa66 (button) folded before Flop (didn't bet)
Seat 2: zlat11 (small blind) folded on the Turn
Seat 3: gs0097 (big blind) folded before Flop
Seat 4: mrniceseed folded before Flop (didn't bet)
Seat 5: Catania838 folded before Flop (didn't bet)
Seat 6: caduceus369 collected (€0.63)



PokerStars Zoom Hand #257957978514:  Hold'em No Limit (€0.01/€0.02) [ADM ID: M62BA304494E32ST] - 2025/10/01 14:59:15 CET [2025/10/01 8:59:15 ET]
Table 'Sirio' 6-max Seat #1 is the button
Seat 1: mattya69 (€2.77 in chips) 
Seat 2: THE_CLOWN_74 (€2.08 in chips) 
Seat 3: Hope7075 (€0.80 in chips) 
Seat 4: caduceus369 (€3.39 in chips) 
Seat 5: pylonstrip (€4.28 in chips) 
Seat 6: lucpri (€1.90 in chips) 
THE_CLOWN_74: posts small blind €0.01
Hope7075: posts big blind €0.02
*** HOLE CARDS ***
Dealt to caduceus369 [Qc Qd]
caduceus369: raises €0.02 to €0.04
pylonstrip: folds 
lucpri: folds 
mattya69: folds 
THE_CLOWN_74: folds 
Hope7075: calls €0.02
*** FLOP *** [8s 3c Kd]
Hope7075: checks 
caduceus369: bets €0.02
Hope7075: calls €0.02
*** TURN *** [8s 3c Kd] [6h]
Hope7075: checks 
caduceus369: checks 
*** RIVER *** [8s 3c Kd 6h] [7d]
Hope7075: checks 
caduceus369: bets €0.04
Hope7075: folds 
Uncalled bet (€0.04) returned to caduceus369
caduceus369 collected €0.13 from pot
caduceus369: doesn't show hand 
*** SUMMARY ***
Total pot €0.13 | Rake €0 
Board [8s 3c Kd 6h 7d]
Seat 1: mattya69 (button) folded before Flop (didn't bet)
Seat 2: THE_CLOWN_74 (small blind) folded before Flop
Seat 3: Hope7075 (big blind) folded on the River
Seat 4: caduceus369 collected (€0.13)
Seat 5: pylonstrip folded before Flop (didn't bet)
Seat 6: lucpri folded before Flop (didn't bet)



PokerStars Zoom Hand #257957982829:  Hold'em No Limit (€0.01/€0.02) [ADM ID: M62BA304494E32ST] - 2025/10/01 14:59:56 CET [2025/10/01 8:59:56 ET]
Table 'Sirio' 6-max Seat #1 is the button
Seat 1: caduceus369 (€3.46 in chips) 
Seat 2: mattya69 (€3.96 in chips) 
Seat 3: cino63 (€1.89 in chips) 
Seat 4: mrniceseed (€3.44 in chips) 
Seat 5: lavendemmia (€1.26 in chips) 
Seat 6: TIZZOTTO (€1.29 in chips) 
mattya69: posts small blind €0.01
cino63: posts big blind €0.02
*** HOLE CARDS ***
Dealt to caduceus369 [9c Ts]
mrniceseed: folds 
lavendemmia: folds 
TIZZOTTO: calls €0.02
caduceus369: folds 
mattya69: folds 
cino63: checks 
*** FLOP *** [Ks Ad Qc]
cino63: checks 
TIZZOTTO: checks 
*** TURN *** [Ks Ad Qc] [4s]
cino63: checks 
TIZZOTTO: checks 
*** RIVER *** [Ks Ad Qc 4s] [4h]
cino63: checks 
TIZZOTTO: checks 
*** SHOW DOWN ***
cino63: shows [8h 9d] (a pair of Fours)
TIZZOTTO: shows [Tc 8s] (a pair of Fours)
cino63 collected €0.03 from pot
TIZZOTTO collected €0.02 from pot
*** SUMMARY ***
Total pot €0.05 | Rake €0 
Board [Ks Ad Qc 4s 4h]
Seat 1: caduceus369 (button) folded before Flop (didn't bet)
Seat 2: mattya69 (small blind) folded before Flop
Seat 3: cino63 (big blind) showed [8h 9d] and won (€0.03) with a pair of Fours
Seat 4: mrniceseed folded before Flop (didn't bet)
Seat 5: lavendemmia folded before Flop (didn't bet)
Seat 6: TIZZOTTO showed [Tc 8s] and won (€0.02) with a pair of Fours



PokerStars Zoom Hand #257957983414:  Hold'em No Limit (€0.01/€0.02) [ADM ID: M62BA304494E32ST] - 2025/10/01 15:00:01 CET [2025/10/01 9:00:01 ET]
Table 'Sirio' 6-max Seat #1 is the button
Seat 1: mattya69 (€3.95 in chips) 
Seat 2: francovirde (€2.05 in chips) 
Seat 3: caduceus369 (€3.46 in chips) 
Seat 4: OMGWOLFX (€3.67 in chips) 
Seat 5: Catania838 (€2.10 in chips) 
Seat 6: mrniceseed (€3.44 in chips) 
francovirde: posts small blind €0.01
caduceus369: posts big blind €0.02
*** HOLE CARDS ***
Dealt to caduceus369 [9h 9c]
OMGWOLFX: folds 
Catania838: folds 
mrniceseed: folds 
mattya69: folds 
francovirde: raises €0.02 to €0.04
caduceus369: raises €0.08 to €0.12
francovirde: calls €0.08
*** FLOP *** [4s 3s Kd]
francovirde: checks 
caduceus369: bets €0.06
francovirde: calls €0.06
*** TURN *** [4s 3s Kd] [9d]
francovirde: checks 
caduceus369: bets €0.02
francovirde: raises €0.39 to €0.41
caduceus369: raises €0.39 to €0.80
francovirde: folds 
Uncalled bet (€0.39) returned to caduceus369
caduceus369 collected €1.12 from pot
caduceus369: doesn't show hand 
*** SUMMARY ***
Total pot €1.18 | Rake €0.06 
Board [4s 3s Kd 9d]
Seat 1: mattya69 (button) folded before Flop (didn't bet)
Seat 2: francovirde (small blind) folded on the Turn
Seat 3: caduceus369 (big blind) collected (€1.12)
Seat 4: OMGWOLFX folded before Flop (didn't bet)
Seat 5: Catania838 folded before Flop (didn't bet)
Seat 6: mrniceseed folded before Flop (didn't bet)



PokerStars Zoom Hand #257957989625:  Hold'em No Limit (€0.01/€0.02) [ADM ID: M62BA304494E32ST] - 2025/10/01 15:00:57 CET [2025/10/01 9:00:57 ET]
Table 'Sirio' 6-max Seat #1 is the button
Seat 1: francovirde (€1.46 in chips) 
Seat 2: vikisdad99 (€1.92 in chips) 
Seat 3: THE_CLOWN_74 (€2.04 in chips) 
Seat 4: Catania838 (€1.84 in chips) 
Seat 5: caduceus369 (€3.99 in chips) 
Seat 6: OMGWOLFX (€3.64 in chips) 
vikisdad99: posts small blind €0.01
THE_CLOWN_74: posts big blind €0.02
*** HOLE CARDS ***
Dealt to caduceus369 [6d 5c]
Catania838: calls €0.02
caduceus369: folds 
OMGWOLFX: folds 
francovirde: raises €1.44 to €1.46 and is all-in
vikisdad99: folds 
THE_CLOWN_74: folds 
Catania838: folds 
Uncalled bet (€1.44) returned to francovirde
francovirde collected €0.07 from pot
francovirde: doesn't show hand 
*** SUMMARY ***
Total pot €0.07 | Rake €0 
Seat 1: francovirde (button) collected (€0.07)
Seat 2: vikisdad99 (small blind) folded before Flop
Seat 3: THE_CLOWN_74 (big blind) folded before Flop
Seat 4: Catania838 folded before Flop
Seat 5: caduceus369 folded before Flop (didn't bet)
Seat 6: OMGWOLFX folded before Flop (didn't bet)



PokerStars Zoom Hand #257957990483:  Hold'em No Limit (€0.01/€0.02) [ADM ID: M62BA304494E32ST] - 2025/10/01 15:01:04 CET [2025/10/01 9:01:04 ET]
Table 'Sirio' 6-max Seat #1 is the button
Seat 1: vikisdad99 (€1.91 in chips) 
Seat 2: caduceus369 (€3.99 in chips) 
Seat 3: cino63 (€1.89 in chips) 
Seat 4: ValenTom25 (€1.81 in chips) 
Seat 5: pylonstrip (€4.45 in chips) 
Seat 6: ghosto69 (€1.97 in chips) 
caduceus369: posts small blind €0.01
cino63: posts big blind €0.02
*** HOLE CARDS ***
Dealt to caduceus369 [Jc 2h]
ValenTom25: calls €0.02
pylonstrip: folds 
ghosto69: raises €0.04 to €0.06
vikisdad99: folds 
caduceus369: folds 
cino63: calls €0.04
ValenTom25: calls €0.04
*** FLOP *** [6c 2c 2s]
cino63: checks 
ValenTom25: checks 
ghosto69: checks 
*** TURN *** [6c 2c 2s] [5s]
cino63: checks 
ValenTom25: bets €0.09
ghosto69: folds 
cino63: folds 
Uncalled bet (€0.09) returned to ValenTom25
ValenTom25 collected €0.18 from pot
ValenTom25: doesn't show hand 
*** SUMMARY ***
Total pot €0.19 | Rake €0.01 
Board [6c 2c 2s 5s]
Seat 1: vikisdad99 (button) folded before Flop (didn't bet)
Seat 2: caduceus369 (small blind) folded before Flop
Seat 3: cino63 (big blind) folded on the Turn
Seat 4: ValenTom25 collected (€0.18)
Seat 5: pylonstrip folded before Flop (didn't bet)
Seat 6: ghosto69 folded on the Turn



PokerStars Zoom Hand #257957995780:  Hold'em No Limit (€0.01/€0.02) [ADM ID: M62BA304494E32ST] - 2025/10/01 15:01:47 CET [2025/10/01 9:01:47 ET]
Table 'Sirio' 6-max Seat #1 is the button
Seat 1: caduceus369 (€3.96 in chips) 
Seat 2: Catania838 (€1.72 in chips) 
Seat 3: TOROLAI (€1.82 in chips) 
Seat 4: Emm3B1 (€2.95 in chips) 
Seat 5: ghosto69 (€1.91 in chips) 
Seat 6: OMGWOLFX (€5.65 in chips) 
Catania838: posts small blind €0.01
TOROLAI: posts big blind €0.02
*** HOLE CARDS ***
Dealt to caduceus369 [6d 2d]
Emm3B1: folds 
ghosto69: folds 
OMGWOLFX: folds 
caduceus369: folds 
Catania838: folds 
Uncalled bet (€0.01) returned to TOROLAI
TOROLAI collected €0.02 from pot
TOROLAI: doesn't show hand 
*** SUMMARY ***
Total pot €0.02 | Rake €0 
Seat 1: caduceus369 (button) folded before Flop (didn't bet)
Seat 2: Catania838 (small blind) folded before Flop
Seat 3: TOROLAI (big blind) collected (€0.02)
Seat 4: Emm3B1 folded before Flop (didn't bet)
Seat 5: ghosto69 folded before Flop (didn't bet)
Seat 6: OMGWOLFX folded before Flop (didn't bet)



PokerStars Zoom Hand #257957991734:  Hold'em No Limit (€0.01/€0.02) [ADM ID: M62BA304494E32ST] - 2025/10/01 15:01:14 CET [2025/10/01 9:01:14 ET]
Table 'Sirio' 6-max Seat #1 is the button
Seat 1: TazCrack (€0.87 in chips) 
Seat 2: Catania838 (€1.38 in chips) 
Seat 3: TONNOeRUCOLA (€2 in chips) 
Seat 4: vikisdad99 (€1.91 in chips) 
Seat 5: TOROLAI (€1.83 in chips) 
Seat 6: caduceus369 (€3.98 in chips) 
Catania838: posts small blind €0.01
TONNOeRUCOLA: posts big blind €0.02
*** HOLE CARDS ***
Dealt to caduceus369 [5c Qs]
vikisdad99: folds 
TOROLAI: folds 
caduceus369: folds 
TazCrack: calls €0.02
Catania838: folds 
TONNOeRUCOLA: checks 
*** FLOP *** [Td 8h Qh]
TONNOeRUCOLA: checks 
TazCrack: checks 
*** TURN *** [Td 8h Qh] [6s]
TONNOeRUCOLA: checks 
TazCrack: checks 
*** RIVER *** [Td 8h Qh 6s] [9d]
TONNOeRUCOLA: bets €0.05
TazCrack: folds 
Uncalled bet (€0.05) returned to TONNOeRUCOLA
TONNOeRUCOLA collected €0.05 from pot
TONNOeRUCOLA: doesn't show hand 
*** SUMMARY ***
Total pot €0.05 | Rake €0 
Board [Td 8h Qh 6s 9d]
Seat 1: TazCrack (button) folded on the River
Seat 2: Catania838 (small blind) folded before Flop
Seat 3: TONNOeRUCOLA (big blind) collected (€0.05)
Seat 4: vikisdad99 folded before Flop (didn't bet)
Seat 5: TOROLAI folded before Flop (didn't bet)
Seat 6: caduceus369 folded before Flop (didn't bet)



PokerStars Zoom Hand #257957992509:  Hold'em No Limit (€0.01/€0.02) [ADM ID: M62BA304494E32ST] - 2025/10/01 15:01:21 CET [2025/10/01 9:01:21 ET]
Table 'Sirio' 6-max Seat #1 is the button
Seat 1: TIZZOTTO (€1.24 in chips) 
Seat 2: Catania838 (€1.46 in chips) 
Seat 3: francovirde (€1.51 in chips) 
Seat 4: caduceus369 (€3.98 in chips) 
Seat 5: Hope7075 (€0.99 in chips) 
Seat 6: ghosto69 (€2.51 in chips) 
Catania838: posts small blind €0.01
francovirde: posts big blind €0.02
*** HOLE CARDS ***
Dealt to caduceus369 [4s As]
caduceus369: folds 
Hope7075: raises €0.04 to €0.06
ghosto69: calls €0.06
TIZZOTTO: folds 
Catania838: folds 
francovirde: calls €0.04
*** FLOP *** [Ad 4d Jh]
francovirde: checks 
Hope7075: checks 
ghosto69: checks 
*** TURN *** [Ad 4d Jh] [5s]
francovirde: checks 
Hope7075: checks 
ghosto69: checks 
*** RIVER *** [Ad 4d Jh 5s] [9h]
francovirde: bets €0.18
Hope7075: folds 
ghosto69: folds 
Uncalled bet (€0.18) returned to francovirde
francovirde collected €0.18 from pot
francovirde: doesn't show hand 
*** SUMMARY ***
Total pot €0.19 | Rake €0.01 
Board [Ad 4d Jh 5s 9h]
Seat 1: TIZZOTTO (button) folded before Flop (didn't bet)
Seat 2: Catania838 (small blind) folded before Flop
Seat 3: francovirde (big blind) collected (€0.18)
Seat 4: caduceus369 folded before Flop (didn't bet)
Seat 5: Hope7075 folded on the River
Seat 6: ghosto69 folded on the River



PokerStars Zoom Hand #257957994012:  Hold'em No Limit (€0.01/€0.02) [ADM ID: M62BA304494E32ST] - 2025/10/01 15:01:33 CET [2025/10/01 9:01:33 ET]
Table 'Sirio' 6-max Seat #1 is the button
Seat 1: Catania838 (€1.37 in chips) 
Seat 2: Semifonte (€1.89 in chips) 
Seat 3: caduceus369 (€3.98 in chips) 
Seat 4: lampo201 (€3.17 in chips) 
Seat 5: gs0097 (€0.69 in chips) 
Seat 6: OMGWOLFX (€4.55 in chips) 
Semifonte: posts small blind €0.01
caduceus369: posts big blind €0.02
*** HOLE CARDS ***
Dealt to caduceus369 [3s 6h]
lampo201: raises €0.02 to €0.04
gs0097: folds 
OMGWOLFX: calls €0.04
Catania838: calls €0.04
Semifonte: folds 
caduceus369: folds 
*** FLOP *** [Kd 2c As]
lampo201: checks 
OMGWOLFX: bets €0.04
Catania838: folds 
lampo201: calls €0.04
*** TURN *** [Kd 2c As] [8s]
lampo201: checks 
OMGWOLFX: checks 
*** RIVER *** [Kd 2c As 8s] [Qd]
lampo201: bets €0.02
OMGWOLFX: folds 
Uncalled bet (€0.02) returned to lampo201
lampo201 collected €0.22 from pot
lampo201: doesn't show hand 
*** SUMMARY ***
Total pot €0.23 | Rake €0.01 
Board [Kd 2c As 8s Qd]
Seat 1: Catania838 (button) folded on the Flop
Seat 2: Semifonte (small blind) folded before Flop
Seat 3: caduceus369 (big blind) folded before Flop
Seat 4: lampo201 collected (€0.22)
Seat 5: gs0097 folded before Flop (didn't bet)
Seat 6: OMGWOLFX folded on the River



PokerStars Zoom Hand #257957993264:  Hold'em No Limit (€0.01/€0.02) [ADM ID: M62BA304494E32ST] - 2025/10/01 15:01:27 CET [2025/10/01 9:01:27 ET]
Table 'Sirio' 6-max Seat #1 is the button
Seat 1: gs0097 (€0.69 in chips) 
Seat 2: THE_CLOWN_74 (€2 in chips) 
Seat 3: MathMassacreX (€3.44 in chips) 
Seat 4: Catania838 (€1.45 in chips) 
Seat 5: caduceus369 (€3.98 in chips) 
Seat 6: lampo201 (€3.17 in chips) 
THE_CLOWN_74: posts small blind €0.01
MathMassacreX: posts big blind €0.02
*** HOLE CARDS ***
Dealt to caduceus369 [2s 3s]
Catania838: folds 
caduceus369: folds 
lampo201: folds 
gs0097: folds 
THE_CLOWN_74: raises €0.03 to €0.05
MathMassacreX: calls €0.03
*** FLOP *** [2c 8c 3d]
THE_CLOWN_74: checks 
MathMassacreX: checks 
*** TURN *** [2c 8c 3d] [Qd]
THE_CLOWN_74: bets €0.08
MathMassacreX: calls €0.08
*** RIVER *** [2c 8c 3d Qd] [7c]
THE_CLOWN_74: bets €0.13
MathMassacreX: folds 
Uncalled bet (€0.13) returned to THE_CLOWN_74
THE_CLOWN_74 collected €0.25 from pot
THE_CLOWN_74: doesn't show hand 
*** SUMMARY ***
Total pot €0.26 | Rake €0.01 
Board [2c 8c 3d Qd 7c]
Seat 1: gs0097 (button) folded before Flop (didn't bet)
Seat 2: THE_CLOWN_74 (small blind) collected (€0.25)
Seat 3: MathMassacreX (big blind) folded on the River
Seat 4: Catania838 folded before Flop (didn't bet)
Seat 5: caduceus369 folded before Flop (didn't bet)
Seat 6: lampo201 folded before Flop (didn't bet)



PokerStars Zoom Hand #257957997306:  Hold'em No Limit (€0.01/€0.02) [ADM ID: M62BA304494E32ST] - 2025/10/01 15:01:59 CET [2025/10/01 9:01:59 ET]
Table 'Sirio' 6-max Seat #1 is the button
Seat 1: cagliari59 (€2.23 in chips) 
Seat 2: caduceus369 (€3.96 in chips) 
Seat 3: OMGWOLFX (€6.28 in chips) 
Seat 4: pylonstrip (€4.45 in chips) 
Seat 5: lucpri (€2.15 in chips) 
Seat 6: Catania838 (€1.71 in chips) 
caduceus369: posts small blind €0.01
OMGWOLFX: posts big blind €0.02
*** HOLE CARDS ***
Dealt to caduceus369 [Qd Jc]
pylonstrip: folds 
lucpri: folds 
Catania838: folds 
cagliari59: raises €0.02 to €0.04
caduceus369: folds 
OMGWOLFX: folds 
Uncalled bet (€0.02) returned to cagliari59
cagliari59 collected €0.05 from pot
cagliari59: doesn't show hand 
*** SUMMARY ***
Total pot €0.05 | Rake €0 
Seat 1: cagliari59 (button) collected (€0.05)
Seat 2: caduceus369 (small blind) folded before Flop
Seat 3: OMGWOLFX (big blind) folded before Flop
Seat 4: pylonstrip folded before Flop (didn't bet)
Seat 5: lucpri folded before Flop (didn't bet)
Seat 6: Catania838 folded before Flop (didn't bet)



PokerStars Zoom Hand #257957999912:  Hold'em No Limit (€0.01/€0.02) [ADM ID: M62BA304494E32ST] - 2025/10/01 15:02:20 CET [2025/10/01 9:02:20 ET]
Table 'Sirio' 6-max Seat #1 is the button
Seat 1: Catania838 (€1.36 in chips) 
Seat 2: TazCrack (€0.83 in chips) 
Seat 3: THE_CLOWN_74 (€2.62 in chips) 
Seat 4: ghosto69 (€2.45 in chips) 
Seat 5: francovirde (€1.63 in chips) 
Seat 6: caduceus369 (€3.95 in chips) 
TazCrack: posts small blind €0.01
THE_CLOWN_74: posts big blind €0.02
*** HOLE CARDS ***
Dealt to caduceus369 [Ad 5d]
ghosto69: folds 
francovirde: folds 
caduceus369: raises €0.02 to €0.04
Catania838: calls €0.04
TazCrack: folds 
THE_CLOWN_74: folds 
*** FLOP *** [6c 3h 4s]
caduceus369: checks 
Catania838: bets €0.11
caduceus369: calls €0.11
*** TURN *** [6c 3h 4s] [Jd]
caduceus369: checks 
Catania838: bets €0.16
caduceus369: folds 
Uncalled bet (€0.16) returned to Catania838
Catania838 collected €0.32 from pot
Catania838: doesn't show hand 
*** SUMMARY ***
Total pot €0.33 | Rake €0.01 
Board [6c 3h 4s Jd]
Seat 1: Catania838 (button) collected (€0.32)
Seat 2: TazCrack (small blind) folded before Flop
Seat 3: THE_CLOWN_74 (big blind) folded before Flop
Seat 4: ghosto69 folded before Flop (didn't bet)
Seat 5: francovirde folded before Flop (didn't bet)
Seat 6: caduceus369 folded on the Turn



PokerStars Zoom Hand #257958007206:  Hold'em No Limit (€0.01/€0.02) [ADM ID: M62BA304494E32ST] - 2025/10/01 15:03:18 CET [2025/10/01 9:03:18 ET]
Table 'Sirio' 6-max Seat #1 is the button
Seat 1: cagliari59 (€2.23 in chips) 
Seat 2: THE_CLOWN_74 (€2.58 in chips) 
Seat 3: lucpri (€2.13 in chips) 
Seat 4: cino63 (€1.94 in chips) 
Seat 5: caduceus369 (€3.80 in chips) 
Seat 6: ghosto69 (€2.45 in chips) 
THE_CLOWN_74: posts small blind €0.01
lucpri: posts big blind €0.02
*** HOLE CARDS ***
Dealt to caduceus369 [3c 7s]
cino63: folds 
caduceus369: folds 
ghosto69: folds 
cagliari59: folds 
THE_CLOWN_74: raises €0.04 to €0.06
lucpri: calls €0.04
*** FLOP *** [4d 6d 4h]
THE_CLOWN_74: bets €0.09
lucpri: calls €0.09
*** TURN *** [4d 6d 4h] [Ad]
THE_CLOWN_74: bets €0.15
lucpri: calls €0.15
*** RIVER *** [4d 6d 4h Ad] [4c]
THE_CLOWN_74: bets €0.29
lucpri: calls €0.29
*** SHOW DOWN ***
THE_CLOWN_74: shows [Td Th] (a full house, Fours full of Tens)
lucpri: shows [Jd Ah] (a full house, Fours full of Aces)
lucpri collected €1.12 from pot
*** SUMMARY ***
Total pot €1.18 | Rake €0.06 
Board [4d 6d 4h Ad 4c]
Seat 1: cagliari59 (button) folded before Flop (didn't bet)
Seat 2: THE_CLOWN_74 (small blind) showed [Td Th] and lost with a full house, Fours full of Tens
Seat 3: lucpri (big blind) showed [Jd Ah] and won (€1.12) with a full house, Fours full of Aces
Seat 4: cino63 folded before Flop (didn't bet)
Seat 5: caduceus369 folded before Flop (didn't bet)
Seat 6: ghosto69 folded before Flop (didn't bet)



PokerStars Zoom Hand #257958007990:  Hold'em No Limit (€0.01/€0.02) [ADM ID: M62BA304494E32ST] - 2025/10/01 15:03:24 CET [2025/10/01 9:03:24 ET]
Table 'Sirio' 6-max Seat #1 is the button
Seat 1: ghosto69 (€2.51 in chips) 
Seat 2: Fiocco231 (€1.53 in chips) 
Seat 3: cino63 (€1.94 in chips) 
Seat 4: caduceus369 (€3.80 in chips) 
Seat 5: TONNOeRUCOLA (€2 in chips) 
Seat 6: cagliari59 (€2.23 in chips) 
Fiocco231: posts small blind €0.01
cino63: posts big blind €0.02
*** HOLE CARDS ***
Dealt to caduceus369 [3h 7s]
caduceus369: folds 
TONNOeRUCOLA: folds 
cagliari59: raises €0.02 to €0.04
ghosto69: folds 
Fiocco231: calls €0.03
cino63: calls €0.02
*** FLOP *** [7d 2c 7h]
Fiocco231: checks 
cino63: checks 
cagliari59: checks 
*** TURN *** [7d 2c 7h] [6h]
Fiocco231: bets €0.02
cino63: calls €0.02
cagliari59: calls €0.02
*** RIVER *** [7d 2c 7h 6h] [Qs]
Fiocco231: bets €0.10
cino63: folds 
cagliari59: folds 
Uncalled bet (€0.10) returned to Fiocco231
Fiocco231 collected €0.18 from pot
Fiocco231: doesn't show hand 
*** SUMMARY ***
Total pot €0.18 | Rake €0 
Board [7d 2c 7h 6h Qs]
Seat 1: ghosto69 (button) folded before Flop (didn't bet)
Seat 2: Fiocco231 (small blind) collected (€0.18)
Seat 3: cino63 (big blind) folded on the River
Seat 4: caduceus369 folded before Flop (didn't bet)
Seat 5: TONNOeRUCOLA folded before Flop (didn't bet)
Seat 6: cagliari59 folded on the River



PokerStars Zoom Hand #257958012000:  Hold'em No Limit (€0.01/€0.02) [ADM ID: M62BA304494E32ST] - 2025/10/01 15:03:56 CET [2025/10/01 9:03:56 ET]
Table 'Sirio' 6-max Seat #1 is the button
Seat 1: ghosto69 (€2.45 in chips) 
Seat 2: pylonstrip (€4.79 in chips) 
Seat 3: OMGWOLFX (€4.41 in chips) 
Seat 4: francovirde (€1.70 in chips) 
Seat 5: caduceus369 (€3.78 in chips) 
Seat 6: vikisdad99 (€2 in chips) 
pylonstrip: posts small blind €0.01
OMGWOLFX: posts big blind €0.02
*** HOLE CARDS ***
Dealt to caduceus369 [Qs 8d]
francovirde: folds 
caduceus369: folds 
vikisdad99: folds 
ghosto69: folds 
pylonstrip: folds 
Uncalled bet (€0.01) returned to OMGWOLFX
OMGWOLFX collected €0.02 from pot
OMGWOLFX: doesn't show hand 
*** SUMMARY ***
Total pot €0.02 | Rake €0 
Seat 1: ghosto69 (button) folded before Flop (didn't bet)
Seat 2: pylonstrip (small blind) folded before Flop
Seat 3: OMGWOLFX (big blind) collected (€0.02)
Seat 4: francovirde folded before Flop (didn't bet)
Seat 5: caduceus369 folded before Flop (didn't bet)
Seat 6: vikisdad99 folded before Flop (didn't bet)



PokerStars Zoom Hand #257958008935:  Hold'em No Limit (€0.01/€0.02) [ADM ID: M62BA304494E32ST] - 2025/10/01 15:03:32 CET [2025/10/01 9:03:32 ET]
Table 'Sirio' 6-max Seat #1 is the button
Seat 1: vikisdad99 (€0.73 in chips) 
Seat 2: Emm3B1 (€2.90 in chips) 
Seat 3: caduceus369 (€3.80 in chips) 
Seat 4: OMGWOLFX (€5.80 in chips) 
Seat 5: MathMassacreX (€4.60 in chips) 
Seat 6: colosso2022 (€1.82 in chips) 
Emm3B1: posts small blind €0.01
caduceus369: posts big blind €0.02
*** HOLE CARDS ***
Dealt to caduceus369 [9d 2c]
OMGWOLFX: raises €0.02 to €0.04
MathMassacreX: folds 
colosso2022: calls €0.04
vikisdad99: folds 
Emm3B1: folds 
caduceus369: folds 
*** FLOP *** [9c Tc 4d]
OMGWOLFX: bets €0.06
colosso2022: raises €0.23 to €0.29
OMGWOLFX: calls €0.23
*** TURN *** [9c Tc 4d] [6d]
OMGWOLFX: checks 
colosso2022: bets €0.08
OMGWOLFX: calls €0.08
*** RIVER *** [9c Tc 4d 6d] [Jh]
OMGWOLFX: checks 
colosso2022: checks 
*** SHOW DOWN ***
OMGWOLFX: shows [8c 6c] (a pair of Sixes)
colosso2022: shows [Ts Qh] (a pair of Tens)
colosso2022 collected €0.81 from pot
*** SUMMARY ***
Total pot €0.85 | Rake €0.04 
Board [9c Tc 4d 6d Jh]
Seat 1: vikisdad99 (button) folded before Flop (didn't bet)
Seat 2: Emm3B1 (small blind) folded before Flop
Seat 3: caduceus369 (big blind) folded before Flop
Seat 4: OMGWOLFX showed [8c 6c] and lost with a pair of Sixes
Seat 5: MathMassacreX folded before Flop (didn't bet)
Seat 6: colosso2022 showed [Ts Qh] and won (€0.81) with a pair of Tens



PokerStars Zoom Hand #257958012772:  Hold'em No Limit (€0.01/€0.02) [ADM ID: M62BA304494E32ST] - 2025/10/01 15:04:02 CET [2025/10/01 9:04:02 ET]
Table 'Sirio' 6-max Seat #1 is the button
Seat 1: OMGWOLFX (€5.93 in chips) 
Seat 2: caduceus369 (€3.78 in chips) 
Seat 3: vikisdad99 (€2 in chips) 
Seat 4: francovirde (€1.70 in chips) 
Seat 5: Catania838 (€1.37 in chips) 
Seat 6: cino63 (€1.88 in chips) 
caduceus369: posts small blind €0.01
vikisdad99: posts big blind €0.02
*** HOLE CARDS ***
Dealt to caduceus369 [6s 3s]
francovirde: folds 
Catania838: folds 
cino63: folds 
OMGWOLFX: raises €0.04 to €0.06
caduceus369: folds 
vikisdad99: folds 
Uncalled bet (€0.04) returned to OMGWOLFX
OMGWOLFX collected €0.05 from pot
OMGWOLFX: doesn't show hand 
*** SUMMARY ***
Total pot €0.05 | Rake €0 
Seat 1: OMGWOLFX (button) collected (€0.05)
Seat 2: caduceus369 (small blind) folded before Flop
Seat 3: vikisdad99 (big blind) folded before Flop
Seat 4: francovirde folded before Flop (didn't bet)
Seat 5: Catania838 folded before Flop (didn't bet)
Seat 6: cino63 folded before Flop (didn't bet)



PokerStars Zoom Hand #257958010473:  Hold'em No Limit (€0.01/€0.02) [ADM ID: M62BA304494E32ST] - 2025/10/01 15:03:44 CET [2025/10/01 9:03:44 ET]
Table 'Sirio' 6-max Seat #1 is the button
Seat 1: caduceus369 (€3.78 in chips) 
Seat 2: Semifonte (€1.81 in chips) 
Seat 3: francovirde (€1.72 in chips) 
Seat 4: TONNOeRUCOLA (€2 in chips) 
Seat 5: Emm3B1 (€2.89 in chips) 
Seat 6: THE_CLOWN_74 (€2.09 in chips) 
Semifonte: posts small blind €0.01
francovirde: posts big blind €0.02
*** HOLE CARDS ***
Dealt to caduceus369 [7d As]
TONNOeRUCOLA: folds 
Emm3B1: folds 
THE_CLOWN_74: raises €0.03 to €0.05
caduceus369: folds 
Semifonte: calls €0.04
francovirde: folds 
*** FLOP *** [5c 9d Jd]
Semifonte: checks 
THE_CLOWN_74: checks 
*** TURN *** [5c 9d Jd] [Jh]
Semifonte: checks 
THE_CLOWN_74: bets €0.08
Semifonte: folds 
Uncalled bet (€0.08) returned to THE_CLOWN_74
THE_CLOWN_74 collected €0.12 from pot
THE_CLOWN_74: doesn't show hand 
*** SUMMARY ***
Total pot €0.12 | Rake €0 
Board [5c 9d Jd Jh]
Seat 1: caduceus369 (button) folded before Flop (didn't bet)
Seat 2: Semifonte (small blind) folded on the Turn
Seat 3: francovirde (big blind) folded before Flop
Seat 4: TONNOeRUCOLA folded before Flop (didn't bet)
Seat 5: Emm3B1 folded before Flop (didn't bet)
Seat 6: THE_CLOWN_74 collected (€0.12)



PokerStars Zoom Hand #257958014523:  Hold'em No Limit (€0.01/€0.02) [ADM ID: M62BA304494E32ST] - 2025/10/01 15:04:16 CET [2025/10/01 9:04:16 ET]
Table 'Sirio' 6-max Seat #1 is the button
Seat 1: THE_CLOWN_74 (€2.10 in chips) 
Seat 2: OMGWOLFX (€4.42 in chips) 
Seat 3: caduceus369 (€3.77 in chips) 
Seat 4: Catania838 (€1.50 in chips) 
Seat 5: pylonstrip (€4.76 in chips) 
Seat 6: lucpri (€2.65 in chips) 
OMGWOLFX: posts small blind €0.01
caduceus369: posts big blind €0.02
*** HOLE CARDS ***
Dealt to caduceus369 [Tc 9d]
Catania838: folds 
pylonstrip: folds 
lucpri: folds 
THE_CLOWN_74: folds 
OMGWOLFX: raises €0.04 to €0.06
caduceus369: folds 
Uncalled bet (€0.04) returned to OMGWOLFX
OMGWOLFX collected €0.04 from pot
OMGWOLFX: doesn't show hand 
*** SUMMARY ***
Total pot €0.04 | Rake €0 
Seat 1: THE_CLOWN_74 (button) folded before Flop (didn't bet)
Seat 2: OMGWOLFX (small blind) collected (€0.04)
Seat 3: caduceus369 (big blind) folded before Flop
Seat 4: Catania838 folded before Flop (didn't bet)
Seat 5: pylonstrip folded before Flop (didn't bet)
Seat 6: lucpri folded before Flop (didn't bet)



PokerStars Zoom Hand #257958013225:  Hold'em No Limit (€0.01/€0.02) [ADM ID: M62BA304494E32ST] - 2025/10/01 15:04:06 CET [2025/10/01 9:04:06 ET]
Table 'Sirio' 6-max Seat #1 is the button
Seat 1: cino63 (€1.88 in chips) 
Seat 2: THE_CLOWN_74 (€2.11 in chips) 
Seat 3: MathMassacreX (€4.59 in chips) 
Seat 4: francovirde (€1.70 in chips) 
Seat 5: ghosto69 (€1.53 in chips) 
Seat 6: caduceus369 (€3.77 in chips) 
THE_CLOWN_74: posts small blind €0.01
MathMassacreX: posts big blind €0.02
*** HOLE CARDS ***
Dealt to caduceus369 [2h 4s]
francovirde: folds 
ghosto69: folds 
caduceus369: folds 
cino63: calls €0.02
THE_CLOWN_74: folds 
MathMassacreX: checks 
*** FLOP *** [Th 2c Js]
MathMassacreX: checks 
cino63: checks 
*** TURN *** [Th 2c Js] [2s]
MathMassacreX: checks 
cino63: checks 
*** RIVER *** [Th 2c Js 2s] [Ad]
MathMassacreX: checks 
cino63: bets €0.05
MathMassacreX: folds 
Uncalled bet (€0.05) returned to cino63
cino63 collected €0.05 from pot
cino63: doesn't show hand 
*** SUMMARY ***
Total pot €0.05 | Rake €0 
Board [Th 2c Js 2s Ad]
Seat 1: cino63 (button) collected (€0.05)
Seat 2: THE_CLOWN_74 (small blind) folded before Flop
Seat 3: MathMassacreX (big blind) folded on the River
Seat 4: francovirde folded before Flop (didn't bet)
Seat 5: ghosto69 folded before Flop (didn't bet)
Seat 6: caduceus369 folded before Flop (didn't bet)



PokerStars Zoom Hand #257958016542:  Hold'em No Limit (€0.01/€0.02) [ADM ID: M62BA304494E32ST] - 2025/10/01 15:04:32 CET [2025/10/01 9:04:32 ET]
Table 'Sirio' 6-max Seat #1 is the button
Seat 1: lucpri (€2.65 in chips) 
Seat 2: caduceus369 (€3.75 in chips) 
Seat 3: ghosto69 (€2.50 in chips) 
Seat 4: vikisdad99 (€1.97 in chips) 
Seat 5: THE_CLOWN_74 (€2.10 in chips) 
Seat 6: pylonstrip (€4.75 in chips) 
caduceus369: posts small blind €0.01
ghosto69: posts big blind €0.02
*** HOLE CARDS ***
Dealt to caduceus369 [9c 4h]
vikisdad99: calls €0.02
THE_CLOWN_74: folds 
pylonstrip: folds 
lucpri: folds 
caduceus369: folds 
ghosto69: raises €0.04 to €0.06
vikisdad99: calls €0.04
*** FLOP *** [Kc 7d 8d]
ghosto69: checks 
vikisdad99: bets €0.07
ghosto69: calls €0.07
*** TURN *** [Kc 7d 8d] [Ts]
ghosto69: checks 
vikisdad99: bets €0.13
ghosto69: folds 
Uncalled bet (€0.13) returned to vikisdad99
vikisdad99 collected €0.26 from pot
vikisdad99: doesn't show hand 
*** SUMMARY ***
Total pot €0.27 | Rake €0.01 
Board [Kc 7d 8d Ts]
Seat 1: lucpri (button) folded before Flop (didn't bet)
Seat 2: caduceus369 (small blind) folded before Flop
Seat 3: ghosto69 (big blind) folded on the Turn
Seat 4: vikisdad99 collected (€0.26)
Seat 5: THE_CLOWN_74 folded before Flop (didn't bet)
Seat 6: pylonstrip folded before Flop (didn't bet)



PokerStars Zoom Hand #257958018288:  Hold'em No Limit (€0.01/€0.02) [ADM ID: M62BA304494E32ST] - 2025/10/01 15:04:46 CET [2025/10/01 9:04:46 ET]
Table 'Sirio' 6-max Seat #1 is the button
Seat 1: caduceus369 (€3.74 in chips) 
Seat 2: Emm3B1 (€3.48 in chips) 
Seat 3: OMGWOLFX (€5.39 in chips) 
Seat 4: gs0097 (€0.52 in chips) 
Seat 5: THE_CLOWN_74 (€2 in chips) 
Seat 6: Semifonte (€1.76 in chips) 
Emm3B1: posts small blind €0.01
OMGWOLFX: posts big blind €0.02
*** HOLE CARDS ***
Dealt to caduceus369 [Qc Jc]
gs0097: raises €0.04 to €0.06
THE_CLOWN_74: folds 
Semifonte: folds 
caduceus369: calls €0.06
Emm3B1: calls €0.05
OMGWOLFX: calls €0.04
*** FLOP *** [5s 6d 2s]
Emm3B1: checks 
OMGWOLFX: checks 
gs0097: checks 
caduceus369: checks 
*** TURN *** [5s 6d 2s] [4h]
Emm3B1: checks 
OMGWOLFX: bets €0.12
gs0097: folds 
caduceus369: folds 
Emm3B1: calls €0.12
*** RIVER *** [5s 6d 2s 4h] [7h]
Emm3B1: checks 
OMGWOLFX: checks 
*** SHOW DOWN ***
Emm3B1: shows [Ts 7s] (a pair of Sevens)
OMGWOLFX: mucks hand 
Emm3B1 collected €0.46 from pot
*** SUMMARY ***
Total pot €0.48 | Rake €0.02 
Board [5s 6d 2s 4h 7h]
Seat 1: caduceus369 (button) folded on the Turn
Seat 2: Emm3B1 (small blind) showed [Ts 7s] and won (€0.46) with a pair of Sevens
Seat 3: OMGWOLFX (big blind) mucked [Ah 5c]
Seat 4: gs0097 folded on the Turn
Seat 5: THE_CLOWN_74 folded before Flop (didn't bet)
Seat 6: Semifonte folded before Flop (didn't bet)



PokerStars Zoom Hand #257958025700:  Hold'em No Limit (€0.01/€0.02) [ADM ID: M62BA304494E32ST] - 2025/10/01 15:05:43 CET [2025/10/01 9:05:43 ET]
Table 'Sirio' 6-max Seat #1 is the button
Seat 1: gs0097 (€0.44 in chips) 
Seat 2: Semifonte (€2 in chips) 
Seat 3: THE_CLOWN_74 (€3.21 in chips) 
Seat 4: Catania838 (€1.36 in chips) 
Seat 5: caduceus369 (€3.68 in chips) 
Seat 6: OMGWOLFX (€5.94 in chips) 
Semifonte: posts small blind €0.01
THE_CLOWN_74: posts big blind €0.02
*** HOLE CARDS ***
Dealt to caduceus369 [Kh 4s]
Catania838: folds 
caduceus369: folds 
OMGWOLFX: raises €0.04 to €0.06
gs0097: folds 
Semifonte: calls €0.05
THE_CLOWN_74: folds 
*** FLOP *** [4c Kd 6d]
Semifonte: checks 
OMGWOLFX: bets €0.07
Semifonte: folds 
Uncalled bet (€0.07) returned to OMGWOLFX
OMGWOLFX collected €0.14 from pot
OMGWOLFX: doesn't show hand 
*** SUMMARY ***
Total pot €0.14 | Rake €0 
Board [4c Kd 6d]
Seat 1: gs0097 (button) folded before Flop (didn't bet)
Seat 2: Semifonte (small blind) folded on the Flop
Seat 3: THE_CLOWN_74 (big blind) folded before Flop
Seat 4: Catania838 folded before Flop (didn't bet)
Seat 5: caduceus369 folded before Flop (didn't bet)
Seat 6: OMGWOLFX collected (€0.14)



PokerStars Zoom Hand #257958026628:  Hold'em No Limit (€0.01/€0.02) [ADM ID: M62BA304494E32ST] - 2025/10/01 15:05:51 CET [2025/10/01 9:05:51 ET]
Table 'Sirio' 6-max Seat #1 is the button
Seat 1: THE_CLOWN_74 (€2 in chips) 
Seat 2: OMGWOLFX (€5.21 in chips) 
Seat 3: Catania838 (€1.49 in chips) 
Seat 4: caduceus369 (€3.68 in chips) 
Seat 5: ghosto69 (€1.50 in chips) 
Seat 6: gs0097 (€0.44 in chips) 
OMGWOLFX: posts small blind €0.01
Catania838: posts big blind €0.02
*** HOLE CARDS ***
Dealt to caduceus369 [2d Jh]
caduceus369: folds 
ghosto69: folds 
gs0097: folds 
THE_CLOWN_74: raises €0.02 to €0.04
OMGWOLFX: calls €0.03
Catania838: folds 
*** FLOP *** [Kh 5h Ad]
OMGWOLFX: checks 
THE_CLOWN_74: checks 
*** TURN *** [Kh 5h Ad] [7s]
OMGWOLFX: bets €0.04
THE_CLOWN_74: folds 
Uncalled bet (€0.04) returned to OMGWOLFX
OMGWOLFX collected €0.10 from pot
OMGWOLFX: doesn't show hand 
*** SUMMARY ***
Total pot €0.10 | Rake €0 
Board [Kh 5h Ad 7s]
Seat 1: THE_CLOWN_74 (button) folded on the Turn
Seat 2: OMGWOLFX (small blind) collected (€0.10)
Seat 3: Catania838 (big blind) folded before Flop
Seat 4: caduceus369 folded before Flop (didn't bet)
Seat 5: ghosto69 folded before Flop (didn't bet)
Seat 6: gs0097 folded before Flop (didn't bet)



PokerStars Zoom Hand #257958027638:  Hold'em No Limit (€0.01/€0.02) [ADM ID: M62BA304494E32ST] - 2025/10/01 15:05:58 CET [2025/10/01 9:05:58 ET]
Table 'Sirio' 6-max Seat #1 is the button
Seat 1: THE_CLOWN_74 (€3.18 in chips) 
Seat 2: pylonstrip (€4.59 in chips) 
Seat 3: colosso2022 (€2.16 in chips) 
Seat 4: mrniceseed (€3.35 in chips) 
Seat 5: ghosto69 (€2.36 in chips) 
Seat 6: caduceus369 (€3.68 in chips) 
pylonstrip: posts small blind €0.01
colosso2022: posts big blind €0.02
*** HOLE CARDS ***
Dealt to caduceus369 [Kc As]
mrniceseed: raises €0.05 to €0.07
ghosto69: folds 
caduceus369: raises €0.17 to €0.24
THE_CLOWN_74: folds 
pylonstrip: folds 
colosso2022: folds 
mrniceseed: calls €0.17
*** FLOP *** [Tc 7d Ah]
mrniceseed: checks 
caduceus369: checks 
*** TURN *** [Tc 7d Ah] [4d]
mrniceseed: bets €0.28
caduceus369: calls €0.28
*** RIVER *** [Tc 7d Ah 4d] [2c]
mrniceseed: checks 
caduceus369: bets €0.49
mrniceseed: calls €0.49
*** SHOW DOWN ***
caduceus369: shows [Kc As] (a pair of Aces)
mrniceseed: mucks hand 
caduceus369 collected €1.94 from pot
*** SUMMARY ***
Total pot €2.05 | Rake €0.11 
Board [Tc 7d Ah 4d 2c]
Seat 1: THE_CLOWN_74 (button) folded before Flop (didn't bet)
Seat 2: pylonstrip (small blind) folded before Flop
Seat 3: colosso2022 (big blind) folded before Flop
Seat 4: mrniceseed mucked [8d Ad]
Seat 5: ghosto69 folded before Flop (didn't bet)
Seat 6: caduceus369 showed [Kc As] and won (€1.94) with a pair of Aces



PokerStars Zoom Hand #257958034617:  Hold'em No Limit (€0.01/€0.02) [ADM ID: M62BA304494E32ST] - 2025/10/01 15:06:52 CET [2025/10/01 9:06:52 ET]
Table 'Sirio' 6-max Seat #1 is the button
Seat 1: Catania838 (€1.50 in chips) 
Seat 2: ghosto69 (€2.31 in chips) 
Seat 3: caduceus369 (€4.61 in chips) 
Seat 4: francovirde (€0.92 in chips) 
Seat 5: OMGWOLFX (€5.95 in chips) 
Seat 6: THE_CLOWN_74 (€2 in chips) 
ghosto69: posts small blind €0.01
caduceus369: posts big blind €0.02
*** HOLE CARDS ***
Dealt to caduceus369 [8s Qd]
francovirde: folds 
OMGWOLFX: folds 
THE_CLOWN_74: folds 
Catania838: raises €0.04 to €0.06
ghosto69: folds 
caduceus369: folds 
Uncalled bet (€0.04) returned to Catania838
Catania838 collected €0.05 from pot
Catania838: doesn't show hand 
*** SUMMARY ***
Total pot €0.05 | Rake €0 
Seat 1: Catania838 (button) collected (€0.05)
Seat 2: ghosto69 (small blind) folded before Flop
Seat 3: caduceus369 (big blind) folded before Flop
Seat 4: francovirde folded before Flop (didn't bet)
Seat 5: OMGWOLFX folded before Flop (didn't bet)
Seat 6: THE_CLOWN_74 folded before Flop (didn't bet)



PokerStars Zoom Hand #257958033604:  Hold'em No Limit (€0.01/€0.02) [ADM ID: M62BA304494E32ST] - 2025/10/01 15:06:44 CET [2025/10/01 9:06:44 ET]
Table 'Sirio' 6-max Seat #1 is the button
Seat 1: mrniceseed (€2.34 in chips) 
Seat 2: zlat11 (€1.36 in chips) 
Seat 3: MathMassacreX (€5.75 in chips) 
Seat 4: caduceus369 (€4.61 in chips) 
Seat 5: THE_CLOWN_74 (€3.18 in chips) 
Seat 6: OMGWOLFX (€3.37 in chips) 
zlat11: posts small blind €0.01
MathMassacreX: posts big blind €0.02
*** HOLE CARDS ***
Dealt to caduceus369 [Js 4d]
caduceus369: folds 
THE_CLOWN_74: folds 
OMGWOLFX: folds 
mrniceseed: calls €0.02
zlat11: calls €0.01
MathMassacreX: checks 
*** FLOP *** [2h 8d Kh]
zlat11: checks 
MathMassacreX: checks 
mrniceseed: bets €0.06
zlat11: folds 
MathMassacreX: calls €0.06
*** TURN *** [2h 8d Kh] [Jc]
MathMassacreX: checks 
mrniceseed: bets €0.04
MathMassacreX: calls €0.04
*** RIVER *** [2h 8d Kh Jc] [9s]
MathMassacreX: checks 
mrniceseed: checks 
*** SHOW DOWN ***
MathMassacreX: shows [8s Ts] (a pair of Eights)
mrniceseed: shows [Kd Tc] (a pair of Kings)
mrniceseed collected €0.25 from pot
*** SUMMARY ***
Total pot €0.26 | Rake €0.01 
Board [2h 8d Kh Jc 9s]
Seat 1: mrniceseed (button) showed [Kd Tc] and won (€0.25) with a pair of Kings
Seat 2: zlat11 (small blind) folded on the Flop
Seat 3: MathMassacreX (big blind) showed [8s Ts] and lost with a pair of Eights
Seat 4: caduceus369 folded before Flop (didn't bet)
Seat 5: THE_CLOWN_74 folded before Flop (didn't bet)
Seat 6: OMGWOLFX folded before Flop (didn't bet)



PokerStars Zoom Hand #257958039106:  Hold'em No Limit (€0.01/€0.02) [ADM ID: M62BA304494E32ST] - 2025/10/01 15:07:27 CET [2025/10/01 9:07:27 ET]
Table 'Sirio' 6-max Seat #1 is the button
Seat 1: caduceus369 (€4.59 in chips) 
Seat 2: lampo201 (€3.47 in chips) 
Seat 3: ghosto69 (€2.30 in chips) 
Seat 4: cino63 (€1.22 in chips) 
Seat 5: Catania838 (€1.33 in chips) 
Seat 6: THE_CLOWN_74 (€2.06 in chips) 
lampo201: posts small blind €0.01
ghosto69: posts big blind €0.02
*** HOLE CARDS ***
Dealt to caduceus369 [8d 4c]
cino63: folds 
Catania838: raises €0.04 to €0.06
THE_CLOWN_74: raises €0.08 to €0.14
caduceus369: folds 
lampo201: calls €0.13
ghosto69: folds 
Catania838: raises €1.19 to €1.33 and is all-in
THE_CLOWN_74: folds 
lampo201: folds 
Uncalled bet (€1.19) returned to Catania838
Catania838 collected €0.44 from pot
Catania838: doesn't show hand 
*** SUMMARY ***
Total pot €0.44 | Rake €0 
Seat 1: caduceus369 (button) folded before Flop (didn't bet)
Seat 2: lampo201 (small blind) folded before Flop
Seat 3: ghosto69 (big blind) folded before Flop
Seat 4: cino63 folded before Flop (didn't bet)
Seat 5: Catania838 collected (€0.44)
Seat 6: THE_CLOWN_74 folded before Flop



PokerStars Zoom Hand #257958040473:  Hold'em No Limit (€0.01/€0.02) [ADM ID: M62BA304494E32ST] - 2025/10/01 15:07:37 CET [2025/10/01 9:07:37 ET]
Table 'Sirio' 6-max Seat #1 is the button
Seat 1: pylonstrip (€4.56 in chips) 
Seat 2: caduceus369 (€4.59 in chips) 
Seat 3: Catania838 (€1.52 in chips) 
Seat 4: TONNOeRUCOLA (€2 in chips) 
Seat 5: Emm3B1 (€3.77 in chips) 
Seat 6: vikisdad99 (€2.45 in chips) 
caduceus369: posts small blind €0.01
Catania838: posts big blind €0.02
*** HOLE CARDS ***
Dealt to caduceus369 [Jh Qh]
TONNOeRUCOLA: folds 
Emm3B1: folds 
vikisdad99: folds 
pylonstrip: raises €0.04 to €0.06
caduceus369: calls €0.05
Catania838: folds 
*** FLOP *** [Tc Ts Ah]
caduceus369: checks 
pylonstrip: bets €0.07
caduceus369: calls €0.07
*** TURN *** [Tc Ts Ah] [Qd]
caduceus369: checks 
pylonstrip: checks 
*** RIVER *** [Tc Ts Ah Qd] [Th]
caduceus369: bets €0.06
pylonstrip: calls €0.06
*** SHOW DOWN ***
caduceus369: shows [Jh Qh] (a full house, Tens full of Queens)
pylonstrip: shows [Kh Ks] (a full house, Tens full of Kings)
pylonstrip collected €0.38 from pot
*** SUMMARY ***
Total pot €0.40 | Rake €0.02 
Board [Tc Ts Ah Qd Th]
Seat 1: pylonstrip (button) showed [Kh Ks] and won (€0.38) with a full house, Tens full of Kings
Seat 2: caduceus369 (small blind) showed [Jh Qh] and lost with a full house, Tens full of Queens
Seat 3: Catania838 (big blind) folded before Flop
Seat 4: TONNOeRUCOLA folded before Flop (didn't bet)
Seat 5: Emm3B1 folded before Flop (didn't bet)
Seat 6: vikisdad99 folded before Flop (didn't bet)



PokerStars Zoom Hand #257958047437:  Hold'em No Limit (€0.01/€0.02) [ADM ID: M62BA304494E32ST] - 2025/10/01 15:08:31 CET [2025/10/01 9:08:31 ET]
Table 'Sirio' 6-max Seat #1 is the button
Seat 1: cagno78 (€1.84 in chips) 
Seat 2: Catania838 (€1.50 in chips) 
Seat 3: zlat11 (€1.36 in chips) 
Seat 4: lucpri (€2.66 in chips) 
Seat 5: caduceus369 (€4.40 in chips) 
Seat 6: gs0097 (€0.37 in chips) 
Catania838: posts small blind €0.01
zlat11: posts big blind €0.02
*** HOLE CARDS ***
Dealt to caduceus369 [Ks 4h]
lucpri: folds 
caduceus369: folds 
gs0097: folds 
cagno78: folds 
Catania838: folds 
Uncalled bet (€0.01) returned to zlat11
zlat11 collected €0.02 from pot
zlat11: doesn't show hand 
*** SUMMARY ***
Total pot €0.02 | Rake €0 
Seat 1: cagno78 (button) folded before Flop (didn't bet)
Seat 2: Catania838 (small blind) folded before Flop
Seat 3: zlat11 (big blind) collected (€0.02)
Seat 4: lucpri folded before Flop (didn't bet)
Seat 5: caduceus369 folded before Flop (didn't bet)
Seat 6: gs0097 folded before Flop (didn't bet)



PokerStars Zoom Hand #257958048355:  Hold'em No Limit (€0.01/€0.02) [ADM ID: M62BA304494E32ST] - 2025/10/01 15:08:38 CET [2025/10/01 9:08:38 ET]
Table 'Sirio' 6-max Seat #1 is the button
Seat 1: lucpri (€2.66 in chips) 
Seat 2: Catania838 (€1.64 in chips) 
Seat 3: TONNOeRUCOLA (€2.15 in chips) 
Seat 4: caduceus369 (€4.40 in chips) 
Seat 5: pylonstrip (€4.75 in chips) 
Seat 6: lavendemmia (€1.75 in chips) 
Catania838: posts small blind €0.01
TONNOeRUCOLA: posts big blind €0.02
*** HOLE CARDS ***
Dealt to caduceus369 [Kd 6c]
caduceus369: folds 
pylonstrip: folds 
lavendemmia: folds 
lucpri: folds 
Catania838: folds 
Uncalled bet (€0.01) returned to TONNOeRUCOLA
TONNOeRUCOLA collected €0.02 from pot
TONNOeRUCOLA: doesn't show hand 
*** SUMMARY ***
Total pot €0.02 | Rake €0 
Seat 1: lucpri (button) folded before Flop (didn't bet)
Seat 2: Catania838 (small blind) folded before Flop
Seat 3: TONNOeRUCOLA (big blind) collected (€0.02)
Seat 4: caduceus369 folded before Flop (didn't bet)
Seat 5: pylonstrip folded before Flop (didn't bet)
Seat 6: lavendemmia folded before Flop (didn't bet)



PokerStars Zoom Hand #257958048838:  Hold'em No Limit (€0.01/€0.02) [ADM ID: M62BA304494E32ST] - 2025/10/01 15:08:42 CET [2025/10/01 9:08:42 ET]
Table 'Sirio' 6-max Seat #1 is the button
Seat 1: Catania838 (€1.49 in chips) 
Seat 2: andrewbilliejoe (€2 in chips) 
Seat 3: pylonstrip (€4.75 in chips) 
Seat 4: caduceus369 (€4.40 in chips) 
Seat 5: THE_CLOWN_74 (€2 in chips) 
Seat 6: Emm3B1 (€3.75 in chips) 
andrewbilliejoe: posts small blind €0.01
pylonstrip: posts big blind €0.02
*** HOLE CARDS ***
Dealt to caduceus369 [7s Ad]
caduceus369: folds 
THE_CLOWN_74: folds 
Emm3B1: folds 
Catania838: folds 
andrewbilliejoe: folds 
Uncalled bet (€0.01) returned to pylonstrip
pylonstrip collected €0.02 from pot
pylonstrip: doesn't show hand 
*** SUMMARY ***
Total pot €0.02 | Rake €0 
Seat 1: Catania838 (button) folded before Flop (didn't bet)
Seat 2: andrewbilliejoe (small blind) folded before Flop
Seat 3: pylonstrip (big blind) collected (€0.02)
Seat 4: caduceus369 folded before Flop (didn't bet)
Seat 5: THE_CLOWN_74 folded before Flop (didn't bet)
Seat 6: Emm3B1 folded before Flop (didn't bet)



PokerStars Zoom Hand #257958046960:  Hold'em No Limit (€0.01/€0.02) [ADM ID: M62BA304494E32ST] - 2025/10/01 15:08:28 CET [2025/10/01 9:08:28 ET]
Table 'Sirio' 6-max Seat #1 is the button
Seat 1: lampo201 (€3.29 in chips) 
Seat 2: ValenTom25 (€1.78 in chips) 
Seat 3: andrewbilliejoe (€2 in chips) 
Seat 4: pylonstrip (€4.75 in chips) 
Seat 5: OMGWOLFX (€4.86 in chips) 
Seat 6: caduceus369 (€4.40 in chips) 
ValenTom25: posts small blind €0.01
andrewbilliejoe: posts big blind €0.02
*** HOLE CARDS ***
Dealt to caduceus369 [8c Ts]
pylonstrip: folds 
OMGWOLFX: raises €0.04 to €0.06
caduceus369: folds 
lampo201: calls €0.06
ValenTom25: calls €0.05
andrewbilliejoe: folds 
*** FLOP *** [Qc 7d 8s]
ValenTom25: checks 
OMGWOLFX: checks 
lampo201: bets €0.10
ValenTom25: folds 
OMGWOLFX: folds 
Uncalled bet (€0.10) returned to lampo201
lampo201 collected €0.19 from pot
lampo201: doesn't show hand 
*** SUMMARY ***
Total pot €0.20 | Rake €0.01 
Board [Qc 7d 8s]
Seat 1: lampo201 (button) collected (€0.19)
Seat 2: ValenTom25 (small blind) folded on the Flop
Seat 3: andrewbilliejoe (big blind) folded before Flop
Seat 4: pylonstrip folded before Flop (didn't bet)
Seat 5: OMGWOLFX folded on the Flop
Seat 6: caduceus369 folded before Flop (didn't bet)



PokerStars Zoom Hand #257958049222:  Hold'em No Limit (€0.01/€0.02) [ADM ID: M62BA304494E32ST] - 2025/10/01 15:08:45 CET [2025/10/01 9:08:45 ET]
Table 'Sirio' 6-max Seat #1 is the button
Seat 1: Semifonte (€2.07 in chips) 
Seat 2: andrewbilliejoe (€2 in chips) 
Seat 3: caduceus369 (€4.40 in chips) 
Seat 4: Catania838 (€1.63 in chips) 
Seat 5: Brigantoni66 (€0.42 in chips) 
Seat 6: lucpri (€2.66 in chips) 
andrewbilliejoe: posts small blind €0.01
caduceus369: posts big blind €0.02
*** HOLE CARDS ***
Dealt to caduceus369 [3d 4s]
Catania838: calls €0.02
Brigantoni66: folds 
lucpri: folds 
Semifonte: raises €0.02 to €0.04
andrewbilliejoe: raises €0.14 to €0.18
caduceus369: folds 
Catania838: folds 
Semifonte: calls €0.14
*** FLOP *** [4h Qc 3c]
andrewbilliejoe: checks 
Semifonte: bets €0.19
andrewbilliejoe: raises €0.38 to €0.57
Semifonte: raises €1.32 to €1.89 and is all-in
andrewbilliejoe: calls €1.25 and is all-in
Uncalled bet (€0.07) returned to Semifonte
*** TURN *** [4h Qc 3c] [8c]
*** RIVER *** [4h Qc 3c 8c] [2h]
*** SHOW DOWN ***
andrewbilliejoe: shows [Ad Qd] (a pair of Queens)
Semifonte: shows [Kc 9c] (a flush, King high)
Semifonte collected €3.82 from pot
*** SUMMARY ***
Total pot €4.04 | Rake €0.22 
Board [4h Qc 3c 8c 2h]
Seat 1: Semifonte (button) showed [Kc 9c] and won (€3.82) with a flush, King high
Seat 2: andrewbilliejoe (small blind) showed [Ad Qd] and lost with a pair of Queens
Seat 3: caduceus369 (big blind) folded before Flop
Seat 4: Catania838 folded before Flop
Seat 5: Brigantoni66 folded before Flop (didn't bet)
Seat 6: lucpri folded before Flop (didn't bet)



PokerStars Zoom Hand #257958051283:  Hold'em No Limit (€0.01/€0.02) [ADM ID: M62BA304494E32ST] - 2025/10/01 15:09:01 CET [2025/10/01 9:09:01 ET]
Table 'Sirio' 6-max Seat #1 is the button
Seat 1: colosso2022 (€2.05 in chips) 
Seat 2: caduceus369 (€4.38 in chips) 
Seat 3: ValenTom25 (€1.72 in chips) 
Seat 4: francovirde (€0.88 in chips) 
Seat 5: THE_CLOWN_74 (€2.34 in chips) 
Seat 6: Catania838 (€1.61 in chips) 
caduceus369: posts small blind €0.01
ValenTom25: posts big blind €0.02
*** HOLE CARDS ***
Dealt to caduceus369 [9h Jh]
francovirde: raises €0.02 to €0.04
THE_CLOWN_74: calls €0.04
Catania838: folds 
colosso2022: calls €0.04
caduceus369: folds 
ValenTom25: calls €0.02
*** FLOP *** [Qh 4d 8s]
ValenTom25: checks 
francovirde: checks 
THE_CLOWN_74: checks 
colosso2022: checks 
*** TURN *** [Qh 4d 8s] [3h]
ValenTom25: checks 
francovirde: checks 
THE_CLOWN_74: bets €0.13
colosso2022: calls €0.13
ValenTom25: folds 
francovirde: folds 
*** RIVER *** [Qh 4d 8s 3h] [9s]
THE_CLOWN_74: bets €0.31
colosso2022: folds 
Uncalled bet (€0.31) returned to THE_CLOWN_74
THE_CLOWN_74 collected €0.41 from pot
THE_CLOWN_74: doesn't show hand 
*** SUMMARY ***
Total pot €0.43 | Rake €0.02 
Board [Qh 4d 8s 3h 9s]
Seat 1: colosso2022 (button) folded on the River
Seat 2: caduceus369 (small blind) folded before Flop
Seat 3: ValenTom25 (big blind) folded on the Turn
Seat 4: francovirde folded on the Turn
Seat 5: THE_CLOWN_74 collected (€0.41)
Seat 6: Catania838 folded before Flop (didn't bet)



PokerStars Zoom Hand #257958052767:  Hold'em No Limit (€0.01/€0.02) [ADM ID: M62BA304494E32ST] - 2025/10/01 15:09:13 CET [2025/10/01 9:09:13 ET]
Table 'Sirio' 6-max Seat #1 is the button
Seat 1: caduceus369 (€4.37 in chips) 
Seat 2: Catania838 (€1.77 in chips) 
Seat 3: cagno78 (€1.87 in chips) 
Seat 4: THE_CLOWN_74 (€2 in chips) 
Seat 5: Emm3B1 (€3.74 in chips) 
Seat 6: lampo201 (€3.42 in chips) 
Catania838: posts small blind €0.01
cagno78: posts big blind €0.02
*** HOLE CARDS ***
Dealt to caduceus369 [Qc Qs]
THE_CLOWN_74: folds 
Emm3B1: folds 
lampo201: folds 
caduceus369: raises €0.02 to €0.04
Catania838: folds 
cagno78: calls €0.02
*** FLOP *** [6c 4c Jd]
cagno78: checks 
caduceus369: bets €0.05
cagno78: calls €0.05
*** TURN *** [6c 4c Jd] [7h]
cagno78: checks 
caduceus369: bets €0.07
cagno78: calls €0.07
*** RIVER *** [6c 4c Jd 7h] [9s]
cagno78: bets €0.06
caduceus369: calls €0.06
*** SHOW DOWN ***
cagno78: shows [5s 9c] (a pair of Nines)
caduceus369: shows [Qc Qs] (a pair of Queens)
caduceus369 collected €0.43 from pot
*** SUMMARY ***
Total pot €0.45 | Rake €0.02 
Board [6c 4c Jd 7h 9s]
Seat 1: caduceus369 (button) showed [Qc Qs] and won (€0.43) with a pair of Queens
Seat 2: Catania838 (small blind) folded before Flop
Seat 3: cagno78 (big blind) showed [5s 9c] and lost with a pair of Nines
Seat 4: THE_CLOWN_74 folded before Flop (didn't bet)
Seat 5: Emm3B1 folded before Flop (didn't bet)
Seat 6: lampo201 folded before Flop (didn't bet)



PokerStars Zoom Hand #257958059231:  Hold'em No Limit (€0.01/€0.02) [ADM ID: M62BA304494E32ST] - 2025/10/01 15:10:03 CET [2025/10/01 9:10:03 ET]
Table 'Sirio' 6-max Seat #1 is the button
Seat 1: OMGWOLFX (€4.92 in chips) 
Seat 2: lucpri (€2.52 in chips) 
Seat 3: cino63 (€0.83 in chips) 
Seat 4: caduceus369 (€4.58 in chips) 
Seat 5: ghosto69 (€2.62 in chips) 
Seat 6: andrewbilliejoe (€2 in chips) 
lucpri: posts small blind €0.01
cino63: posts big blind €0.02
*** HOLE CARDS ***
Dealt to caduceus369 [Kh 8c]
caduceus369: folds 
ghosto69: folds 
andrewbilliejoe: folds 
OMGWOLFX: folds 
lucpri: folds 
Uncalled bet (€0.01) returned to cino63
cino63 collected €0.02 from pot
cino63: doesn't show hand 
*** SUMMARY ***
Total pot €0.02 | Rake €0 
Seat 1: OMGWOLFX (button) folded before Flop (didn't bet)
Seat 2: lucpri (small blind) folded before Flop
Seat 3: cino63 (big blind) collected (€0.02)
Seat 4: caduceus369 folded before Flop (didn't bet)
Seat 5: ghosto69 folded before Flop (didn't bet)
Seat 6: andrewbilliejoe folded before Flop (didn't bet)



PokerStars Zoom Hand #257958058544:  Hold'em No Limit (€0.01/€0.02) [ADM ID: M62BA304494E32ST] - 2025/10/01 15:09:58 CET [2025/10/01 9:09:58 ET]
Table 'Sirio' 6-max Seat #1 is the button
Seat 1: ghosto69 (€1.36 in chips) 
Seat 2: cagno78 (€1.65 in chips) 
Seat 3: Emm3B1 (€3.67 in chips) 
Seat 4: cino63 (€0.83 in chips) 
Seat 5: caduceus369 (€4.58 in chips) 
Seat 6: andrewbilliejoe (€2.03 in chips) 
cagno78: posts small blind €0.01
Emm3B1: posts big blind €0.02
*** HOLE CARDS ***
Dealt to caduceus369 [Jh 7d]
cino63: folds 
caduceus369: folds 
andrewbilliejoe: folds 
ghosto69: folds 
cagno78: folds 
Uncalled bet (€0.01) returned to Emm3B1
Emm3B1 collected €0.02 from pot
Emm3B1: doesn't show hand 
*** SUMMARY ***
Total pot €0.02 | Rake €0 
Seat 1: ghosto69 (button) folded before Flop (didn't bet)
Seat 2: cagno78 (small blind) folded before Flop
Seat 3: Emm3B1 (big blind) collected (€0.02)
Seat 4: cino63 folded before Flop (didn't bet)
Seat 5: caduceus369 folded before Flop (didn't bet)
Seat 6: andrewbilliejoe folded before Flop (didn't bet)



PokerStars Zoom Hand #257958059844:  Hold'em No Limit (€0.01/€0.02) [ADM ID: M62BA304494E32ST] - 2025/10/01 15:10:08 CET [2025/10/01 9:10:08 ET]
Table 'Sirio' 6-max Seat #1 is the button
Seat 1: THE_CLOWN_74 (€2 in chips) 
Seat 2: caduceus369 (€4.58 in chips) 
Seat 3: lampo201 (€3.79 in chips) 
Seat 4: Brigantoni66 (€0.55 in chips) 
Seat 5: lucpri (€2.51 in chips) 
Seat 6: cagno78 (€1.64 in chips) 
caduceus369: posts small blind €0.01
lampo201: posts big blind €0.02
*** HOLE CARDS ***
Dealt to caduceus369 [4h Ks]
Brigantoni66: folds 
lucpri: folds 
cagno78: folds 
THE_CLOWN_74: folds 
caduceus369: folds 
Uncalled bet (€0.01) returned to lampo201
lampo201 collected €0.02 from pot
lampo201: doesn't show hand 
*** SUMMARY ***
Total pot €0.02 | Rake €0 
Seat 1: THE_CLOWN_74 (button) folded before Flop (didn't bet)
Seat 2: caduceus369 (small blind) folded before Flop
Seat 3: lampo201 (big blind) collected (€0.02)
Seat 4: Brigantoni66 folded before Flop (didn't bet)
Seat 5: lucpri folded before Flop (didn't bet)
Seat 6: cagno78 folded before Flop (didn't bet)



PokerStars Zoom Hand #257958066809:  Hold'em No Limit (€0.01/€0.02) [ADM ID: M62BA304494E32ST] - 2025/10/01 15:11:03 CET [2025/10/01 9:11:03 ET]
Table 'Sirio' 6-max Seat #1 is the button
Seat 1: Semifonte (€2.46 in chips) 
Seat 2: cagno78 (€1.74 in chips) 
Seat 3: caduceus369 (€4.57 in chips) 
Seat 4: gs0097 (€0.27 in chips) 
Seat 5: andrewbilliejoe (€2.01 in chips) 
Seat 6: mrniceseed (€2.24 in chips) 
cagno78: posts small blind €0.01
caduceus369: posts big blind €0.02
*** HOLE CARDS ***
Dealt to caduceus369 [5s 3d]
gs0097: folds 
andrewbilliejoe: folds 
mrniceseed: folds 
Semifonte: folds 
cagno78: calls €0.01
caduceus369: checks 
*** FLOP *** [Js Qd 8h]
cagno78: checks 
caduceus369: checks 
*** TURN *** [Js Qd 8h] [3c]
cagno78: bets €0.04
caduceus369: calls €0.04
*** RIVER *** [Js Qd 8h 3c] [7s]
cagno78: checks 
caduceus369: checks 
*** SHOW DOWN ***
cagno78: shows [8c Td] (a pair of Eights)
caduceus369: mucks hand 
cagno78 collected €0.12 from pot
*** SUMMARY ***
Total pot €0.12 | Rake €0 
Board [Js Qd 8h 3c 7s]
Seat 1: Semifonte (button) folded before Flop (didn't bet)
Seat 2: cagno78 (small blind) showed [8c Td] and won (€0.12) with a pair of Eights
Seat 3: caduceus369 (big blind) mucked [5s 3d]
Seat 4: gs0097 folded before Flop (didn't bet)
Seat 5: andrewbilliejoe folded before Flop (didn't bet)
Seat 6: mrniceseed folded before Flop (didn't bet)



PokerStars Zoom Hand #257958072336:  Hold'em No Limit (€0.01/€0.02) [ADM ID: M62BA304494E32ST] - 2025/10/01 15:11:46 CET [2025/10/01 9:11:46 ET]
Table 'Sirio' 6-max Seat #1 is the button
Seat 1: gs0097 (€0.26 in chips) 
Seat 2: Brigantoni66 (€0.69 in chips) 
Seat 3: mrniceseed (€2.21 in chips) 
Seat 4: TONNOeRUCOLA (€2.37 in chips) 
Seat 5: Catania838 (€1.49 in chips) 
Seat 6: caduceus369 (€4.51 in chips) 
Brigantoni66: posts small blind €0.01
mrniceseed: posts big blind €0.02
*** HOLE CARDS ***
Dealt to caduceus369 [7c Kc]
TONNOeRUCOLA: folds 
Catania838: folds 
caduceus369: folds 
gs0097: folds 
Brigantoni66: calls €0.01
mrniceseed: checks 
*** FLOP *** [9d Jh Tc]
Brigantoni66: bets €0.02
mrniceseed: folds 
Uncalled bet (€0.02) returned to Brigantoni66
Brigantoni66 collected €0.04 from pot
Brigantoni66: doesn't show hand 
*** SUMMARY ***
Total pot €0.04 | Rake €0 
Board [9d Jh Tc]
Seat 1: gs0097 (button) folded before Flop (didn't bet)
Seat 2: Brigantoni66 (small blind) collected (€0.04)
Seat 3: mrniceseed (big blind) folded on the Flop
Seat 4: TONNOeRUCOLA folded before Flop (didn't bet)
Seat 5: Catania838 folded before Flop (didn't bet)
Seat 6: caduceus369 folded before Flop (didn't bet)



PokerStars Zoom Hand #257958071827:  Hold'em No Limit (€0.01/€0.02) [ADM ID: M62BA304494E32ST] - 2025/10/01 15:11:42 CET [2025/10/01 9:11:42 ET]
Table 'Sirio' 6-max Seat #1 is the button
Seat 1: caduceus369 (€4.51 in chips) 
Seat 2: mrniceseed (€2.22 in chips) 
Seat 3: cagno78 (€1.80 in chips) 
Seat 4: TazCrack (€0.96 in chips) 
Seat 5: ghosto69 (€2.53 in chips) 
Seat 6: andrewbilliejoe (€2.16 in chips) 
mrniceseed: posts small blind €0.01
cagno78: posts big blind €0.02
*** HOLE CARDS ***
Dealt to caduceus369 [Qd 2s]
TazCrack: calls €0.02
ghosto69: folds 
andrewbilliejoe: raises €0.08 to €0.10
caduceus369: folds 
mrniceseed: folds 
cagno78: calls €0.08
TazCrack: folds 
*** FLOP *** [9h 6s Kc]
cagno78: checks 
andrewbilliejoe: bets €0.07
cagno78: folds 
Uncalled bet (€0.07) returned to andrewbilliejoe
andrewbilliejoe collected €0.22 from pot
andrewbilliejoe: doesn't show hand 
*** SUMMARY ***
Total pot €0.23 | Rake €0.01 
Board [9h 6s Kc]
Seat 1: caduceus369 (button) folded before Flop (didn't bet)
Seat 2: mrniceseed (small blind) folded before Flop
Seat 3: cagno78 (big blind) folded on the Flop
Seat 4: TazCrack folded before Flop
Seat 5: ghosto69 folded before Flop (didn't bet)
Seat 6: andrewbilliejoe collected (€0.22)



PokerStars Zoom Hand #257958066200:  Hold'em No Limit (€0.01/€0.02) [ADM ID: M62BA304494E32ST] - 2025/10/01 15:10:58 CET [2025/10/01 9:10:58 ET]
Table 'Sirio' 6-max Seat #1 is the button
Seat 1: gs0097 (€0.27 in chips) 
Seat 2: OMGWOLFX (€4.88 in chips) 
Seat 3: ghosto69 (€1.36 in chips) 
Seat 4: Catania838 (€1.38 in chips) 
Seat 5: cagno78 (€1.74 in chips) 
Seat 6: caduceus369 (€4.57 in chips) 
OMGWOLFX: posts small blind €0.01
ghosto69: posts big blind €0.02
*** HOLE CARDS ***
Dealt to caduceus369 [Td 7d]
Catania838: calls €0.02
cagno78: folds 
caduceus369: folds 
gs0097: folds 
OMGWOLFX: calls €0.01
ghosto69: checks 
*** FLOP *** [Ks 6d Qc]
OMGWOLFX: checks 
ghosto69: checks 
Catania838: checks 
*** TURN *** [Ks 6d Qc] [9d]
OMGWOLFX: checks 
ghosto69: bets €0.02
Catania838: folds 
OMGWOLFX: folds 
Uncalled bet (€0.02) returned to ghosto69
ghosto69 collected €0.06 from pot
ghosto69: doesn't show hand 
*** SUMMARY ***
Total pot €0.06 | Rake €0 
Board [Ks 6d Qc 9d]
Seat 1: gs0097 (button) folded before Flop (didn't bet)
Seat 2: OMGWOLFX (small blind) folded on the Turn
Seat 3: ghosto69 (big blind) collected (€0.06)
Seat 4: Catania838 folded on the Turn
Seat 5: cagno78 folded before Flop (didn't bet)
Seat 6: caduceus369 folded before Flop (didn't bet)



PokerStars Zoom Hand #257958074527:  Hold'em No Limit (€0.01/€0.02) [ADM ID: M62BA304494E32ST] - 2025/10/01 15:12:03 CET [2025/10/01 9:12:03 ET]
Table 'Sirio' 6-max Seat #1 is the button
Seat 1: TONNOeRUCOLA (€2.36 in chips) 
Seat 2: zlat11 (€1.44 in chips) 
Seat 3: Catania838 (€1.36 in chips) 
Seat 4: OMGWOLFX (€5.98 in chips) 
Seat 5: caduceus369 (€4.51 in chips) 
Seat 6: andrewbilliejoe (€2.01 in chips) 
zlat11: posts small blind €0.01
Catania838: posts big blind €0.02
*** HOLE CARDS ***
Dealt to caduceus369 [Tc 5d]
OMGWOLFX: raises €0.04 to €0.06
caduceus369: folds 
andrewbilliejoe: raises €0.12 to €0.18
TONNOeRUCOLA: calls €0.18
zlat11: folds 
Catania838: folds 
OMGWOLFX: folds 
*** FLOP *** [8h Jh 3c]
andrewbilliejoe: checks 
TONNOeRUCOLA: bets €0.22
andrewbilliejoe: raises €0.44 to €0.66
TONNOeRUCOLA: calls €0.44
*** TURN *** [8h Jh 3c] [Jc]
andrewbilliejoe: bets €1.17 and is all-in
TONNOeRUCOLA: calls €1.17
*** RIVER *** [8h Jh 3c Jc] [9d]
*** SHOW DOWN ***
andrewbilliejoe: shows [As Ac] (two pair, Aces and Jacks)
TONNOeRUCOLA: shows [Js Ad] (three of a kind, Jacks)
TONNOeRUCOLA collected €3.89 from pot
*** SUMMARY ***
Total pot €4.11 | Rake €0.22 
Board [8h Jh 3c Jc 9d]
Seat 1: TONNOeRUCOLA (button) showed [Js Ad] and won (€3.89) with three of a kind, Jacks
Seat 2: zlat11 (small blind) folded before Flop
Seat 3: Catania838 (big blind) folded before Flop
Seat 4: OMGWOLFX folded before Flop
Seat 5: caduceus369 folded before Flop (didn't bet)
Seat 6: andrewbilliejoe showed [As Ac] and lost with two pair, Aces and Jacks



PokerStars Zoom Hand #257958075571:  Hold'em No Limit (€0.01/€0.02) [ADM ID: M62BA304494E32ST] - 2025/10/01 15:12:11 CET [2025/10/01 9:12:11 ET]
Table 'Sirio' 6-max Seat #1 is the button
Seat 1: cino63 (€0.75 in chips) 
Seat 2: caduceus369 (€4.51 in chips) 
Seat 3: Emm3B1 (€3.83 in chips) 
Seat 4: Brigantoni66 (€0.71 in chips) 
Seat 5: colosso2022 (€1.86 in chips) 
Seat 6: lucpri (€2.65 in chips) 
caduceus369: posts small blind €0.01
Emm3B1: posts big blind €0.02
*** HOLE CARDS ***
Dealt to caduceus369 [7s 8s]
Brigantoni66: folds 
colosso2022: calls €0.02
lucpri: folds 
cino63: folds 
caduceus369: calls €0.01
Emm3B1: checks 
*** FLOP *** [6d Ks 8d]
caduceus369: checks 
Emm3B1: checks 
colosso2022: checks 
*** TURN *** [6d Ks 8d] [5d]
caduceus369: bets €0.04
Emm3B1: folds 
colosso2022: raises €0.04 to €0.08
caduceus369: folds 
Uncalled bet (€0.04) returned to colosso2022
colosso2022 collected €0.14 from pot
colosso2022: doesn't show hand 
*** SUMMARY ***
Total pot €0.14 | Rake €0 
Board [6d Ks 8d 5d]
Seat 1: cino63 (button) folded before Flop (didn't bet)
Seat 2: caduceus369 (small blind) folded on the Turn
Seat 3: Emm3B1 (big blind) folded on the Turn
Seat 4: Brigantoni66 folded before Flop (didn't bet)
Seat 5: colosso2022 collected (€0.14)
Seat 6: lucpri folded before Flop (didn't bet)



PokerStars Zoom Hand #257958083197:  Hold'em No Limit (€0.01/€0.02) [ADM ID: M62BA304494E32ST] - 2025/10/01 15:13:09 CET [2025/10/01 9:13:09 ET]
Table 'Sirio' 6-max Seat #1 is the button
Seat 1: ValenTom25 (€2.04 in chips) 
Seat 2: vikisdad99 (€2.38 in chips) 
Seat 3: andrewbilliejoe (€2 in chips) 
Seat 4: Semifonte (€1.95 in chips) 
Seat 5: caduceus369 (€4.45 in chips) 
Seat 6: THE_CLOWN_74 (€2.03 in chips) 
vikisdad99: posts small blind €0.01
andrewbilliejoe: posts big blind €0.02
*** HOLE CARDS ***
Dealt to caduceus369 [Kc Th]
Semifonte: folds 
caduceus369: folds 
THE_CLOWN_74: raises €0.03 to €0.05
ValenTom25: folds 
vikisdad99: folds 
andrewbilliejoe: folds 
Uncalled bet (€0.03) returned to THE_CLOWN_74
THE_CLOWN_74 collected €0.05 from pot
THE_CLOWN_74: doesn't show hand 
*** SUMMARY ***
Total pot €0.05 | Rake €0 
Seat 1: ValenTom25 (button) folded before Flop (didn't bet)
Seat 2: vikisdad99 (small blind) folded before Flop
Seat 3: andrewbilliejoe (big blind) folded before Flop
Seat 4: Semifonte folded before Flop (didn't bet)
Seat 5: caduceus369 folded before Flop (didn't bet)
Seat 6: THE_CLOWN_74 collected (€0.05)



PokerStars Zoom Hand #257958086106:  Hold'em No Limit (€0.01/€0.02) [ADM ID: M62BA304494E32ST] - 2025/10/01 15:13:31 CET [2025/10/01 9:13:31 ET]
Table 'Sirio' 6-max Seat #1 is the button
Seat 1: caduceus369 (€4.43 in chips) 
Seat 2: andrewbilliejoe (€2 in chips) 
Seat 3: cagno78 (€1.75 in chips) 
Seat 4: mrniceseed (€2.03 in chips) 
Seat 5: zlat11 (€1.30 in chips) 
Seat 6: pylonstrip (€5.02 in chips) 
andrewbilliejoe: posts small blind €0.01
cagno78: posts big blind €0.02
*** HOLE CARDS ***
Dealt to caduceus369 [2c 7c]
mrniceseed: folds 
zlat11: folds 
pylonstrip: folds 
caduceus369: folds 
andrewbilliejoe: folds 
Uncalled bet (€0.01) returned to cagno78
cagno78 collected €0.02 from pot
cagno78: doesn't show hand 
*** SUMMARY ***
Total pot €0.02 | Rake €0 
Seat 1: caduceus369 (button) folded before Flop (didn't bet)
Seat 2: andrewbilliejoe (small blind) folded before Flop
Seat 3: cagno78 (big blind) collected (€0.02)
Seat 4: mrniceseed folded before Flop (didn't bet)
Seat 5: zlat11 folded before Flop (didn't bet)
Seat 6: pylonstrip folded before Flop (didn't bet)



PokerStars Zoom Hand #257958086901:  Hold'em No Limit (€0.01/€0.02) [ADM ID: M62BA304494E32ST] - 2025/10/01 15:13:37 CET [2025/10/01 9:13:37 ET]
Table 'Sirio' 6-max Seat #1 is the button
Seat 1: THE_CLOWN_74 (€2.05 in chips) 
Seat 2: lampo201 (€1.98 in chips) 
Seat 3: zlat11 (€1.30 in chips) 
Seat 4: pylonstrip (€5.02 in chips) 
Seat 5: Brigantoni66 (€0.66 in chips) 
Seat 6: caduceus369 (€4.43 in chips) 
lampo201: posts small blind €0.01
zlat11: posts big blind €0.02
*** HOLE CARDS ***
Dealt to caduceus369 [3s Ts]
pylonstrip: folds 
Brigantoni66: folds 
caduceus369: folds 
THE_CLOWN_74: folds 
lampo201: folds 
Uncalled bet (€0.01) returned to zlat11
zlat11 collected €0.02 from pot
zlat11: doesn't show hand 
*** SUMMARY ***
Total pot €0.02 | Rake €0 
Seat 1: THE_CLOWN_74 (button) folded before Flop (didn't bet)
Seat 2: lampo201 (small blind) folded before Flop
Seat 3: zlat11 (big blind) collected (€0.02)
Seat 4: pylonstrip folded before Flop (didn't bet)
Seat 5: Brigantoni66 folded before Flop (didn't bet)
Seat 6: caduceus369 folded before Flop (didn't bet)



PokerStars Zoom Hand #257958084392:  Hold'em No Limit (€0.01/€0.02) [ADM ID: M62BA304494E32ST] - 2025/10/01 15:13:18 CET [2025/10/01 9:13:18 ET]
Table 'Sirio' 6-max Seat #1 is the button
Seat 1: vikisdad99 (€2.37 in chips) 
Seat 2: ghosto69 (€2.51 in chips) 
Seat 3: caduceus369 (€4.45 in chips) 
Seat 4: Brigantoni66 (€0.68 in chips) 
Seat 5: lavendemmia (€2.03 in chips) 
Seat 6: Emm3B1 (€3.80 in chips) 
ghosto69: posts small blind €0.01
caduceus369: posts big blind €0.02
*** HOLE CARDS ***
Dealt to caduceus369 [Ac 7s]
Brigantoni66: folds 
lavendemmia: folds 
Emm3B1: raises €0.04 to €0.06
vikisdad99: calls €0.06
ghosto69: folds 
caduceus369: folds 
*** FLOP *** [Kc 9d 8s]
Emm3B1: checks 
vikisdad99: checks 
*** TURN *** [Kc 9d 8s] [As]
Emm3B1: bets €0.07
vikisdad99: folds 
Uncalled bet (€0.07) returned to Emm3B1
Emm3B1 collected €0.15 from pot
Emm3B1: doesn't show hand 
*** SUMMARY ***
Total pot €0.15 | Rake €0 
Board [Kc 9d 8s As]
Seat 1: vikisdad99 (button) folded on the Turn
Seat 2: ghosto69 (small blind) folded before Flop
Seat 3: caduceus369 (big blind) folded before Flop
Seat 4: Brigantoni66 folded before Flop (didn't bet)
Seat 5: lavendemmia folded before Flop (didn't bet)
Seat 6: Emm3B1 collected (€0.15)



PokerStars Zoom Hand #257958087850:  Hold'em No Limit (€0.01/€0.02) [ADM ID: M62BA304494E32ST] - 2025/10/01 15:13:44 CET [2025/10/01 9:13:44 ET]
Table 'Sirio' 6-max Seat #1 is the button
Seat 1: andrewbilliejoe (€2 in chips) 
Seat 2: pylonstrip (€5.02 in chips) 
Seat 3: mrniceseed (€2.02 in chips) 
Seat 4: caduceus369 (€4.43 in chips) 
Seat 5: THE_CLOWN_74 (€2.05 in chips) 
Seat 6: ghosto69 (€2.16 in chips) 
pylonstrip: posts small blind €0.01
mrniceseed: posts big blind €0.02
*** HOLE CARDS ***
Dealt to caduceus369 [Qs 4d]
caduceus369: folds 
THE_CLOWN_74: raises €0.04 to €0.06
ghosto69: folds 
andrewbilliejoe: folds 
pylonstrip: calls €0.05
mrniceseed: raises €0.24 to €0.30
THE_CLOWN_74: folds 
pylonstrip: folds 
Uncalled bet (€0.24) returned to mrniceseed
mrniceseed collected €0.18 from pot
mrniceseed: doesn't show hand 
*** SUMMARY ***
Total pot €0.18 | Rake €0 
Seat 1: andrewbilliejoe (button) folded before Flop (didn't bet)
Seat 2: pylonstrip (small blind) folded before Flop
Seat 3: mrniceseed (big blind) collected (€0.18)
Seat 4: caduceus369 folded before Flop (didn't bet)
Seat 5: THE_CLOWN_74 folded before Flop
Seat 6: ghosto69 folded before Flop (didn't bet)



PokerStars Zoom Hand #257958089031:  Hold'em No Limit (€0.01/€0.02) [ADM ID: M62BA304494E32ST] - 2025/10/01 15:13:53 CET [2025/10/01 9:13:53 ET]
Table 'Sirio' 6-max Seat #1 is the button
Seat 1: Brigantoni66 (€0.65 in chips) 
Seat 2: caduceus369 (€4.43 in chips) 
Seat 3: lucpri (€2.68 in chips) 
Seat 4: THE_CLOWN_74 (€2 in chips) 
Seat 5: ghosto69 (€2.16 in chips) 
Seat 6: andrewbilliejoe (€2 in chips) 
caduceus369: posts small blind €0.01
lucpri: posts big blind €0.02
*** HOLE CARDS ***
Dealt to caduceus369 [Ts As]
THE_CLOWN_74: folds 
ghosto69: raises €0.04 to €0.06
andrewbilliejoe: folds 
Brigantoni66: folds 
caduceus369: calls €0.05
lucpri: folds 
*** FLOP *** [6d 2d 3d]
caduceus369: checks 
ghosto69: checks 
*** TURN *** [6d 2d 3d] [9d]
caduceus369: bets €0.06
ghosto69: folds 
Uncalled bet (€0.06) returned to caduceus369
caduceus369 collected €0.14 from pot
caduceus369: doesn't show hand 
*** SUMMARY ***
Total pot €0.14 | Rake €0 
Board [6d 2d 3d 9d]
Seat 1: Brigantoni66 (button) folded before Flop (didn't bet)
Seat 2: caduceus369 (small blind) collected (€0.14)
Seat 3: lucpri (big blind) folded before Flop
Seat 4: THE_CLOWN_74 folded before Flop (didn't bet)
Seat 5: ghosto69 folded on the Turn
Seat 6: andrewbilliejoe folded before Flop (didn't bet)



PokerStars Zoom Hand #257958092655:  Hold'em No Limit (€0.01/€0.02) [ADM ID: M62BA304494E32ST] - 2025/10/01 15:14:21 CET [2025/10/01 9:14:21 ET]
Table 'Sirio' 6-max Seat #1 is the button
Seat 1: 606265 (€1.97 in chips) 
Seat 2: THE_CLOWN_74 (€2 in chips) 
Seat 3: caduceus369 (€4.51 in chips) 
Seat 4: ghosto69 (€2.10 in chips) 
Seat 5: Brigantoni66 (€0.63 in chips) 
Seat 6: mrniceseed (€2.14 in chips) 
THE_CLOWN_74: posts small blind €0.01
caduceus369: posts big blind €0.02
*** HOLE CARDS ***
Dealt to caduceus369 [Qc 9c]
ghosto69: folds 
Brigantoni66: folds 
mrniceseed: folds 
606265: folds 
THE_CLOWN_74: folds 
Uncalled bet (€0.01) returned to caduceus369
caduceus369 collected €0.02 from pot
caduceus369: doesn't show hand 
*** SUMMARY ***
Total pot €0.02 | Rake €0 
Seat 1: 606265 (button) folded before Flop (didn't bet)
Seat 2: THE_CLOWN_74 (small blind) folded before Flop
Seat 3: caduceus369 (big blind) collected (€0.02)
Seat 4: ghosto69 folded before Flop (didn't bet)
Seat 5: Brigantoni66 folded before Flop (didn't bet)
Seat 6: mrniceseed folded before Flop (didn't bet)



PokerStars Zoom Hand #257958088378:  Hold'em No Limit (€0.01/€0.02) [ADM ID: M62BA304494E32ST] - 2025/10/01 15:13:48 CET [2025/10/01 9:13:48 ET]
Table 'Sirio' 6-max Seat #1 is the button
Seat 1: caduceus369 (€4.43 in chips) 
Seat 2: zlat11 (€1.31 in chips) 
Seat 3: kikibaba (€0.80 in chips) 
Seat 4: ghosto69 (€1.39 in chips) 
Seat 5: THE_CLOWN_74 (€2 in chips) 
Seat 6: OMGWOLFX (€6.04 in chips) 
zlat11: posts small blind €0.01
kikibaba: posts big blind €0.02
*** HOLE CARDS ***
Dealt to caduceus369 [Qc 3s]
ghosto69: folds 
THE_CLOWN_74: folds 
OMGWOLFX: raises €0.04 to €0.06
caduceus369: folds 
zlat11: raises €0.14 to €0.20
kikibaba: calls €0.18
OMGWOLFX: calls €0.14
*** FLOP *** [6s Kc Ks]
zlat11: checks 
kikibaba: bets €0.10
OMGWOLFX: calls €0.10
zlat11: calls €0.10
*** TURN *** [6s Kc Ks] [Ad]
zlat11: checks 
kikibaba: bets €0.50 and is all-in
OMGWOLFX: folds 
zlat11: calls €0.50
*** RIVER *** [6s Kc Ks Ad] [4c]
*** SHOW DOWN ***
zlat11: shows [Jh Ah] (two pair, Aces and Kings)
kikibaba: shows [Kh Qh] (three of a kind, Kings)
kikibaba collected €1.80 from pot
*** SUMMARY ***
Total pot €1.90 | Rake €0.10 
Board [6s Kc Ks Ad 4c]
Seat 1: caduceus369 (button) folded before Flop (didn't bet)
Seat 2: zlat11 (small blind) showed [Jh Ah] and lost with two pair, Aces and Kings
Seat 3: kikibaba (big blind) showed [Kh Qh] and won (€1.80) with three of a kind, Kings
Seat 4: ghosto69 folded before Flop (didn't bet)
Seat 5: THE_CLOWN_74 folded before Flop (didn't bet)
Seat 6: OMGWOLFX folded on the Turn



PokerStars Zoom Hand #257958096134:  Hold'em No Limit (€0.01/€0.02) [ADM ID: M62BA304494E32ST] - 2025/10/01 15:14:47 CET [2025/10/01 9:14:47 ET]
Table 'Sirio' 6-max Seat #1 is the button
Seat 1: 606265 (€1.97 in chips) 
Seat 2: francovirde (€0.75 in chips) 
Seat 3: lucpri (€2.64 in chips) 
Seat 4: caduceus369 (€4.52 in chips) 
Seat 5: vikisdad99 (€2.22 in chips) 
Seat 6: THE_CLOWN_74 (€2 in chips) 
francovirde: posts small blind €0.01
lucpri: posts big blind €0.02
*** HOLE CARDS ***
Dealt to caduceus369 [Tc Kd]
caduceus369: folds 
vikisdad99: folds 
THE_CLOWN_74: folds 
606265: calls €0.02
francovirde: raises €0.73 to €0.75 and is all-in
lucpri: folds 
606265: folds 
Uncalled bet (€0.73) returned to francovirde
francovirde collected €0.06 from pot
francovirde: doesn't show hand 
*** SUMMARY ***
Total pot €0.06 | Rake €0 
Seat 1: 606265 (button) folded before Flop
Seat 2: francovirde (small blind) collected (€0.06)
Seat 3: lucpri (big blind) folded before Flop
Seat 4: caduceus369 folded before Flop (didn't bet)
Seat 5: vikisdad99 folded before Flop (didn't bet)
Seat 6: THE_CLOWN_74 folded before Flop (didn't bet)



PokerStars Zoom Hand #257958096582:  Hold'em No Limit (€0.01/€0.02) [ADM ID: M62BA304494E32ST] - 2025/10/01 15:14:51 CET [2025/10/01 9:14:51 ET]
Table 'Sirio' 6-max Seat #1 is the button
Seat 1: OMGWOLFX (€4.95 in chips) 
Seat 2: ghosto69 (€2.08 in chips) 
Seat 3: padisha00 (€1.19 in chips) 
Seat 4: caduceus369 (€4.52 in chips) 
Seat 5: Fiocco231 (€0.90 in chips) 
Seat 6: gs0097 (€0.43 in chips) 
ghosto69: posts small blind €0.01
padisha00: posts big blind €0.02
*** HOLE CARDS ***
Dealt to caduceus369 [6d 6c]
caduceus369: calls €0.02
Fiocco231: folds 
gs0097: raises €0.07 to €0.09
OMGWOLFX: folds 
ghosto69: folds 
padisha00: folds 
caduceus369: raises €4.43 to €4.52 and is all-in
gs0097: calls €0.34 and is all-in
Uncalled bet (€4.09) returned to caduceus369
*** FLOP *** [9h Qd As]
*** TURN *** [9h Qd As] [Ks]
*** RIVER *** [9h Qd As Ks] [8h]
*** SHOW DOWN ***
caduceus369: shows [6d 6c] (a pair of Sixes)
gs0097: shows [Js Jd] (a pair of Jacks)
gs0097 collected €0.85 from pot
*** SUMMARY ***
Total pot €0.89 | Rake €0.04 
Board [9h Qd As Ks 8h]
Seat 1: OMGWOLFX (button) folded before Flop (didn't bet)
Seat 2: ghosto69 (small blind) folded before Flop
Seat 3: padisha00 (big blind) folded before Flop
Seat 4: caduceus369 showed [6d 6c] and lost with a pair of Sixes
Seat 5: Fiocco231 folded before Flop (didn't bet)
Seat 6: gs0097 showed [Js Jd] and won (€0.85) with a pair of Jacks



PokerStars Zoom Hand #257958095509:  Hold'em No Limit (€0.01/€0.02) [ADM ID: M62BA304494E32ST] - 2025/10/01 15:14:43 CET [2025/10/01 9:14:43 ET]
Table 'Sirio' 6-max Seat #1 is the button
Seat 1: vikisdad99 (€2.22 in chips) 
Seat 2: mauriziora58 (€0.83 in chips) 
Seat 3: OMGWOLFX (€5.74 in chips) 
Seat 4: padisha00 (€1.19 in chips) 
Seat 5: caduceus369 (€4.52 in chips) 
Seat 6: andrewbilliejoe (€2.22 in chips) 
mauriziora58: posts small blind €0.01
OMGWOLFX: posts big blind €0.02
*** HOLE CARDS ***
Dealt to caduceus369 [9d 3d]
padisha00: folds 
caduceus369: folds 
andrewbilliejoe: raises €0.03 to €0.05
vikisdad99: folds 
mauriziora58: calls €0.04
OMGWOLFX: calls €0.03
*** FLOP *** [Kc 8s Ad]
mauriziora58: checks 
OMGWOLFX: checks 
andrewbilliejoe: checks 
*** TURN *** [Kc 8s Ad] [4h]
mauriziora58: checks 
OMGWOLFX: checks 
andrewbilliejoe: checks 
*** RIVER *** [Kc 8s Ad 4h] [Ks]
mauriziora58: checks 
OMGWOLFX: checks 
andrewbilliejoe: checks 
*** SHOW DOWN ***
mauriziora58: shows [7c 2s] (a pair of Kings)
OMGWOLFX: mucks hand 
andrewbilliejoe: shows [Jd Qc] (a pair of Kings - Ace+Queen kicker)
andrewbilliejoe collected €0.15 from pot
*** SUMMARY ***
Total pot €0.15 | Rake €0 
Board [Kc 8s Ad 4h Ks]
Seat 1: vikisdad99 (button) folded before Flop (didn't bet)
Seat 2: mauriziora58 (small blind) showed [7c 2s] and lost with a pair of Kings
Seat 3: OMGWOLFX (big blind) mucked [5h 3h]
Seat 4: padisha00 folded before Flop (didn't bet)
Seat 5: caduceus369 folded before Flop (didn't bet)
Seat 6: andrewbilliejoe showed [Jd Qc] and won (€0.15) with a pair of Kings



PokerStars Zoom Hand #257958101622:  Hold'em No Limit (€0.01/€0.02) [ADM ID: M62BA304494E32ST] - 2025/10/01 15:15:29 CET [2025/10/01 9:15:29 ET]
Table 'Sirio' 6-max Seat #1 is the button
Seat 1: andrewbilliejoe (€2.05 in chips) 
Seat 2: caduceus369 (€4.09 in chips) 
Seat 3: gs0097 (€0.85 in chips) 
Seat 4: zlat11 (€0.59 in chips) 
Seat 5: Semifonte (€1.99 in chips) 
Seat 6: ghosto69 (€2.64 in chips) 
caduceus369: posts small blind €0.01
gs0097: posts big blind €0.02
*** HOLE CARDS ***
Dealt to caduceus369 [Tc 2d]
zlat11: raises €0.07 to €0.09
Semifonte: folds 
ghosto69: folds 
andrewbilliejoe: folds 
caduceus369: folds 
gs0097: folds 
Uncalled bet (€0.07) returned to zlat11
zlat11 collected €0.05 from pot
zlat11: doesn't show hand 
*** SUMMARY ***
Total pot €0.05 | Rake €0 
Seat 1: andrewbilliejoe (button) folded before Flop (didn't bet)
Seat 2: caduceus369 (small blind) folded before Flop
Seat 3: gs0097 (big blind) folded before Flop
Seat 4: zlat11 collected (€0.05)
Seat 5: Semifonte folded before Flop (didn't bet)
Seat 6: ghosto69 folded before Flop (didn't bet)



PokerStars Zoom Hand #257958102860:  Hold'em No Limit (€0.01/€0.02) [ADM ID: M62BA304494E32ST] - 2025/10/01 15:15:38 CET [2025/10/01 9:15:38 ET]
Table 'Sirio' 6-max Seat #1 is the button
Seat 1: lucpri (€2.61 in chips) 
Seat 2: TazCrack (€0.99 in chips) 
Seat 3: caduceus369 (€4.08 in chips) 
Seat 4: andrewbilliejoe (€2.05 in chips) 
Seat 5: Corr2659 (€2 in chips) 
Seat 6: gs0097 (€0.83 in chips) 
TazCrack: posts small blind €0.01
caduceus369: posts big blind €0.02
*** HOLE CARDS ***
Dealt to caduceus369 [Td Ah]
andrewbilliejoe: folds 
Corr2659: folds 
gs0097: folds 
lucpri: folds 
TazCrack: calls €0.01
caduceus369: checks 
*** FLOP *** [8d 4c 5s]
TazCrack: checks 
caduceus369: bets €0.02
TazCrack: calls €0.02
*** TURN *** [8d 4c 5s] [5h]
TazCrack: checks 
caduceus369: checks 
*** RIVER *** [8d 4c 5s 5h] [4s]
TazCrack: checks 
caduceus369: bets €0.02
TazCrack: folds 
Uncalled bet (€0.02) returned to caduceus369
caduceus369 collected €0.08 from pot
caduceus369: doesn't show hand 
*** SUMMARY ***
Total pot €0.08 | Rake €0 
Board [8d 4c 5s 5h 4s]
Seat 1: lucpri (button) folded before Flop (didn't bet)
Seat 2: TazCrack (small blind) folded on the River
Seat 3: caduceus369 (big blind) collected (€0.08)
Seat 4: andrewbilliejoe folded before Flop (didn't bet)
Seat 5: Corr2659 folded before Flop (didn't bet)
Seat 6: gs0097 folded before Flop (didn't bet)



PokerStars Zoom Hand #257958109149:  Hold'em No Limit (€0.01/€0.02) [ADM ID: M62BA304494E32ST] - 2025/10/01 15:16:26 CET [2025/10/01 9:16:26 ET]
Table 'Sirio' 6-max Seat #1 is the button
Seat 1: caduceus369 (€4.12 in chips) 
Seat 2: lucpri (€2.62 in chips) 
Seat 3: francovirde (€0.74 in chips) 
Seat 4: OMGWOLFX (€4.96 in chips) 
Seat 5: zlat11 (€0.60 in chips) 
Seat 6: ghosto69 (€2.03 in chips) 
lucpri: posts small blind €0.01
francovirde: posts big blind €0.02
*** HOLE CARDS ***
Dealt to caduceus369 [2s Qc]
OMGWOLFX: folds 
zlat11: folds 
ghosto69: raises €0.04 to €0.06
caduceus369: folds 
lucpri: folds 
francovirde: calls €0.04
*** FLOP *** [As 3s 6c]
francovirde: checks 
ghosto69: bets €0.04
francovirde: folds 
Uncalled bet (€0.04) returned to ghosto69
ghosto69 collected €0.13 from pot
ghosto69: doesn't show hand 
*** SUMMARY ***
Total pot €0.13 | Rake €0 
Board [As 3s 6c]
Seat 1: caduceus369 (button) folded before Flop (didn't bet)
Seat 2: lucpri (small blind) folded before Flop
Seat 3: francovirde (big blind) folded on the Flop
Seat 4: OMGWOLFX folded before Flop (didn't bet)
Seat 5: zlat11 folded before Flop (didn't bet)
Seat 6: ghosto69 collected (€0.13)



PokerStars Zoom Hand #257958111028:  Hold'em No Limit (€0.01/€0.02) [ADM ID: M62BA304494E32ST] - 2025/10/01 15:16:40 CET [2025/10/01 9:16:40 ET]
Table 'Sirio' 6-max Seat #1 is the button
Seat 1: lucpri (€2.61 in chips) 
Seat 2: OMGWOLFX (€4.59 in chips) 
Seat 3: gs0097 (€0.84 in chips) 
Seat 4: En199 (€0.73 in chips) 
Seat 5: andrewbilliejoe (€2.60 in chips) 
Seat 6: caduceus369 (€4.12 in chips) 
OMGWOLFX: posts small blind €0.01
gs0097: posts big blind €0.02
*** HOLE CARDS ***
Dealt to caduceus369 [6d 9s]
En199: raises €0.04 to €0.06
andrewbilliejoe: folds 
caduceus369: folds 
lucpri: folds 
OMGWOLFX: folds 
gs0097: folds 
Uncalled bet (€0.04) returned to En199
En199 collected €0.05 from pot
En199: doesn't show hand 
*** SUMMARY ***
Total pot €0.05 | Rake €0 
Seat 1: lucpri (button) folded before Flop (didn't bet)
Seat 2: OMGWOLFX (small blind) folded before Flop
Seat 3: gs0097 (big blind) folded before Flop
Seat 4: En199 collected (€0.05)
Seat 5: andrewbilliejoe folded before Flop (didn't bet)
Seat 6: caduceus369 folded before Flop (didn't bet)



PokerStars Zoom Hand #257958110310:  Hold'em No Limit (€0.01/€0.02) [ADM ID: M62BA304494E32ST] - 2025/10/01 15:16:35 CET [2025/10/01 9:16:35 ET]
Table 'Sirio' 6-max Seat #1 is the button
Seat 1: Semifonte (€1.70 in chips) 
Seat 2: andrewbilliejoe (€2 in chips) 
Seat 3: OMGWOLFX (€5.67 in chips) 
Seat 4: THE_CLOWN_74 (€2.31 in chips) 
Seat 5: caduceus369 (€4.12 in chips) 
Seat 6: lampo201 (€1.81 in chips) 
andrewbilliejoe: posts small blind €0.01
OMGWOLFX: posts big blind €0.02
*** HOLE CARDS ***
Dealt to caduceus369 [7h 5h]
THE_CLOWN_74: raises €0.06 to €0.08
caduceus369: folds 
lampo201: calls €0.08
Semifonte: folds 
andrewbilliejoe: folds 
OMGWOLFX: folds 
*** FLOP *** [Kd 7s Ts]
THE_CLOWN_74: bets €0.06
lampo201: calls €0.06
*** TURN *** [Kd 7s Ts] [8h]
THE_CLOWN_74: checks 
lampo201: bets €0.15
THE_CLOWN_74: folds 
Uncalled bet (€0.15) returned to lampo201
lampo201 collected €0.30 from pot
lampo201: doesn't show hand 
*** SUMMARY ***
Total pot €0.31 | Rake €0.01 
Board [Kd 7s Ts 8h]
Seat 1: Semifonte (button) folded before Flop (didn't bet)
Seat 2: andrewbilliejoe (small blind) folded before Flop
Seat 3: OMGWOLFX (big blind) folded before Flop
Seat 4: THE_CLOWN_74 folded on the Turn
Seat 5: caduceus369 folded before Flop (didn't bet)
Seat 6: lampo201 collected (€0.30)



PokerStars Zoom Hand #257958112033:  Hold'em No Limit (€0.01/€0.02) [ADM ID: M62BA304494E32ST] - 2025/10/01 15:16:48 CET [2025/10/01 9:16:48 ET]
Table 'Sirio' 6-max Seat #1 is the button
Seat 1: THE_CLOWN_74 (€2 in chips) 
Seat 2: caduceus369 (€4.12 in chips) 
Seat 3: ghosto69 (€2.61 in chips) 
Seat 4: andrewbilliejoe (€2 in chips) 
Seat 5: pylonstrip (€5.10 in chips) 
Seat 6: lucpri (€2.61 in chips) 
caduceus369: posts small blind €0.01
ghosto69: posts big blind €0.02
*** HOLE CARDS ***
Dealt to caduceus369 [Js Td]
andrewbilliejoe: folds 
pylonstrip: folds 
lucpri: calls €0.02
THE_CLOWN_74: raises €0.06 to €0.08
caduceus369: folds 
ghosto69: folds 
lucpri: folds 
Uncalled bet (€0.06) returned to THE_CLOWN_74
THE_CLOWN_74 collected €0.07 from pot
THE_CLOWN_74: doesn't show hand 
*** SUMMARY ***
Total pot €0.07 | Rake €0 
Seat 1: THE_CLOWN_74 (button) collected (€0.07)
Seat 2: caduceus369 (small blind) folded before Flop
Seat 3: ghosto69 (big blind) folded before Flop
Seat 4: andrewbilliejoe folded before Flop (didn't bet)
Seat 5: pylonstrip folded before Flop (didn't bet)
Seat 6: lucpri folded before Flop



PokerStars Zoom Hand #257958115056:  Hold'em No Limit (€0.01/€0.02) [ADM ID: M62BA304494E32ST] - 2025/10/01 15:17:11 CET [2025/10/01 9:17:11 ET]
Table 'Sirio' 6-max Seat #1 is the button
Seat 1: gs0097 (€0.82 in chips) 
Seat 2: OMGWOLFX (€5.65 in chips) 
Seat 3: andrewbilliejoe (€2 in chips) 
Seat 4: caduceus369 (€4.11 in chips) 
Seat 5: ghosto69 (€2.59 in chips) 
Seat 6: THE_CLOWN_74 (€2 in chips) 
OMGWOLFX: posts small blind €0.01
andrewbilliejoe: posts big blind €0.02
*** HOLE CARDS ***
Dealt to caduceus369 [Tc Qc]
caduceus369: calls €0.02
ghosto69: folds 
THE_CLOWN_74: folds 
gs0097: folds 
OMGWOLFX: calls €0.01
andrewbilliejoe: checks 
*** FLOP *** [4h Td Qs]
OMGWOLFX: bets €0.04
andrewbilliejoe: folds 
caduceus369: calls €0.04
*** TURN *** [4h Td Qs] [2c]
OMGWOLFX: bets €0.07
caduceus369: calls €0.07
*** RIVER *** [4h Td Qs 2c] [7d]
OMGWOLFX: bets €0.14
caduceus369: raises €0.32 to €0.46
OMGWOLFX: folds 
Uncalled bet (€0.32) returned to caduceus369
caduceus369 collected €0.53 from pot
caduceus369: doesn't show hand 
*** SUMMARY ***
Total pot €0.56 | Rake €0.03 
Board [4h Td Qs 2c 7d]
Seat 1: gs0097 (button) folded before Flop (didn't bet)
Seat 2: OMGWOLFX (small blind) folded on the River
Seat 3: andrewbilliejoe (big blind) folded on the Flop
Seat 4: caduceus369 collected (€0.53)
Seat 5: ghosto69 folded before Flop (didn't bet)
Seat 6: THE_CLOWN_74 folded before Flop (didn't bet)



PokerStars Zoom Hand #257958123856:  Hold'em No Limit (€0.01/€0.02) [ADM ID: M62BA304494E32ST] - 2025/10/01 15:18:18 CET [2025/10/01 9:18:18 ET]
Table 'Sirio' 6-max Seat #1 is the button
Seat 1: caduceus369 (€4.37 in chips) 
Seat 2: mrniceseed (€3.77 in chips) 
Seat 3: andrewbilliejoe (€2.61 in chips) 
Seat 4: pylonstrip (€5.33 in chips) 
Seat 5: THE_CLOWN_74 (€2.08 in chips) 
Seat 6: vikisdad99 (€1.67 in chips) 
mrniceseed: posts small blind €0.01
andrewbilliejoe: posts big blind €0.02
*** HOLE CARDS ***
Dealt to caduceus369 [Th 4s]
pylonstrip: folds 
THE_CLOWN_74: folds 
vikisdad99: folds 
caduceus369: folds 
mrniceseed: folds 
Uncalled bet (€0.01) returned to andrewbilliejoe
andrewbilliejoe collected €0.02 from pot
andrewbilliejoe: doesn't show hand 
*** SUMMARY ***
Total pot €0.02 | Rake €0 
Seat 1: caduceus369 (button) folded before Flop (didn't bet)
Seat 2: mrniceseed (small blind) folded before Flop
Seat 3: andrewbilliejoe (big blind) collected (€0.02)
Seat 4: pylonstrip folded before Flop (didn't bet)
Seat 5: THE_CLOWN_74 folded before Flop (didn't bet)
Seat 6: vikisdad99 folded before Flop (didn't bet)



PokerStars Zoom Hand #257958109551:  Hold'em No Limit (€0.01/€0.02) [ADM ID: M62BA304494E32ST] - 2025/10/01 15:16:29 CET [2025/10/01 9:16:29 ET]
Table 'Sirio' 6-max Seat #1 is the button
Seat 1: Corr2659 (€2 in chips) 
Seat 2: Goblin1999 (€2.22 in chips) 
Seat 3: TONNOeRUCOLA (€4.55 in chips) 
Seat 4: andrewbilliejoe (€4.65 in chips) 
Seat 5: TazCrack (€0.95 in chips) 
Seat 6: caduceus369 (€4.12 in chips) 
Goblin1999: posts small blind €0.01
TONNOeRUCOLA: posts big blind €0.02
*** HOLE CARDS ***
Dealt to caduceus369 [6h 2h]
andrewbilliejoe: folds 
TazCrack: raises €0.04 to €0.06
caduceus369: folds 
Corr2659: calls €0.06
Goblin1999: calls €0.05
TONNOeRUCOLA: calls €0.04
*** FLOP *** [6s Tc Js]
Goblin1999: checks 
TONNOeRUCOLA: bets €0.12
TazCrack: calls €0.12
Corr2659: calls €0.12
Goblin1999 is disconnected 
Goblin1999: calls €0.12
*** TURN *** [6s Tc Js] [Ac]
Goblin1999: checks 
TONNOeRUCOLA: checks 
TazCrack: bets €0.19
Corr2659: folds 
Goblin1999: calls €0.19
TONNOeRUCOLA: folds 
*** RIVER *** [6s Tc Js Ac] [4h]
Goblin1999: bets €1.85 and is all-in
TazCrack: calls €0.58 and is all-in
Uncalled bet (€1.27) returned to Goblin1999
*** SHOW DOWN ***
Goblin1999: shows [9c Qc] (high card Ace)
TazCrack: shows [Qh Kd] (a straight, Ten to Ace)
TazCrack collected €2.14 from pot
*** SUMMARY ***
Total pot €2.26 | Rake €0.12 
Board [6s Tc Js Ac 4h]
Seat 1: Corr2659 (button) folded on the Turn
Seat 2: Goblin1999 (small blind) showed [9c Qc] and lost with high card Ace
Seat 3: TONNOeRUCOLA (big blind) folded on the Turn
Seat 4: andrewbilliejoe folded before Flop (didn't bet)
Seat 5: TazCrack showed [Qh Kd] and won (€2.14) with a straight, Ten to Ace
Seat 6: caduceus369 folded before Flop (didn't bet)



PokerStars Zoom Hand #257958125181:  Hold'em No Limit (€0.01/€0.02) [ADM ID: M62BA304494E32ST] - 2025/10/01 15:18:28 CET [2025/10/01 9:18:28 ET]
Table 'Sirio' 6-max Seat #1 is the button
Seat 1: Fiocco231 (€1.16 in chips) 
Seat 2: kikibaba (€1.55 in chips) 
Seat 3: caduceus369 (€4.37 in chips) 
Seat 4: felixbo1 (€2.35 in chips) 
Seat 5: THE_CLOWN_74 (€2.14 in chips) 
Seat 6: andrewbilliejoe (€2 in chips) 
kikibaba: posts small blind €0.01
caduceus369: posts big blind €0.02
*** HOLE CARDS ***
Dealt to caduceus369 [8s Jc]
kikibaba is disconnected 
felixbo1: calls €0.02
THE_CLOWN_74: folds 
andrewbilliejoe: folds 
Fiocco231: calls €0.02
kikibaba has timed out while disconnected
kikibaba: folds 
caduceus369: checks 
*** FLOP *** [2h 8c 7d]
caduceus369: bets €0.02
felixbo1: calls €0.02
Fiocco231: calls €0.02
*** TURN *** [2h 8c 7d] [9s]
caduceus369: checks 
felixbo1: bets €0.13
Fiocco231: folds 
caduceus369: folds 
Uncalled bet (€0.13) returned to felixbo1
felixbo1 collected €0.13 from pot
felixbo1: doesn't show hand 
*** SUMMARY ***
Total pot €0.13 | Rake €0 
Board [2h 8c 7d 9s]
Seat 1: Fiocco231 (button) folded on the Turn
Seat 2: kikibaba (small blind) folded before Flop
Seat 3: caduceus369 (big blind) folded on the Turn
Seat 4: felixbo1 collected (€0.13)
Seat 5: THE_CLOWN_74 folded before Flop (didn't bet)
Seat 6: andrewbilliejoe folded before Flop (didn't bet)



PokerStars Zoom Hand #257958130706:  Hold'em No Limit (€0.01/€0.02) [ADM ID: M62BA304494E32ST] - 2025/10/01 15:19:10 CET [2025/10/01 9:19:10 ET]
Table 'Sirio' 6-max Seat #1 is the button
Seat 1: pylonstrip (€5.57 in chips) 
Seat 2: ghosto69 (€0.81 in chips) 
Seat 3: andrewbilliejoe (€2 in chips) 
Seat 4: padisha00 (€1.53 in chips) 
Seat 5: gs0097 (€0.72 in chips) 
Seat 6: caduceus369 (€4.33 in chips) 
ghosto69: posts small blind €0.01
andrewbilliejoe: posts big blind €0.02
*** HOLE CARDS ***
Dealt to caduceus369 [9h Ad]
padisha00: raises €0.04 to €0.06
gs0097: folds 
caduceus369: folds 
pylonstrip: folds 
ghosto69: folds 
andrewbilliejoe: folds 
Uncalled bet (€0.04) returned to padisha00
padisha00 collected €0.05 from pot
padisha00: doesn't show hand 
*** SUMMARY ***
Total pot €0.05 | Rake €0 
Seat 1: pylonstrip (button) folded before Flop (didn't bet)
Seat 2: ghosto69 (small blind) folded before Flop
Seat 3: andrewbilliejoe (big blind) folded before Flop
Seat 4: padisha00 collected (€0.05)
Seat 5: gs0097 folded before Flop (didn't bet)
Seat 6: caduceus369 folded before Flop (didn't bet)



PokerStars Zoom Hand #257958131183:  Hold'em No Limit (€0.01/€0.02) [ADM ID: M62BA304494E32ST] - 2025/10/01 15:19:13 CET [2025/10/01 9:19:13 ET]
Table 'Sirio' 6-max Seat #1 is the button
Seat 1: ghosto69 (€0.80 in chips) 
Seat 2: Brigantoni66 (€1.42 in chips) 
Seat 3: pylonstrip (€5.57 in chips) 
Seat 4: caduceus369 (€4.33 in chips) 
Seat 5: MathMassacreX (€5.44 in chips) 
Seat 6: 12Ciccio (€1.25 in chips) 
Brigantoni66: posts small blind €0.01
pylonstrip: posts big blind €0.02
*** HOLE CARDS ***
Dealt to caduceus369 [8c Js]
caduceus369: folds 
MathMassacreX: raises €0.05 to €0.07
12Ciccio: calls €0.07
ghosto69: folds 
Brigantoni66: folds 
pylonstrip: folds 
*** FLOP *** [5h Jd As]
MathMassacreX: bets €0.06
12Ciccio: raises €1.12 to €1.18 and is all-in
Brigantoni66 is disconnected 
MathMassacreX: folds 
Uncalled bet (€1.12) returned to 12Ciccio
12Ciccio collected €0.28 from pot
12Ciccio: doesn't show hand 
*** SUMMARY ***
Total pot €0.29 | Rake €0.01 
Board [5h Jd As]
Seat 1: ghosto69 (button) folded before Flop (didn't bet)
Seat 2: Brigantoni66 (small blind) folded before Flop
Seat 3: pylonstrip (big blind) folded before Flop
Seat 4: caduceus369 folded before Flop (didn't bet)
Seat 5: MathMassacreX folded on the Flop
Seat 6: 12Ciccio collected (€0.28)



PokerStars Zoom Hand #257958132499:  Hold'em No Limit (€0.01/€0.02) [ADM ID: M62BA304494E32ST] - 2025/10/01 15:19:23 CET [2025/10/01 9:19:23 ET]
Table 'Sirio' 6-max Seat #1 is the button
Seat 1: OMGWOLFX (€4.57 in chips) 
Seat 2: andrewbilliejoe (€2.62 in chips) 
Seat 3: lampo201 (€2.36 in chips) 
Seat 4: ghosto69 (€2.65 in chips) 
Seat 5: caduceus369 (€4.33 in chips) 
Seat 6: Brigantoni66 (€1.41 in chips) 
andrewbilliejoe: posts small blind €0.01
lampo201: posts big blind €0.02
*** HOLE CARDS ***
Dealt to caduceus369 [Jd 9h]
ghosto69: folds 
caduceus369: folds 
Brigantoni66: folds 
Brigantoni66 is disconnected 
OMGWOLFX: folds 
andrewbilliejoe: folds 
Uncalled bet (€0.01) returned to lampo201
lampo201 collected €0.02 from pot
lampo201: doesn't show hand 
*** SUMMARY ***
Total pot €0.02 | Rake €0 
Seat 1: OMGWOLFX (button) folded before Flop (didn't bet)
Seat 2: andrewbilliejoe (small blind) folded before Flop
Seat 3: lampo201 (big blind) collected (€0.02)
Seat 4: ghosto69 folded before Flop (didn't bet)
Seat 5: caduceus369 folded before Flop (didn't bet)
Seat 6: Brigantoni66 folded before Flop (didn't bet)



PokerStars Zoom Hand #257958133072:  Hold'em No Limit (€0.01/€0.02) [ADM ID: M62BA304494E32ST] - 2025/10/01 15:19:27 CET [2025/10/01 9:19:27 ET]
Table 'Sirio' 6-max Seat #1 is the button
Seat 1: ghosto69 (€2.65 in chips) 
Seat 2: caduceus369 (€4.33 in chips) 
Seat 3: padisha00 (€1.56 in chips) 
Seat 4: Brigantoni66 (€1.41 in chips) 
Seat 5: Corr2659 (€2.07 in chips) 
Seat 6: pylonstrip (€5.55 in chips) 
caduceus369: posts small blind €0.01
padisha00: posts big blind €0.02
*** HOLE CARDS ***
Dealt to caduceus369 [Kc Jh]
Brigantoni66: folds 
Corr2659: folds 
pylonstrip: folds 
ghosto69: folds 
caduceus369: calls €0.01
padisha00: checks 
*** FLOP *** [Kd 5d 4h]
caduceus369: checks 
padisha00: checks 
*** TURN *** [Kd 5d 4h] [2h]
caduceus369: bets €0.02
padisha00: folds 
Uncalled bet (€0.02) returned to caduceus369
caduceus369 collected €0.04 from pot
caduceus369: doesn't show hand 
*** SUMMARY ***
Total pot €0.04 | Rake €0 
Board [Kd 5d 4h 2h]
Seat 1: ghosto69 (button) folded before Flop (didn't bet)
Seat 2: caduceus369 (small blind) collected (€0.04)
Seat 3: padisha00 (big blind) folded on the Turn
Seat 4: Brigantoni66 folded before Flop (didn't bet)
Seat 5: Corr2659 folded before Flop (didn't bet)
Seat 6: pylonstrip folded before Flop (didn't bet)



PokerStars Zoom Hand #257958137262:  Hold'em No Limit (€0.01/€0.02) [ADM ID: M62BA304494E32ST] - 2025/10/01 15:19:58 CET [2025/10/01 9:19:58 ET]
Table 'Sirio' 6-max Seat #1 is the button
Seat 1: gs0097 (€0.71 in chips) 
Seat 2: andrewbilliejoe (€2.01 in chips) 
Seat 3: caduceus369 (€4.35 in chips) 
Seat 4: Miele69409 (€0.49 in chips) 
Seat 5: colosso2022 (€2.58 in chips) 
Seat 6: OMGWOLFX (€4.66 in chips) 
andrewbilliejoe: posts small blind €0.01
caduceus369: posts big blind €0.02
*** HOLE CARDS ***
Dealt to caduceus369 [2d Ah]
Miele69409: calls €0.02
colosso2022: calls €0.02
OMGWOLFX: folds 
gs0097: folds 
andrewbilliejoe: folds 
caduceus369: checks 
*** FLOP *** [3d 8s 3c]
caduceus369: checks 
Miele69409: bets €0.02
colosso2022: raises €0.06 to €0.08
caduceus369: folds 
Miele69409: calls €0.06
*** TURN *** [3d 8s 3c] [8d]
Miele69409: checks 
colosso2022: bets €0.22
Miele69409: calls €0.22
*** RIVER *** [3d 8s 3c 8d] [Tc]
Miele69409: bets €0.17 and is all-in
colosso2022: calls €0.17
*** SHOW DOWN ***
Miele69409: shows [Jh Ac] (two pair, Eights and Threes)
colosso2022: shows [Ad 9d] (two pair, Eights and Threes)
Miele69409 collected €0.48 from pot
colosso2022 collected €0.48 from pot
*** SUMMARY ***
Total pot €1.01 | Rake €0.05 
Board [3d 8s 3c 8d Tc]
Seat 1: gs0097 (button) folded before Flop (didn't bet)
Seat 2: andrewbilliejoe (small blind) folded before Flop
Seat 3: caduceus369 (big blind) folded on the Flop
Seat 4: Miele69409 showed [Jh Ac] and won (€0.48) with two pair, Eights and Threes
Seat 5: colosso2022 showed [Ad 9d] and won (€0.48) with two pair, Eights and Threes
Seat 6: OMGWOLFX folded before Flop (didn't bet)



PokerStars Zoom Hand #257958141124:  Hold'em No Limit (€0.01/€0.02) [ADM ID: M62BA304494E32ST] - 2025/10/01 15:20:28 CET [2025/10/01 9:20:28 ET]
Table 'Sirio' 6-max Seat #1 is the button
Seat 1: caduceus369 (€4.33 in chips) 
Seat 2: 12Ciccio (€0.06 in chips) 
Seat 3: TazCrack (€2.19 in chips) 
Seat 4: francovirde (€2.60 in chips) 
Seat 5: Corr2659 (€2 in chips) 
Seat 6: ghosto69 (€1.07 in chips) 
12Ciccio: posts small blind €0.01
TazCrack: posts big blind €0.02
*** HOLE CARDS ***
Dealt to caduceus369 [9d 3c]
francovirde: folds 
Corr2659: folds 
ghosto69: folds 
caduceus369: folds 
12Ciccio: raises €0.02 to €0.04
TazCrack: folds 
Uncalled bet (€0.02) returned to 12Ciccio
12Ciccio collected €0.04 from pot
12Ciccio: doesn't show hand 
*** SUMMARY ***
Total pot €0.04 | Rake €0 
Seat 1: caduceus369 (button) folded before Flop (didn't bet)
Seat 2: 12Ciccio (small blind) collected (€0.04)
Seat 3: TazCrack (big blind) folded before Flop
Seat 4: francovirde folded before Flop (didn't bet)
Seat 5: Corr2659 folded before Flop (didn't bet)
Seat 6: ghosto69 folded before Flop (didn't bet)



PokerStars Zoom Hand #257958141683:  Hold'em No Limit (€0.01/€0.02) [ADM ID: M62BA304494E32ST] - 2025/10/01 15:20:32 CET [2025/10/01 9:20:32 ET]
Table 'Sirio' 6-max Seat #1 is the button
Seat 1: andrewbilliejoe (€2 in chips) 
Seat 2: OMGWOLFX (€4.57 in chips) 
Seat 3: francovirde (€2.60 in chips) 
Seat 4: caduceus369 (€4.33 in chips) 
Seat 5: TONNOeRUCOLA (€4.59 in chips) 
Seat 6: zlat11 (€1.61 in chips) 
OMGWOLFX: posts small blind €0.01
francovirde: posts big blind €0.02
*** HOLE CARDS ***
Dealt to caduceus369 [8s 9c]
caduceus369: folds 
TONNOeRUCOLA: folds 
zlat11: folds 
andrewbilliejoe: folds 
OMGWOLFX: raises €0.04 to €0.06
francovirde: folds 
Uncalled bet (€0.04) returned to OMGWOLFX
OMGWOLFX collected €0.04 from pot
OMGWOLFX: doesn't show hand 
*** SUMMARY ***
Total pot €0.04 | Rake €0 
Seat 1: andrewbilliejoe (button) folded before Flop (didn't bet)
Seat 2: OMGWOLFX (small blind) collected (€0.04)
Seat 3: francovirde (big blind) folded before Flop
Seat 4: caduceus369 folded before Flop (didn't bet)
Seat 5: TONNOeRUCOLA folded before Flop (didn't bet)
Seat 6: zlat11 folded before Flop (didn't bet)



PokerStars Zoom Hand #257958140572:  Hold'em No Limit (€0.01/€0.02) [ADM ID: M62BA304494E32ST] - 2025/10/01 15:20:24 CET [2025/10/01 9:20:24 ET]
Table 'Sirio' 6-max Seat #1 is the button
Seat 1: pylonstrip (€5.57 in chips) 
Seat 2: mafg420 (€1.07 in chips) 
Seat 3: gs0097 (€0.71 in chips) 
Seat 4: andrewbilliejoe (€2 in chips) 
Seat 5: caduceus369 (€4.33 in chips) 
Seat 6: OMGWOLFX (€5.32 in chips) 
mafg420: posts small blind €0.01
gs0097: posts big blind €0.02
*** HOLE CARDS ***
Dealt to caduceus369 [8s 3d]
andrewbilliejoe: folds 
caduceus369: folds 
OMGWOLFX: folds 
pylonstrip: raises €0.04 to €0.06
mafg420: calls €0.05
gs0097: folds 
*** FLOP *** [4d Td 4c]
mafg420: checks 
pylonstrip: bets €0.07
mafg420: calls €0.07
*** TURN *** [4d Td 4c] [Kc]
mafg420: checks 
pylonstrip: checks 
*** RIVER *** [4d Td 4c Kc] [5c]
mafg420: checks 
pylonstrip: checks 
*** SHOW DOWN ***
mafg420: shows [Ad 6s] (a pair of Fours)
pylonstrip: shows [5s 7s] (two pair, Fives and Fours)
pylonstrip collected €0.27 from pot
*** SUMMARY ***
Total pot €0.28 | Rake €0.01 
Board [4d Td 4c Kc 5c]
Seat 1: pylonstrip (button) showed [5s 7s] and won (€0.27) with two pair, Fives and Fours
Seat 2: mafg420 (small blind) showed [Ad 6s] and lost with a pair of Fours
Seat 3: gs0097 (big blind) folded before Flop
Seat 4: andrewbilliejoe folded before Flop (didn't bet)
Seat 5: caduceus369 folded before Flop (didn't bet)
Seat 6: OMGWOLFX folded before Flop (didn't bet)



PokerStars Zoom Hand #257958143176:  Hold'em No Limit (€0.01/€0.02) [ADM ID: M62BA304494E32ST] - 2025/10/01 15:20:43 CET [2025/10/01 9:20:43 ET]
Table 'Sirio' 6-max Seat #1 is the button
Seat 1: 12Ciccio (€0.08 in chips) 
Seat 2: caduceus369 (€4.33 in chips) 
Seat 3: lucpri (€2.15 in chips) 
Seat 4: zlat11 (€1.61 in chips) 
Seat 5: felixbo1 (€2.36 in chips) 
Seat 6: andrewbilliejoe (€2 in chips) 
caduceus369: posts small blind €0.01
lucpri: posts big blind €0.02
*** HOLE CARDS ***
Dealt to caduceus369 [4d 5h]
zlat11: folds 
felixbo1: folds 
andrewbilliejoe: folds 
12Ciccio: raises €0.06 to €0.08 and is all-in
caduceus369: folds 
lucpri: folds 
Uncalled bet (€0.06) returned to 12Ciccio
12Ciccio collected €0.05 from pot
12Ciccio: doesn't show hand 
*** SUMMARY ***
Total pot €0.05 | Rake €0 
Seat 1: 12Ciccio (button) collected (€0.05)
Seat 2: caduceus369 (small blind) folded before Flop
Seat 3: lucpri (big blind) folded before Flop
Seat 4: zlat11 folded before Flop (didn't bet)
Seat 5: felixbo1 folded before Flop (didn't bet)
Seat 6: andrewbilliejoe folded before Flop (didn't bet)



PokerStars Zoom Hand #257958142382:  Hold'em No Limit (€0.01/€0.02) [ADM ID: M62BA304494E32ST] - 2025/10/01 15:20:37 CET [2025/10/01 9:20:37 ET]
Table 'Sirio' 6-max Seat #1 is the button
Seat 1: andrewbilliejoe (€2.61 in chips) 
Seat 2: padisha00 (€1.50 in chips) 
Seat 3: ghosto69 (€1.07 in chips) 
Seat 4: Corr2659 (€2 in chips) 
Seat 5: zlat11 (€1.61 in chips) 
Seat 6: caduceus369 (€4.33 in chips) 
padisha00: posts small blind €0.01
ghosto69: posts big blind €0.02
*** HOLE CARDS ***
Dealt to caduceus369 [3h 8h]
Corr2659: raises €0.05 to €0.07
zlat11: folds 
caduceus369: folds 
andrewbilliejoe: folds 
padisha00: folds 
ghosto69: calls €0.05
*** FLOP *** [4h Qc Jh]
ghosto69: checks 
Corr2659: bets €0.06
ghosto69: folds 
Uncalled bet (€0.06) returned to Corr2659
Corr2659 collected €0.15 from pot
Corr2659: doesn't show hand 
*** SUMMARY ***
Total pot €0.15 | Rake €0 
Board [4h Qc Jh]
Seat 1: andrewbilliejoe (button) folded before Flop (didn't bet)
Seat 2: padisha00 (small blind) folded before Flop
Seat 3: ghosto69 (big blind) folded on the Flop
Seat 4: Corr2659 collected (€0.15)
Seat 5: zlat11 folded before Flop (didn't bet)
Seat 6: caduceus369 folded before Flop (didn't bet)



PokerStars Zoom Hand #257958143752:  Hold'em No Limit (€0.01/€0.02) [ADM ID: M62BA304494E32ST] - 2025/10/01 15:20:47 CET [2025/10/01 9:20:47 ET]
Table 'Sirio' 6-max Seat #1 is the button
Seat 1: felixbo1 (€2.36 in chips) 
Seat 2: francovirde (€2.58 in chips) 
Seat 3: Semifonte (€2.02 in chips) 
Seat 4: memocol1 (€0.99 in chips) 
Seat 5: caduceus369 (€4.32 in chips) 
Seat 6: zlat11 (€1.61 in chips) 
francovirde: posts small blind €0.01
Semifonte: posts big blind €0.02
*** HOLE CARDS ***
Dealt to caduceus369 [5c Th]
memocol1: calls €0.02
caduceus369: folds 
zlat11: folds 
felixbo1: calls €0.02
francovirde: calls €0.01
Semifonte: checks 
*** FLOP *** [6d 9c 6h]
francovirde: checks 
Semifonte: checks 
memocol1: bets €0.02
felixbo1: folds 
francovirde: folds 
Semifonte: folds 
Uncalled bet (€0.02) returned to memocol1
memocol1 collected €0.08 from pot
memocol1: doesn't show hand 
*** SUMMARY ***
Total pot €0.08 | Rake €0 
Board [6d 9c 6h]
Seat 1: felixbo1 (button) folded on the Flop
Seat 2: francovirde (small blind) folded on the Flop
Seat 3: Semifonte (big blind) folded on the Flop
Seat 4: memocol1 collected (€0.08)
Seat 5: caduceus369 folded before Flop (didn't bet)
Seat 6: zlat11 folded before Flop (didn't bet)



PokerStars Zoom Hand #257958145761:  Hold'em No Limit (€0.01/€0.02) [ADM ID: M62BA304494E32ST] - 2025/10/01 15:21:02 CET [2025/10/01 9:21:02 ET]
Table 'Sirio' 6-max Seat #1 is the button
Seat 1: caduceus369 (€4.30 in chips) 
Seat 2: Quelle128 (€0.80 in chips) 
Seat 3: andrewbilliejoe (€2.08 in chips) 
Seat 4: gs0097 (€0.67 in chips) 
Seat 5: 12Ciccio (€0.11 in chips) 
Seat 6: ghosto69 (€2.61 in chips) 
Quelle128: posts small blind €0.01
andrewbilliejoe: posts big blind €0.02
*** HOLE CARDS ***
Dealt to caduceus369 [5c 9c]
gs0097: folds 
12Ciccio: folds 
ghosto69: folds 
caduceus369: folds 
Quelle128: folds 
Uncalled bet (€0.01) returned to andrewbilliejoe
andrewbilliejoe collected €0.02 from pot
andrewbilliejoe: doesn't show hand 
*** SUMMARY ***
Total pot €0.02 | Rake €0 
Seat 1: caduceus369 (button) folded before Flop (didn't bet)
Seat 2: Quelle128 (small blind) folded before Flop
Seat 3: andrewbilliejoe (big blind) collected (€0.02)
Seat 4: gs0097 folded before Flop (didn't bet)
Seat 5: 12Ciccio folded before Flop (didn't bet)
Seat 6: ghosto69 folded before Flop (didn't bet)



PokerStars Zoom Hand #257958144390:  Hold'em No Limit (€0.01/€0.02) [ADM ID: M62BA304494E32ST] - 2025/10/01 15:20:52 CET [2025/10/01 9:20:52 ET]
Table 'Sirio' 6-max Seat #1 is the button
Seat 1: lampo201 (€3.12 in chips) 
Seat 2: TONNOeRUCOLA (€4.59 in chips) 
Seat 3: caduceus369 (€4.32 in chips) 
Seat 4: andrewbilliejoe (€2 in chips) 
Seat 5: OMGWOLFX (€4.59 in chips) 
Seat 6: ghosto69 (€1.77 in chips) 
TONNOeRUCOLA: posts small blind €0.01
caduceus369: posts big blind €0.02
*** HOLE CARDS ***
Dealt to caduceus369 [Kh 3d]
andrewbilliejoe: folds 
OMGWOLFX: raises €0.04 to €0.06
ghosto69: folds 
lampo201: calls €0.06
TONNOeRUCOLA: folds 
caduceus369: folds 
*** FLOP *** [5h Js Jd]
OMGWOLFX: bets €0.08
lampo201: folds 
Uncalled bet (€0.08) returned to OMGWOLFX
OMGWOLFX collected €0.15 from pot
OMGWOLFX: doesn't show hand 
*** SUMMARY ***
Total pot €0.15 | Rake €0 
Board [5h Js Jd]
Seat 1: lampo201 (button) folded on the Flop
Seat 2: TONNOeRUCOLA (small blind) folded before Flop
Seat 3: caduceus369 (big blind) folded before Flop
Seat 4: andrewbilliejoe folded before Flop (didn't bet)
Seat 5: OMGWOLFX collected (€0.15)
Seat 6: ghosto69 folded before Flop (didn't bet)



PokerStars Zoom Hand #257958146632:  Hold'em No Limit (€0.01/€0.02) [ADM ID: M62BA304494E32ST] - 2025/10/01 15:21:08 CET [2025/10/01 9:21:08 ET]
Table 'Sirio' 6-max Seat #1 is the button
Seat 1: S'dj83 (€2 in chips) 
Seat 2: gs0097 (€0.67 in chips) 
Seat 3: 12Ciccio (€0.11 in chips) 
Seat 4: andrewbilliejoe (€2.59 in chips) 
Seat 5: ghosto69 (€2.61 in chips) 
Seat 6: caduceus369 (€4.30 in chips) 
gs0097: posts small blind €0.01
12Ciccio: posts big blind €0.02
*** HOLE CARDS ***
Dealt to caduceus369 [6h Ac]
andrewbilliejoe: folds 
ghosto69: folds 
caduceus369: folds 
S'dj83: raises €0.04 to €0.06
gs0097: folds 
12Ciccio: raises €0.05 to €0.11 and is all-in
S'dj83: calls €0.05
*** FLOP *** [3d Qs 5h]
*** TURN *** [3d Qs 5h] [8h]
*** RIVER *** [3d Qs 5h 8h] [7h]
*** SHOW DOWN ***
12Ciccio: shows [Jd Ts] (high card Queen)
S'dj83: shows [Tc Jc] (high card Queen)
12Ciccio collected €0.11 from pot
S'dj83 collected €0.11 from pot
*** SUMMARY ***
Total pot €0.23 | Rake €0.01 
Board [3d Qs 5h 8h 7h]
Seat 1: S'dj83 (button) showed [Tc Jc] and won (€0.11) with high card Queen
Seat 2: gs0097 (small blind) folded before Flop
Seat 3: 12Ciccio (big blind) showed [Jd Ts] and won (€0.11) with high card Queen
Seat 4: andrewbilliejoe folded before Flop (didn't bet)
Seat 5: ghosto69 folded before Flop (didn't bet)
Seat 6: caduceus369 folded before Flop (didn't bet)



PokerStars Zoom Hand #257958150614:  Hold'em No Limit (€0.01/€0.02) [ADM ID: M62BA304494E32ST] - 2025/10/01 15:21:38 CET [2025/10/01 9:21:38 ET]
Table 'Sirio' 6-max Seat #1 is the button
Seat 1: padisha00 (€1.48 in chips) 
Seat 2: caduceus369 (€4.26 in chips) 
Seat 3: OMGWOLFX (€4.68 in chips) 
Seat 4: ghosto69 (€0.99 in chips) 
Seat 5: francovirde (€2.38 in chips) 
Seat 6: Semifonte (€1.96 in chips) 
caduceus369: posts small blind €0.01
OMGWOLFX: posts big blind €0.02
*** HOLE CARDS ***
Dealt to caduceus369 [Qs Qd]
ghosto69: folds 
francovirde: folds 
Semifonte: folds 
padisha00: raises €0.04 to €0.06
caduceus369: raises €0.12 to €0.18
OMGWOLFX: folds 
padisha00: folds 
Uncalled bet (€0.12) returned to caduceus369
caduceus369 collected €0.14 from pot
caduceus369: doesn't show hand 
*** SUMMARY ***
Total pot €0.14 | Rake €0 
Seat 1: padisha00 (button) folded before Flop
Seat 2: caduceus369 (small blind) collected (€0.14)
Seat 3: OMGWOLFX (big blind) folded before Flop
Seat 4: ghosto69 folded before Flop (didn't bet)
Seat 5: francovirde folded before Flop (didn't bet)
Seat 6: Semifonte folded before Flop (didn't bet)



PokerStars Zoom Hand #257958147815:  Hold'em No Limit (€0.01/€0.02) [ADM ID: M62BA304494E32ST] - 2025/10/01 15:21:17 CET [2025/10/01 9:21:17 ET]
Table 'Sirio' 6-max Seat #1 is the button
Seat 1: TONNOeRUCOLA (€4.56 in chips) 
Seat 2: memocol1 (€1.05 in chips) 
Seat 3: andrewbilliejoe (€2 in chips) 
Seat 4: caduceus369 (€4.30 in chips) 
Seat 5: gs0097 (€0.66 in chips) 
Seat 6: lucpri (€2.13 in chips) 
memocol1: posts small blind €0.01
andrewbilliejoe: posts big blind €0.02
*** HOLE CARDS ***
Dealt to caduceus369 [Qs Kc]
caduceus369: raises €0.02 to €0.04
gs0097: raises €0.11 to €0.15
lucpri: folds 
TONNOeRUCOLA: calls €0.15
memocol1: folds 
andrewbilliejoe: folds 
caduceus369: folds 
*** FLOP *** [Ah 3s 3d]
gs0097: bets €0.35
TONNOeRUCOLA: folds 
Uncalled bet (€0.35) returned to gs0097
gs0097 collected €0.35 from pot
gs0097: doesn't show hand 
*** SUMMARY ***
Total pot €0.37 | Rake €0.02 
Board [Ah 3s 3d]
Seat 1: TONNOeRUCOLA (button) folded on the Flop
Seat 2: memocol1 (small blind) folded before Flop
Seat 3: andrewbilliejoe (big blind) folded before Flop
Seat 4: caduceus369 folded before Flop
Seat 5: gs0097 collected (€0.35)
Seat 6: lucpri folded before Flop (didn't bet)



PokerStars Zoom Hand #257958153996:  Hold'em No Limit (€0.01/€0.02) [ADM ID: M62BA304494E32ST] - 2025/10/01 15:22:03 CET [2025/10/01 9:22:03 ET]
Table 'Sirio' 6-max Seat #1 is the button
Seat 1: Semifonte (€1.94 in chips) 
Seat 2: pylonstrip (€5.64 in chips) 
Seat 3: OMGWOLFX (€4.31 in chips) 
Seat 4: ghosto69 (€1.74 in chips) 
Seat 5: caduceus369 (€4.34 in chips) 
Seat 6: andrewbilliejoe (€2.08 in chips) 
pylonstrip: posts small blind €0.01
OMGWOLFX: posts big blind €0.02
*** HOLE CARDS ***
Dealt to caduceus369 [5d Js]
ghosto69 has timed out
ghosto69: folds 
caduceus369: folds 
andrewbilliejoe: folds 
Semifonte: folds 
pylonstrip: folds 
Uncalled bet (€0.01) returned to OMGWOLFX
OMGWOLFX collected €0.02 from pot
OMGWOLFX: doesn't show hand 
*** SUMMARY ***
Total pot €0.02 | Rake €0 
Seat 1: Semifonte (button) folded before Flop (didn't bet)
Seat 2: pylonstrip (small blind) folded before Flop
Seat 3: OMGWOLFX (big blind) collected (€0.02)
Seat 4: ghosto69 folded before Flop (didn't bet)
Seat 5: caduceus369 folded before Flop (didn't bet)
Seat 6: andrewbilliejoe folded before Flop (didn't bet)



PokerStars Zoom Hand #257958154893:  Hold'em No Limit (€0.01/€0.02) [ADM ID: M62BA304494E32ST] - 2025/10/01 15:22:10 CET [2025/10/01 9:22:10 ET]
Table 'Sirio' 6-max Seat #1 is the button
Seat 1: raisereraiseall (€1.24 in chips) 
Seat 2: Semifonte (€1.94 in chips) 
Seat 3: caduceus369 (€4.34 in chips) 
Seat 4: lampo201 (€3 in chips) 
Seat 5: andrewbilliejoe (€2 in chips) 
Seat 6: TONNOeRUCOLA (€4.41 in chips) 
Semifonte: posts small blind €0.01
caduceus369: posts big blind €0.02
*** HOLE CARDS ***
Dealt to caduceus369 [Kh 2c]
lampo201: raises €0.02 to €0.04
andrewbilliejoe: folds 
TONNOeRUCOLA: folds 
raisereraiseall: raises €0.28 to €0.32
Semifonte: folds 
caduceus369: folds 
lampo201: calls €0.28
*** FLOP *** [2s Th 7d]
lampo201: checks 
raisereraiseall: bets €0.92 and is all-in
lampo201: folds 
Uncalled bet (€0.92) returned to raisereraiseall
raisereraiseall collected €0.64 from pot
raisereraiseall: doesn't show hand 
*** SUMMARY ***
Total pot €0.67 | Rake €0.03 
Board [2s Th 7d]
Seat 1: raisereraiseall (button) collected (€0.64)
Seat 2: Semifonte (small blind) folded before Flop
Seat 3: caduceus369 (big blind) folded before Flop
Seat 4: lampo201 folded on the Flop
Seat 5: andrewbilliejoe folded before Flop (didn't bet)
Seat 6: TONNOeRUCOLA folded before Flop (didn't bet)



PokerStars Zoom Hand #257958156406:  Hold'em No Limit (€0.01/€0.02) [ADM ID: M62BA304494E32ST] - 2025/10/01 15:22:22 CET [2025/10/01 9:22:22 ET]
Table 'Sirio' 6-max Seat #1 is the button
Seat 1: caduceus369 (€4.32 in chips) 
Seat 2: mafg420 (€1 in chips) 
Seat 3: francovirde (€2.34 in chips) 
Seat 4: andrewbilliejoe (€4.43 in chips) 
Seat 5: egidiosky (€3.68 in chips) 
Seat 6: memocol1 (€1.12 in chips) 
mafg420: posts small blind €0.01
francovirde: posts big blind €0.02
*** HOLE CARDS ***
Dealt to caduceus369 [8d 8h]
andrewbilliejoe: folds 
egidiosky: folds 
memocol1: calls €0.02
caduceus369: calls €0.02
mafg420: calls €0.01
francovirde: checks 
*** FLOP *** [9d Ad Ts]
mafg420: bets €0.02
francovirde: calls €0.02
memocol1: calls €0.02
caduceus369: calls €0.02
*** TURN *** [9d Ad Ts] [4h]
mafg420: checks 
francovirde: checks 
memocol1: checks 
caduceus369: checks 
*** RIVER *** [9d Ad Ts 4h] [4d]
mafg420: checks 
francovirde: bets €0.16
memocol1: folds 
caduceus369: folds 
mafg420: folds 
Uncalled bet (€0.16) returned to francovirde
francovirde collected €0.16 from pot
francovirde: doesn't show hand 
*** SUMMARY ***
Total pot €0.16 | Rake €0 
Board [9d Ad Ts 4h 4d]
Seat 1: caduceus369 (button) folded on the River
Seat 2: mafg420 (small blind) folded on the River
Seat 3: francovirde (big blind) collected (€0.16)
Seat 4: andrewbilliejoe folded before Flop (didn't bet)
Seat 5: egidiosky folded before Flop (didn't bet)
Seat 6: memocol1 folded on the River



PokerStars Zoom Hand #257958167643:  Hold'em No Limit (€0.01/€0.02) [ADM ID: M62BA304494E32ST] - 2025/10/01 15:23:46 CET [2025/10/01 9:23:46 ET]
Table 'Sirio' 6-max Seat #1 is the button
Seat 1: raisereraiseall (€1.66 in chips) 
Seat 2: Catania838 (€1.54 in chips) 
Seat 3: pylonstrip (€5.51 in chips) 
Seat 4: egidiosky (€3.62 in chips) 
Seat 5: caduceus369 (€4.27 in chips) 
Seat 6: ghosto69 (€1.34 in chips) 
Catania838: posts small blind €0.01
pylonstrip: posts big blind €0.02
*** HOLE CARDS ***
Dealt to caduceus369 [4c 8h]
egidiosky: folds 
caduceus369: folds 
ghosto69: folds 
raisereraiseall: folds 
Catania838: folds 
Uncalled bet (€0.01) returned to pylonstrip
pylonstrip collected €0.02 from pot
pylonstrip: doesn't show hand 
*** SUMMARY ***
Total pot €0.02 | Rake €0 
Seat 1: raisereraiseall (button) folded before Flop (didn't bet)
Seat 2: Catania838 (small blind) folded before Flop
Seat 3: pylonstrip (big blind) collected (€0.02)
Seat 4: egidiosky folded before Flop (didn't bet)
Seat 5: caduceus369 folded before Flop (didn't bet)
Seat 6: ghosto69 folded before Flop (didn't bet)



PokerStars Zoom Hand #257958165404:  Hold'em No Limit (€0.01/€0.02) [ADM ID: M62BA304494E32ST] - 2025/10/01 15:23:29 CET [2025/10/01 9:23:29 ET]
Table 'Sirio' 6-max Seat #1 is the button
Seat 1: Quelle128 (€0.63 in chips) 
Seat 2: ghosto69 (€1.35 in chips) 
Seat 3: andrewbilliejoe (€2.07 in chips) 
Seat 4: TONNOeRUCOLA (€4.31 in chips) 
Seat 5: memocol1 (€1.08 in chips) 
Seat 6: caduceus369 (€4.28 in chips) 
ghosto69: posts small blind €0.01
andrewbilliejoe: posts big blind €0.02
*** HOLE CARDS ***
Dealt to caduceus369 [2d Kd]
TONNOeRUCOLA: folds 
memocol1: folds 
caduceus369: folds 
Quelle128: calls €0.02
ghosto69: folds 
andrewbilliejoe: raises €0.08 to €0.10
Quelle128: calls €0.08
*** FLOP *** [Ts Kc 5h]
andrewbilliejoe: bets €0.15
Quelle128: calls €0.15
*** TURN *** [Ts Kc 5h] [4c]
andrewbilliejoe: bets €0.37
Quelle128: raises €0.01 to €0.38 and is all-in
andrewbilliejoe: calls €0.01
*** RIVER *** [Ts Kc 5h 4c] [3d]
*** SHOW DOWN ***
andrewbilliejoe: shows [Tc Td] (three of a kind, Tens)
Quelle128: shows [5d 4d] (two pair, Fives and Fours)
andrewbilliejoe collected €1.21 from pot
*** SUMMARY ***
Total pot €1.27 | Rake €0.06 
Board [Ts Kc 5h 4c 3d]
Seat 1: Quelle128 (button) showed [5d 4d] and lost with two pair, Fives and Fours
Seat 2: ghosto69 (small blind) folded before Flop
Seat 3: andrewbilliejoe (big blind) showed [Tc Td] and won (€1.21) with three of a kind, Tens
Seat 4: TONNOeRUCOLA folded before Flop (didn't bet)
Seat 5: memocol1 folded before Flop (didn't bet)
Seat 6: caduceus369 folded before Flop (didn't bet)



PokerStars Zoom Hand #257958168158:  Hold'em No Limit (€0.01/€0.02) [ADM ID: M62BA304494E32ST] - 2025/10/01 15:23:50 CET [2025/10/01 9:23:50 ET]
Table 'Sirio' 6-max Seat #1 is the button
Seat 1: gs0097 (€0.75 in chips) 
Seat 2: padisha00 (€1.47 in chips) 
Seat 3: egidiosky (€3.62 in chips) 
Seat 4: caduceus369 (€4.27 in chips) 
Seat 5: andrewbilliejoe (€2 in chips) 
Seat 6: Catania838 (€1.46 in chips) 
padisha00: posts small blind €0.01
egidiosky: posts big blind €0.02
*** HOLE CARDS ***
Dealt to caduceus369 [Th Qs]
caduceus369: folds 
andrewbilliejoe: raises €0.03 to €0.05
Catania838: folds 
gs0097: folds 
padisha00: folds 
egidiosky has timed out
egidiosky: folds 
Uncalled bet (€0.03) returned to andrewbilliejoe
andrewbilliejoe collected €0.05 from pot
andrewbilliejoe: doesn't show hand 
*** SUMMARY ***
Total pot €0.05 | Rake €0 
Seat 1: gs0097 (button) folded before Flop (didn't bet)
Seat 2: padisha00 (small blind) folded before Flop
Seat 3: egidiosky (big blind) folded before Flop
Seat 4: caduceus369 folded before Flop (didn't bet)
Seat 5: andrewbilliejoe collected (€0.05)
Seat 6: Catania838 folded before Flop (didn't bet)



PokerStars Zoom Hand #257958167136:  Hold'em No Limit (€0.01/€0.02) [ADM ID: M62BA304494E32ST] - 2025/10/01 15:23:42 CET [2025/10/01 9:23:42 ET]
Table 'Sirio' 6-max Seat #1 is the button
Seat 1: Catania838 (€1.47 in chips) 
Seat 2: caduceus369 (€4.28 in chips) 
Seat 3: TONNOeRUCOLA (€4.31 in chips) 
Seat 4: memocol1 (€1.08 in chips) 
Seat 5: OMGWOLFX (€5.23 in chips) 
Seat 6: S'dj83 (€2 in chips) 
caduceus369: posts small blind €0.01
TONNOeRUCOLA: posts big blind €0.02
*** HOLE CARDS ***
Dealt to caduceus369 [Kh Tc]
memocol1: calls €0.02
OMGWOLFX: folds 
S'dj83: folds 
Catania838: folds 
caduceus369: folds 
TONNOeRUCOLA: raises €0.04 to €0.06
memocol1: calls €0.04
*** FLOP *** [4d Ts 5c]
TONNOeRUCOLA: bets €0.07
memocol1: folds 
Uncalled bet (€0.07) returned to TONNOeRUCOLA
TONNOeRUCOLA collected €0.13 from pot
TONNOeRUCOLA: doesn't show hand 
*** SUMMARY ***
Total pot €0.13 | Rake €0 
Board [4d Ts 5c]
Seat 1: Catania838 (button) folded before Flop (didn't bet)
Seat 2: caduceus369 (small blind) folded before Flop
Seat 3: TONNOeRUCOLA (big blind) collected (€0.13)
Seat 4: memocol1 folded on the Flop
Seat 5: OMGWOLFX folded before Flop (didn't bet)
Seat 6: S'dj83 folded before Flop (didn't bet)



PokerStars Zoom Hand #257958169026:  Hold'em No Limit (€0.01/€0.02) [ADM ID: M62BA304494E32ST] - 2025/10/01 15:23:56 CET [2025/10/01 9:23:56 ET]
Table 'Sirio' 6-max Seat #1 is the button
Seat 1: caduceus369 (€4.27 in chips) 
Seat 2: ghosto69 (€1.30 in chips) 
Seat 3: Semifonte (€2.24 in chips) 
Seat 4: andrewbilliejoe (€4.43 in chips) 
Seat 5: S'dj83 (€2 in chips) 
Seat 6: Catania838 (€1.47 in chips) 
ghosto69: posts small blind €0.01
Semifonte: posts big blind €0.02
*** HOLE CARDS ***
Dealt to caduceus369 [Tc As]
andrewbilliejoe: folds 
S'dj83: raises €0.04 to €0.06
Catania838: folds 
caduceus369 has timed out
caduceus369: folds 
ghosto69: folds 
Semifonte: calls €0.04
*** FLOP *** [6h 2s 8c]
Semifonte: checks 
S'dj83: bets €0.06
Semifonte: calls €0.06
*** TURN *** [6h 2s 8c] [9h]
Semifonte: checks 
S'dj83: checks 
*** RIVER *** [6h 2s 8c 9h] [4d]
Semifonte: checks 
S'dj83: checks 
*** SHOW DOWN ***
Semifonte: shows [7s Jh] (high card Jack)
S'dj83: shows [Td Ks] (high card King)
S'dj83 collected €0.24 from pot
*** SUMMARY ***
Total pot €0.25 | Rake €0.01 
Board [6h 2s 8c 9h 4d]
Seat 1: caduceus369 (button) folded before Flop (didn't bet)
Seat 2: ghosto69 (small blind) folded before Flop
Seat 3: Semifonte (big blind) showed [7s Jh] and lost with high card Jack
Seat 4: andrewbilliejoe folded before Flop (didn't bet)
Seat 5: S'dj83 showed [Td Ks] and won (€0.24) with high card King
Seat 6: Catania838 folded before Flop (didn't bet)



PokerStars Zoom Hand #257958175830:  Hold'em No Limit (€0.01/€0.02) [ADM ID: M62BA304494E32ST] - 2025/10/01 15:24:46 CET [2025/10/01 9:24:46 ET]
Table 'Sirio' 6-max Seat #1 is the button
Seat 1: andrewbilliejoe (€2.65 in chips) 
Seat 2: padisha00 (€1.46 in chips) 
Seat 3: Ilcampione2130 (€1.20 in chips) 
Seat 4: mafg420 (€1.04 in chips) 
Seat 5: Catania838 (€1.42 in chips) 
Seat 6: caduceus369 (€4.27 in chips) 
padisha00: posts small blind €0.01
Ilcampione2130: posts big blind €0.02
*** HOLE CARDS ***
Dealt to caduceus369 [Kh 8s]
mafg420: folds 
Catania838: folds 
caduceus369: folds 
andrewbilliejoe: folds 
padisha00: folds 
Uncalled bet (€0.01) returned to Ilcampione2130
Ilcampione2130 collected €0.02 from pot
Ilcampione2130: doesn't show hand 
*** SUMMARY ***
Total pot €0.02 | Rake €0 
Seat 1: andrewbilliejoe (button) folded before Flop (didn't bet)
Seat 2: padisha00 (small blind) folded before Flop
Seat 3: Ilcampione2130 (big blind) collected (€0.02)
Seat 4: mafg420 folded before Flop (didn't bet)
Seat 5: Catania838 folded before Flop (didn't bet)
Seat 6: caduceus369 folded before Flop (didn't bet)



PokerStars Zoom Hand #257958178626:  Hold'em No Limit (€0.01/€0.02) [ADM ID: M62BA304494E32ST] - 2025/10/01 15:25:06 CET [2025/10/01 9:25:06 ET]
Table 'Sirio' 6-max Seat #1 is the button
Seat 1: Catania838 (€1.69 in chips) 
Seat 2: memocol1 (€1 in chips) 
Seat 3: caduceus369 (€4.27 in chips) 
Seat 4: andrewbilliejoe (€4.63 in chips) 
Seat 5: S'dj83 (€2.12 in chips) 
Seat 6: OMGWOLFX (€5.20 in chips) 
memocol1: posts small blind €0.01
caduceus369: posts big blind €0.02
*** HOLE CARDS ***
Dealt to caduceus369 [Jh Qc]
andrewbilliejoe: folds 
S'dj83: raises €0.04 to €0.06
OMGWOLFX: folds 
Catania838: folds 
memocol1: calls €0.05
caduceus369: folds 
*** FLOP *** [3d As 6s]
memocol1: checks 
S'dj83: bets €0.08
memocol1: folds 
Uncalled bet (€0.08) returned to S'dj83
S'dj83 collected €0.14 from pot
S'dj83: doesn't show hand 
*** SUMMARY ***
Total pot €0.14 | Rake €0 
Board [3d As 6s]
Seat 1: Catania838 (button) folded before Flop (didn't bet)
Seat 2: memocol1 (small blind) folded on the Flop
Seat 3: caduceus369 (big blind) folded before Flop
Seat 4: andrewbilliejoe folded before Flop (didn't bet)
Seat 5: S'dj83 collected (€0.14)
Seat 6: OMGWOLFX folded before Flop (didn't bet)



PokerStars Zoom Hand #257958182035:  Hold'em No Limit (€0.01/€0.02) [ADM ID: M62BA304494E32ST] - 2025/10/01 15:25:32 CET [2025/10/01 9:25:32 ET]
Table 'Sirio' 6-max Seat #1 is the button
Seat 1: Catania838 (€1.15 in chips) 
Seat 2: lampo201 (€2.76 in chips) 
Seat 3: andrewbilliejoe (€4.63 in chips) 
Seat 4: gs0097 (€0.64 in chips) 
Seat 5: caduceus369 (€4.25 in chips) 
Seat 6: OMGWOLFX (€5.20 in chips) 
lampo201: posts small blind €0.01
andrewbilliejoe: posts big blind €0.02
*** HOLE CARDS ***
Dealt to caduceus369 [8s 4c]
gs0097: calls €0.02
caduceus369: folds 
OMGWOLFX: folds 
Catania838: folds 
lampo201: folds 
andrewbilliejoe: raises €0.08 to €0.10
gs0097: calls €0.08
*** FLOP *** [3h Ah 7c]
andrewbilliejoe: checks 
gs0097: checks 
*** TURN *** [3h Ah 7c] [6s]
andrewbilliejoe: bets €0.15
gs0097: folds 
Uncalled bet (€0.15) returned to andrewbilliejoe
andrewbilliejoe collected €0.20 from pot
andrewbilliejoe: doesn't show hand 
*** SUMMARY ***
Total pot €0.21 | Rake €0.01 
Board [3h Ah 7c 6s]
Seat 1: Catania838 (button) folded before Flop (didn't bet)
Seat 2: lampo201 (small blind) folded before Flop
Seat 3: andrewbilliejoe (big blind) collected (€0.20)
Seat 4: gs0097 folded on the Turn
Seat 5: caduceus369 folded before Flop (didn't bet)
Seat 6: OMGWOLFX folded before Flop (didn't bet)



PokerStars Zoom Hand #257958183951:  Hold'em No Limit (€0.01/€0.02) [ADM ID: M62BA304494E32ST] - 2025/10/01 15:25:46 CET [2025/10/01 9:25:46 ET]
Table 'Sirio' 6-max Seat #1 is the button
Seat 1: OMGWOLFX (€4.15 in chips) 
Seat 2: caduceus369 (€4.25 in chips) 
Seat 3: raisereraiseall (€1.96 in chips) 
Seat 4: Catania838 (€1.15 in chips) 
Seat 5: andrewbilliejoe (€4.40 in chips) 
Seat 6: lampo201 (€2.75 in chips) 
caduceus369: posts small blind €0.01
raisereraiseall: posts big blind €0.02
*** HOLE CARDS ***
Dealt to caduceus369 [Qd 8h]
Catania838: folds 
andrewbilliejoe: folds 
lampo201: folds 
OMGWOLFX: folds 
caduceus369: folds 
Uncalled bet (€0.01) returned to raisereraiseall
raisereraiseall collected €0.02 from pot
raisereraiseall: doesn't show hand 
*** SUMMARY ***
Total pot €0.02 | Rake €0 
Seat 1: OMGWOLFX (button) folded before Flop (didn't bet)
Seat 2: caduceus369 (small blind) folded before Flop
Seat 3: raisereraiseall (big blind) collected (€0.02)
Seat 4: Catania838 folded before Flop (didn't bet)
Seat 5: andrewbilliejoe folded before Flop (didn't bet)
Seat 6: lampo201 folded before Flop (didn't bet)



PokerStars Zoom Hand #257958186827:  Hold'em No Limit (€0.01/€0.02) [ADM ID: M62BA304494E32ST] - 2025/10/01 15:26:07 CET [2025/10/01 9:26:07 ET]
Table 'Sirio' 6-max Seat #1 is the button
Seat 1: caduceus369 (€4.24 in chips) 
Seat 2: andrewbilliejoe (€4.73 in chips) 
Seat 3: lampo201 (€2.75 in chips) 
Seat 4: francovirde (€2.64 in chips) 
Seat 5: Catania838 (€1.39 in chips) 
Seat 6: colosso2022 (€2.60 in chips) 
andrewbilliejoe: posts small blind €0.01
lampo201: posts big blind €0.02
*** HOLE CARDS ***
Dealt to caduceus369 [8h 9c]
francovirde: folds 
Catania838: folds 
colosso2022: folds 
caduceus369: folds 
andrewbilliejoe: folds 
Uncalled bet (€0.01) returned to lampo201
lampo201 collected €0.02 from pot
lampo201: doesn't show hand 
*** SUMMARY ***
Total pot €0.02 | Rake €0 
Seat 1: caduceus369 (button) folded before Flop (didn't bet)
Seat 2: andrewbilliejoe (small blind) folded before Flop
Seat 3: lampo201 (big blind) collected (€0.02)
Seat 4: francovirde folded before Flop (didn't bet)
Seat 5: Catania838 folded before Flop (didn't bet)
Seat 6: colosso2022 folded before Flop (didn't bet)



PokerStars Zoom Hand #257958188086:  Hold'em No Limit (€0.01/€0.02) [ADM ID: M62BA304494E32ST] - 2025/10/01 15:26:16 CET [2025/10/01 9:26:16 ET]
Table 'Sirio' 6-max Seat #1 is the button
Seat 1: andrewbilliejoe (€2.57 in chips) 
Seat 2: francovirde (€2.64 in chips) 
Seat 3: caduceus369 (€4.24 in chips) 
Seat 4: Catania838 (€1.68 in chips) 
Seat 5: OMGWOLFX (€4.08 in chips) 
Seat 6: ghosto69 (€1.33 in chips) 
francovirde: posts small blind €0.01
caduceus369: posts big blind €0.02
*** HOLE CARDS ***
Dealt to caduceus369 [9c 2h]
Catania838: folds 
OMGWOLFX: folds 
ghosto69: folds 
andrewbilliejoe: folds 
francovirde: raises €2.62 to €2.64 and is all-in
caduceus369: folds 
Uncalled bet (€2.62) returned to francovirde
francovirde collected €0.04 from pot
francovirde: doesn't show hand 
*** SUMMARY ***
Total pot €0.04 | Rake €0 
Seat 1: andrewbilliejoe (button) folded before Flop (didn't bet)
Seat 2: francovirde (small blind) collected (€0.04)
Seat 3: caduceus369 (big blind) folded before Flop
Seat 4: Catania838 folded before Flop (didn't bet)
Seat 5: OMGWOLFX folded before Flop (didn't bet)
Seat 6: ghosto69 folded before Flop (didn't bet)



PokerStars Zoom Hand #257958183191:  Hold'em No Limit (€0.01/€0.02) [ADM ID: M62BA304494E32ST] - 2025/10/01 15:25:40 CET [2025/10/01 9:25:40 ET]
Table 'Sirio' 6-max Seat #1 is the button
Seat 1: Catania838 (€1.39 in chips) 
Seat 2: MathMassacreX (€4.99 in chips) 
Seat 3: Miele69409 (€0.88 in chips) 
Seat 4: caduceus369 (€4.25 in chips) 
Seat 5: raisereraiseall (€1.96 in chips) 
Seat 6: lucpri (€2.32 in chips) 
MathMassacreX: posts small blind €0.01
Miele69409: posts big blind €0.02
*** HOLE CARDS ***
Dealt to caduceus369 [2h 3s]
caduceus369: folds 
raisereraiseall: folds 
lucpri: folds 
Catania838: folds 
MathMassacreX: raises €0.05 to €0.07
Miele69409: calls €0.05
*** FLOP *** [5h Tc 4h]
MathMassacreX: bets €0.05
Miele69409: calls €0.05
*** TURN *** [5h Tc 4h] [Td]
MathMassacreX: checks 
Miele69409: bets €0.12
MathMassacreX: calls €0.12
*** RIVER *** [5h Tc 4h Td] [Ks]
MathMassacreX: checks 
Miele69409: checks 
*** SHOW DOWN ***
MathMassacreX: shows [Js Qs] (a pair of Tens)
Miele69409: mucks hand 
MathMassacreX collected €0.46 from pot
*** SUMMARY ***
Total pot €0.48 | Rake €0.02 
Board [5h Tc 4h Td Ks]
Seat 1: Catania838 (button) folded before Flop (didn't bet)
Seat 2: MathMassacreX (small blind) showed [Js Qs] and won (€0.46) with a pair of Tens
Seat 3: Miele69409 (big blind) mucked [8c 6d]
Seat 4: caduceus369 folded before Flop (didn't bet)
Seat 5: raisereraiseall folded before Flop (didn't bet)
Seat 6: lucpri folded before Flop (didn't bet)



PokerStars Zoom Hand #257958191547:  Hold'em No Limit (€0.01/€0.02) [ADM ID: M62BA304494E32ST] - 2025/10/01 15:26:41 CET [2025/10/01 9:26:41 ET]
Table 'Sirio' 6-max Seat #1 is the button
Seat 1: gs0097 (€0.51 in chips) 
Seat 2: colosso2022 (€2.66 in chips) 
Seat 3: OMGWOLFX (€5.12 in chips) 
Seat 4: andrewbilliejoe (€2.57 in chips) 
Seat 5: raisereraiseall (€1.96 in chips) 
Seat 6: caduceus369 (€4.22 in chips) 
colosso2022: posts small blind €0.01
OMGWOLFX: posts big blind €0.02
*** HOLE CARDS ***
Dealt to caduceus369 [8d 9h]
andrewbilliejoe: folds 
raisereraiseall: folds 
caduceus369: folds 
gs0097: folds 
colosso2022: calls €0.01
OMGWOLFX: checks 
*** FLOP *** [5c 6d Ks]
colosso2022: checks 
OMGWOLFX: bets €0.02
colosso2022: calls €0.02
*** TURN *** [5c 6d Ks] [6h]
colosso2022: checks 
OMGWOLFX: checks 
*** RIVER *** [5c 6d Ks 6h] [3c]
colosso2022: checks 
OMGWOLFX: checks 
*** SHOW DOWN ***
colosso2022: shows [2s Js] (a pair of Sixes)
OMGWOLFX: shows [Qh 5h] (two pair, Sixes and Fives)
OMGWOLFX collected €0.08 from pot
*** SUMMARY ***
Total pot €0.08 | Rake €0 
Board [5c 6d Ks 6h 3c]
Seat 1: gs0097 (button) folded before Flop (didn't bet)
Seat 2: colosso2022 (small blind) showed [2s Js] and lost with a pair of Sixes
Seat 3: OMGWOLFX (big blind) showed [Qh 5h] and won (€0.08) with two pair, Sixes and Fives
Seat 4: andrewbilliejoe folded before Flop (didn't bet)
Seat 5: raisereraiseall folded before Flop (didn't bet)
Seat 6: caduceus369 folded before Flop (didn't bet)



PokerStars Zoom Hand #257958192066:  Hold'em No Limit (€0.01/€0.02) [ADM ID: M62BA304494E32ST] - 2025/10/01 15:26:45 CET [2025/10/01 9:26:45 ET]
Table 'Sirio' 6-max Seat #1 is the button
Seat 1: pylonstrip (€6.41 in chips) 
Seat 2: lampo201 (€2.76 in chips) 
Seat 3: francovirde (€2.66 in chips) 
Seat 4: TONNOeRUCOLA (€4.65 in chips) 
Seat 5: caduceus369 (€4.22 in chips) 
Seat 6: raisereraiseall (€1.96 in chips) 
lampo201: posts small blind €0.01
francovirde: posts big blind €0.02
*** HOLE CARDS ***
Dealt to caduceus369 [9s 6h]
TONNOeRUCOLA: raises €0.04 to €0.06
caduceus369: folds 
raisereraiseall: raises €0.12 to €0.18
pylonstrip: folds 
lampo201: folds 
francovirde: folds 
TONNOeRUCOLA: calls €0.12
*** FLOP *** [8s Qs Td]
TONNOeRUCOLA: bets €0.19
raisereraiseall: calls €0.19
*** TURN *** [8s Qs Td] [4h]
TONNOeRUCOLA: bets €0.37
raisereraiseall: calls €0.37
*** RIVER *** [8s Qs Td 4h] [3h]
TONNOeRUCOLA: bets €0.72
raisereraiseall: calls €0.72
*** SHOW DOWN ***
TONNOeRUCOLA: shows [Kd Qd] (a pair of Queens)
raisereraiseall: mucks hand 
TONNOeRUCOLA collected €2.79 from pot
*** SUMMARY ***
Total pot €2.95 | Rake €0.16 
Board [8s Qs Td 4h 3h]
Seat 1: pylonstrip (button) folded before Flop (didn't bet)
Seat 2: lampo201 (small blind) folded before Flop
Seat 3: francovirde (big blind) folded before Flop
Seat 4: TONNOeRUCOLA showed [Kd Qd] and won (€2.79) with a pair of Queens
Seat 5: caduceus369 folded before Flop (didn't bet)
Seat 6: raisereraiseall mucked [Th As]



PokerStars Zoom Hand #257958193080:  Hold'em No Limit (€0.01/€0.02) [ADM ID: M62BA304494E32ST] - 2025/10/01 15:26:52 CET [2025/10/01 9:26:52 ET]
Table 'Sirio' 6-max Seat #1 is the button
Seat 1: S'dj83 (€2.20 in chips) 
Seat 2: caduceus369 (€4.22 in chips) 
Seat 3: OMGWOLFX (€4.31 in chips) 
Seat 4: lucpri (€2.29 in chips) 
Seat 5: Catania838 (€1.12 in chips) 
Seat 6: andrewbilliejoe (€2.57 in chips) 
caduceus369: posts small blind €0.01
OMGWOLFX: posts big blind €0.02
*** HOLE CARDS ***
Dealt to caduceus369 [Qs Th]
lucpri: folds 
Catania838: calls €0.02
andrewbilliejoe: folds 
S'dj83: folds 
caduceus369: folds 
OMGWOLFX: checks 
*** FLOP *** [2h Ks 9h]
OMGWOLFX: bets €0.02
Catania838: calls €0.02
*** TURN *** [2h Ks 9h] [Kd]
OMGWOLFX: bets €0.04
Catania838: folds 
Uncalled bet (€0.04) returned to OMGWOLFX
OMGWOLFX collected €0.09 from pot
OMGWOLFX: doesn't show hand 
*** SUMMARY ***
Total pot €0.09 | Rake €0 
Board [2h Ks 9h Kd]
Seat 1: S'dj83 (button) folded before Flop (didn't bet)
Seat 2: caduceus369 (small blind) folded before Flop
Seat 3: OMGWOLFX (big blind) collected (€0.09)
Seat 4: lucpri folded before Flop (didn't bet)
Seat 5: Catania838 folded on the Turn
Seat 6: andrewbilliejoe folded before Flop (didn't bet)



PokerStars Zoom Hand #257958196343:  Hold'em No Limit (€0.01/€0.02) [ADM ID: M62BA304494E32ST] - 2025/10/01 15:27:17 CET [2025/10/01 9:27:17 ET]
Table 'Sirio' 6-max Seat #1 is the button
Seat 1: caduceus369 (€4.21 in chips) 
Seat 2: andrewbilliejoe (€2 in chips) 
Seat 3: padisha00 (€1.35 in chips) 
Seat 4: francovirde (€2.64 in chips) 
Seat 5: Semifonte (€2.33 in chips) 
Seat 6: Catania838 (€1.61 in chips) 
andrewbilliejoe: posts small blind €0.01
padisha00: posts big blind €0.02
*** HOLE CARDS ***
Dealt to caduceus369 [Ks As]
francovirde: folds 
Semifonte: raises €0.05 to €0.07
Catania838: folds 
caduceus369: raises €0.19 to €0.26
andrewbilliejoe: folds 
padisha00: folds 
Semifonte: calls €0.19
*** FLOP *** [Jc 9c 3d]
Semifonte: checks 
caduceus369: bets €0.14
Semifonte: calls €0.14
*** TURN *** [Jc 9c 3d] [8s]
Semifonte: checks 
caduceus369: checks 
*** RIVER *** [Jc 9c 3d 8s] [9d]
Semifonte: checks 
caduceus369: bets €0.18
Semifonte: folds 
Uncalled bet (€0.18) returned to caduceus369
caduceus369 collected €0.79 from pot
caduceus369: doesn't show hand 
*** SUMMARY ***
Total pot €0.83 | Rake €0.04 
Board [Jc 9c 3d 8s 9d]
Seat 1: caduceus369 (button) collected (€0.79)
Seat 2: andrewbilliejoe (small blind) folded before Flop
Seat 3: padisha00 (big blind) folded before Flop
Seat 4: francovirde folded before Flop (didn't bet)
Seat 5: Semifonte folded on the River
Seat 6: Catania838 folded before Flop (didn't bet)



PokerStars Zoom Hand #257958202713:  Hold'em No Limit (€0.01/€0.02) [ADM ID: M62BA304494E32ST] - 2025/10/01 15:28:03 CET [2025/10/01 9:28:03 ET]
Table 'Sirio' 6-max Seat #1 is the button
Seat 1: padisha00 (€1.31 in chips) 
Seat 2: S'dj83 (€2.21 in chips) 
Seat 3: Semifonte (€1.93 in chips) 
Seat 4: caduceus369 (€4.60 in chips) 
Seat 5: MathMassacreX (€5.16 in chips) 
Seat 6: OMGWOLFX (€4.97 in chips) 
S'dj83: posts small blind €0.01
Semifonte: posts big blind €0.02
*** HOLE CARDS ***
Dealt to caduceus369 [3d Jh]
caduceus369: folds 
MathMassacreX: folds 
OMGWOLFX: folds 
padisha00: folds 
S'dj83: raises €0.04 to €0.06
Semifonte: calls €0.04
*** FLOP *** [Js 6h Ad]
S'dj83: bets €0.08
Semifonte: calls €0.08
*** TURN *** [Js 6h Ad] [Ac]
S'dj83: bets €0.18
Semifonte: folds 
Uncalled bet (€0.18) returned to S'dj83
S'dj83 collected €0.27 from pot
S'dj83: doesn't show hand 
*** SUMMARY ***
Total pot €0.28 | Rake €0.01 
Board [Js 6h Ad Ac]
Seat 1: padisha00 (button) folded before Flop (didn't bet)
Seat 2: S'dj83 (small blind) collected (€0.27)
Seat 3: Semifonte (big blind) folded on the Turn
Seat 4: caduceus369 folded before Flop (didn't bet)
Seat 5: MathMassacreX folded before Flop (didn't bet)
Seat 6: OMGWOLFX folded before Flop (didn't bet)



