PokerStars Zoom Hand #258038955254:  Hold'em No Limit (€0.01/€0.02) [ADM ID: M62C03044AE79CRJ] - 2025/10/07 23:32:57 CET [2025/10/07 17:32:57 ET]
Table 'Sirio' 6-max Seat #1 is the button
Seat 1: OMGWOLFX (€9.85 in chips) 
Seat 2: vifracar1 (€6.63 in chips) 
Seat 3: caduceus369 (€2 in chips) 
Seat 4: bafo77_po (€1.25 in chips) 
Seat 5: SebaRapy14 (€2.05 in chips) 
Seat 6: Iacuba (€3.40 in chips) 
vifracar1: posts small blind €0.01
caduceus369: posts big blind €0.02
*** HOLE CARDS ***
Dealt to caduceus369 [6s 4s]
bafo77_po: raises €0.02 to €0.04
SebaRapy14: folds 
Iacuba: folds 
OMGWOLFX: folds 
vifracar1: calls €0.03
caduceus369: calls €0.02
*** FLOP *** [2s Tc 7h]
vifracar1: bets €0.02
caduceus369: folds 
bafo77_po: calls €0.02
*** TURN *** [2s Tc 7h] [Ks]
vifracar1: checks 
bafo77_po: checks 
*** RIVER *** [2s Tc 7h Ks] [5d]
vifracar1: checks 
bafo77_po: checks 
*** SHOW DOWN ***
vifracar1: shows [Ad Qs] (high card Ace)
bafo77_po: mucks hand 
vifracar1 collected €0.16 from pot
*** SUMMARY ***
Total pot €0.16 | Rake €0 
Board [2s Tc 7h Ks 5d]
Seat 1: OMGWOLFX (button) folded before Flop (didn't bet)
Seat 2: vifracar1 (small blind) showed [Ad Qs] and won (€0.16) with high card Ace
Seat 3: caduceus369 (big blind) folded on the Flop
Seat 4: bafo77_po mucked [8d Ac]
Seat 5: SebaRapy14 folded before Flop (didn't bet)
Seat 6: Iacuba folded before Flop (didn't bet)



PokerStars Zoom Hand #258038961365:  Hold'em No Limit (€0.01/€0.02) [ADM ID: M62C03044AE79CRJ] - 2025/10/07 23:33:23 CET [2025/10/07 17:33:23 ET]
Table 'Sirio' 6-max Seat #1 is the button
Seat 1: gigiruk91 (€2 in chips) 
Seat 2: caduceus369 (€2 in chips) 
Seat 3: OMGWOLFX (€9.85 in chips) 
Seat 4: pistaKKio23 (€3.70 in chips) 
Seat 5: deojking (€2.72 in chips) 
Seat 6: maury999999 (€3.78 in chips) 
caduceus369: posts small blind €0.01
OMGWOLFX: posts big blind €0.02
*** HOLE CARDS ***
Dealt to caduceus369 [9h 3d]
pistaKKio23: folds 
deojking: folds 
maury999999: folds 
gigiruk91: folds 
caduceus369: folds 
Uncalled bet (€0.01) returned to OMGWOLFX
OMGWOLFX collected €0.02 from pot
OMGWOLFX: doesn't show hand 
*** SUMMARY ***
Total pot €0.02 | Rake €0 
Seat 1: gigiruk91 (button) folded before Flop (didn't bet)
Seat 2: caduceus369 (small blind) folded before Flop
Seat 3: OMGWOLFX (big blind) collected (€0.02)
Seat 4: pistaKKio23 folded before Flop (didn't bet)
Seat 5: deojking folded before Flop (didn't bet)
Seat 6: maury999999 folded before Flop (didn't bet)



PokerStars Zoom Hand #258038964337:  Hold'em No Limit (€0.01/€0.02) [ADM ID: M62C03044AE79CRJ] - 2025/10/07 23:33:35 CET [2025/10/07 17:33:35 ET]
Table 'Sirio' 6-max Seat #1 is the button
Seat 1: deojking (€2.72 in chips) 
Seat 2: bruciapelo (€3.21 in chips) 
Seat 3: vifracar1 (€6.73 in chips) 
Seat 4: cuzzi68 (€1.01 in chips) 
Seat 5: bafo77_po (€1.19 in chips) 
Seat 6: caduceus369 (€2 in chips) 
bruciapelo: posts small blind €0.01
vifracar1: posts big blind €0.02
*** HOLE CARDS ***
Dealt to caduceus369 [7d 2c]
cuzzi68: folds 
bafo77_po: calls €0.02
caduceus369: folds 
deojking: calls €0.02
bruciapelo: folds 
vifracar1: checks 
*** FLOP *** [Qs 5s 6s]
vifracar1: checks 
bafo77_po: bets €0.02
deojking: folds 
vifracar1: folds 
Uncalled bet (€0.02) returned to bafo77_po
bafo77_po collected €0.07 from pot
bafo77_po: doesn't show hand 
*** SUMMARY ***
Total pot €0.07 | Rake €0 
Board [Qs 5s 6s]
Seat 1: deojking (button) folded on the Flop
Seat 2: bruciapelo (small blind) folded before Flop
Seat 3: vifracar1 (big blind) folded on the Flop
Seat 4: cuzzi68 folded before Flop (didn't bet)
Seat 5: bafo77_po collected (€0.07)
Seat 6: caduceus369 folded before Flop (didn't bet)



PokerStars Zoom Hand #258038966817:  Hold'em No Limit (€0.01/€0.02) [ADM ID: M62C03044AE79CRJ] - 2025/10/07 23:33:46 CET [2025/10/07 17:33:46 ET]
Table 'Sirio' 6-max Seat #1 is the button
Seat 1: caduceus369 (€2 in chips) 
Seat 2: KindRonin (€0.79 in chips) 
Seat 3: mashallahh (€8.29 in chips) 
Seat 4: gigiruk91 (€2.29 in chips) 
Seat 5: ADRIAN0_MEIS (€21.59 in chips) 
Seat 6: Coffeebreak96 (€2.11 in chips) 
KindRonin: posts small blind €0.01
mashallahh: posts big blind €0.02
*** HOLE CARDS ***
Dealt to caduceus369 [2d 4d]
gigiruk91: folds 
ADRIAN0_MEIS: folds 
Coffeebreak96: folds 
caduceus369: folds 
KindRonin: folds 
Uncalled bet (€0.01) returned to mashallahh
mashallahh collected €0.02 from pot
mashallahh: doesn't show hand 
*** SUMMARY ***
Total pot €0.02 | Rake €0 
Seat 1: caduceus369 (button) folded before Flop (didn't bet)
Seat 2: KindRonin (small blind) folded before Flop
Seat 3: mashallahh (big blind) collected (€0.02)
Seat 4: gigiruk91 folded before Flop (didn't bet)
Seat 5: ADRIAN0_MEIS folded before Flop (didn't bet)
Seat 6: Coffeebreak96 folded before Flop (didn't bet)



PokerStars Zoom Hand #258038969260:  Hold'em No Limit (€0.01/€0.02) [ADM ID: M62C03044AE79CRJ] - 2025/10/07 23:33:56 CET [2025/10/07 17:33:56 ET]
Table 'Sirio' 6-max Seat #1 is the button
Seat 1: OMGWOLFX (€9.85 in chips) 
Seat 2: deojking (€2.70 in chips) 
Seat 3: MaxGreco (€2 in chips) 
Seat 4: VagALiss (€7.51 in chips) 
Seat 5: caduceus369 (€2 in chips) 
Seat 6: gigiruk91 (€3.92 in chips) 
deojking: posts small blind €0.01
MaxGreco: posts big blind €0.02
*** HOLE CARDS ***
Dealt to caduceus369 [2c 4s]
VagALiss: raises €0.03 to €0.05
caduceus369: folds 
gigiruk91: folds 
OMGWOLFX: folds 
deojking: folds 
MaxGreco: folds 
Uncalled bet (€0.03) returned to VagALiss
VagALiss collected €0.05 from pot
VagALiss: doesn't show hand 
*** SUMMARY ***
Total pot €0.05 | Rake €0 
Seat 1: OMGWOLFX (button) folded before Flop (didn't bet)
Seat 2: deojking (small blind) folded before Flop
Seat 3: MaxGreco (big blind) folded before Flop
Seat 4: VagALiss collected (€0.05)
Seat 5: caduceus369 folded before Flop (didn't bet)
Seat 6: gigiruk91 folded before Flop (didn't bet)



PokerStars Zoom Hand #258038970095:  Hold'em No Limit (€0.01/€0.02) [ADM ID: M62C03044AE79CRJ] - 2025/10/07 23:34:00 CET [2025/10/07 17:34:00 ET]
Table 'Sirio' 6-max Seat #1 is the button
Seat 1: darkodiablo (€0.82 in chips) 
Seat 2: mashallahh (€2.62 in chips) 
Seat 3: caduceus369 (€2 in chips) 
Seat 4: maury999999 (€2 in chips) 
Seat 5: goxstars (€2.09 in chips) 
Seat 6: bafo77_po (€1.24 in chips) 
mashallahh: posts small blind €0.01
caduceus369: posts big blind €0.02
*** HOLE CARDS ***
Dealt to caduceus369 [Qh 3d]
maury999999: folds 
goxstars: folds 
bafo77_po: folds 
darkodiablo: folds 
mashallahh: folds 
Uncalled bet (€0.01) returned to caduceus369
caduceus369 collected €0.02 from pot
caduceus369: doesn't show hand 
*** SUMMARY ***
Total pot €0.02 | Rake €0 
Seat 1: darkodiablo (button) folded before Flop (didn't bet)
Seat 2: mashallahh (small blind) folded before Flop
Seat 3: caduceus369 (big blind) collected (€0.02)
Seat 4: maury999999 folded before Flop (didn't bet)
Seat 5: goxstars folded before Flop (didn't bet)
Seat 6: bafo77_po folded before Flop (didn't bet)



PokerStars Zoom Hand #258038976255:  Hold'em No Limit (€0.01/€0.02) [ADM ID: M62C03044AE79CRJ] - 2025/10/07 23:34:26 CET [2025/10/07 17:34:26 ET]
Table 'Sirio' 6-max Seat #1 is the button
Seat 1: caduceus369 (€2.01 in chips) 
Seat 2: QUATTRODAME (€2.46 in chips) 
Seat 3: gigiruk91 (€2 in chips) 
Seat 4: Chia9711 (€7.20 in chips) 
Seat 5: pistaKKio23 (€2.79 in chips) 
Seat 6: vifracar1 (€6.94 in chips) 
QUATTRODAME: posts small blind €0.01
gigiruk91: posts big blind €0.02
*** HOLE CARDS ***
Dealt to caduceus369 [9s 3s]
Chia9711: folds 
pistaKKio23: folds 
vifracar1: folds 
caduceus369: folds 
QUATTRODAME: folds 
Uncalled bet (€0.01) returned to gigiruk91
gigiruk91 collected €0.02 from pot
gigiruk91: doesn't show hand 
*** SUMMARY ***
Total pot €0.02 | Rake €0 
Seat 1: caduceus369 (button) folded before Flop (didn't bet)
Seat 2: QUATTRODAME (small blind) folded before Flop
Seat 3: gigiruk91 (big blind) collected (€0.02)
Seat 4: Chia9711 folded before Flop (didn't bet)
Seat 5: pistaKKio23 folded before Flop (didn't bet)
Seat 6: vifracar1 folded before Flop (didn't bet)



PokerStars Zoom Hand #258038978027:  Hold'em No Limit (€0.01/€0.02) [ADM ID: M62C03044AE79CRJ] - 2025/10/07 23:34:33 CET [2025/10/07 17:34:33 ET]
Table 'Sirio' 6-max Seat #1 is the button
Seat 1: robertoH2O (€3.52 in chips) 
Seat 2: Iacuba (€3.48 in chips) 
Seat 3: stev@nin (€4.61 in chips) 
Seat 4: caduceus369 (€2.01 in chips) 
Seat 5: deojking (€1.90 in chips) 
Seat 6: maury999999 (€3.76 in chips) 
Iacuba: posts small blind €0.01
stev@nin: posts big blind €0.02
*** HOLE CARDS ***
Dealt to caduceus369 [Ks Qc]
caduceus369: raises €0.04 to €0.06
deojking: calls €0.06
maury999999: folds 
robertoH2O: folds 
Iacuba: calls €0.05
stev@nin: calls €0.04
*** FLOP *** [4h 7s 2s]
Iacuba: checks 
stev@nin: checks 
caduceus369: checks 
deojking: bets €0.20
Iacuba: folds 
stev@nin: calls €0.20
caduceus369: folds 
*** TURN *** [4h 7s 2s] [6c]
stev@nin: checks 
deojking: checks 
*** RIVER *** [4h 7s 2s 6c] [Kh]
stev@nin: checks 
deojking: checks 
*** SHOW DOWN ***
stev@nin: shows [4c 5d] (a pair of Fours)
deojking: mucks hand 
stev@nin collected €0.61 from pot
*** SUMMARY ***
Total pot €0.64 | Rake €0.03 
Board [4h 7s 2s 6c Kh]
Seat 1: robertoH2O (button) folded before Flop (didn't bet)
Seat 2: Iacuba (small blind) folded on the Flop
Seat 3: stev@nin (big blind) showed [4c 5d] and won (€0.61) with a pair of Fours
Seat 4: caduceus369 folded on the Flop
Seat 5: deojking mucked [Ts Js]
Seat 6: maury999999 folded before Flop (didn't bet)



PokerStars Zoom Hand #258038990469:  Hold'em No Limit (€0.01/€0.02) [ADM ID: M62C03044AE79CRJ] - 2025/10/07 23:35:26 CET [2025/10/07 17:35:26 ET]
Table 'Sirio' 6-max Seat #1 is the button
Seat 1: Fengjie82 (€1.47 in chips) 
Seat 2: caduceus369 (€2 in chips) 
Seat 3: robertoH2O (€3.49 in chips) 
Seat 4: vifracar1 (€7.10 in chips) 
Seat 5: Grasso2016 (€4.60 in chips) 
Seat 6: robinone577 (€0.57 in chips) 
caduceus369: posts small blind €0.01
robertoH2O: posts big blind €0.02
*** HOLE CARDS ***
Dealt to caduceus369 [5s Qc]
vifracar1: folds 
Grasso2016: raises €0.03 to €0.05
robinone577: calls €0.05
Fengjie82: calls €0.05
caduceus369: folds 
robertoH2O: folds 
*** FLOP *** [4c 9h 3d]
Grasso2016: checks 
robinone577: bets €0.02
Fengjie82: folds 
Grasso2016: calls €0.02
*** TURN *** [4c 9h 3d] [Kd]
Grasso2016: checks 
robinone577: checks 
*** RIVER *** [4c 9h 3d Kd] [2c]
Grasso2016: checks 
robinone577: checks 
*** SHOW DOWN ***
Grasso2016: shows [Qd Js] (high card King)
robinone577: shows [Ac 3s] (a pair of Threes)
robinone577 collected €0.21 from pot
*** SUMMARY ***
Total pot €0.22 | Rake €0.01 
Board [4c 9h 3d Kd 2c]
Seat 1: Fengjie82 (button) folded on the Flop
Seat 2: caduceus369 (small blind) folded before Flop
Seat 3: robertoH2O (big blind) folded before Flop
Seat 4: vifracar1 folded before Flop (didn't bet)
Seat 5: Grasso2016 showed [Qd Js] and lost with high card King
Seat 6: robinone577 showed [Ac 3s] and won (€0.21) with a pair of Threes



PokerStars Zoom Hand #258038992866:  Hold'em No Limit (€0.01/€0.02) [ADM ID: M62C03044AE79CRJ] - 2025/10/07 23:35:36 CET [2025/10/07 17:35:36 ET]
Table 'Sirio' 6-max Seat #1 is the button
Seat 1: Poonte (€5.76 in chips) 
Seat 2: BetNoLook (€2 in chips) 
Seat 3: ADRIAN0_MEIS (€21.31 in chips) 
Seat 4: darkodiablo (€0.78 in chips) 
Seat 5: gitikappa (€0.71 in chips) 
Seat 6: caduceus369 (€2 in chips) 
BetNoLook: posts small blind €0.01
ADRIAN0_MEIS: posts big blind €0.02
*** HOLE CARDS ***
Dealt to caduceus369 [Kc Tc]
darkodiablo: folds 
gitikappa: calls €0.02
caduceus369: raises €0.06 to €0.08
Poonte: folds 
BetNoLook: folds 
ADRIAN0_MEIS: folds 
gitikappa: calls €0.06
*** FLOP *** [Ac Jc 7c]
gitikappa: bets €0.03
caduceus369: calls €0.03
*** TURN *** [Ac Jc 7c] [4d]
gitikappa: bets €0.04
caduceus369: raises €0.04 to €0.08
gitikappa: folds 
Uncalled bet (€0.04) returned to caduceus369
caduceus369 collected €0.32 from pot
caduceus369: doesn't show hand 
*** SUMMARY ***
Total pot €0.33 | Rake €0.01 
Board [Ac Jc 7c 4d]
Seat 1: Poonte (button) folded before Flop (didn't bet)
Seat 2: BetNoLook (small blind) folded before Flop
Seat 3: ADRIAN0_MEIS (big blind) folded before Flop
Seat 4: darkodiablo folded before Flop (didn't bet)
Seat 5: gitikappa folded on the Turn
Seat 6: caduceus369 collected (€0.32)



PokerStars Zoom Hand #258039014757:  Hold'em No Limit (€0.01/€0.02) [ADM ID: M62C03044AE79CRJ] - 2025/10/07 23:37:09 CET [2025/10/07 17:37:09 ET]
Table 'Sirio' 6-max Seat #1 is the button
Seat 1: mondie73100 (€2.28 in chips) 
Seat 2: KindRonin (€0.64 in chips) 
Seat 3: maury999999 (€3.86 in chips) 
Seat 4: QUATTRODAME (€5.39 in chips) 
Seat 5: caduceus369 (€2.17 in chips) 
Seat 6: Fengjie82 (€1.31 in chips) 
KindRonin: posts small blind €0.01
maury999999: posts big blind €0.02
*** HOLE CARDS ***
Dealt to caduceus369 [9h 6s]
QUATTRODAME: folds 
caduceus369: folds 
Fengjie82: folds 
mondie73100: folds 
KindRonin: folds 
Uncalled bet (€0.01) returned to maury999999
maury999999 collected €0.02 from pot
maury999999: doesn't show hand 
*** SUMMARY ***
Total pot €0.02 | Rake €0 
Seat 1: mondie73100 (button) folded before Flop (didn't bet)
Seat 2: KindRonin (small blind) folded before Flop
Seat 3: maury999999 (big blind) collected (€0.02)
Seat 4: QUATTRODAME folded before Flop (didn't bet)
Seat 5: caduceus369 folded before Flop (didn't bet)
Seat 6: Fengjie82 folded before Flop (didn't bet)



PokerStars Zoom Hand #258039015981:  Hold'em No Limit (€0.01/€0.02) [ADM ID: M62C03044AE79CRJ] - 2025/10/07 23:37:14 CET [2025/10/07 17:37:14 ET]
Table 'Sirio' 6-max Seat #1 is the button
Seat 1: Iacuba (€3.44 in chips) 
Seat 2: OMGWOLFX (€3.79 in chips) 
Seat 3: caduceus369 (€2.17 in chips) 
Seat 4: gigiruk91 (€2.55 in chips) 
Seat 5: vifracar1 (€6.79 in chips) 
Seat 6: mashallahh (€4.46 in chips) 
OMGWOLFX: posts small blind €0.01
caduceus369: posts big blind €0.02
*** HOLE CARDS ***
Dealt to caduceus369 [Ts Kc]
gigiruk91: folds 
vifracar1: folds 
mashallahh: folds 
Iacuba: folds 
OMGWOLFX: raises €0.02 to €0.04
caduceus369: calls €0.02
*** FLOP *** [9h Ks Jc]
OMGWOLFX: bets €0.04
caduceus369: calls €0.04
*** TURN *** [9h Ks Jc] [7s]
OMGWOLFX: bets €0.08
caduceus369: calls €0.08
*** RIVER *** [9h Ks Jc 7s] [8c]
OMGWOLFX: checks 
caduceus369: bets €0.31
OMGWOLFX: folds 
Uncalled bet (€0.31) returned to caduceus369
caduceus369 collected €0.31 from pot
caduceus369: doesn't show hand 
*** SUMMARY ***
Total pot €0.32 | Rake €0.01 
Board [9h Ks Jc 7s 8c]
Seat 1: Iacuba (button) folded before Flop (didn't bet)
Seat 2: OMGWOLFX (small blind) folded on the River
Seat 3: caduceus369 (big blind) collected (€0.31)
Seat 4: gigiruk91 folded before Flop (didn't bet)
Seat 5: vifracar1 folded before Flop (didn't bet)
Seat 6: mashallahh folded before Flop (didn't bet)



PokerStars Zoom Hand #258039027694:  Hold'em No Limit (€0.01/€0.02) [ADM ID: M62C03044AE79CRJ] - 2025/10/07 23:38:04 CET [2025/10/07 17:38:04 ET]
Table 'Sirio' 6-max Seat #1 is the button
Seat 1: caduceus369 (€2.32 in chips) 
Seat 2: SebaRapy14 (€2.17 in chips) 
Seat 3: robertoH2O (€3.50 in chips) 
Seat 4: maury999999 (€3.79 in chips) 
Seat 5: pistaKKio23 (€3.96 in chips) 
Seat 6: OMGWOLFX (€3.63 in chips) 
SebaRapy14: posts small blind €0.01
robertoH2O: posts big blind €0.02
*** HOLE CARDS ***
Dealt to caduceus369 [3d 9c]
maury999999: folds 
pistaKKio23: folds 
OMGWOLFX: folds 
caduceus369: folds 
SebaRapy14: raises €0.04 to €0.06
robertoH2O: folds 
Uncalled bet (€0.04) returned to SebaRapy14
SebaRapy14 collected €0.04 from pot
SebaRapy14: doesn't show hand 
*** SUMMARY ***
Total pot €0.04 | Rake €0 
Seat 1: caduceus369 (button) folded before Flop (didn't bet)
Seat 2: SebaRapy14 (small blind) collected (€0.04)
Seat 3: robertoH2O (big blind) folded before Flop
Seat 4: maury999999 folded before Flop (didn't bet)
Seat 5: pistaKKio23 folded before Flop (didn't bet)
Seat 6: OMGWOLFX folded before Flop (didn't bet)



PokerStars Zoom Hand #258039033120:  Hold'em No Limit (€0.01/€0.02) [ADM ID: M62C03044AE79CRJ] - 2025/10/07 23:38:27 CET [2025/10/07 17:38:27 ET]
Table 'Sirio' 6-max Seat #1 is the button
Seat 1: SebaRapy14 (€2.19 in chips) 
Seat 2: caduceus369 (€2.32 in chips) 
Seat 3: gigiruk91 (€2.36 in chips) 
Seat 4: mashallahh (€6.73 in chips) 
Seat 5: Coffeebreak96 (€1.88 in chips) 
Seat 6: stev@nin (€4.81 in chips) 
caduceus369: posts small blind €0.01
gigiruk91: posts big blind €0.02
*** HOLE CARDS ***
Dealt to caduceus369 [9h 5c]
mashallahh: folds 
Coffeebreak96: folds 
stev@nin: folds 
SebaRapy14: raises €0.04 to €0.06
caduceus369: folds 
gigiruk91: folds 
Uncalled bet (€0.04) returned to SebaRapy14
SebaRapy14 collected €0.05 from pot
SebaRapy14: doesn't show hand 
*** SUMMARY ***
Total pot €0.05 | Rake €0 
Seat 1: SebaRapy14 (button) collected (€0.05)
Seat 2: caduceus369 (small blind) folded before Flop
Seat 3: gigiruk91 (big blind) folded before Flop
Seat 4: mashallahh folded before Flop (didn't bet)
Seat 5: Coffeebreak96 folded before Flop (didn't bet)
Seat 6: stev@nin folded before Flop (didn't bet)



PokerStars Zoom Hand #258039031027:  Hold'em No Limit (€0.01/€0.02) [ADM ID: M62C03044AE79CRJ] - 2025/10/07 23:38:18 CET [2025/10/07 17:38:18 ET]
Table 'Sirio' 6-max Seat #1 is the button
Seat 1: cuzzi68 (€1.38 in chips) 
Seat 2: gigiruk91 (€4.52 in chips) 
Seat 3: OMGWOLFX (€5.90 in chips) 
Seat 4: mashallahh (€4.42 in chips) 
Seat 5: pistaKKio23 (€3.96 in chips) 
Seat 6: caduceus369 (€2.32 in chips) 
gigiruk91: posts small blind €0.01
OMGWOLFX: posts big blind €0.02
*** HOLE CARDS ***
Dealt to caduceus369 [4c 4s]
mashallahh: folds 
pistaKKio23: folds 
caduceus369: folds 
cuzzi68: calls €0.02
gigiruk91: folds 
OMGWOLFX: raises €0.04 to €0.06
cuzzi68: calls €0.04
*** FLOP *** [Ts Jh 7c]
OMGWOLFX: bets €0.07
cuzzi68: folds 
Uncalled bet (€0.07) returned to OMGWOLFX
OMGWOLFX collected €0.13 from pot
OMGWOLFX: doesn't show hand 
*** SUMMARY ***
Total pot €0.13 | Rake €0 
Board [Ts Jh 7c]
Seat 1: cuzzi68 (button) folded on the Flop
Seat 2: gigiruk91 (small blind) folded before Flop
Seat 3: OMGWOLFX (big blind) collected (€0.13)
Seat 4: mashallahh folded before Flop (didn't bet)
Seat 5: pistaKKio23 folded before Flop (didn't bet)
Seat 6: caduceus369 folded before Flop (didn't bet)



PokerStars Zoom Hand #258039034659:  Hold'em No Limit (€0.01/€0.02) [ADM ID: M62C03044AE79CRJ] - 2025/10/07 23:38:33 CET [2025/10/07 17:38:33 ET]
Table 'Sirio' 6-max Seat #1 is the button
Seat 1: Ch4oS_Matteo00 (€1.47 in chips) 
Seat 2: stev@nin (€4.81 in chips) 
Seat 3: pistaKKio23 (€4.13 in chips) 
Seat 4: robertoH2O (€3.48 in chips) 
Seat 5: caduceus369 (€2.31 in chips) 
Seat 6: Chia9711 (€5.77 in chips) 
stev@nin: posts small blind €0.01
pistaKKio23: posts big blind €0.02
*** HOLE CARDS ***
Dealt to caduceus369 [Td Ad]
robertoH2O: raises €0.03 to €0.05
caduceus369: raises €0.10 to €0.15
Chia9711: folds 
Ch4oS_Matteo00: raises €0.38 to €0.53
stev@nin: folds 
pistaKKio23: folds 
robertoH2O: folds 
caduceus369: folds 
Uncalled bet (€0.38) returned to Ch4oS_Matteo00
Ch4oS_Matteo00 collected €0.38 from pot
Ch4oS_Matteo00: doesn't show hand 
*** SUMMARY ***
Total pot €0.38 | Rake €0 
Seat 1: Ch4oS_Matteo00 (button) collected (€0.38)
Seat 2: stev@nin (small blind) folded before Flop
Seat 3: pistaKKio23 (big blind) folded before Flop
Seat 4: robertoH2O folded before Flop
Seat 5: caduceus369 folded before Flop
Seat 6: Chia9711 folded before Flop (didn't bet)



PokerStars Zoom Hand #258039040878:  Hold'em No Limit (€0.01/€0.02) [ADM ID: M62C03044AE79CRJ] - 2025/10/07 23:38:59 CET [2025/10/07 17:38:59 ET]
Table 'Sirio' 6-max Seat #1 is the button
Seat 1: gigiruk91 (€2 in chips) 
Seat 2: goxstars (€2.01 in chips) 
Seat 3: mondie73100 (€2.02 in chips) 
Seat 4: caduceus369 (€2.16 in chips) 
Seat 5: Ultragsg (€0.98 in chips) 
Seat 6: Mark Poke783 (€1.18 in chips) 
goxstars: posts small blind €0.01
mondie73100: posts big blind €0.02
*** HOLE CARDS ***
Dealt to caduceus369 [4c Tc]
caduceus369: folds 
Ultragsg: folds 
Mark Poke783: calls €0.02
gigiruk91: raises €0.02 to €0.04
goxstars: folds 
mondie73100: calls €0.02
Mark Poke783: calls €0.02
*** FLOP *** [As Ks 3h]
mondie73100: checks 
Mark Poke783: bets €0.13
gigiruk91: folds 
mondie73100: calls €0.13
*** TURN *** [As Ks 3h] [5d]
mondie73100: checks 
Mark Poke783: bets €0.37
mondie73100: folds 
Uncalled bet (€0.37) returned to Mark Poke783
Mark Poke783 collected €0.37 from pot
Mark Poke783: doesn't show hand 
*** SUMMARY ***
Total pot €0.39 | Rake €0.02 
Board [As Ks 3h 5d]
Seat 1: gigiruk91 (button) folded on the Flop
Seat 2: goxstars (small blind) folded before Flop
Seat 3: mondie73100 (big blind) folded on the Turn
Seat 4: caduceus369 folded before Flop (didn't bet)
Seat 5: Ultragsg folded before Flop (didn't bet)
Seat 6: Mark Poke783 collected (€0.37)



PokerStars Zoom Hand #258039042635:  Hold'em No Limit (€0.01/€0.02) [ADM ID: M62C03044AE79CRJ] - 2025/10/07 23:39:07 CET [2025/10/07 17:39:07 ET]
Table 'Sirio' 6-max Seat #1 is the button
Seat 1: SebaRapy14 (€2.38 in chips) 
Seat 2: mashallahh (€4.39 in chips) 
Seat 3: caduceus369 (€2.16 in chips) 
Seat 4: Fengjie82 (€1.57 in chips) 
Seat 5: maury999999 (€2.10 in chips) 
Seat 6: Poonte (€5.77 in chips) 
mashallahh: posts small blind €0.01
caduceus369: posts big blind €0.02
*** HOLE CARDS ***
Dealt to caduceus369 [8h 5d]
Fengjie82: folds 
maury999999: raises €0.02 to €0.04
Poonte: folds 
SebaRapy14: folds 
mashallahh: folds 
caduceus369: calls €0.02
*** FLOP *** [7h 6s 4c]
caduceus369: checks 
maury999999: bets €0.03
caduceus369: calls €0.03
*** TURN *** [7h 6s 4c] [3d]
caduceus369: checks 
maury999999: bets €0.10
caduceus369: calls €0.10
*** RIVER *** [7h 6s 4c 3d] [Ah]
caduceus369: bets €0.21
maury999999: calls €0.21
*** SHOW DOWN ***
caduceus369: shows [8h 5d] (a straight, Four to Eight)
maury999999: mucks hand 
caduceus369 collected €0.73 from pot
*** SUMMARY ***
Total pot €0.77 | Rake €0.04 
Board [7h 6s 4c 3d Ah]
Seat 1: SebaRapy14 (button) folded before Flop (didn't bet)
Seat 2: mashallahh (small blind) folded before Flop
Seat 3: caduceus369 (big blind) showed [8h 5d] and won (€0.73) with a straight, Four to Eight
Seat 4: Fengjie82 folded before Flop (didn't bet)
Seat 5: maury999999 mucked [6d Ad]
Seat 6: Poonte folded before Flop (didn't bet)



PokerStars Zoom Hand #258039064488:  Hold'em No Limit (€0.01/€0.02) [ADM ID: M62C03044AE79CRJ] - 2025/10/07 23:40:39 CET [2025/10/07 17:40:39 ET]
Table 'Sirio' 6-max Seat #1 is the button
Seat 1: QUATTRODAME (€5.24 in chips) 
Seat 2: gigiruk91 (€2 in chips) 
Seat 3: mashallahh (€6.67 in chips) 
Seat 4: caduceus369 (€2.51 in chips) 
Seat 5: pistaKKio23 (€4.09 in chips) 
Seat 6: vifracar1 (€6.32 in chips) 
gigiruk91: posts small blind €0.01
mashallahh: posts big blind €0.02
*** HOLE CARDS ***
Dealt to caduceus369 [Ad Jc]
caduceus369: raises €0.04 to €0.06
pistaKKio23: folds 
vifracar1: calls €0.06
QUATTRODAME: folds 
gigiruk91: folds 
mashallahh: folds 
*** FLOP *** [Js 8h 6s]
caduceus369: checks 
vifracar1: checks 
*** TURN *** [Js 8h 6s] [4h]
caduceus369: bets €0.06
vifracar1: calls €0.06
*** RIVER *** [Js 8h 6s 4h] [Qd]
caduceus369: checks 
vifracar1: checks 
*** SHOW DOWN ***
caduceus369: shows [Ad Jc] (a pair of Jacks)
vifracar1: shows [Qh 9s] (a pair of Queens)
vifracar1 collected €0.26 from pot
*** SUMMARY ***
Total pot €0.27 | Rake €0.01 
Board [Js 8h 6s 4h Qd]
Seat 1: QUATTRODAME (button) folded before Flop (didn't bet)
Seat 2: gigiruk91 (small blind) folded before Flop
Seat 3: mashallahh (big blind) folded before Flop
Seat 4: caduceus369 showed [Ad Jc] and lost with a pair of Jacks
Seat 5: pistaKKio23 folded before Flop (didn't bet)
Seat 6: vifracar1 showed [Qh 9s] and won (€0.26) with a pair of Queens



PokerStars Zoom Hand #258039078477:  Hold'em No Limit (€0.01/€0.02) [ADM ID: M62C03044AE79CRJ] - 2025/10/07 23:41:39 CET [2025/10/07 17:41:39 ET]
Table 'Sirio' 6-max Seat #1 is the button
Seat 1: caduceus369 (€2.39 in chips) 
Seat 2: maury999999 (€2 in chips) 
Seat 3: OMGWOLFX (€6.84 in chips) 
Seat 4: demolitor75 (€0.74 in chips) 
Seat 5: save117 (€0.95 in chips) 
Seat 6: bafo77_po (€2.38 in chips) 
maury999999: posts small blind €0.01
OMGWOLFX: posts big blind €0.02
*** HOLE CARDS ***
Dealt to caduceus369 [5d 8c]
demolitor75: calls €0.02
save117: raises €0.07 to €0.09
bafo77_po: folds 
caduceus369: folds 
maury999999: folds 
OMGWOLFX: calls €0.07
demolitor75: calls €0.07
*** FLOP *** [8s 6h 3c]
OMGWOLFX: checks 
demolitor75: checks 
save117: checks 
*** TURN *** [8s 6h 3c] [4h]
OMGWOLFX: checks 
demolitor75: checks 
save117: bets €0.27
OMGWOLFX: folds 
demolitor75: folds 
Uncalled bet (€0.27) returned to save117
save117 collected €0.27 from pot
save117: doesn't show hand 
*** SUMMARY ***
Total pot €0.28 | Rake €0.01 
Board [8s 6h 3c 4h]
Seat 1: caduceus369 (button) folded before Flop (didn't bet)
Seat 2: maury999999 (small blind) folded before Flop
Seat 3: OMGWOLFX (big blind) folded on the Turn
Seat 4: demolitor75 folded on the Turn
Seat 5: save117 collected (€0.27)
Seat 6: bafo77_po folded before Flop (didn't bet)



PokerStars Zoom Hand #258039081704:  Hold'em No Limit (€0.01/€0.02) [ADM ID: M62C03044AE79CRJ] - 2025/10/07 23:41:53 CET [2025/10/07 17:41:53 ET]
Table 'Sirio' 6-max Seat #1 is the button
Seat 1: robertoH2O (€3.24 in chips) 
Seat 2: Chia9711 (€5.48 in chips) 
Seat 3: bruciapelo (€4.72 in chips) 
Seat 4: algr78 (€0.82 in chips) 
Seat 5: OMGWOLFX (€9.14 in chips) 
Seat 6: caduceus369 (€2.39 in chips) 
Chia9711: posts small blind €0.01
bruciapelo: posts big blind €0.02
*** HOLE CARDS ***
Dealt to caduceus369 [As Td]
algr78: calls €0.02
OMGWOLFX: raises €0.04 to €0.06
caduceus369: folds 
robertoH2O: folds 
Chia9711: folds 
bruciapelo: raises €0.12 to €0.18
algr78: calls €0.16
OMGWOLFX: calls €0.12
*** FLOP *** [9s Qc Ks]
bruciapelo: bets €0.26
algr78: folds 
OMGWOLFX: folds 
Uncalled bet (€0.26) returned to bruciapelo
bruciapelo collected €0.52 from pot
bruciapelo: doesn't show hand 
*** SUMMARY ***
Total pot €0.55 | Rake €0.03 
Board [9s Qc Ks]
Seat 1: robertoH2O (button) folded before Flop (didn't bet)
Seat 2: Chia9711 (small blind) folded before Flop
Seat 3: bruciapelo (big blind) collected (€0.52)
Seat 4: algr78 folded on the Flop
Seat 5: OMGWOLFX folded on the Flop
Seat 6: caduceus369 folded before Flop (didn't bet)



PokerStars Zoom Hand #258039088350:  Hold'em No Limit (€0.01/€0.02) [ADM ID: M62C03044AE79CRJ] - 2025/10/07 23:42:21 CET [2025/10/07 17:42:21 ET]
Table 'Sirio' 6-max Seat #1 is the button
Seat 1: gigiruk91 (€4.34 in chips) 
Seat 2: Fengjie82 (€1.61 in chips) 
Seat 3: QUATTRODAME (€5.17 in chips) 
Seat 4: BetNoLook (€3.88 in chips) 
Seat 5: caduceus369 (€2.38 in chips) 
Seat 6: cuzzi68 (€2.29 in chips) 
Fengjie82: posts small blind €0.01
QUATTRODAME: posts big blind €0.02
*** HOLE CARDS ***
Dealt to caduceus369 [Ts 7c]
BetNoLook: raises €0.05 to €0.07
caduceus369: folds 
cuzzi68: folds 
gigiruk91: folds 
Fengjie82: folds 
QUATTRODAME: folds 
Uncalled bet (€0.05) returned to BetNoLook
BetNoLook collected €0.05 from pot
BetNoLook: doesn't show hand 
*** SUMMARY ***
Total pot €0.05 | Rake €0 
Seat 1: gigiruk91 (button) folded before Flop (didn't bet)
Seat 2: Fengjie82 (small blind) folded before Flop
Seat 3: QUATTRODAME (big blind) folded before Flop
Seat 4: BetNoLook collected (€0.05)
Seat 5: caduceus369 folded before Flop (didn't bet)
Seat 6: cuzzi68 folded before Flop (didn't bet)



PokerStars Zoom Hand #258039085004:  Hold'em No Limit (€0.01/€0.02) [ADM ID: M62C03044AE79CRJ] - 2025/10/07 23:42:07 CET [2025/10/07 17:42:07 ET]
Table 'Sirio' 6-max Seat #1 is the button
Seat 1: VagALiss (€7.40 in chips) 
Seat 2: caduceus369 (€2.39 in chips) 
Seat 3: robertoH2O (€3.23 in chips) 
Seat 4: QUATTRODAME (€5.18 in chips) 
Seat 5: mashallahh (€2.16 in chips) 
Seat 6: SidneyPrescott (€5.99 in chips) 
caduceus369: posts small blind €0.01
robertoH2O: posts big blind €0.02
*** HOLE CARDS ***
Dealt to caduceus369 [2s Qd]
QUATTRODAME: folds 
mashallahh: folds 
SidneyPrescott: folds 
VagALiss: raises €0.03 to €0.05
caduceus369: folds 
robertoH2O: folds 
Uncalled bet (€0.03) returned to VagALiss
VagALiss collected €0.05 from pot
VagALiss: doesn't show hand 
*** SUMMARY ***
Total pot €0.05 | Rake €0 
Seat 1: VagALiss (button) collected (€0.05)
Seat 2: caduceus369 (small blind) folded before Flop
Seat 3: robertoH2O (big blind) folded before Flop
Seat 4: QUATTRODAME folded before Flop (didn't bet)
Seat 5: mashallahh folded before Flop (didn't bet)
Seat 6: SidneyPrescott folded before Flop (didn't bet)



PokerStars Zoom Hand #258039096093:  Hold'em No Limit (€0.01/€0.02) [ADM ID: M62C03044AE79CRJ] - 2025/10/07 23:42:54 CET [2025/10/07 17:42:54 ET]
Table 'Sirio' 6-max Seat #1 is the button
Seat 1: Iacuba (€3.47 in chips) 
Seat 2: demolitor75 (€0.62 in chips) 
Seat 3: plutonexx (€1.47 in chips) 
Seat 4: SidneyPrescott (€5.91 in chips) 
Seat 5: caduceus369 (€2.35 in chips) 
Seat 6: Ch4oS_Matteo00 (€2.14 in chips) 
demolitor75: posts small blind €0.01
plutonexx: posts big blind €0.02
*** HOLE CARDS ***
Dealt to caduceus369 [As 9c]
SidneyPrescott: raises €0.04 to €0.06
caduceus369: folds 
Ch4oS_Matteo00: folds 
Iacuba: folds 
demolitor75: folds 
plutonexx: folds 
Uncalled bet (€0.04) returned to SidneyPrescott
SidneyPrescott collected €0.05 from pot
SidneyPrescott: doesn't show hand 
*** SUMMARY ***
Total pot €0.05 | Rake €0 
Seat 1: Iacuba (button) folded before Flop (didn't bet)
Seat 2: demolitor75 (small blind) folded before Flop
Seat 3: plutonexx (big blind) folded before Flop
Seat 4: SidneyPrescott collected (€0.05)
Seat 5: caduceus369 folded before Flop (didn't bet)
Seat 6: Ch4oS_Matteo00 folded before Flop (didn't bet)



PokerStars Zoom Hand #258039091184:  Hold'em No Limit (€0.01/€0.02) [ADM ID: M62C03044AE79CRJ] - 2025/10/07 23:42:33 CET [2025/10/07 17:42:33 ET]
Table 'Sirio' 6-max Seat #1 is the button
Seat 1: caduceus369 (€2.36 in chips) 
Seat 2: QUATTRODAME (€5.15 in chips) 
Seat 3: algr78 (€0.64 in chips) 
Seat 4: SiMoOoOo93 (€1.04 in chips) 
Seat 5: OMGWOLFX (€3.55 in chips) 
Seat 6: Tuttopersempre (€1.11 in chips) 
QUATTRODAME: posts small blind €0.01
algr78: posts big blind €0.02
*** HOLE CARDS ***
Dealt to caduceus369 [Qh 7d]
SiMoOoOo93: folds 
OMGWOLFX: raises €0.04 to €0.06
Tuttopersempre: calls €0.06
caduceus369: folds 
QUATTRODAME: folds 
algr78: folds 
*** FLOP *** [3c Tc Kh]
OMGWOLFX: bets €0.08
Tuttopersempre: calls €0.08
*** TURN *** [3c Tc Kh] [6c]
OMGWOLFX: bets €0.18
Tuttopersempre: raises €0.18 to €0.36
OMGWOLFX: raises €0.18 to €0.54
Tuttopersempre: calls €0.18
*** RIVER *** [3c Tc Kh 6c] [4d]
OMGWOLFX: bets €0.66
Tuttopersempre: folds 
Uncalled bet (€0.66) returned to OMGWOLFX
OMGWOLFX collected €1.32 from pot
OMGWOLFX: doesn't show hand 
*** SUMMARY ***
Total pot €1.39 | Rake €0.07 
Board [3c Tc Kh 6c 4d]
Seat 1: caduceus369 (button) folded before Flop (didn't bet)
Seat 2: QUATTRODAME (small blind) folded before Flop
Seat 3: algr78 (big blind) folded before Flop
Seat 4: SiMoOoOo93 folded before Flop (didn't bet)
Seat 5: OMGWOLFX collected (€1.32)
Seat 6: Tuttopersempre folded on the River



PokerStars Zoom Hand #258039093712:  Hold'em No Limit (€0.01/€0.02) [ADM ID: M62C03044AE79CRJ] - 2025/10/07 23:42:44 CET [2025/10/07 17:42:44 ET]
Table 'Sirio' 6-max Seat #1 is the button
Seat 1: gigiruk91 (€5.08 in chips) 
Seat 2: caduceus369 (€2.36 in chips) 
Seat 3: SiMoOoOo93 (€1.04 in chips) 
Seat 4: mashallahh (€8.26 in chips) 
Seat 5: plutonexx (€1.47 in chips) 
Seat 6: ADRIAN0_MEIS (€21.12 in chips) 
caduceus369: posts small blind €0.01
SiMoOoOo93: posts big blind €0.02
*** HOLE CARDS ***
Dealt to caduceus369 [Qh 8s]
mashallahh: folds 
plutonexx: folds 
ADRIAN0_MEIS: folds 
gigiruk91: raises €0.02 to €0.04
caduceus369: folds 
SiMoOoOo93: calls €0.02
*** FLOP *** [Ah Js 7c]
SiMoOoOo93: checks 
gigiruk91: bets €0.09
SiMoOoOo93: calls €0.09
*** TURN *** [Ah Js 7c] [2s]
SiMoOoOo93: checks 
gigiruk91: bets €0.26
SiMoOoOo93: calls €0.26
*** RIVER *** [Ah Js 7c 2s] [Ts]
SiMoOoOo93: checks 
gigiruk91: bets €0.38
SiMoOoOo93: raises €0.27 to €0.65 and is all-in
gigiruk91: calls €0.27
*** SHOW DOWN ***
SiMoOoOo93: shows [Ac 7h] (two pair, Aces and Sevens)
gigiruk91: shows [Ad Jh] (two pair, Aces and Jacks)
gigiruk91 collected €1.98 from pot
*** SUMMARY ***
Total pot €2.09 | Rake €0.11 
Board [Ah Js 7c 2s Ts]
Seat 1: gigiruk91 (button) showed [Ad Jh] and won (€1.98) with two pair, Aces and Jacks
Seat 2: caduceus369 (small blind) folded before Flop
Seat 3: SiMoOoOo93 (big blind) showed [Ac 7h] and lost with two pair, Aces and Sevens
Seat 4: mashallahh folded before Flop (didn't bet)
Seat 5: plutonexx folded before Flop (didn't bet)
Seat 6: ADRIAN0_MEIS folded before Flop (didn't bet)



PokerStars Zoom Hand #258039098250:  Hold'em No Limit (€0.01/€0.02) [ADM ID: M62C03044AE79CRJ] - 2025/10/07 23:43:03 CET [2025/10/07 17:43:03 ET]
Table 'Sirio' 6-max Seat #1 is the button
Seat 1: Fengjie82 (€1.67 in chips) 
Seat 2: algr78 (€0.62 in chips) 
Seat 3: caduceus369 (€2.35 in chips) 
Seat 4: mondie73100 (€2.04 in chips) 
Seat 5: Mark Poke783 (€1.04 in chips) 
Seat 6: Ch4oS_Matteo00 (€2.14 in chips) 
algr78: posts small blind €0.01
caduceus369: posts big blind €0.02
*** HOLE CARDS ***
Dealt to caduceus369 [As 6c]
mondie73100: folds 
Mark Poke783: calls €0.02
Ch4oS_Matteo00: folds 
Fengjie82: folds 
algr78: calls €0.01
caduceus369: checks 
*** FLOP *** [2s Tc 8h]
algr78: checks 
caduceus369: checks 
Mark Poke783: checks 
*** TURN *** [2s Tc 8h] [Jc]
algr78: checks 
caduceus369: checks 
Mark Poke783: checks 
*** RIVER *** [2s Tc 8h Jc] [7c]
algr78: checks 
caduceus369: checks 
Mark Poke783: checks 
*** SHOW DOWN ***
algr78: shows [3d Kh] (high card King)
caduceus369: shows [As 6c] (high card Ace)
Mark Poke783: shows [4d Ad] (high card Ace)
caduceus369 collected €0.03 from pot
Mark Poke783 collected €0.03 from pot
*** SUMMARY ***
Total pot €0.06 | Rake €0 
Board [2s Tc 8h Jc 7c]
Seat 1: Fengjie82 (button) folded before Flop (didn't bet)
Seat 2: algr78 (small blind) showed [3d Kh] and lost with high card King
Seat 3: caduceus369 (big blind) showed [As 6c] and won (€0.03) with high card Ace
Seat 4: mondie73100 folded before Flop (didn't bet)
Seat 5: Mark Poke783 showed [4d Ad] and won (€0.03) with high card Ace
Seat 6: Ch4oS_Matteo00 folded before Flop (didn't bet)



PokerStars Zoom Hand #258039089729:  Hold'em No Limit (€0.01/€0.02) [ADM ID: M62C03044AE79CRJ] - 2025/10/07 23:42:27 CET [2025/10/07 17:42:27 ET]
Table 'Sirio' 6-max Seat #1 is the button
Seat 1: maury999999 (€2 in chips) 
Seat 2: OMGWOLFX (€4.35 in chips) 
Seat 3: caduceus369 (€2.38 in chips) 
Seat 4: SidneyPrescott (€5.97 in chips) 
Seat 5: cuzzi68 (€2.29 in chips) 
Seat 6: mondie73100 (€2.03 in chips) 
OMGWOLFX: posts small blind €0.01
caduceus369: posts big blind €0.02
*** HOLE CARDS ***
Dealt to caduceus369 [Td 3h]
SidneyPrescott: raises €0.03 to €0.05
cuzzi68: calls €0.05
mondie73100: folds 
maury999999: raises €0.19 to €0.24
OMGWOLFX: folds 
caduceus369: folds 
SidneyPrescott: folds 
cuzzi68: calls €0.19
*** FLOP *** [7s 2s Qc]
cuzzi68: checks 
maury999999: bets €0.17
cuzzi68: calls €0.17
*** TURN *** [7s 2s Qc] [9s]
cuzzi68: checks 
maury999999: bets €0.57
cuzzi68: raises €1.31 to €1.88 and is all-in
maury999999: folds 
Uncalled bet (€1.31) returned to cuzzi68
cuzzi68 collected €1.93 from pot
cuzzi68: doesn't show hand 
*** SUMMARY ***
Total pot €2.04 | Rake €0.11 
Board [7s 2s Qc 9s]
Seat 1: maury999999 (button) folded on the Turn
Seat 2: OMGWOLFX (small blind) folded before Flop
Seat 3: caduceus369 (big blind) folded before Flop
Seat 4: SidneyPrescott folded before Flop
Seat 5: cuzzi68 collected (€1.93)
Seat 6: mondie73100 folded before Flop (didn't bet)



PokerStars Zoom Hand #258039108982:  Hold'em No Limit (€0.01/€0.02) [ADM ID: M62C03044AE79CRJ] - 2025/10/07 23:43:49 CET [2025/10/07 17:43:49 ET]
Table 'Sirio' 6-max Seat #1 is the button
Seat 1: SiMoOoOo93 (€1.14 in chips) 
Seat 2: QUATTRODAME (€5.15 in chips) 
Seat 3: stev@nin (€5.34 in chips) 
Seat 4: mondie73100 (€2 in chips) 
Seat 5: algr78 (€0.60 in chips) 
Seat 6: caduceus369 (€2.36 in chips) 
QUATTRODAME: posts small blind €0.01
stev@nin: posts big blind €0.02
*** HOLE CARDS ***
Dealt to caduceus369 [Qs Qd]
mondie73100: folds 
algr78: folds 
caduceus369: raises €0.04 to €0.06
SiMoOoOo93: folds 
QUATTRODAME: folds 
stev@nin: folds 
Uncalled bet (€0.04) returned to caduceus369
caduceus369 collected €0.05 from pot
caduceus369: doesn't show hand 
*** SUMMARY ***
Total pot €0.05 | Rake €0 
Seat 1: SiMoOoOo93 (button) folded before Flop (didn't bet)
Seat 2: QUATTRODAME (small blind) folded before Flop
Seat 3: stev@nin (big blind) folded before Flop
Seat 4: mondie73100 folded before Flop (didn't bet)
Seat 5: algr78 folded before Flop (didn't bet)
Seat 6: caduceus369 collected (€0.05)



PokerStars Zoom Hand #258039114781:  Hold'em No Limit (€0.01/€0.02) [ADM ID: M62C03044AE79CRJ] - 2025/10/07 23:44:14 CET [2025/10/07 17:44:14 ET]
Table 'Sirio' 6-max Seat #1 is the button
Seat 1: caduceus369 (€2.39 in chips) 
Seat 2: dellas3131 (€2 in chips) 
Seat 3: maury999999 (€2 in chips) 
Seat 4: Fengjie82 (€1.74 in chips) 
Seat 5: QUATTRODAME (€5.12 in chips) 
Seat 6: gigiruk91 (€6 in chips) 
dellas3131: posts small blind €0.01
maury999999: posts big blind €0.02
*** HOLE CARDS ***
Dealt to caduceus369 [3d 4s]
Fengjie82: folds 
QUATTRODAME: folds 
gigiruk91: folds 
caduceus369: folds 
dellas3131: folds 
Uncalled bet (€0.01) returned to maury999999
maury999999 collected €0.02 from pot
maury999999: doesn't show hand 
*** SUMMARY ***
Total pot €0.02 | Rake €0 
Seat 1: caduceus369 (button) folded before Flop (didn't bet)
Seat 2: dellas3131 (small blind) folded before Flop
Seat 3: maury999999 (big blind) collected (€0.02)
Seat 4: Fengjie82 folded before Flop (didn't bet)
Seat 5: QUATTRODAME folded before Flop (didn't bet)
Seat 6: gigiruk91 folded before Flop (didn't bet)



PokerStars Zoom Hand #258039113471:  Hold'em No Limit (€0.01/€0.02) [ADM ID: M62C03044AE79CRJ] - 2025/10/07 23:44:08 CET [2025/10/07 17:44:08 ET]
Table 'Sirio' 6-max Seat #1 is the button
Seat 1: gigiruk91 (€4.31 in chips) 
Seat 2: mashallahh (€6.59 in chips) 
Seat 3: SiMoOoOo93 (€1.14 in chips) 
Seat 4: caduceus369 (€2.39 in chips) 
Seat 5: SidneyPrescott (€6.06 in chips) 
Seat 6: cuzzi68 (€3.24 in chips) 
mashallahh: posts small blind €0.01
SiMoOoOo93: posts big blind €0.02
*** HOLE CARDS ***
Dealt to caduceus369 [7c 5s]
caduceus369: folds 
SidneyPrescott: folds 
cuzzi68: calls €0.02
gigiruk91: folds 
mashallahh: raises €0.06 to €0.08
SiMoOoOo93: raises €0.14 to €0.22
cuzzi68: folds 
mashallahh: folds 
Uncalled bet (€0.14) returned to SiMoOoOo93
SiMoOoOo93 collected €0.18 from pot
SiMoOoOo93: doesn't show hand 
*** SUMMARY ***
Total pot €0.18 | Rake €0 
Seat 1: gigiruk91 (button) folded before Flop (didn't bet)
Seat 2: mashallahh (small blind) folded before Flop
Seat 3: SiMoOoOo93 (big blind) collected (€0.18)
Seat 4: caduceus369 folded before Flop (didn't bet)
Seat 5: SidneyPrescott folded before Flop (didn't bet)
Seat 6: cuzzi68 folded before Flop



PokerStars Zoom Hand #258039120689:  Hold'em No Limit (€0.01/€0.02) [ADM ID: M62C03044AE79CRJ] - 2025/10/07 23:44:39 CET [2025/10/07 17:44:39 ET]
Table 'Sirio' 6-max Seat #1 is the button
Seat 1: QUATTRODAME (€5.10 in chips) 
Seat 2: maury999999 (€2.01 in chips) 
Seat 3: diesel197474 (€1.97 in chips) 
Seat 4: Coffeebreak96 (€4.16 in chips) 
Seat 5: caduceus369 (€2.38 in chips) 
Seat 6: bruciapelo (€4.99 in chips) 
maury999999: posts small blind €0.01
diesel197474: posts big blind €0.02
*** HOLE CARDS ***
Dealt to caduceus369 [Td 8d]
Coffeebreak96: folds 
caduceus369: folds 
bruciapelo: folds 
QUATTRODAME: folds 
maury999999: raises €0.04 to €0.06
diesel197474: folds 
Uncalled bet (€0.04) returned to maury999999
maury999999 collected €0.04 from pot
maury999999: doesn't show hand 
*** SUMMARY ***
Total pot €0.04 | Rake €0 
Seat 1: QUATTRODAME (button) folded before Flop (didn't bet)
Seat 2: maury999999 (small blind) collected (€0.04)
Seat 3: diesel197474 (big blind) folded before Flop
Seat 4: Coffeebreak96 folded before Flop (didn't bet)
Seat 5: caduceus369 folded before Flop (didn't bet)
Seat 6: bruciapelo folded before Flop (didn't bet)



PokerStars Zoom Hand #258039118146:  Hold'em No Limit (€0.01/€0.02) [ADM ID: M62C03044AE79CRJ] - 2025/10/07 23:44:28 CET [2025/10/07 17:44:28 ET]
Table 'Sirio' 6-max Seat #1 is the button
Seat 1: Paky6688988 (€1.04 in chips) 
Seat 2: fantaasso (€1.88 in chips) 
Seat 3: simo942477 (€0.48 in chips) 
Seat 4: dellas3131 (€2 in chips) 
Seat 5: Tuttopersempre (€0.29 in chips) 
Seat 6: caduceus369 (€2.38 in chips) 
fantaasso: posts small blind €0.01
simo942477: posts big blind €0.02
*** HOLE CARDS ***
Dealt to caduceus369 [5s Ts]
dellas3131: folds 
Tuttopersempre: calls €0.02
caduceus369: folds 
Paky6688988: folds 
fantaasso: folds 
simo942477: raises €0.04 to €0.06
Tuttopersempre: calls €0.04
*** FLOP *** [9h 6c 5h]
simo942477: checks 
Tuttopersempre: bets €0.23 and is all-in
simo942477: folds 
Uncalled bet (€0.23) returned to Tuttopersempre
Tuttopersempre collected €0.13 from pot
Tuttopersempre: doesn't show hand 
*** SUMMARY ***
Total pot €0.13 | Rake €0 
Board [9h 6c 5h]
Seat 1: Paky6688988 (button) folded before Flop (didn't bet)
Seat 2: fantaasso (small blind) folded before Flop
Seat 3: simo942477 (big blind) folded on the Flop
Seat 4: dellas3131 folded before Flop (didn't bet)
Seat 5: Tuttopersempre collected (€0.13)
Seat 6: caduceus369 folded before Flop (didn't bet)



PokerStars Zoom Hand #258039116011:  Hold'em No Limit (€0.01/€0.02) [ADM ID: M62C03044AE79CRJ] - 2025/10/07 23:44:19 CET [2025/10/07 17:44:19 ET]
Table 'Sirio' 6-max Seat #1 is the button
Seat 1: cagliari59 (€3.42 in chips) 
Seat 2: caduceus369 (€2.39 in chips) 
Seat 3: algr78 (€0.97 in chips) 
Seat 4: mashallahh (€2.76 in chips) 
Seat 5: Coffeebreak96 (€4.18 in chips) 
Seat 6: Tuttopersempre (€0.29 in chips) 
caduceus369: posts small blind €0.01
algr78: posts big blind €0.02
*** HOLE CARDS ***
Dealt to caduceus369 [4d Kd]
mashallahh: raises €0.04 to €0.06
Coffeebreak96: folds 
Tuttopersempre: folds 
cagliari59: folds 
caduceus369: folds 
algr78: calls €0.04
*** FLOP *** [5d Ah 9d]
algr78: checks 
mashallahh: bets €0.09
algr78: calls €0.09
*** TURN *** [5d Ah 9d] [Js]
algr78: checks 
mashallahh: checks 
*** RIVER *** [5d Ah 9d Js] [9s]
algr78: bets €0.14
mashallahh: calls €0.14
*** SHOW DOWN ***
algr78: shows [As 9h] (a full house, Nines full of Aces)
mashallahh: mucks hand 
algr78 collected €0.56 from pot
*** SUMMARY ***
Total pot €0.59 | Rake €0.03 
Board [5d Ah 9d Js 9s]
Seat 1: cagliari59 (button) folded before Flop (didn't bet)
Seat 2: caduceus369 (small blind) folded before Flop
Seat 3: algr78 (big blind) showed [As 9h] and won (€0.56) with a full house, Nines full of Aces
Seat 4: mashallahh mucked [Kh Qs]
Seat 5: Coffeebreak96 folded before Flop (didn't bet)
Seat 6: Tuttopersempre folded before Flop (didn't bet)



PokerStars Zoom Hand #258039122001:  Hold'em No Limit (€0.01/€0.02) [ADM ID: M62C03044AE79CRJ] - 2025/10/07 23:44:45 CET [2025/10/07 17:44:45 ET]
Table 'Sirio' 6-max Seat #1 is the button
Seat 1: Ilpazzo58 (€1.80 in chips) 
Seat 2: Coffeebreak96 (€4.16 in chips) 
Seat 3: gigiruk91 (€5.99 in chips) 
Seat 4: caduceus369 (€2.38 in chips) 
Seat 5: QUATTRODAME (€5.10 in chips) 
Seat 6: mashallahh (€6.51 in chips) 
Coffeebreak96: posts small blind €0.01
gigiruk91: posts big blind €0.02
*** HOLE CARDS ***
Dealt to caduceus369 [7s 6c]
caduceus369: folds 
QUATTRODAME: raises €0.04 to €0.06
mashallahh: folds 
Ilpazzo58: raises €0.06 to €0.12
Coffeebreak96: folds 
gigiruk91: folds 
QUATTRODAME: calls €0.06
*** FLOP *** [Kc 9s 6s]
QUATTRODAME: checks 
Ilpazzo58: checks 
*** TURN *** [Kc 9s 6s] [9c]
QUATTRODAME: bets €0.26
Ilpazzo58: calls €0.26
*** RIVER *** [Kc 9s 6s 9c] [Td]
QUATTRODAME: checks 
Ilpazzo58: checks 
*** SHOW DOWN ***
QUATTRODAME: shows [Ts Jh] (two pair, Tens and Nines)
Ilpazzo58: mucks hand 
QUATTRODAME collected €0.75 from pot
*** SUMMARY ***
Total pot €0.79 | Rake €0.04 
Board [Kc 9s 6s 9c Td]
Seat 1: Ilpazzo58 (button) mucked [Qh As]
Seat 2: Coffeebreak96 (small blind) folded before Flop
Seat 3: gigiruk91 (big blind) folded before Flop
Seat 4: caduceus369 folded before Flop (didn't bet)
Seat 5: QUATTRODAME showed [Ts Jh] and won (€0.75) with two pair, Tens and Nines
Seat 6: mashallahh folded before Flop (didn't bet)



PokerStars Zoom Hand #258039123498:  Hold'em No Limit (€0.01/€0.02) [ADM ID: M62C03044AE79CRJ] - 2025/10/07 23:44:51 CET [2025/10/07 17:44:51 ET]
Table 'Sirio' 6-max Seat #1 is the button
Seat 1: fantaasso (€1.85 in chips) 
Seat 2: SebaRapy14 (€2.22 in chips) 
Seat 3: caduceus369 (€2.38 in chips) 
Seat 4: mondie73100 (€2 in chips) 
Seat 5: SiMoOoOo93 (€1.23 in chips) 
Seat 6: dellas3131 (€2 in chips) 
SebaRapy14: posts small blind €0.01
caduceus369: posts big blind €0.02
*** HOLE CARDS ***
Dealt to caduceus369 [5h 5c]
mondie73100: folds 
SiMoOoOo93: folds 
dellas3131: folds 
fantaasso: folds 
SebaRapy14: raises €0.04 to €0.06
caduceus369: calls €0.04
*** FLOP *** [3h 6d Kh]
SebaRapy14: bets €0.05
caduceus369: calls €0.05
*** TURN *** [3h 6d Kh] [7c]
SebaRapy14: checks 
caduceus369: checks 
*** RIVER *** [3h 6d Kh 7c] [Ks]
SebaRapy14: bets €0.14
caduceus369: calls €0.14
*** SHOW DOWN ***
SebaRapy14: shows [3c Ac] (two pair, Kings and Threes)
caduceus369: shows [5h 5c] (two pair, Kings and Fives)
caduceus369 collected €0.48 from pot
*** SUMMARY ***
Total pot €0.50 | Rake €0.02 
Board [3h 6d Kh 7c Ks]
Seat 1: fantaasso (button) folded before Flop (didn't bet)
Seat 2: SebaRapy14 (small blind) showed [3c Ac] and lost with two pair, Kings and Threes
Seat 3: caduceus369 (big blind) showed [5h 5c] and won (€0.48) with two pair, Kings and Fives
Seat 4: mondie73100 folded before Flop (didn't bet)
Seat 5: SiMoOoOo93 folded before Flop (didn't bet)
Seat 6: dellas3131 folded before Flop (didn't bet)



PokerStars Zoom Hand #258039144693:  Hold'em No Limit (€0.01/€0.02) [ADM ID: M62C03044AE79CRJ] - 2025/10/07 23:46:23 CET [2025/10/07 17:46:23 ET]
Table 'Sirio' 6-max Seat #1 is the button
Seat 1: caduceus369 (€2.61 in chips) 
Seat 2: robertoH2O (€2.86 in chips) 
Seat 3: Fengjie82 (€1.81 in chips) 
Seat 4: eni164 (€1.23 in chips) 
Seat 5: BetNoLook (€3.21 in chips) 
Seat 6: algr78 (€0.56 in chips) 
robertoH2O: posts small blind €0.01
Fengjie82: posts big blind €0.02
*** HOLE CARDS ***
Dealt to caduceus369 [9c 7h]
eni164: folds 
BetNoLook: raises €0.05 to €0.07
algr78: folds 
caduceus369: folds 
robertoH2O: raises €0.17 to €0.24
Fengjie82: folds 
BetNoLook: calls €0.17
*** FLOP *** [As 9s 6s]
robertoH2O: checks 
BetNoLook: checks 
*** TURN *** [As 9s 6s] [5d]
robertoH2O: bets €0.36
BetNoLook: folds 
Uncalled bet (€0.36) returned to robertoH2O
robertoH2O collected €0.48 from pot
robertoH2O: doesn't show hand 
*** SUMMARY ***
Total pot €0.50 | Rake €0.02 
Board [As 9s 6s 5d]
Seat 1: caduceus369 (button) folded before Flop (didn't bet)
Seat 2: robertoH2O (small blind) collected (€0.48)
Seat 3: Fengjie82 (big blind) folded before Flop
Seat 4: eni164 folded before Flop (didn't bet)
Seat 5: BetNoLook folded on the Turn
Seat 6: algr78 folded before Flop (didn't bet)



PokerStars Zoom Hand #258039142574:  Hold'em No Limit (€0.01/€0.02) [ADM ID: M62C03044AE79CRJ] - 2025/10/07 23:46:13 CET [2025/10/07 17:46:13 ET]
Table 'Sirio' 6-max Seat #1 is the button
Seat 1: Strizzi91 (€0.61 in chips) 
Seat 2: Ilpazzo58 (€1.42 in chips) 
Seat 3: VagALiss (€7.29 in chips) 
Seat 4: algr78 (€0.56 in chips) 
Seat 5: caduceus369 (€2.61 in chips) 
Seat 6: stev@nin (€4 in chips) 
Ilpazzo58: posts small blind €0.01
VagALiss: posts big blind €0.02
*** HOLE CARDS ***
Dealt to caduceus369 [5h Qs]
algr78: folds 
caduceus369: folds 
stev@nin: folds 
Strizzi91: folds 
Ilpazzo58: calls €0.01
VagALiss: checks 
*** FLOP *** [2d Kd 8s]
Ilpazzo58: checks 
VagALiss: bets €0.02
Ilpazzo58: calls €0.02
*** TURN *** [2d Kd 8s] [Ks]
Ilpazzo58: checks 
VagALiss: bets €0.04
Ilpazzo58: calls €0.04
*** RIVER *** [2d Kd 8s Ks] [Kc]
Ilpazzo58: bets €0.04
VagALiss: calls €0.04
*** SHOW DOWN ***
Ilpazzo58: shows [Kh 3s] (four of a kind, Kings)
VagALiss: mucks hand 
Ilpazzo58 collected €0.23 from pot
*** SUMMARY ***
Total pot €0.24 | Rake €0.01 
Board [2d Kd 8s Ks Kc]
Seat 1: Strizzi91 (button) folded before Flop (didn't bet)
Seat 2: Ilpazzo58 (small blind) showed [Kh 3s] and won (€0.23) with four of a kind, Kings
Seat 3: VagALiss (big blind) mucked [2c 2h]
Seat 4: algr78 folded before Flop (didn't bet)
Seat 5: caduceus369 folded before Flop (didn't bet)
Seat 6: stev@nin folded before Flop (didn't bet)



PokerStars Zoom Hand #258039146503:  Hold'em No Limit (€0.01/€0.02) [ADM ID: M62C03044AE79CRJ] - 2025/10/07 23:46:30 CET [2025/10/07 17:46:30 ET]
Table 'Sirio' 6-max Seat #1 is the button
Seat 1: algr78 (€0.56 in chips) 
Seat 2: caduceus369 (€2.61 in chips) 
Seat 3: stev@nin (€4 in chips) 
Seat 4: dellas3131 (€2 in chips) 
Seat 5: gigiruk91 (€2.04 in chips) 
Seat 6: mondie73100 (€2 in chips) 
caduceus369: posts small blind €0.01
stev@nin: posts big blind €0.02
*** HOLE CARDS ***
Dealt to caduceus369 [Kd 6h]
dellas3131: folds 
gigiruk91: folds 
mondie73100: raises €0.04 to €0.06
algr78: folds 
caduceus369: folds 
stev@nin: folds 
Uncalled bet (€0.04) returned to mondie73100
mondie73100 collected €0.05 from pot
mondie73100: doesn't show hand 
*** SUMMARY ***
Total pot €0.05 | Rake €0 
Seat 1: algr78 (button) folded before Flop (didn't bet)
Seat 2: caduceus369 (small blind) folded before Flop
Seat 3: stev@nin (big blind) folded before Flop
Seat 4: dellas3131 folded before Flop (didn't bet)
Seat 5: gigiruk91 folded before Flop (didn't bet)
Seat 6: mondie73100 collected (€0.05)



PokerStars Zoom Hand #258039152081:  Hold'em No Limit (€0.01/€0.02) [ADM ID: M62C03044AE79CRJ] - 2025/10/07 23:46:55 CET [2025/10/07 17:46:55 ET]
Table 'Sirio' 6-max Seat #1 is the button
Seat 1: mashallahh (€8.23 in chips) 
Seat 2: stev@nin (€5.72 in chips) 
Seat 3: Gaboops (€1.93 in chips) 
Seat 4: simo942477 (€0.40 in chips) 
Seat 5: pistaKKio23 (€5.08 in chips) 
Seat 6: caduceus369 (€2.60 in chips) 
stev@nin: posts small blind €0.01
Gaboops: posts big blind €0.02
*** HOLE CARDS ***
Dealt to caduceus369 [Ac Ts]
simo942477: raises €0.04 to €0.06
pistaKKio23: folds 
caduceus369: folds 
mashallahh: folds 
stev@nin: folds 
Gaboops: folds 
Uncalled bet (€0.04) returned to simo942477
simo942477 collected €0.05 from pot
simo942477: doesn't show hand 
*** SUMMARY ***
Total pot €0.05 | Rake €0 
Seat 1: mashallahh (button) folded before Flop (didn't bet)
Seat 2: stev@nin (small blind) folded before Flop
Seat 3: Gaboops (big blind) folded before Flop
Seat 4: simo942477 collected (€0.05)
Seat 5: pistaKKio23 folded before Flop (didn't bet)
Seat 6: caduceus369 folded before Flop (didn't bet)



PokerStars Zoom Hand #258039156492:  Hold'em No Limit (€0.01/€0.02) [ADM ID: M62C03044AE79CRJ] - 2025/10/07 23:47:14 CET [2025/10/07 17:47:14 ET]
Table 'Sirio' 6-max Seat #1 is the button
Seat 1: caduceus369 (€2.60 in chips) 
Seat 2: SidneyPrescott (€7.11 in chips) 
Seat 3: stev@nin (€5.71 in chips) 
Seat 4: Iacuba (€3.86 in chips) 
Seat 5: diesel197474 (€1.81 in chips) 
Seat 6: gigiruk91 (€4.77 in chips) 
SidneyPrescott: posts small blind €0.01
stev@nin: posts big blind €0.02
*** HOLE CARDS ***
Dealt to caduceus369 [6c Ad]
Iacuba has timed out
Iacuba: folds 
diesel197474: folds 
gigiruk91: folds 
caduceus369: raises €0.04 to €0.06
SidneyPrescott: folds 
stev@nin: folds 
Uncalled bet (€0.04) returned to caduceus369
caduceus369 collected €0.05 from pot
caduceus369: doesn't show hand 
*** SUMMARY ***
Total pot €0.05 | Rake €0 
Seat 1: caduceus369 (button) collected (€0.05)
Seat 2: SidneyPrescott (small blind) folded before Flop
Seat 3: stev@nin (big blind) folded before Flop
Seat 4: Iacuba folded before Flop (didn't bet)
Seat 5: diesel197474 folded before Flop (didn't bet)
Seat 6: gigiruk91 folded before Flop (didn't bet)



PokerStars Zoom Hand #258039154981:  Hold'em No Limit (€0.01/€0.02) [ADM ID: M62C03044AE79CRJ] - 2025/10/07 23:47:07 CET [2025/10/07 17:47:07 ET]
Table 'Sirio' 6-max Seat #1 is the button
Seat 1: vifracar1 (€7.23 in chips) 
Seat 2: Tuttopersempre (€1.01 in chips) 
Seat 3: pistaKKio23 (€3.75 in chips) 
Seat 4: caduceus369 (€2.60 in chips) 
Seat 5: mashallahh (€2.56 in chips) 
Seat 6: Strizzi91 (€0.73 in chips) 
Tuttopersempre: posts small blind €0.01
pistaKKio23: posts big blind €0.02
*** HOLE CARDS ***
Dealt to caduceus369 [5c 6s]
caduceus369: folds 
mashallahh: folds 
Strizzi91: calls €0.02
vifracar1: calls €0.02
Tuttopersempre: raises €0.02 to €0.04
pistaKKio23: folds 
Strizzi91: calls €0.02
vifracar1: calls €0.02
*** FLOP *** [Qc 4c 5d]
Tuttopersempre: checks 
Strizzi91: bets €0.02
vifracar1: raises €0.08 to €0.10
Tuttopersempre: folds 
Strizzi91: calls €0.08
*** TURN *** [Qc 4c 5d] [Th]
Strizzi91: checks 
vifracar1: bets €0.33
Strizzi91: calls €0.33
*** RIVER *** [Qc 4c 5d Th] [Ad]
Strizzi91: checks 
vifracar1: bets €0.95
Strizzi91: calls €0.26 and is all-in
Uncalled bet (€0.69) returned to vifracar1
*** SHOW DOWN ***
vifracar1: shows [Qh 4h] (two pair, Queens and Fours)
Strizzi91: shows [Qd 7c] (a pair of Queens)
vifracar1 collected €1.44 from pot
*** SUMMARY ***
Total pot €1.52 | Rake €0.08 
Board [Qc 4c 5d Th Ad]
Seat 1: vifracar1 (button) showed [Qh 4h] and won (€1.44) with two pair, Queens and Fours
Seat 2: Tuttopersempre (small blind) folded on the Flop
Seat 3: pistaKKio23 (big blind) folded before Flop
Seat 4: caduceus369 folded before Flop (didn't bet)
Seat 5: mashallahh folded before Flop (didn't bet)
Seat 6: Strizzi91 showed [Qd 7c] and lost with a pair of Queens



PokerStars Zoom Hand #258039163283:  Hold'em No Limit (€0.01/€0.02) [ADM ID: M62C03044AE79CRJ] - 2025/10/07 23:47:43 CET [2025/10/07 17:47:43 ET]
Table 'Sirio' 6-max Seat #1 is the button
Seat 1: SebaRapy14 (€6.80 in chips) 
Seat 2: fantaasso (€1.89 in chips) 
Seat 3: caduceus369 (€2.63 in chips) 
Seat 4: pistaKKio23 (€5.21 in chips) 
Seat 5: Iacuba (€3.86 in chips) 
Seat 6: cuzzi68 (€3.33 in chips) 
fantaasso: posts small blind €0.01
caduceus369: posts big blind €0.02
*** HOLE CARDS ***
Dealt to caduceus369 [9s 6d]
pistaKKio23: folds 
Iacuba: raises €0.02 to €0.04
cuzzi68: folds 
SebaRapy14: raises €0.10 to €0.14
fantaasso: folds 
caduceus369: folds 
Iacuba: calls €0.10
*** FLOP *** [9h 3h Tc]
Iacuba: checks 
SebaRapy14: bets €0.13
Iacuba: folds 
Uncalled bet (€0.13) returned to SebaRapy14
SebaRapy14 collected €0.30 from pot
SebaRapy14: doesn't show hand 
*** SUMMARY ***
Total pot €0.31 | Rake €0.01 
Board [9h 3h Tc]
Seat 1: SebaRapy14 (button) collected (€0.30)
Seat 2: fantaasso (small blind) folded before Flop
Seat 3: caduceus369 (big blind) folded before Flop
Seat 4: pistaKKio23 folded before Flop (didn't bet)
Seat 5: Iacuba folded on the Flop
Seat 6: cuzzi68 folded before Flop (didn't bet)



PokerStars Zoom Hand #258039170641:  Hold'em No Limit (€0.01/€0.02) [ADM ID: M62C03044AE79CRJ] - 2025/10/07 23:48:15 CET [2025/10/07 17:48:15 ET]
Table 'Sirio' 6-max Seat #1 is the button
Seat 1: samgun.73 (€1.38 in chips) 
Seat 2: simo942477 (€0.45 in chips) 
Seat 3: VagALiss (€7.03 in chips) 
Seat 4: gigiruk91 (€4.73 in chips) 
Seat 5: caduceus369 (€2.60 in chips) 
Seat 6: mondie73100 (€2 in chips) 
simo942477: posts small blind €0.01
VagALiss: posts big blind €0.02
*** HOLE CARDS ***
Dealt to caduceus369 [Js 8s]
gigiruk91: raises €0.02 to €0.04
caduceus369: folds 
mondie73100: raises €0.15 to €0.19
samgun.73: folds 
simo942477: folds 
VagALiss: folds 
gigiruk91: folds 
Uncalled bet (€0.15) returned to mondie73100
mondie73100 collected €0.11 from pot
mondie73100: doesn't show hand 
*** SUMMARY ***
Total pot €0.11 | Rake €0 
Seat 1: samgun.73 (button) folded before Flop (didn't bet)
Seat 2: simo942477 (small blind) folded before Flop
Seat 3: VagALiss (big blind) folded before Flop
Seat 4: gigiruk91 folded before Flop
Seat 5: caduceus369 folded before Flop (didn't bet)
Seat 6: mondie73100 collected (€0.11)



PokerStars Zoom Hand #258039169282:  Hold'em No Limit (€0.01/€0.02) [ADM ID: M62C03044AE79CRJ] - 2025/10/07 23:48:09 CET [2025/10/07 17:48:09 ET]
Table 'Sirio' 6-max Seat #1 is the button
Seat 1: pistaKKio23 (€2.59 in chips) 
Seat 2: caduceus369 (€2.61 in chips) 
Seat 3: dellas3131 (€2.14 in chips) 
Seat 4: SaTheNuts_77 (€2.95 in chips) 
Seat 5: SidneyPrescott (€8.33 in chips) 
Seat 6: SiMoOoOo93 (€1.09 in chips) 
caduceus369: posts small blind €0.01
dellas3131: posts big blind €0.02
*** HOLE CARDS ***
Dealt to caduceus369 [9s 4h]
SaTheNuts_77: raises €0.03 to €0.05
SidneyPrescott: folds 
SiMoOoOo93: folds 
pistaKKio23: folds 
caduceus369: folds 
dellas3131: calls €0.03
*** FLOP *** [6h Jh 8d]
dellas3131: bets €0.08
SaTheNuts_77: calls €0.08
*** TURN *** [6h Jh 8d] [Jd]
dellas3131: bets €0.19
SaTheNuts_77: folds 
Uncalled bet (€0.19) returned to dellas3131
dellas3131 collected €0.26 from pot
dellas3131: doesn't show hand 
*** SUMMARY ***
Total pot €0.27 | Rake €0.01 
Board [6h Jh 8d Jd]
Seat 1: pistaKKio23 (button) folded before Flop (didn't bet)
Seat 2: caduceus369 (small blind) folded before Flop
Seat 3: dellas3131 (big blind) collected (€0.26)
Seat 4: SaTheNuts_77 folded on the Turn
Seat 5: SidneyPrescott folded before Flop (didn't bet)
Seat 6: SiMoOoOo93 folded before Flop (didn't bet)



PokerStars Zoom Hand #258039167158:  Hold'em No Limit (€0.01/€0.02) [ADM ID: M62C03044AE79CRJ] - 2025/10/07 23:48:00 CET [2025/10/07 17:48:00 ET]
Table 'Sirio' 6-max Seat #1 is the button
Seat 1: mashallahh (€2.53 in chips) 
Seat 2: eni164 (€1.10 in chips) 
Seat 3: pistaKKio23 (€3.73 in chips) 
Seat 4: ADRIAN0_MEIS (€22.97 in chips) 
Seat 5: diesel197474 (€1.78 in chips) 
Seat 6: caduceus369 (€2.61 in chips) 
eni164: posts small blind €0.01
pistaKKio23: posts big blind €0.02
*** HOLE CARDS ***
Dealt to caduceus369 [Ah 2c]
ADRIAN0_MEIS: folds 
diesel197474: folds 
caduceus369: folds 
mashallahh: folds 
eni164: raises €0.04 to €0.06
pistaKKio23: folds 
Uncalled bet (€0.04) returned to eni164
eni164 collected €0.04 from pot
eni164: doesn't show hand 
*** SUMMARY ***
Total pot €0.04 | Rake €0 
Seat 1: mashallahh (button) folded before Flop (didn't bet)
Seat 2: eni164 (small blind) collected (€0.04)
Seat 3: pistaKKio23 (big blind) folded before Flop
Seat 4: ADRIAN0_MEIS folded before Flop (didn't bet)
Seat 5: diesel197474 folded before Flop (didn't bet)
Seat 6: caduceus369 folded before Flop (didn't bet)



PokerStars Zoom Hand #258039177351:  Hold'em No Limit (€0.01/€0.02) [ADM ID: M62C03044AE79CRJ] - 2025/10/07 23:48:44 CET [2025/10/07 17:48:44 ET]
Table 'Sirio' 6-max Seat #1 is the button
Seat 1: SaTheNuts_77 (€2.82 in chips) 
Seat 2: chalexblake98 (€1.98 in chips) 
Seat 3: plutonexx (€1.49 in chips) 
Seat 4: caduceus369 (€2.58 in chips) 
Seat 5: QUATTRODAME (€5.29 in chips) 
Seat 6: gigiruk91 (€2.04 in chips) 
chalexblake98: posts small blind €0.01
plutonexx: posts big blind €0.02
*** HOLE CARDS ***
Dealt to caduceus369 [8c Ts]
caduceus369: folds 
QUATTRODAME: folds 
gigiruk91: raises €0.02 to €0.04
SaTheNuts_77: folds 
chalexblake98: folds 
plutonexx: raises €0.02 to €0.06
gigiruk91: calls €0.02
*** FLOP *** [Td 5h Kc]
plutonexx: bets €0.07
gigiruk91: folds 
Uncalled bet (€0.07) returned to plutonexx
plutonexx collected €0.13 from pot
plutonexx: doesn't show hand 
*** SUMMARY ***
Total pot €0.13 | Rake €0 
Board [Td 5h Kc]
Seat 1: SaTheNuts_77 (button) folded before Flop (didn't bet)
Seat 2: chalexblake98 (small blind) folded before Flop
Seat 3: plutonexx (big blind) collected (€0.13)
Seat 4: caduceus369 folded before Flop (didn't bet)
Seat 5: QUATTRODAME folded before Flop (didn't bet)
Seat 6: gigiruk91 folded on the Flop



PokerStars Zoom Hand #258039172267:  Hold'em No Limit (€0.01/€0.02) [ADM ID: M62C03044AE79CRJ] - 2025/10/07 23:48:22 CET [2025/10/07 17:48:22 ET]
Table 'Sirio' 6-max Seat #1 is the button
Seat 1: SidneyPrescott (€8.33 in chips) 
Seat 2: VagALiss (€7.01 in chips) 
Seat 3: caduceus369 (€2.60 in chips) 
Seat 4: samgun.73 (€1.38 in chips) 
Seat 5: bafo77_po (€1.03 in chips) 
Seat 6: darkodiablo (€1.42 in chips) 
VagALiss: posts small blind €0.01
caduceus369: posts big blind €0.02
*** HOLE CARDS ***
Dealt to caduceus369 [6s Ad]
samgun.73: folds 
bafo77_po: calls €0.02
darkodiablo: calls €0.02
SidneyPrescott: raises €0.06 to €0.08
VagALiss: folds 
caduceus369: folds 
bafo77_po: calls €0.06
darkodiablo: calls €0.06
*** FLOP *** [3d 5d Ks]
bafo77_po: bets €0.95 and is all-in
darkodiablo: calls €0.95
SidneyPrescott: folds 
*** TURN *** [3d 5d Ks] [Ah]
*** RIVER *** [3d 5d Ks Ah] [2h]
*** SHOW DOWN ***
bafo77_po: shows [3c 5c] (two pair, Fives and Threes)
darkodiablo: shows [Kh Js] (a pair of Kings)
bafo77_po collected €2.06 from pot
*** SUMMARY ***
Total pot €2.17 | Rake €0.11 
Board [3d 5d Ks Ah 2h]
Seat 1: SidneyPrescott (button) folded on the Flop
Seat 2: VagALiss (small blind) folded before Flop
Seat 3: caduceus369 (big blind) folded before Flop
Seat 4: samgun.73 folded before Flop (didn't bet)
Seat 5: bafo77_po showed [3c 5c] and won (€2.06) with two pair, Fives and Threes
Seat 6: darkodiablo showed [Kh Js] and lost with a pair of Kings



PokerStars Zoom Hand #258039178915:  Hold'em No Limit (€0.01/€0.02) [ADM ID: M62C03044AE79CRJ] - 2025/10/07 23:48:51 CET [2025/10/07 17:48:51 ET]
Table 'Sirio' 6-max Seat #1 is the button
Seat 1: caduceus369 (€2.58 in chips) 
Seat 2: SaTheNuts_77 (€2.82 in chips) 
Seat 3: Strizzi91 (€1.20 in chips) 
Seat 4: Coffeebreak96 (€3.75 in chips) 
Seat 5: Fengjie82 (€1.62 in chips) 
Seat 6: gigiruk91 (€5.87 in chips) 
SaTheNuts_77: posts small blind €0.01
Strizzi91: posts big blind €0.02
*** HOLE CARDS ***
Dealt to caduceus369 [6s 2s]
Coffeebreak96: folds 
Fengjie82: folds 
gigiruk91: raises €0.04 to €0.06
caduceus369: folds 
SaTheNuts_77: folds 
Strizzi91: calls €0.04
*** FLOP *** [3d 5s 4d]
Strizzi91: bets €0.02
gigiruk91: calls €0.02
*** TURN *** [3d 5s 4d] [2h]
Strizzi91: checks 
gigiruk91: bets €0.09
Strizzi91: calls €0.09
*** RIVER *** [3d 5s 4d 2h] [9c]
Strizzi91: checks 
gigiruk91: bets €0.17
Strizzi91: calls €0.17
*** SHOW DOWN ***
gigiruk91: shows [Ad Kd] (a straight, Ace to Five)
Strizzi91: mucks hand 
gigiruk91 collected €0.66 from pot
*** SUMMARY ***
Total pot €0.69 | Rake €0.03 
Board [3d 5s 4d 2h 9c]
Seat 1: caduceus369 (button) folded before Flop (didn't bet)
Seat 2: SaTheNuts_77 (small blind) folded before Flop
Seat 3: Strizzi91 (big blind) mucked [5c 4c]
Seat 4: Coffeebreak96 folded before Flop (didn't bet)
Seat 5: Fengjie82 folded before Flop (didn't bet)
Seat 6: gigiruk91 showed [Ad Kd] and won (€0.66) with a straight, Ace to Five



PokerStars Zoom Hand #258039184929:  Hold'em No Limit (€0.01/€0.02) [ADM ID: M62C03044AE79CRJ] - 2025/10/07 23:49:17 CET [2025/10/07 17:49:17 ET]
Table 'Sirio' 6-max Seat #1 is the button
Seat 1: mondie73100 (€2.12 in chips) 
Seat 2: mashallahh (€2.57 in chips) 
Seat 3: gigiruk91 (€2 in chips) 
Seat 4: SidneyPrescott (€7.28 in chips) 
Seat 5: pistaKKio23 (€3.69 in chips) 
Seat 6: caduceus369 (€2.57 in chips) 
mashallahh: posts small blind €0.01
gigiruk91: posts big blind €0.02
*** HOLE CARDS ***
Dealt to caduceus369 [Kc 6c]
SidneyPrescott: folds 
pistaKKio23: folds 
caduceus369: folds 
mondie73100: folds 
mashallahh: folds 
Uncalled bet (€0.01) returned to gigiruk91
gigiruk91 collected €0.02 from pot
gigiruk91: doesn't show hand 
*** SUMMARY ***
Total pot €0.02 | Rake €0 
Seat 1: mondie73100 (button) folded before Flop (didn't bet)
Seat 2: mashallahh (small blind) folded before Flop
Seat 3: gigiruk91 (big blind) collected (€0.02)
Seat 4: SidneyPrescott folded before Flop (didn't bet)
Seat 5: pistaKKio23 folded before Flop (didn't bet)
Seat 6: caduceus369 folded before Flop (didn't bet)



PokerStars Zoom Hand #258039182699:  Hold'em No Limit (€0.01/€0.02) [ADM ID: M62C03044AE79CRJ] - 2025/10/07 23:49:07 CET [2025/10/07 17:49:07 ET]
Table 'Sirio' 6-max Seat #1 is the button
Seat 1: eni164 (€1.20 in chips) 
Seat 2: caduceus369 (€2.58 in chips) 
Seat 3: SebaRapy14 (€2.12 in chips) 
Seat 4: gigiruk91 (€2 in chips) 
Seat 5: SaTheNuts_77 (€2.81 in chips) 
Seat 6: pistaKKio23 (€2.57 in chips) 
caduceus369: posts small blind €0.01
SebaRapy14: posts big blind €0.02
*** HOLE CARDS ***
Dealt to caduceus369 [7d Ks]
gigiruk91: folds 
SaTheNuts_77: folds 
pistaKKio23: raises €0.02 to €0.04
eni164: folds 
caduceus369: folds 
SebaRapy14: calls €0.02
*** FLOP *** [Ad Qc 2h]
SebaRapy14: checks 
pistaKKio23: checks 
*** TURN *** [Ad Qc 2h] [Kc]
SebaRapy14: bets €0.05
pistaKKio23: folds 
Uncalled bet (€0.05) returned to SebaRapy14
SebaRapy14 collected €0.09 from pot
SebaRapy14: doesn't show hand 
*** SUMMARY ***
Total pot €0.09 | Rake €0 
Board [Ad Qc 2h Kc]
Seat 1: eni164 (button) folded before Flop (didn't bet)
Seat 2: caduceus369 (small blind) folded before Flop
Seat 3: SebaRapy14 (big blind) collected (€0.09)
Seat 4: gigiruk91 folded before Flop (didn't bet)
Seat 5: SaTheNuts_77 folded before Flop (didn't bet)
Seat 6: pistaKKio23 folded on the Turn



PokerStars Zoom Hand #258039180140:  Hold'em No Limit (€0.01/€0.02) [ADM ID: M62C03044AE79CRJ] - 2025/10/07 23:48:56 CET [2025/10/07 17:48:56 ET]
Table 'Sirio' 6-max Seat #1 is the button
Seat 1: fantaasso (€1.86 in chips) 
Seat 2: pistaKKio23 (€3.61 in chips) 
Seat 3: mondie73100 (€2.07 in chips) 
Seat 4: QUATTRODAME (€5.27 in chips) 
Seat 5: caduceus369 (€2.58 in chips) 
Seat 6: SaTheNuts_77 (€2.81 in chips) 
pistaKKio23: posts small blind €0.01
mondie73100: posts big blind €0.02
*** HOLE CARDS ***
Dealt to caduceus369 [Td Ac]
QUATTRODAME: raises €0.04 to €0.06
caduceus369: folds 
SaTheNuts_77: folds 
fantaasso: folds 
pistaKKio23: folds 
mondie73100: calls €0.04
*** FLOP *** [3s 7s 9s]
mondie73100: checks 
QUATTRODAME: checks 
*** TURN *** [3s 7s 9s] [8d]
mondie73100: checks 
QUATTRODAME: checks 
*** RIVER *** [3s 7s 9s 8d] [6d]
mondie73100: checks 
QUATTRODAME: checks 
*** SHOW DOWN ***
mondie73100: shows [2d 2c] (a pair of Deuces)
QUATTRODAME: mucks hand 
mondie73100 collected €0.13 from pot
*** SUMMARY ***
Total pot €0.13 | Rake €0 
Board [3s 7s 9s 8d 6d]
Seat 1: fantaasso (button) folded before Flop (didn't bet)
Seat 2: pistaKKio23 (small blind) folded before Flop
Seat 3: mondie73100 (big blind) showed [2d 2c] and won (€0.13) with a pair of Deuces
Seat 4: QUATTRODAME mucked [Ah Jh]
Seat 5: caduceus369 folded before Flop (didn't bet)
Seat 6: SaTheNuts_77 folded before Flop (didn't bet)



PokerStars Zoom Hand #258039188123:  Hold'em No Limit (€0.01/€0.02) [ADM ID: M62C03044AE79CRJ] - 2025/10/07 23:49:31 CET [2025/10/07 17:49:31 ET]
Table 'Sirio' 6-max Seat #1 is the button
Seat 1: gigiruk91 (€4.62 in chips) 
Seat 2: Ultragsg (€1.10 in chips) 
Seat 3: vifracar1 (€7.32 in chips) 
Seat 4: caduceus369 (€2.57 in chips) 
Seat 5: fantaasso (€1.80 in chips) 
Seat 6: SebaRapy14 (€7.18 in chips) 
Ultragsg: posts small blind €0.01
vifracar1: posts big blind €0.02
*** HOLE CARDS ***
Dealt to caduceus369 [5d Qc]
caduceus369: folds 
fantaasso: folds 
SebaRapy14: raises €0.04 to €0.06
gigiruk91: folds 
Ultragsg: calls €0.05
vifracar1: folds 
*** FLOP *** [7c 4s 3h]
Ultragsg: checks 
SebaRapy14: checks 
*** TURN *** [7c 4s 3h] [7h]
Ultragsg: bets €0.12
SebaRapy14: folds 
Uncalled bet (€0.12) returned to Ultragsg
Ultragsg collected €0.14 from pot
Ultragsg: doesn't show hand 
*** SUMMARY ***
Total pot €0.14 | Rake €0 
Board [7c 4s 3h 7h]
Seat 1: gigiruk91 (button) folded before Flop (didn't bet)
Seat 2: Ultragsg (small blind) collected (€0.14)
Seat 3: vifracar1 (big blind) folded before Flop
Seat 4: caduceus369 folded before Flop (didn't bet)
Seat 5: fantaasso folded before Flop (didn't bet)
Seat 6: SebaRapy14 folded on the Turn



PokerStars Zoom Hand #258039189467:  Hold'em No Limit (€0.01/€0.02) [ADM ID: M62C03044AE79CRJ] - 2025/10/07 23:49:37 CET [2025/10/07 17:49:37 ET]
Table 'Sirio' 6-max Seat #1 is the button
Seat 1: algr78 (€0.35 in chips) 
Seat 2: mondie73100 (€2.12 in chips) 
Seat 3: SidneyPrescott (€8.24 in chips) 
Seat 4: caduceus369 (€2.57 in chips) 
Seat 5: samgun.73 (€1.39 in chips) 
Seat 6: dellas3131 (€2 in chips) 
mondie73100: posts small blind €0.01
SidneyPrescott: posts big blind €0.02
*** HOLE CARDS ***
Dealt to caduceus369 [Tc 2s]
caduceus369: folds 
samgun.73: folds 
dellas3131: folds 
algr78: calls €0.02
mondie73100: folds 
SidneyPrescott: raises €0.06 to €0.08
algr78: folds 
Uncalled bet (€0.06) returned to SidneyPrescott
SidneyPrescott collected €0.05 from pot
SidneyPrescott: doesn't show hand 
*** SUMMARY ***
Total pot €0.05 | Rake €0 
Seat 1: algr78 (button) folded before Flop
Seat 2: mondie73100 (small blind) folded before Flop
Seat 3: SidneyPrescott (big blind) collected (€0.05)
Seat 4: caduceus369 folded before Flop (didn't bet)
Seat 5: samgun.73 folded before Flop (didn't bet)
Seat 6: dellas3131 folded before Flop (didn't bet)



PokerStars Zoom Hand #258039190723:  Hold'em No Limit (€0.01/€0.02) [ADM ID: M62C03044AE79CRJ] - 2025/10/07 23:49:43 CET [2025/10/07 17:49:43 ET]
Table 'Sirio' 6-max Seat #1 is the button
Seat 1: Ilpazzo58 (€1.67 in chips) 
Seat 2: SebaRapy14 (€2.17 in chips) 
Seat 3: caduceus369 (€2.57 in chips) 
Seat 4: darkodiablo (€1.24 in chips) 
Seat 5: pistaKKio23 (€5.61 in chips) 
Seat 6: SidneyPrescott (€7.26 in chips) 
SebaRapy14: posts small blind €0.01
caduceus369: posts big blind €0.02
*** HOLE CARDS ***
Dealt to caduceus369 [Kh 4h]
darkodiablo: folds 
pistaKKio23: raises €0.02 to €0.04
SidneyPrescott: folds 
Ilpazzo58: folds 
SebaRapy14: folds 
caduceus369: calls €0.02
*** FLOP *** [Jd 9d 6h]
caduceus369: checks 
pistaKKio23: checks 
*** TURN *** [Jd 9d 6h] [Ts]
caduceus369: checks 
pistaKKio23: bets €0.05
caduceus369: folds 
Uncalled bet (€0.05) returned to pistaKKio23
pistaKKio23 collected €0.09 from pot
pistaKKio23: doesn't show hand 
*** SUMMARY ***
Total pot €0.09 | Rake €0 
Board [Jd 9d 6h Ts]
Seat 1: Ilpazzo58 (button) folded before Flop (didn't bet)
Seat 2: SebaRapy14 (small blind) folded before Flop
Seat 3: caduceus369 (big blind) folded on the Turn
Seat 4: darkodiablo folded before Flop (didn't bet)
Seat 5: pistaKKio23 collected (€0.09)
Seat 6: SidneyPrescott folded before Flop (didn't bet)



PokerStars Zoom Hand #258039203376:  Hold'em No Limit (€0.01/€0.02) [ADM ID: M62C03044AE79CRJ] - 2025/10/07 23:50:39 CET [2025/10/07 17:50:39 ET]
Table 'Sirio' 6-max Seat #1 is the button
Seat 1: fantaasso (€1.68 in chips) 
Seat 2: caduceus369 (€2.53 in chips) 
Seat 3: Fengjie82 (€1.61 in chips) 
Seat 4: Strizzi91 (€0.86 in chips) 
Seat 5: cagliari59 (€2.67 in chips) 
Seat 6: gigiruk91 (€4.59 in chips) 
caduceus369: posts small blind €0.01
Fengjie82: posts big blind €0.02
*** HOLE CARDS ***
Dealt to caduceus369 [6s 4c]
Strizzi91: raises €0.02 to €0.04
cagliari59: calls €0.04
gigiruk91: folds 
fantaasso: folds 
caduceus369: folds 
Fengjie82: calls €0.02
*** FLOP *** [9h 3h 8h]
Fengjie82: bets €0.04
Strizzi91: folds 
cagliari59: folds 
Uncalled bet (€0.04) returned to Fengjie82
Fengjie82 collected €0.13 from pot
Fengjie82: doesn't show hand 
*** SUMMARY ***
Total pot €0.13 | Rake €0 
Board [9h 3h 8h]
Seat 1: fantaasso (button) folded before Flop (didn't bet)
Seat 2: caduceus369 (small blind) folded before Flop
Seat 3: Fengjie82 (big blind) collected (€0.13)
Seat 4: Strizzi91 folded on the Flop
Seat 5: cagliari59 folded on the Flop
Seat 6: gigiruk91 folded before Flop (didn't bet)



PokerStars Zoom Hand #258039206065:  Hold'em No Limit (€0.01/€0.02) [ADM ID: M62C03044AE79CRJ] - 2025/10/07 23:50:50 CET [2025/10/07 17:50:50 ET]
Table 'Sirio' 6-max Seat #1 is the button
Seat 1: caduceus369 (€2.52 in chips) 
Seat 2: mashallahh (€4.87 in chips) 
Seat 3: gigiruk91 (€6.17 in chips) 
Seat 4: diesel197474 (€1.79 in chips) 
Seat 5: SebaRapy14 (€2.28 in chips) 
Seat 6: fantaasso (€1.68 in chips) 
mashallahh: posts small blind €0.01
gigiruk91: posts big blind €0.02
*** HOLE CARDS ***
Dealt to caduceus369 [Ah Kd]
diesel197474: folds 
SebaRapy14: raises €0.04 to €0.06
fantaasso: folds 
caduceus369: raises €0.18 to €0.24
mashallahh: folds 
gigiruk91: folds 
SebaRapy14: calls €0.18
*** FLOP *** [Qc 6h Ad]
SebaRapy14: checks 
caduceus369: bets €0.17
SebaRapy14: raises €0.31 to €0.48
caduceus369: calls €0.31
*** TURN *** [Qc 6h Ad] [Ac]
SebaRapy14: checks 
caduceus369: bets €0.26
SebaRapy14: calls €0.26
*** RIVER *** [Qc 6h Ad Ac] [8s]
SebaRapy14: checks 
caduceus369: bets €1.54 and is all-in
SebaRapy14: calls €1.30 and is all-in
Uncalled bet (€0.24) returned to caduceus369
*** SHOW DOWN ***
caduceus369: shows [Ah Kd] (three of a kind, Aces)
SebaRapy14: shows [Jc As] (three of a kind, Aces - lower kicker)
caduceus369 collected €4.34 from pot
*** SUMMARY ***
Total pot €4.59 | Rake €0.25 
Board [Qc 6h Ad Ac 8s]
Seat 1: caduceus369 (button) showed [Ah Kd] and won (€4.34) with three of a kind, Aces
Seat 2: mashallahh (small blind) folded before Flop
Seat 3: gigiruk91 (big blind) folded before Flop
Seat 4: diesel197474 folded before Flop (didn't bet)
Seat 5: SebaRapy14 showed [Jc As] and lost with three of a kind, Aces
Seat 6: fantaasso folded before Flop (didn't bet)



PokerStars Zoom Hand #258039229251:  Hold'em No Limit (€0.01/€0.02) [ADM ID: M62C03044AE79CRJ] - 2025/10/07 23:52:33 CET [2025/10/07 17:52:33 ET]
Table 'Sirio' 6-max Seat #1 is the button
Seat 1: SidneyPrescott (€7.19 in chips) 
Seat 2: pistaKKio23 (€3.63 in chips) 
Seat 3: SebaRapy14 (€2 in chips) 
Seat 4: QUATTRODAME (€5.20 in chips) 
Seat 5: caduceus369 (€4.58 in chips) 
Seat 6: ermajico84 (€0.95 in chips) 
pistaKKio23: posts small blind €0.01
SebaRapy14: posts big blind €0.02
*** HOLE CARDS ***
Dealt to caduceus369 [5h 2s]
QUATTRODAME: folds 
caduceus369: folds 
ermajico84: folds 
SidneyPrescott: raises €0.04 to €0.06
pistaKKio23: raises €0.14 to €0.20
SebaRapy14: folds 
SidneyPrescott: folds 
Uncalled bet (€0.14) returned to pistaKKio23
pistaKKio23 collected €0.14 from pot
pistaKKio23: doesn't show hand 
*** SUMMARY ***
Total pot €0.14 | Rake €0 
Seat 1: SidneyPrescott (button) folded before Flop
Seat 2: pistaKKio23 (small blind) collected (€0.14)
Seat 3: SebaRapy14 (big blind) folded before Flop
Seat 4: QUATTRODAME folded before Flop (didn't bet)
Seat 5: caduceus369 folded before Flop (didn't bet)
Seat 6: ermajico84 folded before Flop (didn't bet)



PokerStars Zoom Hand #258039233333:  Hold'em No Limit (€0.01/€0.02) [ADM ID: M62C03044AE79CRJ] - 2025/10/07 23:52:51 CET [2025/10/07 17:52:51 ET]
Table 'Sirio' 6-max Seat #1 is the button
Seat 1: darkodiablo (€0.16 in chips) 
Seat 2: mondie73100 (€2.15 in chips) 
Seat 3: cagliari59 (€3.08 in chips) 
Seat 4: dellas3131 (€2.35 in chips) 
Seat 5: caduceus369 (€4.58 in chips) 
Seat 6: plutonexx (€1.51 in chips) 
mondie73100: posts small blind €0.01
cagliari59: posts big blind €0.02
*** HOLE CARDS ***
Dealt to caduceus369 [2s Kc]
dellas3131: folds 
caduceus369: folds 
plutonexx: raises €0.05 to €0.07
darkodiablo: folds 
mondie73100: folds 
cagliari59: folds 
Uncalled bet (€0.05) returned to plutonexx
plutonexx collected €0.05 from pot
plutonexx: doesn't show hand 
*** SUMMARY ***
Total pot €0.05 | Rake €0 
Seat 1: darkodiablo (button) folded before Flop (didn't bet)
Seat 2: mondie73100 (small blind) folded before Flop
Seat 3: cagliari59 (big blind) folded before Flop
Seat 4: dellas3131 folded before Flop (didn't bet)
Seat 5: caduceus369 folded before Flop (didn't bet)
Seat 6: plutonexx collected (€0.05)



PokerStars Zoom Hand #258039231710:  Hold'em No Limit (€0.01/€0.02) [ADM ID: M62C03044AE79CRJ] - 2025/10/07 23:52:44 CET [2025/10/07 17:52:44 ET]
Table 'Sirio' 6-max Seat #1 is the button
Seat 1: dellas3131 (€2.15 in chips) 
Seat 2: mashallahh (€8.18 in chips) 
Seat 3: Poonte (€4.74 in chips) 
Seat 4: BetNoLook (€7.86 in chips) 
Seat 5: Tuttopersempre (€2.80 in chips) 
Seat 6: caduceus369 (€4.58 in chips) 
mashallahh: posts small blind €0.01
Poonte: posts big blind €0.02
*** HOLE CARDS ***
Dealt to caduceus369 [Jh 3c]
BetNoLook: raises €0.05 to €0.07
Tuttopersempre: raises €0.17 to €0.24
caduceus369: folds 
dellas3131: folds 
mashallahh: folds 
Poonte: folds 
BetNoLook: calls €0.17
*** FLOP *** [Ad Ts Kd]
BetNoLook: checks 
Tuttopersempre: bets €2.56 and is all-in
BetNoLook: folds 
Uncalled bet (€2.56) returned to Tuttopersempre
Tuttopersempre collected €0.49 from pot
Tuttopersempre: doesn't show hand 
*** SUMMARY ***
Total pot €0.51 | Rake €0.02 
Board [Ad Ts Kd]
Seat 1: dellas3131 (button) folded before Flop (didn't bet)
Seat 2: mashallahh (small blind) folded before Flop
Seat 3: Poonte (big blind) folded before Flop
Seat 4: BetNoLook folded on the Flop
Seat 5: Tuttopersempre collected (€0.49)
Seat 6: caduceus369 folded before Flop (didn't bet)



PokerStars Zoom Hand #258039234627:  Hold'em No Limit (€0.01/€0.02) [ADM ID: M62C03044AE79CRJ] - 2025/10/07 23:52:57 CET [2025/10/07 17:52:57 ET]
Table 'Sirio' 6-max Seat #1 is the button
Seat 1: QUATTRODAME (€5.21 in chips) 
Seat 2: SidneyPrescott (€7.13 in chips) 
Seat 3: caduceus369 (€4.58 in chips) 
Seat 4: VagALiss (€6.49 in chips) 
Seat 5: mashallahh (€8.17 in chips) 
Seat 6: Ilpazzo58 (€1.93 in chips) 
SidneyPrescott: posts small blind €0.01
caduceus369: posts big blind €0.02
*** HOLE CARDS ***
Dealt to caduceus369 [As 2c]
VagALiss: folds 
mashallahh: folds 
Ilpazzo58: folds 
QUATTRODAME: folds 
SidneyPrescott: folds 
Uncalled bet (€0.01) returned to caduceus369
caduceus369 collected €0.02 from pot
caduceus369: doesn't show hand 
*** SUMMARY ***
Total pot €0.02 | Rake €0 
Seat 1: QUATTRODAME (button) folded before Flop (didn't bet)
Seat 2: SidneyPrescott (small blind) folded before Flop
Seat 3: caduceus369 (big blind) collected (€0.02)
Seat 4: VagALiss folded before Flop (didn't bet)
Seat 5: mashallahh folded before Flop (didn't bet)
Seat 6: Ilpazzo58 folded before Flop (didn't bet)



PokerStars Zoom Hand #258039240404:  Hold'em No Limit (€0.01/€0.02) [ADM ID: M62C03044AE79CRJ] - 2025/10/07 23:53:23 CET [2025/10/07 17:53:23 ET]
Table 'Sirio' 6-max Seat #1 is the button
Seat 1: pistaKKio23 (€5.59 in chips) 
Seat 2: SaTheNuts_77 (€1.16 in chips) 
Seat 3: gigiruk91 (€6.53 in chips) 
Seat 4: mashallahh (€4.61 in chips) 
Seat 5: fantaasso (€1.60 in chips) 
Seat 6: caduceus369 (€4.59 in chips) 
SaTheNuts_77: posts small blind €0.01
gigiruk91: posts big blind €0.02
*** HOLE CARDS ***
Dealt to caduceus369 [Jd 8d]
mashallahh: folds 
fantaasso: raises €0.04 to €0.06
caduceus369: folds 
pistaKKio23: folds 
SaTheNuts_77: folds 
gigiruk91: folds 
Uncalled bet (€0.04) returned to fantaasso
fantaasso collected €0.05 from pot
fantaasso: doesn't show hand 
*** SUMMARY ***
Total pot €0.05 | Rake €0 
Seat 1: pistaKKio23 (button) folded before Flop (didn't bet)
Seat 2: SaTheNuts_77 (small blind) folded before Flop
Seat 3: gigiruk91 (big blind) folded before Flop
Seat 4: mashallahh folded before Flop (didn't bet)
Seat 5: fantaasso collected (€0.05)
Seat 6: caduceus369 folded before Flop (didn't bet)



PokerStars Zoom Hand #258039243220:  Hold'em No Limit (€0.01/€0.02) [ADM ID: M62C03044AE79CRJ] - 2025/10/07 23:53:36 CET [2025/10/07 17:53:36 ET]
Table 'Sirio' 6-max Seat #1 is the button
Seat 1: caduceus369 (€4.59 in chips) 
Seat 2: dellas3131 (€2.43 in chips) 
Seat 3: gigiruk91 (€2.02 in chips) 
Seat 4: maury999999 (€2 in chips) 
Seat 5: samgun.73 (€0.70 in chips) 
Seat 6: Fengjie82 (€1.68 in chips) 
dellas3131: posts small blind €0.01
gigiruk91: posts big blind €0.02
*** HOLE CARDS ***
Dealt to caduceus369 [2c 3h]
maury999999: raises €0.02 to €0.04
samgun.73: folds 
Fengjie82: folds 
caduceus369: folds 
dellas3131: raises €0.12 to €0.16
gigiruk91: folds 
maury999999: folds 
Uncalled bet (€0.12) returned to dellas3131
dellas3131 collected €0.10 from pot
dellas3131: doesn't show hand 
*** SUMMARY ***
Total pot €0.10 | Rake €0 
Seat 1: caduceus369 (button) folded before Flop (didn't bet)
Seat 2: dellas3131 (small blind) collected (€0.10)
Seat 3: gigiruk91 (big blind) folded before Flop
Seat 4: maury999999 folded before Flop
Seat 5: samgun.73 folded before Flop (didn't bet)
Seat 6: Fengjie82 folded before Flop (didn't bet)



PokerStars Zoom Hand #258039244791:  Hold'em No Limit (€0.01/€0.02) [ADM ID: M62C03044AE79CRJ] - 2025/10/07 23:53:43 CET [2025/10/07 17:53:43 ET]
Table 'Sirio' 6-max Seat #1 is the button
Seat 1: mondie73100 (€2 in chips) 
Seat 2: caduceus369 (€4.59 in chips) 
Seat 3: ADRIAN0_MEIS (€23.07 in chips) 
Seat 4: cuzzi68 (€2.72 in chips) 
Seat 5: QUATTRODAME (€5.14 in chips) 
Seat 6: darkodiablo (€0.32 in chips) 
caduceus369: posts small blind €0.01
ADRIAN0_MEIS: posts big blind €0.02
*** HOLE CARDS ***
Dealt to caduceus369 [8d 6s]
cuzzi68: folds 
QUATTRODAME: folds 
darkodiablo: folds 
mondie73100: raises €0.04 to €0.06
caduceus369: folds 
ADRIAN0_MEIS: folds 
Uncalled bet (€0.04) returned to mondie73100
mondie73100 collected €0.05 from pot
mondie73100: doesn't show hand 
*** SUMMARY ***
Total pot €0.05 | Rake €0 
Seat 1: mondie73100 (button) collected (€0.05)
Seat 2: caduceus369 (small blind) folded before Flop
Seat 3: ADRIAN0_MEIS (big blind) folded before Flop
Seat 4: cuzzi68 folded before Flop (didn't bet)
Seat 5: QUATTRODAME folded before Flop (didn't bet)
Seat 6: darkodiablo folded before Flop (didn't bet)



PokerStars Zoom Hand #258039251401:  Hold'em No Limit (€0.01/€0.02) [ADM ID: M62C03044AE79CRJ] - 2025/10/07 23:54:13 CET [2025/10/07 17:54:13 ET]
Table 'Sirio' 6-max Seat #1 is the button
Seat 1: Strizzi91 (€1.25 in chips) 
Seat 2: mondie73100 (€2.12 in chips) 
Seat 3: mashallahh (€8.14 in chips) 
Seat 4: caduceus369 (€4.58 in chips) 
Seat 5: darkodiablo (€0.23 in chips) 
Seat 6: Ultragsg (€0.58 in chips) 
mondie73100: posts small blind €0.01
mashallahh: posts big blind €0.02
*** HOLE CARDS ***
Dealt to caduceus369 [4c 5c]
caduceus369: folds 
darkodiablo: calls €0.02
Ultragsg: raises €0.12 to €0.14
Strizzi91: folds 
mondie73100: folds 
mashallahh: folds 
darkodiablo: folds 
Uncalled bet (€0.12) returned to Ultragsg
Ultragsg collected €0.07 from pot
Ultragsg: doesn't show hand 
*** SUMMARY ***
Total pot €0.07 | Rake €0 
Seat 1: Strizzi91 (button) folded before Flop (didn't bet)
Seat 2: mondie73100 (small blind) folded before Flop
Seat 3: mashallahh (big blind) folded before Flop
Seat 4: caduceus369 folded before Flop (didn't bet)
Seat 5: darkodiablo folded before Flop
Seat 6: Ultragsg collected (€0.07)



PokerStars Zoom Hand #258039252706:  Hold'em No Limit (€0.01/€0.02) [ADM ID: M62C03044AE79CRJ] - 2025/10/07 23:54:20 CET [2025/10/07 17:54:20 ET]
Table 'Sirio' 6-max Seat #1 is the button
Seat 1: BetNoLook (€7.55 in chips) 
Seat 2: Iacuba (€3.98 in chips) 
Seat 3: pistaKKio23 (€4.08 in chips) 
Seat 4: SiMoOoOo93 (€1.50 in chips) 
Seat 5: plutonexx (€1.74 in chips) 
Seat 6: caduceus369 (€4.58 in chips) 
Iacuba: posts small blind €0.01
pistaKKio23: posts big blind €0.02
*** HOLE CARDS ***
Dealt to caduceus369 [Ad 2h]
SiMoOoOo93: folds 
plutonexx: raises €0.05 to €0.07
caduceus369: folds 
BetNoLook: folds 
Iacuba: folds 
pistaKKio23: folds 
Uncalled bet (€0.05) returned to plutonexx
plutonexx collected €0.05 from pot
plutonexx: doesn't show hand 
*** SUMMARY ***
Total pot €0.05 | Rake €0 
Seat 1: BetNoLook (button) folded before Flop (didn't bet)
Seat 2: Iacuba (small blind) folded before Flop
Seat 3: pistaKKio23 (big blind) folded before Flop
Seat 4: SiMoOoOo93 folded before Flop (didn't bet)
Seat 5: plutonexx collected (€0.05)
Seat 6: caduceus369 folded before Flop (didn't bet)



PokerStars Zoom Hand #258039254424:  Hold'em No Limit (€0.01/€0.02) [ADM ID: M62C03044AE79CRJ] - 2025/10/07 23:54:27 CET [2025/10/07 17:54:27 ET]
Table 'Sirio' 6-max Seat #1 is the button
Seat 1: pistaKKio23 (€3.60 in chips) 
Seat 2: BetNoLook (€7.55 in chips) 
Seat 3: caduceus369 (€4.58 in chips) 
Seat 4: darkodiablo (€0.21 in chips) 
Seat 5: fantaasso (€1.65 in chips) 
Seat 6: SebaRapy14 (€2.24 in chips) 
BetNoLook: posts small blind €0.01
caduceus369: posts big blind €0.02
*** HOLE CARDS ***
Dealt to caduceus369 [3h Jd]
darkodiablo: calls €0.02
fantaasso: raises €0.04 to €0.06
SebaRapy14: folds 
pistaKKio23: folds 
BetNoLook: folds 
caduceus369: folds 
darkodiablo: calls €0.04
*** FLOP *** [Ac 9h Tc]
darkodiablo: checks 
fantaasso: checks 
*** TURN *** [Ac 9h Tc] [3c]
darkodiablo: checks 
fantaasso: bets €0.08
darkodiablo: folds 
Uncalled bet (€0.08) returned to fantaasso
fantaasso collected €0.15 from pot
fantaasso: doesn't show hand 
*** SUMMARY ***
Total pot €0.15 | Rake €0 
Board [Ac 9h Tc 3c]
Seat 1: pistaKKio23 (button) folded before Flop (didn't bet)
Seat 2: BetNoLook (small blind) folded before Flop
Seat 3: caduceus369 (big blind) folded before Flop
Seat 4: darkodiablo folded on the Turn
Seat 5: fantaasso collected (€0.15)
Seat 6: SebaRapy14 folded before Flop (didn't bet)



PokerStars Zoom Hand #258039260178:  Hold'em No Limit (€0.01/€0.02) [ADM ID: M62C03044AE79CRJ] - 2025/10/07 23:54:54 CET [2025/10/07 17:54:54 ET]
Table 'Sirio' 6-max Seat #1 is the button
Seat 1: caduceus369 (€4.56 in chips) 
Seat 2: dellas3131 (€2.47 in chips) 
Seat 3: robertoH2O (€3.58 in chips) 
Seat 4: SiMoOoOo93 (€1.52 in chips) 
Seat 5: Strizzi91 (€1.21 in chips) 
Seat 6: SidneyPrescott (€7.70 in chips) 
dellas3131: posts small blind €0.01
robertoH2O: posts big blind €0.02
*** HOLE CARDS ***
Dealt to caduceus369 [Td 8h]
SiMoOoOo93: folds 
Strizzi91: raises €0.02 to €0.04
SidneyPrescott: folds 
caduceus369: folds 
dellas3131: folds 
robertoH2O: folds 
Uncalled bet (€0.02) returned to Strizzi91
Strizzi91 collected €0.05 from pot
Strizzi91: doesn't show hand 
*** SUMMARY ***
Total pot €0.05 | Rake €0 
Seat 1: caduceus369 (button) folded before Flop (didn't bet)
Seat 2: dellas3131 (small blind) folded before Flop
Seat 3: robertoH2O (big blind) folded before Flop
Seat 4: SiMoOoOo93 folded before Flop (didn't bet)
Seat 5: Strizzi91 collected (€0.05)
Seat 6: SidneyPrescott folded before Flop (didn't bet)



PokerStars Zoom Hand #258039262208:  Hold'em No Limit (€0.01/€0.02) [ADM ID: M62C03044AE79CRJ] - 2025/10/07 23:55:03 CET [2025/10/07 17:55:03 ET]
Table 'Sirio' 6-max Seat #1 is the button
Seat 1: SiMoOoOo93 (€1.50 in chips) 
Seat 2: SebaRapy14 (€7.49 in chips) 
Seat 3: ADRIAN0_MEIS (€23.04 in chips) 
Seat 4: pistaKKio23 (€4.06 in chips) 
Seat 5: caduceus369 (€4.56 in chips) 
Seat 6: algr78 (€1.47 in chips) 
SebaRapy14: posts small blind €0.01
ADRIAN0_MEIS: posts big blind €0.02
*** HOLE CARDS ***
Dealt to caduceus369 [Ac Tc]
pistaKKio23: folds 
caduceus369: raises €0.04 to €0.06
algr78: folds 
SiMoOoOo93: folds 
SebaRapy14: folds 
ADRIAN0_MEIS: folds 
Uncalled bet (€0.04) returned to caduceus369
caduceus369 collected €0.05 from pot
caduceus369: doesn't show hand 
*** SUMMARY ***
Total pot €0.05 | Rake €0 
Seat 1: SiMoOoOo93 (button) folded before Flop (didn't bet)
Seat 2: SebaRapy14 (small blind) folded before Flop
Seat 3: ADRIAN0_MEIS (big blind) folded before Flop
Seat 4: pistaKKio23 folded before Flop (didn't bet)
Seat 5: caduceus369 collected (€0.05)
Seat 6: algr78 folded before Flop (didn't bet)



PokerStars Zoom Hand #258039266099:  Hold'em No Limit (€0.01/€0.02) [ADM ID: M62C03044AE79CRJ] - 2025/10/07 23:55:29 CET [2025/10/07 17:55:29 ET]
Table 'Sirio' 6-max Seat #1 is the button
Seat 1: SidneyPrescott (€7.79 in chips) 
Seat 2: caduceus369 (€4.59 in chips) 
Seat 3: mashallahh (€4.61 in chips) 
Seat 4: ADRIAN0_MEIS (€23.02 in chips) 
Seat 5: gigiruk91 (€2.56 in chips) 
Seat 6: Ultragsg (€0.65 in chips) 
caduceus369: posts small blind €0.01
mashallahh: posts big blind €0.02
*** HOLE CARDS ***
Dealt to caduceus369 [Ah Jc]
ADRIAN0_MEIS: folds 
gigiruk91: folds 
Ultragsg: folds 
SidneyPrescott: raises €0.04 to €0.06
caduceus369: raises €0.18 to €0.24
mashallahh: folds 
SidneyPrescott: calls €0.18
*** FLOP *** [8h Kd 6s]
caduceus369: checks 
SidneyPrescott: bets €0.24
caduceus369: folds 
Uncalled bet (€0.24) returned to SidneyPrescott
SidneyPrescott collected €0.48 from pot
SidneyPrescott: doesn't show hand 
*** SUMMARY ***
Total pot €0.50 | Rake €0.02 
Board [8h Kd 6s]
Seat 1: SidneyPrescott (button) collected (€0.48)
Seat 2: caduceus369 (small blind) folded on the Flop
Seat 3: mashallahh (big blind) folded before Flop
Seat 4: ADRIAN0_MEIS folded before Flop (didn't bet)
Seat 5: gigiruk91 folded before Flop (didn't bet)
Seat 6: Ultragsg folded before Flop (didn't bet)



PokerStars Zoom Hand #258039272517:  Hold'em No Limit (€0.01/€0.02) [ADM ID: M62C03044AE79CRJ] - 2025/10/07 23:56:10 CET [2025/10/07 17:56:10 ET]
Table 'Sirio' 6-max Seat #1 is the button
Seat 1: Strizzi91 (€1.38 in chips) 
Seat 2: bafo77_po (€2.06 in chips) 
Seat 3: robertoH2O (€3.52 in chips) 
Seat 4: caduceus369 (€4.35 in chips) 
Seat 5: fantaasso (€1.77 in chips) 
Seat 6: Sium12302 (€1.97 in chips) 
bafo77_po: posts small blind €0.01
robertoH2O: posts big blind €0.02
*** HOLE CARDS ***
Dealt to caduceus369 [Jd 4d]
caduceus369: folds 
fantaasso: folds 
Sium12302: folds 
Strizzi91: raises €0.02 to €0.04
bafo77_po: folds 
robertoH2O: raises €0.12 to €0.16
Strizzi91: raises €1.22 to €1.38 and is all-in
robertoH2O: calls €1.22
*** FLOP *** [9c 5d Ts]
*** TURN *** [9c 5d Ts] [3h]
*** RIVER *** [9c 5d Ts 3h] [3d]
*** SHOW DOWN ***
robertoH2O: shows [Qh Qc] (two pair, Queens and Threes)
Strizzi91: shows [9d 9h] (a full house, Nines full of Threes)
Strizzi91 collected €2.62 from pot
*** SUMMARY ***
Total pot €2.77 | Rake €0.15 
Board [9c 5d Ts 3h 3d]
Seat 1: Strizzi91 (button) showed [9d 9h] and won (€2.62) with a full house, Nines full of Threes
Seat 2: bafo77_po (small blind) folded before Flop
Seat 3: robertoH2O (big blind) showed [Qh Qc] and lost with two pair, Queens and Threes
Seat 4: caduceus369 folded before Flop (didn't bet)
Seat 5: fantaasso folded before Flop (didn't bet)
Seat 6: Sium12302 folded before Flop (didn't bet)



PokerStars Zoom Hand #258039273500:  Hold'em No Limit (€0.01/€0.02) [ADM ID: M62C03044AE79CRJ] - 2025/10/07 23:56:16 CET [2025/10/07 17:56:16 ET]
Table 'Sirio' 6-max Seat #1 is the button
Seat 1: pistaKKio23 (€4.02 in chips) 
Seat 2: Ultragsg (€0.66 in chips) 
Seat 3: Tuttopersempre (€2.97 in chips) 
Seat 4: caduceus369 (€4.35 in chips) 
Seat 5: ADRIAN0_MEIS (€23.02 in chips) 
Seat 6: gigiruk91 (€2.53 in chips) 
Ultragsg: posts small blind €0.01
Tuttopersempre: posts big blind €0.02
*** HOLE CARDS ***
Dealt to caduceus369 [Qc 5h]
caduceus369: folds 
ADRIAN0_MEIS: folds 
gigiruk91: folds 
pistaKKio23: raises €0.02 to €0.04
Ultragsg: calls €0.03
Tuttopersempre: calls €0.02
*** FLOP *** [3h 8c Ad]
Ultragsg: checks 
Tuttopersempre: checks 
pistaKKio23: checks 
*** TURN *** [3h 8c Ad] [5s]
Ultragsg: bets €0.06
Tuttopersempre: calls €0.06
pistaKKio23: folds 
*** RIVER *** [3h 8c Ad 5s] [Js]
Ultragsg: bets €0.06
Tuttopersempre: calls €0.06
*** SHOW DOWN ***
Ultragsg: shows [7h 8s] (a pair of Eights)
Tuttopersempre: shows [Ah 4s] (a pair of Aces)
Tuttopersempre collected €0.35 from pot
*** SUMMARY ***
Total pot €0.36 | Rake €0.01 
Board [3h 8c Ad 5s Js]
Seat 1: pistaKKio23 (button) folded on the Turn
Seat 2: Ultragsg (small blind) showed [7h 8s] and lost with a pair of Eights
Seat 3: Tuttopersempre (big blind) showed [Ah 4s] and won (€0.35) with a pair of Aces
Seat 4: caduceus369 folded before Flop (didn't bet)
Seat 5: ADRIAN0_MEIS folded before Flop (didn't bet)
Seat 6: gigiruk91 folded before Flop (didn't bet)



PokerStars Zoom Hand #258039276379:  Hold'em No Limit (€0.01/€0.02) [ADM ID: M62C03044AE79CRJ] - 2025/10/07 23:56:34 CET [2025/10/07 17:56:34 ET]
Table 'Sirio' 6-max Seat #1 is the button
Seat 1: caduceus369 (€4.33 in chips) 
Seat 2: BetNoLook (€7.53 in chips) 
Seat 3: mondie73100 (€2 in chips) 
Seat 4: mashallahh (€4.58 in chips) 
Seat 5: gigiruk91 (€6.58 in chips) 
Seat 6: pistaKKio23 (€6.02 in chips) 
BetNoLook: posts small blind €0.01
mondie73100: posts big blind €0.02
*** HOLE CARDS ***
Dealt to caduceus369 [5d 5s]
mashallahh: folds 
gigiruk91: folds 
pistaKKio23: folds 
caduceus369: raises €0.04 to €0.06
BetNoLook: calls €0.05
mondie73100: raises €0.18 to €0.24
caduceus369: folds 
BetNoLook: calls €0.18
*** FLOP *** [9h 7s 6s]
BetNoLook: checks 
mondie73100: checks 
*** TURN *** [9h 7s 6s] [4c]
BetNoLook: bets €0.39
mondie73100: folds 
Uncalled bet (€0.39) returned to BetNoLook
BetNoLook collected €0.52 from pot
BetNoLook: doesn't show hand 
*** SUMMARY ***
Total pot €0.54 | Rake €0.02 
Board [9h 7s 6s 4c]
Seat 1: caduceus369 (button) folded before Flop
Seat 2: BetNoLook (small blind) collected (€0.52)
Seat 3: mondie73100 (big blind) folded on the Turn
Seat 4: mashallahh folded before Flop (didn't bet)
Seat 5: gigiruk91 folded before Flop (didn't bet)
Seat 6: pistaKKio23 folded before Flop (didn't bet)



PokerStars Zoom Hand #258039274584:  Hold'em No Limit (€0.01/€0.02) [ADM ID: M62C03044AE79CRJ] - 2025/10/07 23:56:23 CET [2025/10/07 17:56:23 ET]
Table 'Sirio' 6-max Seat #1 is the button
Seat 1: pistaKKio23 (€6.02 in chips) 
Seat 2: SidneyPrescott (€7.16 in chips) 
Seat 3: caduceus369 (€4.35 in chips) 
Seat 4: maury999999 (€2.41 in chips) 
Seat 5: bafo77_po (€2.05 in chips) 
Seat 6: Iacuba (€3.95 in chips) 
SidneyPrescott: posts small blind €0.01
caduceus369: posts big blind €0.02
*** HOLE CARDS ***
Dealt to caduceus369 [2s 3d]
maury999999: folds 
bafo77_po: folds 
Iacuba: raises €0.02 to €0.04
pistaKKio23: folds 
SidneyPrescott: raises €0.12 to €0.16
caduceus369: folds 
Iacuba: raises €0.12 to €0.28
SidneyPrescott: calls €0.12
*** FLOP *** [5h 5d 5s]
SidneyPrescott: checks 
Iacuba: checks 
*** TURN *** [5h 5d 5s] [As]
SidneyPrescott: bets €0.18
Iacuba: folds 
Uncalled bet (€0.18) returned to SidneyPrescott
SidneyPrescott collected €0.55 from pot
SidneyPrescott: doesn't show hand 
*** SUMMARY ***
Total pot €0.58 | Rake €0.03 
Board [5h 5d 5s As]
Seat 1: pistaKKio23 (button) folded before Flop (didn't bet)
Seat 2: SidneyPrescott (small blind) collected (€0.55)
Seat 3: caduceus369 (big blind) folded before Flop
Seat 4: maury999999 folded before Flop (didn't bet)
Seat 5: bafo77_po folded before Flop (didn't bet)
Seat 6: Iacuba folded on the Turn



PokerStars Zoom Hand #258039280476:  Hold'em No Limit (€0.01/€0.02) [ADM ID: M62C03044AE79CRJ] - 2025/10/07 23:57:01 CET [2025/10/07 17:57:01 ET]
Table 'Sirio' 6-max Seat #1 is the button
Seat 1: algr78 (€0.03 in chips) 
Seat 2: caduceus369 (€4.27 in chips) 
Seat 3: gigiruk91 (€2.65 in chips) 
Seat 4: cagliari59 (€2.47 in chips) 
Seat 5: fantaasso (€1.77 in chips) 
Seat 6: Gaboops (€0.73 in chips) 
caduceus369: posts small blind €0.01
gigiruk91: posts big blind €0.02
*** HOLE CARDS ***
Dealt to caduceus369 [8d Qd]
cagliari59: folds 
fantaasso: folds 
Gaboops: folds 
algr78: calls €0.02
caduceus369: calls €0.01
gigiruk91: checks 
*** FLOP *** [8h 4s 4h]
caduceus369: checks 
gigiruk91: checks 
algr78: checks 
*** TURN *** [8h 4s 4h] [Ah]
caduceus369: checks 
gigiruk91: bets €0.06
algr78: calls €0.01 and is all-in
caduceus369: folds 
Uncalled bet (€0.05) returned to gigiruk91
*** RIVER *** [8h 4s 4h Ah] [Ts]
*** SHOW DOWN ***
gigiruk91: shows [Jh 7h] (a flush, Ace high)
algr78: shows [9s Kc] (a pair of Fours)
gigiruk91 collected €0.08 from pot
*** SUMMARY ***
Total pot €0.08 | Rake €0 
Board [8h 4s 4h Ah Ts]
Seat 1: algr78 (button) showed [9s Kc] and lost with a pair of Fours
Seat 2: caduceus369 (small blind) folded on the Turn
Seat 3: gigiruk91 (big blind) showed [Jh 7h] and won (€0.08) with a flush, Ace high
Seat 4: cagliari59 folded before Flop (didn't bet)
Seat 5: fantaasso folded before Flop (didn't bet)
Seat 6: Gaboops folded before Flop (didn't bet)



PokerStars Zoom Hand #258039288242:  Hold'em No Limit (€0.01/€0.02) [ADM ID: M62C03044AE79CRJ] - 2025/10/07 23:57:49 CET [2025/10/07 17:57:49 ET]
Table 'Sirio' 6-max Seat #1 is the button
Seat 1: mondie73100 (€2 in chips) 
Seat 2: fantaasso (€1.71 in chips) 
Seat 3: Gaboops (€2 in chips) 
Seat 4: cagliari59 (€2.41 in chips) 
Seat 5: bafo77_po (€2.08 in chips) 
Seat 6: caduceus369 (€4.25 in chips) 
fantaasso: posts small blind €0.01
Gaboops: posts big blind €0.02
*** HOLE CARDS ***
Dealt to caduceus369 [9h Jc]
cagliari59: folds 
bafo77_po: folds 
caduceus369: folds 
mondie73100: folds 
fantaasso: folds 
Uncalled bet (€0.01) returned to Gaboops
Gaboops collected €0.02 from pot
Gaboops: doesn't show hand 
*** SUMMARY ***
Total pot €0.02 | Rake €0 
Seat 1: mondie73100 (button) folded before Flop (didn't bet)
Seat 2: fantaasso (small blind) folded before Flop
Seat 3: Gaboops (big blind) collected (€0.02)
Seat 4: cagliari59 folded before Flop (didn't bet)
Seat 5: bafo77_po folded before Flop (didn't bet)
Seat 6: caduceus369 folded before Flop (didn't bet)



PokerStars Zoom Hand #258039289257:  Hold'em No Limit (€0.01/€0.02) [ADM ID: M62C03044AE79CRJ] - 2025/10/07 23:57:55 CET [2025/10/07 17:57:55 ET]
Table 'Sirio' 6-max Seat #1 is the button
Seat 1: pistaKKio23 (€3.53 in chips) 
Seat 2: SaTheNuts_77 (€1.37 in chips) 
Seat 3: mondie73100 (€3.69 in chips) 
Seat 4: Ultragsg (€0.61 in chips) 
Seat 5: caduceus369 (€4.25 in chips) 
Seat 6: bafo77_po (€2.08 in chips) 
SaTheNuts_77: posts small blind €0.01
mondie73100: posts big blind €0.02
*** HOLE CARDS ***
Dealt to caduceus369 [3h 6c]
Ultragsg: folds 
caduceus369: folds 
bafo77_po: folds 
pistaKKio23: raises €0.04 to €0.06
SaTheNuts_77: folds 
mondie73100: folds 
Uncalled bet (€0.04) returned to pistaKKio23
pistaKKio23 collected €0.05 from pot
pistaKKio23: doesn't show hand 
*** SUMMARY ***
Total pot €0.05 | Rake €0 
Seat 1: pistaKKio23 (button) collected (€0.05)
Seat 2: SaTheNuts_77 (small blind) folded before Flop
Seat 3: mondie73100 (big blind) folded before Flop
Seat 4: Ultragsg folded before Flop (didn't bet)
Seat 5: caduceus369 folded before Flop (didn't bet)
Seat 6: bafo77_po folded before Flop (didn't bet)



PokerStars Zoom Hand #258039290424:  Hold'em No Limit (€0.01/€0.02) [ADM ID: M62C03044AE79CRJ] - 2025/10/07 23:58:02 CET [2025/10/07 17:58:02 ET]
Table 'Sirio' 6-max Seat #1 is the button
Seat 1: Ilpazzo58 (€1.12 in chips) 
Seat 2: QUATTRODAME (€1.97 in chips) 
Seat 3: SaTheNuts_77 (€1.36 in chips) 
Seat 4: bafo77_po (€2.08 in chips) 
Seat 5: caduceus369 (€4.25 in chips) 
Seat 6: fantaasso (€1.70 in chips) 
QUATTRODAME: posts small blind €0.01
SaTheNuts_77: posts big blind €0.02
*** HOLE CARDS ***
Dealt to caduceus369 [5h 2c]
bafo77_po: folds 
caduceus369: folds 
fantaasso: raises €0.04 to €0.06
Ilpazzo58: calls €0.06
QUATTRODAME: folds 
SaTheNuts_77: raises €0.19 to €0.25
fantaasso: folds 
Ilpazzo58: folds 
Uncalled bet (€0.19) returned to SaTheNuts_77
SaTheNuts_77 collected €0.19 from pot
SaTheNuts_77: doesn't show hand 
*** SUMMARY ***
Total pot €0.19 | Rake €0 
Seat 1: Ilpazzo58 (button) folded before Flop
Seat 2: QUATTRODAME (small blind) folded before Flop
Seat 3: SaTheNuts_77 (big blind) collected (€0.19)
Seat 4: bafo77_po folded before Flop (didn't bet)
Seat 5: caduceus369 folded before Flop (didn't bet)
Seat 6: fantaasso folded before Flop



PokerStars Zoom Hand #258039292102:  Hold'em No Limit (€0.01/€0.02) [ADM ID: M62C03044AE79CRJ] - 2025/10/07 23:58:13 CET [2025/10/07 17:58:13 ET]
Table 'Sirio' 6-max Seat #1 is the button
Seat 1: bafo77_po (€2.08 in chips) 
Seat 2: gigiruk91 (€6.49 in chips) 
Seat 3: caduceus369 (€4.25 in chips) 
Seat 4: mondie73100 (€3.67 in chips) 
Seat 5: pistaKKio23 (€3.98 in chips) 
Seat 6: maury999999 (€2.24 in chips) 
gigiruk91: posts small blind €0.01
caduceus369: posts big blind €0.02
*** HOLE CARDS ***
Dealt to caduceus369 [6s 8c]
mondie73100: folds 
pistaKKio23: raises €0.04 to €0.06
maury999999: folds 
bafo77_po: folds 
gigiruk91: folds 
caduceus369: folds 
Uncalled bet (€0.04) returned to pistaKKio23
pistaKKio23 collected €0.05 from pot
pistaKKio23: doesn't show hand 
*** SUMMARY ***
Total pot €0.05 | Rake €0 
Seat 1: bafo77_po (button) folded before Flop (didn't bet)
Seat 2: gigiruk91 (small blind) folded before Flop
Seat 3: caduceus369 (big blind) folded before Flop
Seat 4: mondie73100 folded before Flop (didn't bet)
Seat 5: pistaKKio23 collected (€0.05)
Seat 6: maury999999 folded before Flop (didn't bet)



PokerStars Zoom Hand #258039298669:  Hold'em No Limit (€0.01/€0.02) [ADM ID: M62C03044AE79CRJ] - 2025/10/07 23:58:54 CET [2025/10/07 17:58:54 ET]
Table 'Sirio' 6-max Seat #1 is the button
Seat 1: QUATTRODAME (€1.90 in chips) 
Seat 2: caduceus369 (€4.23 in chips) 
Seat 3: bafo77_po (€2.07 in chips) 
Seat 4: dellas3131 (€2.66 in chips) 
Seat 5: gigiruk91 (€6.48 in chips) 
Seat 6: SebaRapy14 (€7.10 in chips) 
caduceus369: posts small blind €0.01
bafo77_po: posts big blind €0.02
*** HOLE CARDS ***
Dealt to caduceus369 [9s 4d]
dellas3131: folds 
gigiruk91: folds 
SebaRapy14: raises €0.04 to €0.06
QUATTRODAME: folds 
caduceus369: folds 
bafo77_po: folds 
Uncalled bet (€0.04) returned to SebaRapy14
SebaRapy14 collected €0.05 from pot
SebaRapy14: doesn't show hand 
*** SUMMARY ***
Total pot €0.05 | Rake €0 
Seat 1: QUATTRODAME (button) folded before Flop (didn't bet)
Seat 2: caduceus369 (small blind) folded before Flop
Seat 3: bafo77_po (big blind) folded before Flop
Seat 4: dellas3131 folded before Flop (didn't bet)
Seat 5: gigiruk91 folded before Flop (didn't bet)
Seat 6: SebaRapy14 collected (€0.05)



PokerStars Zoom Hand #258039299725:  Hold'em No Limit (€0.01/€0.02) [ADM ID: M62C03044AE79CRJ] - 2025/10/07 23:59:01 CET [2025/10/07 17:59:01 ET]
Table 'Sirio' 6-max Seat #1 is the button
Seat 1: caduceus369 (€4.22 in chips) 
Seat 2: QUATTRODAME (€1.90 in chips) 
Seat 3: SaTheNuts_77 (€1.48 in chips) 
Seat 4: mashallahh (€4.99 in chips) 
Seat 5: mondie73100 (€2.09 in chips) 
Seat 6: Poonte (€5.11 in chips) 
QUATTRODAME: posts small blind €0.01
SaTheNuts_77: posts big blind €0.02
*** HOLE CARDS ***
Dealt to caduceus369 [Tc Ah]
mashallahh: calls €0.02
mondie73100: folds 
Poonte: folds 
caduceus369: raises €0.06 to €0.08
QUATTRODAME: folds 
SaTheNuts_77: folds 
mashallahh: calls €0.06
*** FLOP *** [Kc 3s Jd]
mashallahh: checks 
caduceus369: checks 
*** TURN *** [Kc 3s Jd] [Jh]
mashallahh: checks 
caduceus369: bets €0.07
mashallahh: calls €0.07
*** RIVER *** [Kc 3s Jd Jh] [Qd]
mashallahh: checks 
caduceus369: bets €0.36
mashallahh: folds 
Uncalled bet (€0.36) returned to caduceus369
caduceus369 collected €0.32 from pot
caduceus369: doesn't show hand 
*** SUMMARY ***
Total pot €0.33 | Rake €0.01 
Board [Kc 3s Jd Jh Qd]
Seat 1: caduceus369 (button) collected (€0.32)
Seat 2: QUATTRODAME (small blind) folded before Flop
Seat 3: SaTheNuts_77 (big blind) folded before Flop
Seat 4: mashallahh folded on the River
Seat 5: mondie73100 folded before Flop (didn't bet)
Seat 6: Poonte folded before Flop (didn't bet)



PokerStars Zoom Hand #258039318141:  Hold'em No Limit (€0.01/€0.02) [ADM ID: M62C03044AE79CRJ] - 2025/10/08 0:00:53 CET [2025/10/07 18:00:53 ET]
Table 'Sirio' 6-max Seat #1 is the button
Seat 1: ADRIAN0_MEIS (€23.13 in chips) 
Seat 2: mashallahh (€4.24 in chips) 
Seat 3: Gaboops (€2.01 in chips) 
Seat 4: Fengjie82 (€2.29 in chips) 
Seat 5: robertoH2O (€2.03 in chips) 
Seat 6: caduceus369 (€4.39 in chips) 
mashallahh: posts small blind €0.01
Gaboops: posts big blind €0.02
*** HOLE CARDS ***
Dealt to caduceus369 [2c 7c]
Fengjie82: folds 
robertoH2O: folds 
caduceus369: folds 
ADRIAN0_MEIS: folds 
mashallahh: folds 
Uncalled bet (€0.01) returned to Gaboops
Gaboops collected €0.02 from pot
Gaboops: doesn't show hand 
*** SUMMARY ***
Total pot €0.02 | Rake €0 
Seat 1: ADRIAN0_MEIS (button) folded before Flop (didn't bet)
Seat 2: mashallahh (small blind) folded before Flop
Seat 3: Gaboops (big blind) collected (€0.02)
Seat 4: Fengjie82 folded before Flop (didn't bet)
Seat 5: robertoH2O folded before Flop (didn't bet)
Seat 6: caduceus369 folded before Flop (didn't bet)



PokerStars Zoom Hand #258039320164:  Hold'em No Limit (€0.01/€0.02) [ADM ID: M62C03044AE79CRJ] - 2025/10/08 0:01:03 CET [2025/10/07 18:01:03 ET]
Table 'Sirio' 6-max Seat #1 is the button
Seat 1: SebaRapy14 (€3.53 in chips) 
Seat 2: pistaKKio23 (€6 in chips) 
Seat 3: dellas3131 (€2.66 in chips) 
Seat 4: caduceus369 (€4.39 in chips) 
Seat 5: nikolor (€1.79 in chips) 
Seat 6: gigiruk91 (€5.52 in chips) 
pistaKKio23: posts small blind €0.01
dellas3131: posts big blind €0.02
*** HOLE CARDS ***
Dealt to caduceus369 [Ad 2h]
caduceus369: folds 
nikolor: folds 
gigiruk91: folds 
SebaRapy14: folds 
pistaKKio23: folds 
Uncalled bet (€0.01) returned to dellas3131
dellas3131 collected €0.02 from pot
dellas3131: doesn't show hand 
*** SUMMARY ***
Total pot €0.02 | Rake €0 
Seat 1: SebaRapy14 (button) folded before Flop (didn't bet)
Seat 2: pistaKKio23 (small blind) folded before Flop
Seat 3: dellas3131 (big blind) collected (€0.02)
Seat 4: caduceus369 folded before Flop (didn't bet)
Seat 5: nikolor folded before Flop (didn't bet)
Seat 6: gigiruk91 folded before Flop (didn't bet)



PokerStars Zoom Hand #258039323063:  Hold'em No Limit (€0.01/€0.02) [ADM ID: M62C03044AE79CRJ] - 2025/10/08 0:01:17 CET [2025/10/07 18:01:17 ET]
Table 'Sirio' 6-max Seat #1 is the button
Seat 1: SebaRapy14 (€6.98 in chips) 
Seat 2: gigiruk91 (€2.05 in chips) 
Seat 3: caduceus369 (€4.39 in chips) 
Seat 4: mondie73100 (€2.42 in chips) 
Seat 5: dellas3131 (€5.22 in chips) 
Seat 6: mashallahh (€4.85 in chips) 
gigiruk91: posts small blind €0.01
caduceus369: posts big blind €0.02
*** HOLE CARDS ***
Dealt to caduceus369 [4s Ac]
mondie73100: folds 
dellas3131: raises €0.05 to €0.07
mashallahh: folds 
SebaRapy14: calls €0.07
gigiruk91: folds 
caduceus369: folds 
*** FLOP *** [Qs Kc 9h]
dellas3131: checks 
SebaRapy14: checks 
*** TURN *** [Qs Kc 9h] [Jh]
dellas3131: bets €0.10
SebaRapy14: calls €0.10
*** RIVER *** [Qs Kc 9h Jh] [9c]
dellas3131: bets €0.21
SebaRapy14: folds 
Uncalled bet (€0.21) returned to dellas3131
dellas3131 collected €0.35 from pot
dellas3131: doesn't show hand 
*** SUMMARY ***
Total pot €0.37 | Rake €0.02 
Board [Qs Kc 9h Jh 9c]
Seat 1: SebaRapy14 (button) folded on the River
Seat 2: gigiruk91 (small blind) folded before Flop
Seat 3: caduceus369 (big blind) folded before Flop
Seat 4: mondie73100 folded before Flop (didn't bet)
Seat 5: dellas3131 collected (€0.35)
Seat 6: mashallahh folded before Flop (didn't bet)



PokerStars Zoom Hand #258039321532:  Hold'em No Limit (€0.01/€0.02) [ADM ID: M62C03044AE79CRJ] - 2025/10/08 0:01:10 CET [2025/10/07 18:01:10 ET]
Table 'Sirio' 6-max Seat #1 is the button
Seat 1: mashallahh (€7.31 in chips) 
Seat 2: SebaRapy14 (€3.53 in chips) 
Seat 3: nikolor (€1.79 in chips) 
Seat 4: caduceus369 (€4.39 in chips) 
Seat 5: ermajico84 (€0.53 in chips) 
Seat 6: Gaboops (€2.02 in chips) 
SebaRapy14: posts small blind €0.01
nikolor: posts big blind €0.02
*** HOLE CARDS ***
Dealt to caduceus369 [2s Ts]
caduceus369: folds 
ermajico84: calls €0.02
Gaboops: folds 
mashallahh: raises €0.06 to €0.08
SebaRapy14: folds 
nikolor: folds 
ermajico84: calls €0.06
*** FLOP *** [Th Jd 5d]
ermajico84: checks 
mashallahh: bets €0.14
ermajico84: folds 
Uncalled bet (€0.14) returned to mashallahh
mashallahh collected €0.18 from pot
mashallahh: doesn't show hand 
*** SUMMARY ***
Total pot €0.19 | Rake €0.01 
Board [Th Jd 5d]
Seat 1: mashallahh (button) collected (€0.18)
Seat 2: SebaRapy14 (small blind) folded before Flop
Seat 3: nikolor (big blind) folded before Flop
Seat 4: caduceus369 folded before Flop (didn't bet)
Seat 5: ermajico84 folded on the Flop
Seat 6: Gaboops folded before Flop (didn't bet)



PokerStars Zoom Hand #258039332169:  Hold'em No Limit (€0.01/€0.02) [ADM ID: M62C03044AE79CRJ] - 2025/10/08 0:02:00 CET [2025/10/07 18:02:00 ET]
Table 'Sirio' 6-max Seat #1 is the button
Seat 1: rw01yk (€2.05 in chips) 
Seat 2: caduceus369 (€4.37 in chips) 
Seat 3: gigiruk91 (€6.61 in chips) 
Seat 4: mashallahh (€3.82 in chips) 
Seat 5: dellas3131 (€5.40 in chips) 
Seat 6: Iacuba (€3.37 in chips) 
caduceus369: posts small blind €0.01
gigiruk91: posts big blind €0.02
*** HOLE CARDS ***
Dealt to caduceus369 [Ad 9c]
mashallahh: folds 
dellas3131: folds 
Iacuba: folds 
rw01yk: folds 
caduceus369: raises €0.04 to €0.06
gigiruk91: folds 
Uncalled bet (€0.04) returned to caduceus369
caduceus369 collected €0.04 from pot
caduceus369: doesn't show hand 
*** SUMMARY ***
Total pot €0.04 | Rake €0 
Seat 1: rw01yk (button) folded before Flop (didn't bet)
Seat 2: caduceus369 (small blind) collected (€0.04)
Seat 3: gigiruk91 (big blind) folded before Flop
Seat 4: mashallahh folded before Flop (didn't bet)
Seat 5: dellas3131 folded before Flop (didn't bet)
Seat 6: Iacuba folded before Flop (didn't bet)



PokerStars Zoom Hand #258039339555:  Hold'em No Limit (€0.01/€0.02) [ADM ID: M62C03044AE79CRJ] - 2025/10/08 0:02:35 CET [2025/10/07 18:02:35 ET]
Table 'Sirio' 6-max Seat #1 is the button
Seat 1: QUATTRODAME (€1.97 in chips) 
Seat 2: gigiruk91 (€6.59 in chips) 
Seat 3: dellas3131 (€5.39 in chips) 
Seat 4: caduceus369 (€4.39 in chips) 
Seat 5: pistaKKio23 (€2.23 in chips) 
Seat 6: Tuttopersempre (€3 in chips) 
gigiruk91: posts small blind €0.01
dellas3131: posts big blind €0.02
*** HOLE CARDS ***
Dealt to caduceus369 [Ts Kh]
caduceus369: folds 
pistaKKio23: folds 
Tuttopersempre: folds 
QUATTRODAME: folds 
gigiruk91: raises €0.02 to €0.04
dellas3131: folds 
Uncalled bet (€0.02) returned to gigiruk91
gigiruk91 collected €0.04 from pot
gigiruk91: doesn't show hand 
*** SUMMARY ***
Total pot €0.04 | Rake €0 
Seat 1: QUATTRODAME (button) folded before Flop (didn't bet)
Seat 2: gigiruk91 (small blind) collected (€0.04)
Seat 3: dellas3131 (big blind) folded before Flop
Seat 4: caduceus369 folded before Flop (didn't bet)
Seat 5: pistaKKio23 folded before Flop (didn't bet)
Seat 6: Tuttopersempre folded before Flop (didn't bet)



PokerStars Zoom Hand #258039338072:  Hold'em No Limit (€0.01/€0.02) [ADM ID: M62C03044AE79CRJ] - 2025/10/08 0:02:28 CET [2025/10/07 18:02:28 ET]
Table 'Sirio' 6-max Seat #1 is the button
Seat 1: caduceus369 (€4.39 in chips) 
Seat 2: robertoH2O (€3.08 in chips) 
Seat 3: Poonte (€5.14 in chips) 
Seat 4: mashallahh (€4.08 in chips) 
Seat 5: Ilpazzo58 (€2.18 in chips) 
Seat 6: nikolor (€2.15 in chips) 
robertoH2O: posts small blind €0.01
Poonte: posts big blind €0.02
*** HOLE CARDS ***
Dealt to caduceus369 [6s Jd]
mashallahh: raises €0.04 to €0.06
Ilpazzo58: folds 
nikolor: calls €0.06
caduceus369: folds 
robertoH2O: calls €0.05
Poonte: folds 
*** FLOP *** [Qd 9d Ts]
robertoH2O: checks 
mashallahh: bets €0.13
nikolor: folds 
robertoH2O: folds 
Uncalled bet (€0.13) returned to mashallahh
mashallahh collected €0.19 from pot
mashallahh: doesn't show hand 
*** SUMMARY ***
Total pot €0.20 | Rake €0.01 
Board [Qd 9d Ts]
Seat 1: caduceus369 (button) folded before Flop (didn't bet)
Seat 2: robertoH2O (small blind) folded on the Flop
Seat 3: Poonte (big blind) folded before Flop
Seat 4: mashallahh collected (€0.19)
Seat 5: Ilpazzo58 folded before Flop (didn't bet)
Seat 6: nikolor folded on the Flop



PokerStars Zoom Hand #258039341812:  Hold'em No Limit (€0.01/€0.02) [ADM ID: M62C03044AE79CRJ] - 2025/10/08 0:02:46 CET [2025/10/07 18:02:46 ET]
Table 'Sirio' 6-max Seat #1 is the button
Seat 1: Poonte (€5.12 in chips) 
Seat 2: Tuttopersempre (€3 in chips) 
Seat 3: mondie73100 (€3.56 in chips) 
Seat 4: pistaKKio23 (€2.23 in chips) 
Seat 5: gigiruk91 (€2.16 in chips) 
Seat 6: caduceus369 (€4.39 in chips) 
Tuttopersempre: posts small blind €0.01
mondie73100: posts big blind €0.02
*** HOLE CARDS ***
Dealt to caduceus369 [Th 8c]
pistaKKio23: folds 
gigiruk91: folds 
caduceus369: folds 
Poonte: calls €0.02
Tuttopersempre: folds 
mondie73100: checks 
*** FLOP *** [Kc Tc Jh]
mondie73100: checks 
Poonte: checks 
*** TURN *** [Kc Tc Jh] [Ad]
mondie73100: bets €0.02
Poonte: calls €0.02
*** RIVER *** [Kc Tc Jh Ad] [6s]
mondie73100: checks 
Poonte: bets €0.09
mondie73100: folds 
Uncalled bet (€0.09) returned to Poonte
Poonte collected €0.09 from pot
Poonte: doesn't show hand 
*** SUMMARY ***
Total pot €0.09 | Rake €0 
Board [Kc Tc Jh Ad 6s]
Seat 1: Poonte (button) collected (€0.09)
Seat 2: Tuttopersempre (small blind) folded before Flop
Seat 3: mondie73100 (big blind) folded on the River
Seat 4: pistaKKio23 folded before Flop (didn't bet)
Seat 5: gigiruk91 folded before Flop (didn't bet)
Seat 6: caduceus369 folded before Flop (didn't bet)



PokerStars Zoom Hand #258039343464:  Hold'em No Limit (€0.01/€0.02) [ADM ID: M62C03044AE79CRJ] - 2025/10/08 0:02:53 CET [2025/10/07 18:02:53 ET]
Table 'Sirio' 6-max Seat #1 is the button
Seat 1: mashallahh (€2.91 in chips) 
Seat 2: Danielino1212 (€1.49 in chips) 
Seat 3: caduceus369 (€4.39 in chips) 
Seat 4: Iacuba (€3.35 in chips) 
Seat 5: Tuttopersempre (€2.99 in chips) 
Seat 6: pistaKKio23 (€3.50 in chips) 
Danielino1212: posts small blind €0.01
caduceus369: posts big blind €0.02
*** HOLE CARDS ***
Dealt to caduceus369 [8h 7h]
Iacuba: folds 
Tuttopersempre: raises €0.02 to €0.04
pistaKKio23: folds 
mashallahh: folds 
Danielino1212: calls €0.03
caduceus369: calls €0.02
*** FLOP *** [9s Ks 6d]
Danielino1212: checks 
caduceus369: bets €0.04
Tuttopersempre: calls €0.04
Danielino1212: calls €0.04
*** TURN *** [9s Ks 6d] [4c]
Danielino1212: checks 
caduceus369: checks 
Tuttopersempre: checks 
*** RIVER *** [9s Ks 6d 4c] [6s]
Danielino1212: checks 
caduceus369: bets €0.07
Tuttopersempre: folds 
Danielino1212: folds 
Uncalled bet (€0.07) returned to caduceus369
caduceus369 collected €0.23 from pot
caduceus369: doesn't show hand 
*** SUMMARY ***
Total pot €0.24 | Rake €0.01 
Board [9s Ks 6d 4c 6s]
Seat 1: mashallahh (button) folded before Flop (didn't bet)
Seat 2: Danielino1212 (small blind) folded on the River
Seat 3: caduceus369 (big blind) collected (€0.23)
Seat 4: Iacuba folded before Flop (didn't bet)
Seat 5: Tuttopersempre folded on the River
Seat 6: pistaKKio23 folded before Flop (didn't bet)



PokerStars Zoom Hand #258039358398:  Hold'em No Limit (€0.01/€0.02) [ADM ID: M62C03044AE79CRJ] - 2025/10/08 0:04:02 CET [2025/10/07 18:04:02 ET]
Table 'Sirio' 6-max Seat #1 is the button
Seat 1: maury999999 (€2.03 in chips) 
Seat 2: caduceus369 (€4.54 in chips) 
Seat 3: Ilpazzo58 (€2.43 in chips) 
Seat 4: SiMoOoOo93 (€2.14 in chips) 
Seat 5: gigiruk91 (€5.52 in chips) 
Seat 6: QUATTRODAME (€1.90 in chips) 
caduceus369: posts small blind €0.01
Ilpazzo58: posts big blind €0.02
*** HOLE CARDS ***
Dealt to caduceus369 [Js 7d]
SiMoOoOo93: folds 
gigiruk91: folds 
QUATTRODAME: folds 
maury999999: folds 
caduceus369: folds 
Uncalled bet (€0.01) returned to Ilpazzo58
Ilpazzo58 collected €0.02 from pot
Ilpazzo58: doesn't show hand 
*** SUMMARY ***
Total pot €0.02 | Rake €0 
Seat 1: maury999999 (button) folded before Flop (didn't bet)
Seat 2: caduceus369 (small blind) folded before Flop
Seat 3: Ilpazzo58 (big blind) collected (€0.02)
Seat 4: SiMoOoOo93 folded before Flop (didn't bet)
Seat 5: gigiruk91 folded before Flop (didn't bet)
Seat 6: QUATTRODAME folded before Flop (didn't bet)



PokerStars Zoom Hand #258039356883:  Hold'em No Limit (€0.01/€0.02) [ADM ID: M62C03044AE79CRJ] - 2025/10/08 0:03:55 CET [2025/10/07 18:03:55 ET]
Table 'Sirio' 6-max Seat #1 is the button
Seat 1: caduceus369 (€4.54 in chips) 
Seat 2: SiMoOoOo93 (€2.15 in chips) 
Seat 3: vesper622 (€2 in chips) 
Seat 4: gigiruk91 (€2.07 in chips) 
Seat 5: pistaKKio23 (€2.33 in chips) 
Seat 6: mashallahh (€2.88 in chips) 
SiMoOoOo93: posts small blind €0.01
vesper622: posts big blind €0.02
*** HOLE CARDS ***
Dealt to caduceus369 [6c 8d]
gigiruk91: folds 
pistaKKio23: folds 
mashallahh: folds 
caduceus369: folds 
SiMoOoOo93: folds 
Uncalled bet (€0.01) returned to vesper622
vesper622 collected €0.02 from pot
vesper622: doesn't show hand 
*** SUMMARY ***
Total pot €0.02 | Rake €0 
Seat 1: caduceus369 (button) folded before Flop (didn't bet)
Seat 2: SiMoOoOo93 (small blind) folded before Flop
Seat 3: vesper622 (big blind) collected (€0.02)
Seat 4: gigiruk91 folded before Flop (didn't bet)
Seat 5: pistaKKio23 folded before Flop (didn't bet)
Seat 6: mashallahh folded before Flop (didn't bet)



PokerStars Zoom Hand #258039361440:  Hold'em No Limit (€0.01/€0.02) [ADM ID: M62C03044AE79CRJ] - 2025/10/08 0:04:16 CET [2025/10/07 18:04:16 ET]
Table 'Sirio' 6-max Seat #1 is the button
Seat 1: dellas3131 (€5.34 in chips) 
Seat 2: gigiruk91 (€2.05 in chips) 
Seat 3: maury999999 (€2.32 in chips) 
Seat 4: pistaKKio23 (€5.91 in chips) 
Seat 5: caduceus369 (€4.53 in chips) 
Seat 6: SiMoOoOo93 (€2.14 in chips) 
gigiruk91: posts small blind €0.01
maury999999: posts big blind €0.02
*** HOLE CARDS ***
Dealt to caduceus369 [2s Qh]
pistaKKio23: folds 
caduceus369: folds 
SiMoOoOo93: folds 
dellas3131: raises €0.05 to €0.07
gigiruk91: folds 
maury999999: folds 
Uncalled bet (€0.05) returned to dellas3131
dellas3131 collected €0.05 from pot
dellas3131: doesn't show hand 
*** SUMMARY ***
Total pot €0.05 | Rake €0 
Seat 1: dellas3131 (button) collected (€0.05)
Seat 2: gigiruk91 (small blind) folded before Flop
Seat 3: maury999999 (big blind) folded before Flop
Seat 4: pistaKKio23 folded before Flop (didn't bet)
Seat 5: caduceus369 folded before Flop (didn't bet)
Seat 6: SiMoOoOo93 folded before Flop (didn't bet)



PokerStars Zoom Hand #258039363595:  Hold'em No Limit (€0.01/€0.02) [ADM ID: M62C03044AE79CRJ] - 2025/10/08 0:04:26 CET [2025/10/07 18:04:26 ET]
Table 'Sirio' 6-max Seat #1 is the button
Seat 1: dellas3131 (€2.56 in chips) 
Seat 2: SaTheNuts_77 (€0.95 in chips) 
Seat 3: mondie73100 (€3.51 in chips) 
Seat 4: mashallahh (€7.36 in chips) 
Seat 5: pistaKKio23 (€5.91 in chips) 
Seat 6: caduceus369 (€4.53 in chips) 
SaTheNuts_77: posts small blind €0.01
mondie73100: posts big blind €0.02
*** HOLE CARDS ***
Dealt to caduceus369 [8c Qh]
mashallahh: folds 
pistaKKio23: folds 
caduceus369: folds 
dellas3131: raises €0.05 to €0.07
SaTheNuts_77: folds 
mondie73100: folds 
Uncalled bet (€0.05) returned to dellas3131
dellas3131 collected €0.05 from pot
dellas3131: doesn't show hand 
*** SUMMARY ***
Total pot €0.05 | Rake €0 
Seat 1: dellas3131 (button) collected (€0.05)
Seat 2: SaTheNuts_77 (small blind) folded before Flop
Seat 3: mondie73100 (big blind) folded before Flop
Seat 4: mashallahh folded before Flop (didn't bet)
Seat 5: pistaKKio23 folded before Flop (didn't bet)
Seat 6: caduceus369 folded before Flop (didn't bet)



PokerStars Zoom Hand #258039365135:  Hold'em No Limit (€0.01/€0.02) [ADM ID: M62C03044AE79CRJ] - 2025/10/08 0:04:33 CET [2025/10/07 18:04:33 ET]
Table 'Sirio' 6-max Seat #1 is the button
Seat 1: SebaRapy14 (€7.18 in chips) 
Seat 2: Ilpazzo58 (€2.44 in chips) 
Seat 3: mashallahh (€4.20 in chips) 
Seat 4: cagliari59 (€2.20 in chips) 
Seat 5: caduceus369 (€4.53 in chips) 
Seat 6: SaTheNuts_77 (€0.94 in chips) 
Ilpazzo58: posts small blind €0.01
mashallahh: posts big blind €0.02
*** HOLE CARDS ***
Dealt to caduceus369 [Tc Td]
cagliari59: raises €0.02 to €0.04
caduceus369: raises €0.10 to €0.14
SaTheNuts_77: folds 
SebaRapy14: folds 
Ilpazzo58: folds 
mashallahh: folds 
cagliari59: folds 
Uncalled bet (€0.10) returned to caduceus369
caduceus369 collected €0.11 from pot
caduceus369: doesn't show hand 
*** SUMMARY ***
Total pot €0.11 | Rake €0 
Seat 1: SebaRapy14 (button) folded before Flop (didn't bet)
Seat 2: Ilpazzo58 (small blind) folded before Flop
Seat 3: mashallahh (big blind) folded before Flop
Seat 4: cagliari59 folded before Flop
Seat 5: caduceus369 collected (€0.11)
Seat 6: SaTheNuts_77 folded before Flop (didn't bet)



PokerStars Zoom Hand #258039362673:  Hold'em No Limit (€0.01/€0.02) [ADM ID: M62C03044AE79CRJ] - 2025/10/08 0:04:22 CET [2025/10/07 18:04:22 ET]
Table 'Sirio' 6-max Seat #1 is the button
Seat 1: mashallahh (€2.88 in chips) 
Seat 2: vesper622 (€2.01 in chips) 
Seat 3: SiMoOoOo93 (€2.14 in chips) 
Seat 4: caduceus369 (€4.53 in chips) 
Seat 5: SebaRapy14 (€7.18 in chips) 
Seat 6: Ilpazzo58 (€2.44 in chips) 
vesper622: posts small blind €0.01
SiMoOoOo93: posts big blind €0.02
*** HOLE CARDS ***
Dealt to caduceus369 [3s Kc]
caduceus369: folds 
SebaRapy14: folds 
Ilpazzo58: folds 
mashallahh: folds 
vesper622: raises €0.02 to €0.04
SiMoOoOo93: calls €0.02
*** FLOP *** [6d Ks 5c]
vesper622: bets €0.04
SiMoOoOo93: calls €0.04
*** TURN *** [6d Ks 5c] [Qs]
vesper622: bets €0.11
SiMoOoOo93: calls €0.11
*** RIVER *** [6d Ks 5c Qs] [7d]
vesper622: checks 
SiMoOoOo93: checks 
*** SHOW DOWN ***
vesper622: shows [4s Ac] (high card Ace)
SiMoOoOo93: mucks hand 
vesper622 collected €0.36 from pot
*** SUMMARY ***
Total pot €0.38 | Rake €0.02 
Board [6d Ks 5c Qs 7d]
Seat 1: mashallahh (button) folded before Flop (didn't bet)
Seat 2: vesper622 (small blind) showed [4s Ac] and won (€0.36) with high card Ace
Seat 3: SiMoOoOo93 (big blind) mucked [9c Tc]
Seat 4: caduceus369 folded before Flop (didn't bet)
Seat 5: SebaRapy14 folded before Flop (didn't bet)
Seat 6: Ilpazzo58 folded before Flop (didn't bet)



PokerStars Zoom Hand #258039373152:  Hold'em No Limit (€0.01/€0.02) [ADM ID: M62C03044AE79CRJ] - 2025/10/08 0:05:10 CET [2025/10/07 18:05:10 ET]
Table 'Sirio' 6-max Seat #1 is the button
Seat 1: pistaKKio23 (€2.33 in chips) 
Seat 2: gigiruk91 (€6.64 in chips) 
Seat 3: caduceus369 (€4.60 in chips) 
Seat 4: QUATTRODAME (€1.89 in chips) 
Seat 5: rw01yk (€1.41 in chips) 
Seat 6: mashallahh (€7.38 in chips) 
gigiruk91: posts small blind €0.01
caduceus369: posts big blind €0.02
*** HOLE CARDS ***
Dealt to caduceus369 [6h Ah]
QUATTRODAME: raises €0.04 to €0.06
rw01yk: raises €1.35 to €1.41 and is all-in
mashallahh: folds 
pistaKKio23: folds 
gigiruk91: folds 
caduceus369: folds 
QUATTRODAME: folds 
Uncalled bet (€1.35) returned to rw01yk
rw01yk collected €0.15 from pot
rw01yk: doesn't show hand 
*** SUMMARY ***
Total pot €0.15 | Rake €0 
Seat 1: pistaKKio23 (button) folded before Flop (didn't bet)
Seat 2: gigiruk91 (small blind) folded before Flop
Seat 3: caduceus369 (big blind) folded before Flop
Seat 4: QUATTRODAME folded before Flop
Seat 5: rw01yk collected (€0.15)
Seat 6: mashallahh folded before Flop (didn't bet)



PokerStars Zoom Hand #258039379670:  Hold'em No Limit (€0.01/€0.02) [ADM ID: M62C03044AE79CRJ] - 2025/10/08 0:05:39 CET [2025/10/07 18:05:39 ET]
Table 'Sirio' 6-max Seat #1 is the button
Seat 1: robertoH2O (€2.96 in chips) 
Seat 2: caduceus369 (€4.58 in chips) 
Seat 3: ADRIAN0_MEIS (€23.40 in chips) 
Seat 4: nikolor (€2 in chips) 
Seat 5: pistaKKio23 (€2.33 in chips) 
Seat 6: dellas3131 (€2.37 in chips) 
caduceus369: posts small blind €0.01
ADRIAN0_MEIS: posts big blind €0.02
*** HOLE CARDS ***
Dealt to caduceus369 [3s Ts]
nikolor: folds 
pistaKKio23 has timed out
pistaKKio23: folds 
dellas3131: folds 
robertoH2O: raises €0.03 to €0.05
caduceus369: folds 
ADRIAN0_MEIS: folds 
Uncalled bet (€0.03) returned to robertoH2O
robertoH2O collected €0.05 from pot
robertoH2O: doesn't show hand 
*** SUMMARY ***
Total pot €0.05 | Rake €0 
Seat 1: robertoH2O (button) collected (€0.05)
Seat 2: caduceus369 (small blind) folded before Flop
Seat 3: ADRIAN0_MEIS (big blind) folded before Flop
Seat 4: nikolor folded before Flop (didn't bet)
Seat 5: pistaKKio23 folded before Flop (didn't bet)
Seat 6: dellas3131 folded before Flop (didn't bet)



PokerStars Zoom Hand #258039380788:  Hold'em No Limit (€0.01/€0.02) [ADM ID: M62C03044AE79CRJ] - 2025/10/08 0:05:44 CET [2025/10/07 18:05:44 ET]
Table 'Sirio' 6-max Seat #1 is the button
Seat 1: caduceus369 (€4.57 in chips) 
Seat 2: mashallahh (€4 in chips) 
Seat 3: dellas3131 (€2.37 in chips) 
Seat 4: rw01yk (€1.50 in chips) 
Seat 5: SiMoOoOo93 (€1.94 in chips) 
Seat 6: maury999999 (€2.30 in chips) 
mashallahh: posts small blind €0.01
dellas3131: posts big blind €0.02
*** HOLE CARDS ***
Dealt to caduceus369 [6h 9d]
rw01yk: folds 
SiMoOoOo93: folds 
maury999999: folds 
caduceus369: raises €0.04 to €0.06
mashallahh: folds 
dellas3131: folds 
Uncalled bet (€0.04) returned to caduceus369
caduceus369 collected €0.05 from pot
caduceus369: doesn't show hand 
*** SUMMARY ***
Total pot €0.05 | Rake €0 
Seat 1: caduceus369 (button) collected (€0.05)
Seat 2: mashallahh (small blind) folded before Flop
Seat 3: dellas3131 (big blind) folded before Flop
Seat 4: rw01yk folded before Flop (didn't bet)
Seat 5: SiMoOoOo93 folded before Flop (didn't bet)
Seat 6: maury999999 folded before Flop (didn't bet)



PokerStars Zoom Hand #258039386308:  Hold'em No Limit (€0.01/€0.02) [ADM ID: M62C03044AE79CRJ] - 2025/10/08 0:06:10 CET [2025/10/07 18:06:10 ET]
Table 'Sirio' 6-max Seat #1 is the button
Seat 1: mashallahh (€2.68 in chips) 
Seat 2: robertoH2O (€2.99 in chips) 
Seat 3: gigiruk91 (€2.55 in chips) 
Seat 4: caduceus369 (€4.60 in chips) 
Seat 5: scannabue212 (€0.87 in chips) 
Seat 6: SebaRapy14 (€6.95 in chips) 
robertoH2O: posts small blind €0.01
gigiruk91: posts big blind €0.02
*** HOLE CARDS ***
Dealt to caduceus369 [6c 2s]
caduceus369: folds 
scannabue212: folds 
SebaRapy14: folds 
mashallahh: raises €0.04 to €0.06
robertoH2O: folds 
gigiruk91: folds 
Uncalled bet (€0.04) returned to mashallahh
mashallahh collected €0.05 from pot
mashallahh: doesn't show hand 
*** SUMMARY ***
Total pot €0.05 | Rake €0 
Seat 1: mashallahh (button) collected (€0.05)
Seat 2: robertoH2O (small blind) folded before Flop
Seat 3: gigiruk91 (big blind) folded before Flop
Seat 4: caduceus369 folded before Flop (didn't bet)
Seat 5: scannabue212 folded before Flop (didn't bet)
Seat 6: SebaRapy14 folded before Flop (didn't bet)



PokerStars Zoom Hand #258039387278:  Hold'em No Limit (€0.01/€0.02) [ADM ID: M62C03044AE79CRJ] - 2025/10/08 0:06:15 CET [2025/10/07 18:06:15 ET]
Table 'Sirio' 6-max Seat #1 is the button
Seat 1: ADRIAN0_MEIS (€23.38 in chips) 
Seat 2: pistaKKio23 (€5.96 in chips) 
Seat 3: bafo77_po (€1.35 in chips) 
Seat 4: SebaRapy14 (€6.95 in chips) 
Seat 5: QUATTRODAME (€1.90 in chips) 
Seat 6: caduceus369 (€4.60 in chips) 
pistaKKio23: posts small blind €0.01
bafo77_po: posts big blind €0.02
*** HOLE CARDS ***
Dealt to caduceus369 [Kh 7s]
SebaRapy14: folds 
QUATTRODAME: raises €0.04 to €0.06
caduceus369: folds 
ADRIAN0_MEIS: folds 
pistaKKio23: calls €0.05
bafo77_po: folds 
*** FLOP *** [8c 2d Th]
pistaKKio23: checks 
QUATTRODAME: checks 
*** TURN *** [8c 2d Th] [3d]
pistaKKio23: bets €0.14
QUATTRODAME: folds 
Uncalled bet (€0.14) returned to pistaKKio23
pistaKKio23 collected €0.14 from pot
pistaKKio23: doesn't show hand 
*** SUMMARY ***
Total pot €0.14 | Rake €0 
Board [8c 2d Th 3d]
Seat 1: ADRIAN0_MEIS (button) folded before Flop (didn't bet)
Seat 2: pistaKKio23 (small blind) collected (€0.14)
Seat 3: bafo77_po (big blind) folded before Flop
Seat 4: SebaRapy14 folded before Flop (didn't bet)
Seat 5: QUATTRODAME folded on the Turn
Seat 6: caduceus369 folded before Flop (didn't bet)



PokerStars Zoom Hand #258039392527:  Hold'em No Limit (€0.01/€0.02) [ADM ID: M62C03044AE79CRJ] - 2025/10/08 0:06:39 CET [2025/10/07 18:06:39 ET]
Table 'Sirio' 6-max Seat #1 is the button
Seat 1: caduceus369 (€4.60 in chips) 
Seat 2: mashallahh (€2.71 in chips) 
Seat 3: stev@nin (€4 in chips) 
Seat 4: vesper622 (€2.30 in chips) 
Seat 5: dellas3131 (€5.46 in chips) 
Seat 6: pistaKKio23 (€4.39 in chips) 
mashallahh: posts small blind €0.01
stev@nin: posts big blind €0.02
*** HOLE CARDS ***
Dealt to caduceus369 [6s 2h]
vesper622: folds 
dellas3131: folds 
pistaKKio23: folds 
caduceus369: folds 
mashallahh: raises €0.04 to €0.06
stev@nin: folds 
Uncalled bet (€0.04) returned to mashallahh
mashallahh collected €0.04 from pot
mashallahh: doesn't show hand 
*** SUMMARY ***
Total pot €0.04 | Rake €0 
Seat 1: caduceus369 (button) folded before Flop (didn't bet)
Seat 2: mashallahh (small blind) collected (€0.04)
Seat 3: stev@nin (big blind) folded before Flop
Seat 4: vesper622 folded before Flop (didn't bet)
Seat 5: dellas3131 folded before Flop (didn't bet)
Seat 6: pistaKKio23 folded before Flop (didn't bet)



PokerStars Zoom Hand #258039388514:  Hold'em No Limit (€0.01/€0.02) [ADM ID: M62C03044AE79CRJ] - 2025/10/08 0:06:20 CET [2025/10/07 18:06:20 ET]
Table 'Sirio' 6-max Seat #1 is the button
Seat 1: scannabue212 (€0.87 in chips) 
Seat 2: SaTheNuts_77 (€1.29 in chips) 
Seat 3: SebaRapy14 (€6.95 in chips) 
Seat 4: Iacuba (€3.42 in chips) 
Seat 5: caduceus369 (€4.60 in chips) 
Seat 6: mondie73100 (€2.06 in chips) 
SaTheNuts_77: posts small blind €0.01
SebaRapy14: posts big blind €0.02
*** HOLE CARDS ***
Dealt to caduceus369 [3h 2h]
Iacuba: raises €0.02 to €0.04
caduceus369: folds 
mondie73100: folds 
scannabue212: folds 
SaTheNuts_77: folds 
SebaRapy14: calls €0.02
*** FLOP *** [4h 5d 5s]
SebaRapy14: checks 
Iacuba: checks 
*** TURN *** [4h 5d 5s] [9h]
SebaRapy14: bets €0.06
Iacuba: folds 
Uncalled bet (€0.06) returned to SebaRapy14
SebaRapy14 collected €0.09 from pot
SebaRapy14: doesn't show hand 
*** SUMMARY ***
Total pot €0.09 | Rake €0 
Board [4h 5d 5s 9h]
Seat 1: scannabue212 (button) folded before Flop (didn't bet)
Seat 2: SaTheNuts_77 (small blind) folded before Flop
Seat 3: SebaRapy14 (big blind) collected (€0.09)
Seat 4: Iacuba folded on the Turn
Seat 5: caduceus369 folded before Flop (didn't bet)
Seat 6: mondie73100 folded before Flop (didn't bet)



PokerStars Zoom Hand #258039390999:  Hold'em No Limit (€0.01/€0.02) [ADM ID: M62C03044AE79CRJ] - 2025/10/08 0:06:32 CET [2025/10/07 18:06:32 ET]
Table 'Sirio' 6-max Seat #1 is the button
Seat 1: gigiruk91 (€2.53 in chips) 
Seat 2: Strizzi91 (€2.04 in chips) 
Seat 3: robertoH2O (€2.98 in chips) 
Seat 4: caduceus369 (€4.60 in chips) 
Seat 5: mondie73100 (€2.06 in chips) 
Seat 6: pistaKKio23 (€2.33 in chips) 
Strizzi91: posts small blind €0.01
robertoH2O: posts big blind €0.02
*** HOLE CARDS ***
Dealt to caduceus369 [Qh 7h]
caduceus369: folds 
mondie73100: folds 
pistaKKio23: folds 
gigiruk91: raises €0.02 to €0.04
Strizzi91: calls €0.03
robertoH2O: folds 
*** FLOP *** [Tc 9c As]
Strizzi91: checks 
gigiruk91: checks 
*** TURN *** [Tc 9c As] [Js]
Strizzi91: checks 
gigiruk91: checks 
*** RIVER *** [Tc 9c As Js] [Kc]
Strizzi91: bets €0.10
gigiruk91: folds 
Uncalled bet (€0.10) returned to Strizzi91
Strizzi91 collected €0.10 from pot
Strizzi91: doesn't show hand 
*** SUMMARY ***
Total pot €0.10 | Rake €0 
Board [Tc 9c As Js Kc]
Seat 1: gigiruk91 (button) folded on the River
Seat 2: Strizzi91 (small blind) collected (€0.10)
Seat 3: robertoH2O (big blind) folded before Flop
Seat 4: caduceus369 folded before Flop (didn't bet)
Seat 5: mondie73100 folded before Flop (didn't bet)
Seat 6: pistaKKio23 folded before Flop (didn't bet)



PokerStars Zoom Hand #258039394305:  Hold'em No Limit (€0.01/€0.02) [ADM ID: M62C03044AE79CRJ] - 2025/10/08 0:06:47 CET [2025/10/07 18:06:47 ET]
Table 'Sirio' 6-max Seat #1 is the button
Seat 1: pistaKKio23 (€6.04 in chips) 
Seat 2: gigiruk91 (€2.03 in chips) 
Seat 3: caduceus369 (€4.60 in chips) 
Seat 4: mashallahh (€3.97 in chips) 
Seat 5: Ilpazzo58 (€2.89 in chips) 
Seat 6: nikolor (€1.97 in chips) 
gigiruk91: posts small blind €0.01
caduceus369: posts big blind €0.02
*** HOLE CARDS ***
Dealt to caduceus369 [5c 3s]
Ilpazzo58 is disconnected 
mashallahh has timed out
mashallahh: folds 
Ilpazzo58 has timed out while disconnected
Ilpazzo58: folds 
nikolor: folds 
pistaKKio23: folds 
gigiruk91: raises €0.02 to €0.04
caduceus369: raises €0.10 to €0.14
gigiruk91: folds 
Uncalled bet (€0.10) returned to caduceus369
caduceus369 collected €0.08 from pot
caduceus369: doesn't show hand 
*** SUMMARY ***
Total pot €0.08 | Rake €0 
Seat 1: pistaKKio23 (button) folded before Flop (didn't bet)
Seat 2: gigiruk91 (small blind) folded before Flop
Seat 3: caduceus369 (big blind) collected (€0.08)
Seat 4: mashallahh folded before Flop (didn't bet)
Seat 5: Ilpazzo58 folded before Flop (didn't bet)
Seat 6: nikolor folded before Flop (didn't bet)



PokerStars Zoom Hand #258039420479:  Hold'em No Limit (€0.01/€0.02) [ADM ID: M62C03044AE79CRJ] - 2025/10/08 0:08:49 CET [2025/10/07 18:08:49 ET]
Table 'Sirio' 6-max Seat #1 is the button
Seat 1: robertoH2O (€2.92 in chips) 
Seat 2: mashallahh (€3.97 in chips) 
Seat 3: QUATTRODAME (€1.77 in chips) 
Seat 4: pistaKKio23 (€3.70 in chips) 
Seat 5: caduceus369 (€4.63 in chips) 
Seat 6: rw01yk (€0.31 in chips) 
mashallahh: posts small blind €0.01
QUATTRODAME: posts big blind €0.02
*** HOLE CARDS ***
Dealt to caduceus369 [Th Ah]
pistaKKio23: folds 
caduceus369: raises €0.04 to €0.06
rw01yk: folds 
robertoH2O: folds 
mashallahh: folds 
QUATTRODAME: folds 
Uncalled bet (€0.04) returned to caduceus369
caduceus369 collected €0.05 from pot
caduceus369: doesn't show hand 
*** SUMMARY ***
Total pot €0.05 | Rake €0 
Seat 1: robertoH2O (button) folded before Flop (didn't bet)
Seat 2: mashallahh (small blind) folded before Flop
Seat 3: QUATTRODAME (big blind) folded before Flop
Seat 4: pistaKKio23 folded before Flop (didn't bet)
Seat 5: caduceus369 collected (€0.05)
Seat 6: rw01yk folded before Flop (didn't bet)



PokerStars Zoom Hand #258039416514:  Hold'em No Limit (€0.01/€0.02) [ADM ID: M62C03044AE79CRJ] - 2025/10/08 0:08:31 CET [2025/10/07 18:08:31 ET]
Table 'Sirio' 6-max Seat #1 is the button
Seat 1: xebarpz4400 (€0.77 in chips) 
Seat 2: scannabue212 (€1.03 in chips) 
Seat 3: mondie73100 (€3.61 in chips) 
Seat 4: pistaKKio23 (€6.02 in chips) 
Seat 5: caduceus369 (€4.63 in chips) 
Seat 6: robertoH2O (€2.92 in chips) 
scannabue212: posts small blind €0.01
mondie73100: posts big blind €0.02
*** HOLE CARDS ***
Dealt to caduceus369 [5s 8d]
pistaKKio23 has timed out
pistaKKio23: folds 
caduceus369: folds 
robertoH2O: folds 
xebarpz4400: folds 
scannabue212: raises €0.04 to €0.06
mondie73100: folds 
Uncalled bet (€0.04) returned to scannabue212
scannabue212 collected €0.04 from pot
scannabue212: doesn't show hand 
*** SUMMARY ***
Total pot €0.04 | Rake €0 
Seat 1: xebarpz4400 (button) folded before Flop (didn't bet)
Seat 2: scannabue212 (small blind) collected (€0.04)
Seat 3: mondie73100 (big blind) folded before Flop
Seat 4: pistaKKio23 folded before Flop (didn't bet)
Seat 5: caduceus369 folded before Flop (didn't bet)
Seat 6: robertoH2O folded before Flop (didn't bet)



PokerStars Zoom Hand #258039413761:  Hold'em No Limit (€0.01/€0.02) [ADM ID: M62C03044AE79CRJ] - 2025/10/08 0:08:18 CET [2025/10/07 18:08:18 ET]
Table 'Sirio' 6-max Seat #1 is the button
Seat 1: gigiruk91 (€6.56 in chips) 
Seat 2: caduceus369 (€4.64 in chips) 
Seat 3: vesper622 (€2.32 in chips) 
Seat 4: QUATTRODAME (€1.78 in chips) 
Seat 5: SaTheNuts_77 (€1.18 in chips) 
Seat 6: stev@nin (€5.88 in chips) 
caduceus369: posts small blind €0.01
vesper622: posts big blind €0.02
*** HOLE CARDS ***
Dealt to caduceus369 [2s Ts]
QUATTRODAME: folds 
SaTheNuts_77: folds 
stev@nin: folds 
gigiruk91: raises €0.02 to €0.04
caduceus369: folds 
vesper622: calls €0.02
*** FLOP *** [9s Qh 9c]
vesper622: checks 
gigiruk91: checks 
*** TURN *** [9s Qh 9c] [3d]
vesper622: checks 
gigiruk91: checks 
*** RIVER *** [9s Qh 9c 3d] [Qs]
vesper622: checks 
gigiruk91: checks 
*** SHOW DOWN ***
vesper622: shows [4h 5c] (two pair, Queens and Nines)
gigiruk91: shows [5d 7d] (two pair, Queens and Nines - Seven kicker)
gigiruk91 collected €0.09 from pot
*** SUMMARY ***
Total pot €0.09 | Rake €0 
Board [9s Qh 9c 3d Qs]
Seat 1: gigiruk91 (button) showed [5d 7d] and won (€0.09) with two pair, Queens and Nines
Seat 2: caduceus369 (small blind) folded before Flop
Seat 3: vesper622 (big blind) showed [4h 5c] and lost with two pair, Queens and Nines
Seat 4: QUATTRODAME folded before Flop (didn't bet)
Seat 5: SaTheNuts_77 folded before Flop (didn't bet)
Seat 6: stev@nin folded before Flop (didn't bet)



PokerStars Zoom Hand #258039418669:  Hold'em No Limit (€0.01/€0.02) [ADM ID: M62C03044AE79CRJ] - 2025/10/08 0:08:41 CET [2025/10/07 18:08:41 ET]
Table 'Sirio' 6-max Seat #1 is the button
Seat 1: SebaRapy14 (€6.94 in chips) 
Seat 2: stev@nin (€3.94 in chips) 
Seat 3: fantaasso (€1.66 in chips) 
Seat 4: A_LUCCHESE_92 (€5.68 in chips) 
Seat 5: mashallahh (€7.21 in chips) 
Seat 6: caduceus369 (€4.63 in chips) 
stev@nin: posts small blind €0.01
fantaasso: posts big blind €0.02
*** HOLE CARDS ***
Dealt to caduceus369 [5h Qc]
A_LUCCHESE_92: calls €0.02
mashallahh: folds 
caduceus369: folds 
SebaRapy14: folds 
stev@nin: folds 
fantaasso: checks 
*** FLOP *** [9s Kd Ac]
fantaasso: checks 
A_LUCCHESE_92: checks 
*** TURN *** [9s Kd Ac] [9d]
fantaasso: bets €0.03
A_LUCCHESE_92: calls €0.03
*** RIVER *** [9s Kd Ac 9d] [7c]
fantaasso: checks 
A_LUCCHESE_92: checks 
*** SHOW DOWN ***
fantaasso: shows [Ad 8c] (two pair, Aces and Nines)
A_LUCCHESE_92: mucks hand 
fantaasso collected €0.11 from pot
*** SUMMARY ***
Total pot €0.11 | Rake €0 
Board [9s Kd Ac 9d 7c]
Seat 1: SebaRapy14 (button) folded before Flop (didn't bet)
Seat 2: stev@nin (small blind) folded before Flop
Seat 3: fantaasso (big blind) showed [Ad 8c] and won (€0.11) with two pair, Aces and Nines
Seat 4: A_LUCCHESE_92 mucked [8h 8s]
Seat 5: mashallahh folded before Flop (didn't bet)
Seat 6: caduceus369 folded before Flop (didn't bet)



PokerStars Zoom Hand #258039424071:  Hold'em No Limit (€0.01/€0.02) [ADM ID: M62C03044AE79CRJ] - 2025/10/08 0:09:06 CET [2025/10/07 18:09:06 ET]
Table 'Sirio' 6-max Seat #1 is the button
Seat 1: mondie73100 (€3.59 in chips) 
Seat 2: mashallahh (€2.76 in chips) 
Seat 3: nikolor (€1.87 in chips) 
Seat 4: caduceus369 (€4.66 in chips) 
Seat 5: pistaKKio23 (€4.37 in chips) 
Seat 6: dellas3131 (€6.51 in chips) 
mashallahh: posts small blind €0.01
nikolor: posts big blind €0.02
*** HOLE CARDS ***
Dealt to caduceus369 [Kh Jc]
caduceus369: raises €0.04 to €0.06
pistaKKio23: folds 
dellas3131: folds 
mondie73100: folds 
mashallahh: folds 
nikolor: folds 
Uncalled bet (€0.04) returned to caduceus369
caduceus369 collected €0.05 from pot
caduceus369: doesn't show hand 
*** SUMMARY ***
Total pot €0.05 | Rake €0 
Seat 1: mondie73100 (button) folded before Flop (didn't bet)
Seat 2: mashallahh (small blind) folded before Flop
Seat 3: nikolor (big blind) folded before Flop
Seat 4: caduceus369 collected (€0.05)
Seat 5: pistaKKio23 folded before Flop (didn't bet)
Seat 6: dellas3131 folded before Flop (didn't bet)



PokerStars Zoom Hand #258039428704:  Hold'em No Limit (€0.01/€0.02) [ADM ID: M62C03044AE79CRJ] - 2025/10/08 0:09:27 CET [2025/10/07 18:09:27 ET]
Table 'Sirio' 6-max Seat #1 is the button
Seat 1: dellas3131 (€2.95 in chips) 
Seat 2: pistaKKio23 (€4.37 in chips) 
Seat 3: caduceus369 (€4.69 in chips) 
Seat 4: SebaRapy14 (€3.88 in chips) 
Seat 5: gigiruk91 (€2.08 in chips) 
Seat 6: nikolor (€1.85 in chips) 
pistaKKio23: posts small blind €0.01
caduceus369: posts big blind €0.02
*** HOLE CARDS ***
Dealt to caduceus369 [8s Ks]
SebaRapy14: folds 
gigiruk91: folds 
nikolor: folds 
dellas3131: raises €0.05 to €0.07
pistaKKio23: folds 
caduceus369: calls €0.05
*** FLOP *** [Td Ad 5s]
caduceus369: checks 
dellas3131: checks 
*** TURN *** [Td Ad 5s] [3d]
caduceus369: checks 
dellas3131: checks 
*** RIVER *** [Td Ad 5s 3d] [3h]
caduceus369: checks 
dellas3131: checks 
*** SHOW DOWN ***
caduceus369: shows [8s Ks] (a pair of Threes)
dellas3131: shows [2c 2d] (two pair, Threes and Deuces)
dellas3131 collected €0.15 from pot
*** SUMMARY ***
Total pot €0.15 | Rake €0 
Board [Td Ad 5s 3d 3h]
Seat 1: dellas3131 (button) showed [2c 2d] and won (€0.15) with two pair, Threes and Deuces
Seat 2: pistaKKio23 (small blind) folded before Flop
Seat 3: caduceus369 (big blind) showed [8s Ks] and lost with a pair of Threes
Seat 4: SebaRapy14 folded before Flop (didn't bet)
Seat 5: gigiruk91 folded before Flop (didn't bet)
Seat 6: nikolor folded before Flop (didn't bet)



PokerStars Zoom Hand #258039445708:  Hold'em No Limit (€0.01/€0.02) [ADM ID: M62C03044AE79CRJ] - 2025/10/08 0:10:46 CET [2025/10/07 18:10:46 ET]
Table 'Sirio' 6-max Seat #1 is the button
Seat 1: caduceus369 (€4.61 in chips) 
Seat 2: robertoH2O (€2.87 in chips) 
Seat 3: mashallahh (€4.16 in chips) 
Seat 4: maury999999 (€2.17 in chips) 
Seat 5: SebaRapy14 (€7.02 in chips) 
Seat 6: dellas3131 (€6.48 in chips) 
robertoH2O: posts small blind €0.01
mashallahh: posts big blind €0.02
*** HOLE CARDS ***
Dealt to caduceus369 [Qh Kd]
dellas3131 is disconnected 
maury999999: folds 
SebaRapy14: folds 
dellas3131 has timed out while disconnected
dellas3131: folds 
caduceus369: raises €0.04 to €0.06
robertoH2O: folds 
mashallahh: folds 
Uncalled bet (€0.04) returned to caduceus369
caduceus369 collected €0.05 from pot
caduceus369: doesn't show hand 
*** SUMMARY ***
Total pot €0.05 | Rake €0 
Seat 1: caduceus369 (button) collected (€0.05)
Seat 2: robertoH2O (small blind) folded before Flop
Seat 3: mashallahh (big blind) folded before Flop
Seat 4: maury999999 folded before Flop (didn't bet)
Seat 5: SebaRapy14 folded before Flop (didn't bet)
Seat 6: dellas3131 folded before Flop (didn't bet)



PokerStars Zoom Hand #258039444555:  Hold'em No Limit (€0.01/€0.02) [ADM ID: M62C03044AE79CRJ] - 2025/10/08 0:10:40 CET [2025/10/07 18:10:40 ET]
Table 'Sirio' 6-max Seat #1 is the button
Seat 1: Poonte (€4.85 in chips) 
Seat 2: caduceus369 (€4.62 in chips) 
Seat 3: scannabue212 (€1.12 in chips) 
Seat 4: mondie73100 (€2.59 in chips) 
Seat 5: dellas3131 (€3.03 in chips) 
Seat 6: A_LUCCHESE_92 (€5.54 in chips) 
caduceus369: posts small blind €0.01
scannabue212: posts big blind €0.02
*** HOLE CARDS ***
Dealt to caduceus369 [Kc 6h]
mondie73100: folds 
dellas3131: folds 
A_LUCCHESE_92: folds 
Poonte: calls €0.02
caduceus369: folds 
scannabue212: checks 
*** FLOP *** [2c 8h 2h]
scannabue212: checks 
Poonte: checks 
*** TURN *** [2c 8h 2h] [3c]
scannabue212: checks 
Poonte: checks 
*** RIVER *** [2c 8h 2h 3c] [5h]
scannabue212: bets €0.04
Poonte: folds 
Uncalled bet (€0.04) returned to scannabue212
scannabue212 collected €0.05 from pot
scannabue212: doesn't show hand 
*** SUMMARY ***
Total pot €0.05 | Rake €0 
Board [2c 8h 2h 3c 5h]
Seat 1: Poonte (button) folded on the River
Seat 2: caduceus369 (small blind) folded before Flop
Seat 3: scannabue212 (big blind) collected (€0.05)
Seat 4: mondie73100 folded before Flop (didn't bet)
Seat 5: dellas3131 folded before Flop (didn't bet)
Seat 6: A_LUCCHESE_92 folded before Flop (didn't bet)



PokerStars Zoom Hand #258039452014:  Hold'em No Limit (€0.01/€0.02) [ADM ID: M62C03044AE79CRJ] - 2025/10/08 0:11:15 CET [2025/10/07 18:11:15 ET]
Table 'Sirio' 6-max Seat #1 is the button
Seat 1: Genny040893 (€0.83 in chips) 
Seat 2: Gaboops (€1.79 in chips) 
Seat 3: nikolor (€1.63 in chips) 
Seat 4: mashallahh (€2.03 in chips) 
Seat 5: SaTheNuts_77 (€1.29 in chips) 
Seat 6: caduceus369 (€4.64 in chips) 
Gaboops: posts small blind €0.01
nikolor: posts big blind €0.02
*** HOLE CARDS ***
Dealt to caduceus369 [7c 4s]
mashallahh has timed out
mashallahh: folds 
SaTheNuts_77: raises €0.05 to €0.07
caduceus369: folds 
Genny040893: calls €0.07
Gaboops: folds 
nikolor: folds 
*** FLOP *** [2c 4h 5h]
SaTheNuts_77: bets €0.15
Genny040893: calls €0.15
*** TURN *** [2c 4h 5h] [3d]
SaTheNuts_77: checks 
Genny040893: checks 
*** RIVER *** [2c 4h 5h 3d] [2d]
SaTheNuts_77: bets €0.15
Genny040893: folds 
Uncalled bet (€0.15) returned to SaTheNuts_77
SaTheNuts_77 collected €0.45 from pot
SaTheNuts_77: doesn't show hand 
*** SUMMARY ***
Total pot €0.47 | Rake €0.02 
Board [2c 4h 5h 3d 2d]
Seat 1: Genny040893 (button) folded on the River
Seat 2: Gaboops (small blind) folded before Flop
Seat 3: nikolor (big blind) folded before Flop
Seat 4: mashallahh folded before Flop (didn't bet)
Seat 5: SaTheNuts_77 collected (€0.45)
Seat 6: caduceus369 folded before Flop (didn't bet)



PokerStars Zoom Hand #258039459135:  Hold'em No Limit (€0.01/€0.02) [ADM ID: M62C03044AE79CRJ] - 2025/10/08 0:11:47 CET [2025/10/07 18:11:47 ET]
Table 'Sirio' 6-max Seat #1 is the button
Seat 1: robertoH2O (€2.86 in chips) 
Seat 2: ADRIAN0_MEIS (€23.14 in chips) 
Seat 3: QUATTRODAME (€1.67 in chips) 
Seat 4: caduceus369 (€4.62 in chips) 
Seat 5: maury999999 (€2 in chips) 
Seat 6: nikolor (€1.61 in chips) 
ADRIAN0_MEIS: posts small blind €0.01
QUATTRODAME: posts big blind €0.02
*** HOLE CARDS ***
Dealt to caduceus369 [Qh 7h]
caduceus369: folds 
maury999999: folds 
nikolor: folds 
robertoH2O: folds 
ADRIAN0_MEIS: folds 
Uncalled bet (€0.01) returned to QUATTRODAME
QUATTRODAME collected €0.02 from pot
QUATTRODAME: doesn't show hand 
*** SUMMARY ***
Total pot €0.02 | Rake €0 
Seat 1: robertoH2O (button) folded before Flop (didn't bet)
Seat 2: ADRIAN0_MEIS (small blind) folded before Flop
Seat 3: QUATTRODAME (big blind) collected (€0.02)
Seat 4: caduceus369 folded before Flop (didn't bet)
Seat 5: maury999999 folded before Flop (didn't bet)
Seat 6: nikolor folded before Flop (didn't bet)



PokerStars Zoom Hand #258039456042:  Hold'em No Limit (€0.01/€0.02) [ADM ID: M62C03044AE79CRJ] - 2025/10/08 0:11:33 CET [2025/10/07 18:11:33 ET]
Table 'Sirio' 6-max Seat #1 is the button
Seat 1: scannabue212 (€1.14 in chips) 
Seat 2: stev@nin (€4.04 in chips) 
Seat 3: caduceus369 (€4.64 in chips) 
Seat 4: mondie73100 (€2.66 in chips) 
Seat 5: pistaKKio23 (€4.45 in chips) 
Seat 6: SebaRapy14 (€6.96 in chips) 
stev@nin: posts small blind €0.01
caduceus369: posts big blind €0.02
*** HOLE CARDS ***
Dealt to caduceus369 [Qc 6s]
mondie73100: folds 
pistaKKio23: raises €0.04 to €0.06
SebaRapy14: folds 
scannabue212: folds 
stev@nin: calls €0.05
caduceus369: folds 
*** FLOP *** [Kh Th 6c]
stev@nin: checks 
pistaKKio23: bets €0.07
stev@nin: raises €0.14 to €0.21
pistaKKio23: folds 
Uncalled bet (€0.14) returned to stev@nin
stev@nin collected €0.27 from pot
stev@nin: doesn't show hand 
*** SUMMARY ***
Total pot €0.28 | Rake €0.01 
Board [Kh Th 6c]
Seat 1: scannabue212 (button) folded before Flop (didn't bet)
Seat 2: stev@nin (small blind) collected (€0.27)
Seat 3: caduceus369 (big blind) folded before Flop
Seat 4: mondie73100 folded before Flop (didn't bet)
Seat 5: pistaKKio23 folded on the Flop
Seat 6: SebaRapy14 folded before Flop (didn't bet)



PokerStars Zoom Hand #258039460530:  Hold'em No Limit (€0.01/€0.02) [ADM ID: M62C03044AE79CRJ] - 2025/10/08 0:11:54 CET [2025/10/07 18:11:54 ET]
Table 'Sirio' 6-max Seat #1 is the button
Seat 1: mondie73100 (€2.64 in chips) 
Seat 2: caduceus369 (€4.62 in chips) 
Seat 3: mashallahh (€7.23 in chips) 
Seat 4: stev@nin (€6 in chips) 
Seat 5: robertoH2O (€2.86 in chips) 
Seat 6: fantaasso (€1.65 in chips) 
caduceus369: posts small blind €0.01
mashallahh: posts big blind €0.02
*** HOLE CARDS ***
Dealt to caduceus369 [Jh 3s]
stev@nin: folds 
robertoH2O: folds 
fantaasso: folds 
mondie73100: folds 
caduceus369: folds 
Uncalled bet (€0.01) returned to mashallahh
mashallahh collected €0.02 from pot
mashallahh: doesn't show hand 
*** SUMMARY ***
Total pot €0.02 | Rake €0 
Seat 1: mondie73100 (button) folded before Flop (didn't bet)
Seat 2: caduceus369 (small blind) folded before Flop
Seat 3: mashallahh (big blind) collected (€0.02)
Seat 4: stev@nin folded before Flop (didn't bet)
Seat 5: robertoH2O folded before Flop (didn't bet)
Seat 6: fantaasso folded before Flop (didn't bet)



PokerStars Zoom Hand #258039453005:  Hold'em No Limit (€0.01/€0.02) [ADM ID: M62C03044AE79CRJ] - 2025/10/08 0:11:19 CET [2025/10/07 18:11:19 ET]
Table 'Sirio' 6-max Seat #1 is the button
Seat 1: QUATTRODAME (€1.68 in chips) 
Seat 2: Iacuba (€3.39 in chips) 
Seat 3: ADRIAN0_MEIS (€23.13 in chips) 
Seat 4: robertoH2O (€2.86 in chips) 
Seat 5: caduceus369 (€4.64 in chips) 
Seat 6: pistaKKio23 (€6.01 in chips) 
Iacuba: posts small blind €0.01
ADRIAN0_MEIS: posts big blind €0.02
*** HOLE CARDS ***
Dealt to caduceus369 [Qc 6h]
robertoH2O: folds 
caduceus369: folds 
pistaKKio23: raises €0.04 to €0.06
QUATTRODAME: folds 
Iacuba has timed out
Iacuba: folds 
ADRIAN0_MEIS: folds 
Uncalled bet (€0.04) returned to pistaKKio23
pistaKKio23 collected €0.05 from pot
pistaKKio23: doesn't show hand 
*** SUMMARY ***
Total pot €0.05 | Rake €0 
Seat 1: QUATTRODAME (button) folded before Flop (didn't bet)
Seat 2: Iacuba (small blind) folded before Flop
Seat 3: ADRIAN0_MEIS (big blind) folded before Flop
Seat 4: robertoH2O folded before Flop (didn't bet)
Seat 5: caduceus369 folded before Flop (didn't bet)
Seat 6: pistaKKio23 collected (€0.05)



PokerStars Zoom Hand #258039463742:  Hold'em No Limit (€0.01/€0.02) [ADM ID: M62C03044AE79CRJ] - 2025/10/08 0:12:09 CET [2025/10/07 18:12:09 ET]
Table 'Sirio' 6-max Seat #1 is the button
Seat 1: Danielino1212 (€1.82 in chips) 
Seat 2: stev@nin (€6 in chips) 
Seat 3: Genny040893 (€0.61 in chips) 
Seat 4: pistaKKio23 (€3.66 in chips) 
Seat 5: fantaasso (€1.65 in chips) 
Seat 6: caduceus369 (€4.61 in chips) 
stev@nin: posts small blind €0.01
Genny040893: posts big blind €0.02
*** HOLE CARDS ***
Dealt to caduceus369 [7d Ah]
pistaKKio23: raises €0.02 to €0.04
fantaasso: folds 
caduceus369: folds 
Danielino1212: calls €0.04
stev@nin: folds 
Genny040893: raises €0.06 to €0.10
pistaKKio23: calls €0.06
Danielino1212: folds 
*** FLOP *** [Th 9s 8d]
Genny040893: bets €0.14
pistaKKio23: folds 
Uncalled bet (€0.14) returned to Genny040893
Genny040893 collected €0.24 from pot
Genny040893: doesn't show hand 
*** SUMMARY ***
Total pot €0.25 | Rake €0.01 
Board [Th 9s 8d]
Seat 1: Danielino1212 (button) folded before Flop
Seat 2: stev@nin (small blind) folded before Flop
Seat 3: Genny040893 (big blind) collected (€0.24)
Seat 4: pistaKKio23 folded on the Flop
Seat 5: fantaasso folded before Flop (didn't bet)
Seat 6: caduceus369 folded before Flop (didn't bet)



PokerStars Zoom Hand #258039467159:  Hold'em No Limit (€0.01/€0.02) [ADM ID: M62C03044AE79CRJ] - 2025/10/08 0:12:25 CET [2025/10/07 18:12:25 ET]
Table 'Sirio' 6-max Seat #1 is the button
Seat 1: robertoH2O (€2.86 in chips) 
Seat 2: caduceus369 (€4.61 in chips) 
Seat 3: stev@nin (€4.18 in chips) 
Seat 4: mashallahh (€4.55 in chips) 
Seat 5: maury999999 (€2 in chips) 
Seat 6: pistaKKio23 (€2.45 in chips) 
caduceus369: posts small blind €0.01
stev@nin: posts big blind €0.02
*** HOLE CARDS ***
Dealt to caduceus369 [Qs 2s]
mashallahh: folds 
maury999999: folds 
pistaKKio23: folds 
robertoH2O: folds 
caduceus369: folds 
Uncalled bet (€0.01) returned to stev@nin
stev@nin collected €0.02 from pot
stev@nin: doesn't show hand 
*** SUMMARY ***
Total pot €0.02 | Rake €0 
Seat 1: robertoH2O (button) folded before Flop (didn't bet)
Seat 2: caduceus369 (small blind) folded before Flop
Seat 3: stev@nin (big blind) collected (€0.02)
Seat 4: mashallahh folded before Flop (didn't bet)
Seat 5: maury999999 folded before Flop (didn't bet)
Seat 6: pistaKKio23 folded before Flop (didn't bet)



PokerStars Zoom Hand #258039471842:  Hold'em No Limit (€0.01/€0.02) [ADM ID: M62C03044AE79CRJ] - 2025/10/08 0:12:47 CET [2025/10/07 18:12:47 ET]
Table 'Sirio' 6-max Seat #1 is the button
Seat 1: maury999999 (€2 in chips) 
Seat 2: Genny040893 (€0.75 in chips) 
Seat 3: caduceus369 (€4.60 in chips) 
Seat 4: pistaKKio23 (€2.45 in chips) 
Seat 5: mashallahh (€4.55 in chips) 
Seat 6: fantaasso (€1.63 in chips) 
Genny040893: posts small blind €0.01
caduceus369: posts big blind €0.02
*** HOLE CARDS ***
Dealt to caduceus369 [6h 2c]
pistaKKio23: calls €0.02
mashallahh: raises €0.06 to €0.08
fantaasso: folds 
maury999999: folds 
Genny040893: folds 
caduceus369: folds 
pistaKKio23: calls €0.06
*** FLOP *** [Tc Ks 5c]
pistaKKio23: checks 
mashallahh: bets €0.14
pistaKKio23: folds 
Uncalled bet (€0.14) returned to mashallahh
mashallahh collected €0.18 from pot
mashallahh: doesn't show hand 
*** SUMMARY ***
Total pot €0.19 | Rake €0.01 
Board [Tc Ks 5c]
Seat 1: maury999999 (button) folded before Flop (didn't bet)
Seat 2: Genny040893 (small blind) folded before Flop
Seat 3: caduceus369 (big blind) folded before Flop
Seat 4: pistaKKio23 folded on the Flop
Seat 5: mashallahh collected (€0.18)
Seat 6: fantaasso folded before Flop (didn't bet)



PokerStars Zoom Hand #258039461586:  Hold'em No Limit (€0.01/€0.02) [ADM ID: M62C03044AE79CRJ] - 2025/10/08 0:11:59 CET [2025/10/07 18:11:59 ET]
Table 'Sirio' 6-max Seat #1 is the button
Seat 1: caduceus369 (€4.61 in chips) 
Seat 2: robertoH2O (€2.86 in chips) 
Seat 3: Allino29 (€2 in chips) 
Seat 4: scannabue212 (€1.12 in chips) 
Seat 5: ADRIAN0_MEIS (€23.13 in chips) 
Seat 6: vesper622 (€2.13 in chips) 
robertoH2O: posts small blind €0.01
Allino29: posts big blind €0.02
*** HOLE CARDS ***
Dealt to caduceus369 [Ks 3d]
scannabue212: folds 
ADRIAN0_MEIS: raises €0.03 to €0.05
vesper622: raises €0.09 to €0.14
caduceus369: folds 
robertoH2O: folds 
Allino29: folds 
ADRIAN0_MEIS: calls €0.09
*** FLOP *** [5s 9d 9h]
ADRIAN0_MEIS: checks 
vesper622: checks 
*** TURN *** [5s 9d 9h] [7s]
ADRIAN0_MEIS: checks 
vesper622: bets €0.10
ADRIAN0_MEIS: calls €0.10
*** RIVER *** [5s 9d 9h 7s] [4h]
ADRIAN0_MEIS: checks 
vesper622: bets €0.18
ADRIAN0_MEIS: folds 
Uncalled bet (€0.18) returned to vesper622
vesper622 collected €0.49 from pot
vesper622: doesn't show hand 
*** SUMMARY ***
Total pot €0.51 | Rake €0.02 
Board [5s 9d 9h 7s 4h]
Seat 1: caduceus369 (button) folded before Flop (didn't bet)
Seat 2: robertoH2O (small blind) folded before Flop
Seat 3: Allino29 (big blind) folded before Flop
Seat 4: scannabue212 folded before Flop (didn't bet)
Seat 5: ADRIAN0_MEIS folded on the River
Seat 6: vesper622 collected (€0.49)



PokerStars Zoom Hand #258039482349:  Hold'em No Limit (€0.01/€0.02) [ADM ID: M62C03044AE79CRJ] - 2025/10/08 0:13:35 CET [2025/10/07 18:13:35 ET]
Table 'Sirio' 6-max Seat #1 is the button
Seat 1: mashallahh (€4.65 in chips) 
Seat 2: pistaKKio23 (€6.02 in chips) 
Seat 3: robertoH2O (€3.51 in chips) 
Seat 4: Genny040893 (€0.77 in chips) 
Seat 5: QUATTRODAME (€1.12 in chips) 
Seat 6: caduceus369 (€4.58 in chips) 
pistaKKio23: posts small blind €0.01
robertoH2O: posts big blind €0.02
*** HOLE CARDS ***
Dealt to caduceus369 [Jc Ks]
Genny040893: raises €0.06 to €0.08
QUATTRODAME: folds 
caduceus369: folds 
mashallahh: folds 
pistaKKio23: calls €0.07
robertoH2O: folds 
*** FLOP *** [Qs 7c 9h]
pistaKKio23: checks 
Genny040893: checks 
*** TURN *** [Qs 7c 9h] [9s]
pistaKKio23: bets €0.18
Genny040893: folds 
Uncalled bet (€0.18) returned to pistaKKio23
pistaKKio23 collected €0.18 from pot
pistaKKio23: doesn't show hand 
*** SUMMARY ***
Total pot €0.18 | Rake €0 
Board [Qs 7c 9h 9s]
Seat 1: mashallahh (button) folded before Flop (didn't bet)
Seat 2: pistaKKio23 (small blind) collected (€0.18)
Seat 3: robertoH2O (big blind) folded before Flop
Seat 4: Genny040893 folded on the Turn
Seat 5: QUATTRODAME folded before Flop (didn't bet)
Seat 6: caduceus369 folded before Flop (didn't bet)



PokerStars Zoom Hand #258039484685:  Hold'em No Limit (€0.01/€0.02) [ADM ID: M62C03044AE79CRJ] - 2025/10/08 0:13:47 CET [2025/10/07 18:13:47 ET]
Table 'Sirio' 6-max Seat #1 is the button
Seat 1: caduceus369 (€4.58 in chips) 
Seat 2: scannabue212 (€1.13 in chips) 
Seat 3: mashallahh (€4.65 in chips) 
Seat 4: rw01yk (€0.32 in chips) 
Seat 5: pistaKKio23 (€4.29 in chips) 
Seat 6: maury999999 (€2 in chips) 
scannabue212: posts small blind €0.01
mashallahh: posts big blind €0.02
*** HOLE CARDS ***
Dealt to caduceus369 [3h Qs]
rw01yk: folds 
pistaKKio23: folds 
maury999999: folds 
caduceus369: folds 
scannabue212: calls €0.01
mashallahh: checks 
*** FLOP *** [3c 7d Kh]
scannabue212: checks 
mashallahh: checks 
*** TURN *** [3c 7d Kh] [8s]
scannabue212: checks 
mashallahh: checks 
*** RIVER *** [3c 7d Kh 8s] [Qd]
scannabue212: bets €0.02
mashallahh: folds 
Uncalled bet (€0.02) returned to scannabue212
scannabue212 collected €0.04 from pot
scannabue212: doesn't show hand 
*** SUMMARY ***
Total pot €0.04 | Rake €0 
Board [3c 7d Kh 8s Qd]
Seat 1: caduceus369 (button) folded before Flop (didn't bet)
Seat 2: scannabue212 (small blind) collected (€0.04)
Seat 3: mashallahh (big blind) folded on the River
Seat 4: rw01yk folded before Flop (didn't bet)
Seat 5: pistaKKio23 folded before Flop (didn't bet)
Seat 6: maury999999 folded before Flop (didn't bet)



PokerStars Zoom Hand #258039485810:  Hold'em No Limit (€0.01/€0.02) [ADM ID: M62C03044AE79CRJ] - 2025/10/08 0:13:52 CET [2025/10/07 18:13:52 ET]
Table 'Sirio' 6-max Seat #1 is the button
Seat 1: Naan79 (€1.96 in chips) 
Seat 2: vesper622 (€2.38 in chips) 
Seat 3: A_LUCCHESE_92 (€5.43 in chips) 
Seat 4: maury999999 (€2 in chips) 
Seat 5: caduceus369 (€4.58 in chips) 
Seat 6: Allino29 (€2.14 in chips) 
vesper622: posts small blind €0.01
A_LUCCHESE_92: posts big blind €0.02
*** HOLE CARDS ***
Dealt to caduceus369 [Qh Ad]
maury999999: folds 
caduceus369: raises €0.04 to €0.06
Allino29: folds 
Naan79: folds 
vesper622: folds 
A_LUCCHESE_92: folds 
Uncalled bet (€0.04) returned to caduceus369
caduceus369 collected €0.05 from pot
caduceus369: doesn't show hand 
*** SUMMARY ***
Total pot €0.05 | Rake €0 
Seat 1: Naan79 (button) folded before Flop (didn't bet)
Seat 2: vesper622 (small blind) folded before Flop
Seat 3: A_LUCCHESE_92 (big blind) folded before Flop
Seat 4: maury999999 folded before Flop (didn't bet)
Seat 5: caduceus369 collected (€0.05)
Seat 6: Allino29 folded before Flop (didn't bet)



PokerStars Zoom Hand #258039493217:  Hold'em No Limit (€0.01/€0.02) [ADM ID: M62C03044AE79CRJ] - 2025/10/08 0:14:27 CET [2025/10/07 18:14:27 ET]
Table 'Sirio' 6-max Seat #1 is the button
Seat 1: scannabue212 (€1.15 in chips) 
Seat 2: pistaKKio23 (€4.27 in chips) 
Seat 3: maury999999 (€2 in chips) 
Seat 4: caduceus369 (€4.61 in chips) 
Seat 5: mondie73100 (€2.52 in chips) 
Seat 6: Gaboops (€2.12 in chips) 
pistaKKio23: posts small blind €0.01
maury999999: posts big blind €0.02
*** HOLE CARDS ***
Dealt to caduceus369 [9c 8s]
caduceus369: folds 
mondie73100: folds 
Gaboops: folds 
scannabue212: calls €0.02
pistaKKio23: calls €0.01
maury999999: checks 
*** FLOP *** [3d 2s 7c]
pistaKKio23: checks 
maury999999: bets €0.02
scannabue212: folds 
pistaKKio23: folds 
Uncalled bet (€0.02) returned to maury999999
maury999999 collected €0.06 from pot
maury999999: doesn't show hand 
*** SUMMARY ***
Total pot €0.06 | Rake €0 
Board [3d 2s 7c]
Seat 1: scannabue212 (button) folded on the Flop
Seat 2: pistaKKio23 (small blind) folded on the Flop
Seat 3: maury999999 (big blind) collected (€0.06)
Seat 4: caduceus369 folded before Flop (didn't bet)
Seat 5: mondie73100 folded before Flop (didn't bet)
Seat 6: Gaboops folded before Flop (didn't bet)



PokerStars Zoom Hand #258039495139:  Hold'em No Limit (€0.01/€0.02) [ADM ID: M62C03044AE79CRJ] - 2025/10/08 0:14:36 CET [2025/10/07 18:14:36 ET]
Table 'Sirio' 6-max Seat #1 is the button
Seat 1: AlwaisToRun (€0.77 in chips) 
Seat 2: mashallahh (€4.63 in chips) 
Seat 3: caduceus369 (€4.61 in chips) 
Seat 4: SebaRapy14 (€7.51 in chips) 
Seat 5: mondie73100 (€2.54 in chips) 
Seat 6: Poonte (€4.92 in chips) 
mashallahh: posts small blind €0.01
caduceus369: posts big blind €0.02
*** HOLE CARDS ***
Dealt to caduceus369 [4s 9s]
SebaRapy14: folds 
mondie73100: folds 
Poonte: folds 
AlwaisToRun: calls €0.02
mashallahh: folds 
caduceus369: checks 
*** FLOP *** [3s Kh 5s]
caduceus369: checks 
AlwaisToRun: checks 
*** TURN *** [3s Kh 5s] [Js]
caduceus369: checks 
AlwaisToRun: bets €0.02
caduceus369: calls €0.02
*** RIVER *** [3s Kh 5s Js] [6c]
caduceus369: bets €0.09
AlwaisToRun: folds 
Uncalled bet (€0.09) returned to caduceus369
caduceus369 collected €0.09 from pot
caduceus369: doesn't show hand 
*** SUMMARY ***
Total pot €0.09 | Rake €0 
Board [3s Kh 5s Js 6c]
Seat 1: AlwaisToRun (button) folded on the River
Seat 2: mashallahh (small blind) folded before Flop
Seat 3: caduceus369 (big blind) collected (€0.09)
Seat 4: SebaRapy14 folded before Flop (didn't bet)
Seat 5: mondie73100 folded before Flop (didn't bet)
Seat 6: Poonte folded before Flop (didn't bet)



PokerStars Zoom Hand #258039505515:  Hold'em No Limit (€0.01/€0.02) [ADM ID: M62C03044AE79CRJ] - 2025/10/08 0:15:25 CET [2025/10/07 18:15:25 ET]
Table 'Sirio' 6-max Seat #1 is the button
Seat 1: Allino29 (€2.28 in chips) 
Seat 2: stev@nin (€4.55 in chips) 
Seat 3: SaTheNuts_77 (€1.12 in chips) 
Seat 4: caduceus369 (€4.66 in chips) 
Seat 5: SebaRapy14 (€7.48 in chips) 
Seat 6: AlwaisToRun (€0.73 in chips) 
stev@nin: posts small blind €0.01
SaTheNuts_77: posts big blind €0.02
*** HOLE CARDS ***
Dealt to caduceus369 [Qh Ac]
caduceus369: raises €0.04 to €0.06
SebaRapy14: folds 
AlwaisToRun: folds 
Allino29: folds 
stev@nin: folds 
SaTheNuts_77: folds 
Uncalled bet (€0.04) returned to caduceus369
caduceus369 collected €0.05 from pot
caduceus369: doesn't show hand 
*** SUMMARY ***
Total pot €0.05 | Rake €0 
Seat 1: Allino29 (button) folded before Flop (didn't bet)
Seat 2: stev@nin (small blind) folded before Flop
Seat 3: SaTheNuts_77 (big blind) folded before Flop
Seat 4: caduceus369 collected (€0.05)
Seat 5: SebaRapy14 folded before Flop (didn't bet)
Seat 6: AlwaisToRun folded before Flop (didn't bet)



PokerStars Zoom Hand #258039513685:  Hold'em No Limit (€0.01/€0.02) [ADM ID: M62C03044AE79CRJ] - 2025/10/08 0:16:03 CET [2025/10/07 18:16:03 ET]
Table 'Sirio' 6-max Seat #1 is the button
Seat 1: caduceus369 (€4.68 in chips) 
Seat 2: nikolor (€2.03 in chips) 
Seat 3: Allino29 (€2.27 in chips) 
Seat 4: SaTheNuts_77 (€1.09 in chips) 
Seat 5: pistaKKio23 (€3.48 in chips) 
Seat 6: rw01yk (€0.35 in chips) 
nikolor: posts small blind €0.01
Allino29: posts big blind €0.02
*** HOLE CARDS ***
Dealt to caduceus369 [6d Js]
SaTheNuts_77: folds 
pistaKKio23: folds 
rw01yk: folds 
caduceus369: folds 
nikolor: folds 
Uncalled bet (€0.01) returned to Allino29
Allino29 collected €0.02 from pot
Allino29: doesn't show hand 
*** SUMMARY ***
Total pot €0.02 | Rake €0 
Seat 1: caduceus369 (button) folded before Flop (didn't bet)
Seat 2: nikolor (small blind) folded before Flop
Seat 3: Allino29 (big blind) collected (€0.02)
Seat 4: SaTheNuts_77 folded before Flop (didn't bet)
Seat 5: pistaKKio23 folded before Flop (didn't bet)
Seat 6: rw01yk folded before Flop (didn't bet)



PokerStars Zoom Hand #258039509552:  Hold'em No Limit (€0.01/€0.02) [ADM ID: M62C03044AE79CRJ] - 2025/10/08 0:15:44 CET [2025/10/07 18:15:44 ET]
Table 'Sirio' 6-max Seat #1 is the button
Seat 1: SaTheNuts_77 (€1.09 in chips) 
Seat 2: caduceus369 (€4.69 in chips) 
Seat 3: Naan79 (€1.98 in chips) 
Seat 4: stev@nin (€4.54 in chips) 
Seat 5: QUATTRODAME (€1.32 in chips) 
Seat 6: pistaKKio23 (€6.04 in chips) 
caduceus369: posts small blind €0.01
Naan79: posts big blind €0.02
*** HOLE CARDS ***
Dealt to caduceus369 [5c 7s]
stev@nin: raises €0.04 to €0.06
QUATTRODAME: folds 
pistaKKio23: folds 
SaTheNuts_77: folds 
caduceus369: folds 
Naan79: raises €0.16 to €0.22
stev@nin: raises €0.47 to €0.69
Naan79: folds 
Uncalled bet (€0.47) returned to stev@nin
stev@nin collected €0.45 from pot
stev@nin: doesn't show hand 
*** SUMMARY ***
Total pot €0.45 | Rake €0 
Seat 1: SaTheNuts_77 (button) folded before Flop (didn't bet)
Seat 2: caduceus369 (small blind) folded before Flop
Seat 3: Naan79 (big blind) folded before Flop
Seat 4: stev@nin collected (€0.45)
Seat 5: QUATTRODAME folded before Flop (didn't bet)
Seat 6: pistaKKio23 folded before Flop (didn't bet)



PokerStars Zoom Hand #258039516173:  Hold'em No Limit (€0.01/€0.02) [ADM ID: M62C03044AE79CRJ] - 2025/10/08 0:16:15 CET [2025/10/07 18:16:15 ET]
Table 'Sirio' 6-max Seat #1 is the button
Seat 1: SaTheNuts_77 (€1.08 in chips) 
Seat 2: Gaboops (€2.11 in chips) 
Seat 3: scannabue212 (€1.36 in chips) 
Seat 4: Genny040893 (€0.46 in chips) 
Seat 5: Sobolanumm (€0.89 in chips) 
Seat 6: caduceus369 (€4.68 in chips) 
Gaboops: posts small blind €0.01
scannabue212: posts big blind €0.02
*** HOLE CARDS ***
Dealt to caduceus369 [6h Ts]
Genny040893: raises €0.06 to €0.08
Sobolanumm: folds 
caduceus369: folds 
SaTheNuts_77: folds 
Gaboops: folds 
scannabue212: folds 
Uncalled bet (€0.06) returned to Genny040893
Genny040893 collected €0.05 from pot
Genny040893: doesn't show hand 
*** SUMMARY ***
Total pot €0.05 | Rake €0 
Seat 1: SaTheNuts_77 (button) folded before Flop (didn't bet)
Seat 2: Gaboops (small blind) folded before Flop
Seat 3: scannabue212 (big blind) folded before Flop
Seat 4: Genny040893 collected (€0.05)
Seat 5: Sobolanumm folded before Flop (didn't bet)
Seat 6: caduceus369 folded before Flop (didn't bet)



PokerStars Zoom Hand #258039519126:  Hold'em No Limit (€0.01/€0.02) [ADM ID: M62C03044AE79CRJ] - 2025/10/08 0:16:29 CET [2025/10/07 18:16:29 ET]
Table 'Sirio' 6-max Seat #1 is the button
Seat 1: Naan79 (€1.76 in chips) 
Seat 2: SebaRapy14 (€3.25 in chips) 
Seat 3: AlwaisToRun (€0.69 in chips) 
Seat 4: fantaasso (€0.80 in chips) 
Seat 5: caduceus369 (€4.68 in chips) 
Seat 6: SaTheNuts_77 (€1.06 in chips) 
SebaRapy14: posts small blind €0.01
AlwaisToRun: posts big blind €0.02
*** HOLE CARDS ***
Dealt to caduceus369 [8d 4c]
fantaasso: folds 
caduceus369: folds 
SaTheNuts_77: folds 
Naan79: folds 
SebaRapy14: raises €0.04 to €0.06
AlwaisToRun: folds 
Uncalled bet (€0.04) returned to SebaRapy14
SebaRapy14 collected €0.04 from pot
SebaRapy14: doesn't show hand 
*** SUMMARY ***
Total pot €0.04 | Rake €0 
Seat 1: Naan79 (button) folded before Flop (didn't bet)
Seat 2: SebaRapy14 (small blind) collected (€0.04)
Seat 3: AlwaisToRun (big blind) folded before Flop
Seat 4: fantaasso folded before Flop (didn't bet)
Seat 5: caduceus369 folded before Flop (didn't bet)
Seat 6: SaTheNuts_77 folded before Flop (didn't bet)



PokerStars Zoom Hand #258039521035:  Hold'em No Limit (€0.01/€0.02) [ADM ID: M62C03044AE79CRJ] - 2025/10/08 0:16:38 CET [2025/10/07 18:16:38 ET]
Table 'Sirio' 6-max Seat #1 is the button
Seat 1: fantaasso (€0.80 in chips) 
Seat 2: mashallahh (€3.05 in chips) 
Seat 3: robertoH2O (€3.55 in chips) 
Seat 4: caduceus369 (€4.68 in chips) 
Seat 5: pistaKKio23 (€4.40 in chips) 
Seat 6: SebaRapy14 (€7.41 in chips) 
mashallahh: posts small blind €0.01
robertoH2O: posts big blind €0.02
*** HOLE CARDS ***
Dealt to caduceus369 [3h 9d]
caduceus369: folds 
pistaKKio23: folds 
SebaRapy14: raises €0.04 to €0.06
fantaasso: folds 
mashallahh: folds 
robertoH2O: folds 
Uncalled bet (€0.04) returned to SebaRapy14
SebaRapy14 collected €0.05 from pot
SebaRapy14: doesn't show hand 
*** SUMMARY ***
Total pot €0.05 | Rake €0 
Seat 1: fantaasso (button) folded before Flop (didn't bet)
Seat 2: mashallahh (small blind) folded before Flop
Seat 3: robertoH2O (big blind) folded before Flop
Seat 4: caduceus369 folded before Flop (didn't bet)
Seat 5: pistaKKio23 folded before Flop (didn't bet)
Seat 6: SebaRapy14 collected (€0.05)



PokerStars Zoom Hand #258039522222:  Hold'em No Limit (€0.01/€0.02) [ADM ID: M62C03044AE79CRJ] - 2025/10/08 0:16:44 CET [2025/10/07 18:16:44 ET]
Table 'Sirio' 6-max Seat #1 is the button
Seat 1: pistaKKio23 (€1.90 in chips) 
Seat 2: mashallahh (€7.80 in chips) 
Seat 3: caduceus369 (€4.68 in chips) 
Seat 4: pallagorio (€1.80 in chips) 
Seat 5: Sobolanumm (€0.96 in chips) 
Seat 6: ADRIAN0_MEIS (€22.75 in chips) 
mashallahh: posts small blind €0.01
caduceus369: posts big blind €0.02
*** HOLE CARDS ***
Dealt to caduceus369 [3d Th]
pallagorio: folds 
Sobolanumm: folds 
ADRIAN0_MEIS: folds 
pistaKKio23: raises €0.02 to €0.04
mashallahh: folds 
caduceus369: folds 
Uncalled bet (€0.02) returned to pistaKKio23
pistaKKio23 collected €0.05 from pot
pistaKKio23: doesn't show hand 
*** SUMMARY ***
Total pot €0.05 | Rake €0 
Seat 1: pistaKKio23 (button) collected (€0.05)
Seat 2: mashallahh (small blind) folded before Flop
Seat 3: caduceus369 (big blind) folded before Flop
Seat 4: pallagorio folded before Flop (didn't bet)
Seat 5: Sobolanumm folded before Flop (didn't bet)
Seat 6: ADRIAN0_MEIS folded before Flop (didn't bet)



PokerStars Zoom Hand #258039526603:  Hold'em No Limit (€0.01/€0.02) [ADM ID: M62C03044AE79CRJ] - 2025/10/08 0:17:05 CET [2025/10/07 18:17:05 ET]
Table 'Sirio' 6-max Seat #1 is the button
Seat 1: rw01yk (€0.42 in chips) 
Seat 2: Naan79 (€1.70 in chips) 
Seat 3: fantaasso (€0.79 in chips) 
Seat 4: QUATTRODAME (€1.31 in chips) 
Seat 5: caduceus369 (€4.66 in chips) 
Seat 6: robertoH2O (€3.53 in chips) 
Naan79: posts small blind €0.01
fantaasso: posts big blind €0.02
*** HOLE CARDS ***
Dealt to caduceus369 [2c As]
QUATTRODAME: folds 
caduceus369: folds 
robertoH2O: folds 
rw01yk: raises €0.40 to €0.42 and is all-in
Naan79: folds 
fantaasso: calls €0.40
*** FLOP *** [Qd 6c 3d]
*** TURN *** [Qd 6c 3d] [2s]
*** RIVER *** [Qd 6c 3d 2s] [Qh]
*** SHOW DOWN ***
fantaasso: shows [Ad Jc] (a pair of Queens)
rw01yk: shows [Js 9h] (a pair of Queens - lower kicker)
fantaasso collected €0.81 from pot
*** SUMMARY ***
Total pot €0.85 | Rake €0.04 
Board [Qd 6c 3d 2s Qh]
Seat 1: rw01yk (button) showed [Js 9h] and lost with a pair of Queens
Seat 2: Naan79 (small blind) folded before Flop
Seat 3: fantaasso (big blind) showed [Ad Jc] and won (€0.81) with a pair of Queens
Seat 4: QUATTRODAME folded before Flop (didn't bet)
Seat 5: caduceus369 folded before Flop (didn't bet)
Seat 6: robertoH2O folded before Flop (didn't bet)



PokerStars Zoom Hand #258039528062:  Hold'em No Limit (€0.01/€0.02) [ADM ID: M62C03044AE79CRJ] - 2025/10/08 0:17:12 CET [2025/10/07 18:17:12 ET]
Table 'Sirio' 6-max Seat #1 is the button
Seat 1: mondie73100 (€4.75 in chips) 
Seat 2: caduceus369 (€4.66 in chips) 
Seat 3: QUATTRODAME (€1.31 in chips) 
Seat 4: ADRIAN0_MEIS (€22.75 in chips) 
Seat 5: mashallahh (€2.11 in chips) 
Seat 6: IlDestro71 (€0.84 in chips) 
caduceus369: posts small blind €0.01
QUATTRODAME: posts big blind €0.02
*** HOLE CARDS ***
Dealt to caduceus369 [Js 6s]
ADRIAN0_MEIS: folds 
mashallahh: folds 
IlDestro71: calls €0.02
mondie73100: folds 
caduceus369: calls €0.01
QUATTRODAME: raises €1.29 to €1.31 and is all-in
IlDestro71: folds 
caduceus369: folds 
Uncalled bet (€1.29) returned to QUATTRODAME
QUATTRODAME collected €0.06 from pot
QUATTRODAME: doesn't show hand 
*** SUMMARY ***
Total pot €0.06 | Rake €0 
Seat 1: mondie73100 (button) folded before Flop (didn't bet)
Seat 2: caduceus369 (small blind) folded before Flop
Seat 3: QUATTRODAME (big blind) collected (€0.06)
Seat 4: ADRIAN0_MEIS folded before Flop (didn't bet)
Seat 5: mashallahh folded before Flop (didn't bet)
Seat 6: IlDestro71 folded before Flop



PokerStars Zoom Hand #258039534047:  Hold'em No Limit (€0.01/€0.02) [ADM ID: M62C03044AE79CRJ] - 2025/10/08 0:17:41 CET [2025/10/07 18:17:41 ET]
Table 'Sirio' 6-max Seat #1 is the button
Seat 1: A_LUCCHESE_92 (€5.21 in chips) 
Seat 2: IlDestro71 (€0.82 in chips) 
Seat 3: SaTheNuts_77 (€1.04 in chips) 
Seat 4: caduceus369 (€4.64 in chips) 
Seat 5: mashallahh (€7.80 in chips) 
Seat 6: mondie73100 (€4.74 in chips) 
IlDestro71: posts small blind €0.01
SaTheNuts_77: posts big blind €0.02
*** HOLE CARDS ***
Dealt to caduceus369 [5c 7s]
caduceus369: folds 
mashallahh: folds 
mondie73100: folds 
A_LUCCHESE_92: folds 
IlDestro71: calls €0.01
SaTheNuts_77: raises €0.06 to €0.08
IlDestro71: folds 
Uncalled bet (€0.06) returned to SaTheNuts_77
SaTheNuts_77 collected €0.04 from pot
SaTheNuts_77: doesn't show hand 
*** SUMMARY ***
Total pot €0.04 | Rake €0 
Seat 1: A_LUCCHESE_92 (button) folded before Flop (didn't bet)
Seat 2: IlDestro71 (small blind) folded before Flop
Seat 3: SaTheNuts_77 (big blind) collected (€0.04)
Seat 4: caduceus369 folded before Flop (didn't bet)
Seat 5: mashallahh folded before Flop (didn't bet)
Seat 6: mondie73100 folded before Flop (didn't bet)



PokerStars Zoom Hand #258039535344:  Hold'em No Limit (€0.01/€0.02) [ADM ID: M62C03044AE79CRJ] - 2025/10/08 0:17:46 CET [2025/10/07 18:17:46 ET]
Table 'Sirio' 6-max Seat #1 is the button
Seat 1: caduceus369 (€4.64 in chips) 
Seat 2: pistaKKio23 (€3.45 in chips) 
Seat 3: fantaasso (€1.18 in chips) 
Seat 4: mondie73100 (€3.20 in chips) 
Seat 5: vesper622 (€2.15 in chips) 
Seat 6: robertoH2O (€3.50 in chips) 
pistaKKio23: posts small blind €0.01
fantaasso: posts big blind €0.02
*** HOLE CARDS ***
Dealt to caduceus369 [4d 7c]
mondie73100: raises €0.04 to €0.06
vesper622: folds 
robertoH2O: folds 
caduceus369: folds 
pistaKKio23: folds 
fantaasso: folds 
Uncalled bet (€0.04) returned to mondie73100
mondie73100 collected €0.05 from pot
mondie73100: doesn't show hand 
*** SUMMARY ***
Total pot €0.05 | Rake €0 
Seat 1: caduceus369 (button) folded before Flop (didn't bet)
Seat 2: pistaKKio23 (small blind) folded before Flop
Seat 3: fantaasso (big blind) folded before Flop
Seat 4: mondie73100 collected (€0.05)
Seat 5: vesper622 folded before Flop (didn't bet)
Seat 6: robertoH2O folded before Flop (didn't bet)



PokerStars Zoom Hand #258039536651:  Hold'em No Limit (€0.01/€0.02) [ADM ID: M62C03044AE79CRJ] - 2025/10/08 0:17:53 CET [2025/10/07 18:17:53 ET]
Table 'Sirio' 6-max Seat #1 is the button
Seat 1: robertoH2O (€3.50 in chips) 
Seat 2: QUATTRODAME (€1.35 in chips) 
Seat 3: pallagorio (€1.68 in chips) 
Seat 4: ADRIAN0_MEIS (€22.72 in chips) 
Seat 5: mashallahh (€5.03 in chips) 
Seat 6: caduceus369 (€4.64 in chips) 
QUATTRODAME: posts small blind €0.01
pallagorio: posts big blind €0.02
*** HOLE CARDS ***
Dealt to caduceus369 [Ks Jh]
ADRIAN0_MEIS: folds 
mashallahh: folds 
caduceus369: raises €0.04 to €0.06
robertoH2O: folds 
QUATTRODAME: folds 
pallagorio: calls €0.04
*** FLOP *** [4c Qh 9h]
pallagorio: checks 
caduceus369: bets €0.05
pallagorio is disconnected 
pallagorio has timed out while disconnected
pallagorio: folds 
Uncalled bet (€0.05) returned to caduceus369
caduceus369 collected €0.13 from pot
caduceus369: doesn't show hand 
*** SUMMARY ***
Total pot €0.13 | Rake €0 
Board [4c Qh 9h]
Seat 1: robertoH2O (button) folded before Flop (didn't bet)
Seat 2: QUATTRODAME (small blind) folded before Flop
Seat 3: pallagorio (big blind) folded on the Flop
Seat 4: ADRIAN0_MEIS folded before Flop (didn't bet)
Seat 5: mashallahh folded before Flop (didn't bet)
Seat 6: caduceus369 collected (€0.13)



PokerStars Zoom Hand #258039552316:  Hold'em No Limit (€0.01/€0.02) [ADM ID: M62C03044AE79CRJ] - 2025/10/08 0:19:08 CET [2025/10/07 18:19:08 ET]
Table 'Sirio' 6-max Seat #1 is the button
Seat 1: stev@nin (€6.30 in chips) 
Seat 2: ADRIAN0_MEIS (€22.79 in chips) 
Seat 3: AlwaisToRun (€0.91 in chips) 
Seat 4: caduceus369 (€4.71 in chips) 
Seat 5: pistaKKio23 (€5.95 in chips) 
Seat 6: mashallahh (€5 in chips) 
ADRIAN0_MEIS: posts small blind €0.01
AlwaisToRun: posts big blind €0.02
*** HOLE CARDS ***
Dealt to caduceus369 [2d Tc]
caduceus369: folds 
pistaKKio23: folds 
mashallahh: folds 
stev@nin: folds 
ADRIAN0_MEIS: folds 
Uncalled bet (€0.01) returned to AlwaisToRun
AlwaisToRun collected €0.02 from pot
AlwaisToRun: doesn't show hand 
*** SUMMARY ***
Total pot €0.02 | Rake €0 
Seat 1: stev@nin (button) folded before Flop (didn't bet)
Seat 2: ADRIAN0_MEIS (small blind) folded before Flop
Seat 3: AlwaisToRun (big blind) collected (€0.02)
Seat 4: caduceus369 folded before Flop (didn't bet)
Seat 5: pistaKKio23 folded before Flop (didn't bet)
Seat 6: mashallahh folded before Flop (didn't bet)



PokerStars Zoom Hand #258039558594:  Hold'em No Limit (€0.01/€0.02) [ADM ID: M62C03044AE79CRJ] - 2025/10/08 0:19:38 CET [2025/10/07 18:19:38 ET]
Table 'Sirio' 6-max Seat #1 is the button
Seat 1: mashallahh (€2.08 in chips) 
Seat 2: caduceus369 (€4.69 in chips) 
Seat 3: IlDestro71 (€0.82 in chips) 
Seat 4: nikolor (€2.30 in chips) 
Seat 5: pistaKKio23 (€5.93 in chips) 
caduceus369: posts small blind €0.01
IlDestro71: posts big blind €0.02
*** HOLE CARDS ***
Dealt to caduceus369 [2c Th]
nikolor: folds 
pistaKKio23: folds 
mashallahh: folds 
caduceus369: folds 
Uncalled bet (€0.01) returned to IlDestro71
IlDestro71 collected €0.02 from pot
IlDestro71: doesn't show hand 
*** SUMMARY ***
Total pot €0.02 | Rake €0 
Seat 1: mashallahh (button) folded before Flop (didn't bet)
Seat 2: caduceus369 (small blind) folded before Flop
Seat 3: IlDestro71 (big blind) collected (€0.02)
Seat 4: nikolor folded before Flop (didn't bet)
Seat 5: pistaKKio23 folded before Flop (didn't bet)



PokerStars Zoom Hand #258039560465:  Hold'em No Limit (€0.01/€0.02) [ADM ID: M62C03044AE79CRJ] - 2025/10/08 0:19:47 CET [2025/10/07 18:19:47 ET]
Table 'Sirio' 6-max Seat #1 is the button
Seat 1: caduceus369 (€4.68 in chips) 
Seat 2: pistaKKio23 (€5.93 in chips) 
Seat 3: nikolor (€2.30 in chips) 
Seat 4: mashallahh (€2.08 in chips) 
Seat 5: mondie73100 (€3.21 in chips) 
pistaKKio23: posts small blind €0.01
nikolor: posts big blind €0.02
*** HOLE CARDS ***
Dealt to caduceus369 [Ah Ts]
mashallahh: raises €0.04 to €0.06
mondie73100: folds 
caduceus369: folds 
pistaKKio23: folds 
nikolor: folds 
Uncalled bet (€0.04) returned to mashallahh
mashallahh collected €0.05 from pot
mashallahh: doesn't show hand 
*** SUMMARY ***
Total pot €0.05 | Rake €0 
Seat 1: caduceus369 (button) folded before Flop (didn't bet)
Seat 2: pistaKKio23 (small blind) folded before Flop
Seat 3: nikolor (big blind) folded before Flop
Seat 4: mashallahh collected (€0.05)
Seat 5: mondie73100 folded before Flop (didn't bet)



PokerStars Zoom Hand #258039553273:  Hold'em No Limit (€0.01/€0.02) [ADM ID: M62C03044AE79CRJ] - 2025/10/08 0:19:13 CET [2025/10/07 18:19:13 ET]
Table 'Sirio' 6-max Seat #1 is the button
Seat 1: nikolor (€1.91 in chips) 
Seat 2: stev@nin (€6.30 in chips) 
Seat 3: caduceus369 (€4.71 in chips) 
Seat 4: fantaasso (€1.32 in chips) 
Seat 5: sebaparhasar84 (€1.95 in chips) 
stev@nin: posts small blind €0.01
caduceus369: posts big blind €0.02
*** HOLE CARDS ***
Dealt to caduceus369 [8s Kc]
fantaasso: folds 
sebaparhasar84: calls €0.02
nikolor: raises €0.04 to €0.06
stev@nin: calls €0.05
caduceus369: folds 
sebaparhasar84: calls €0.04
*** FLOP *** [Qc 3d 4s]
stev@nin: checks 
sebaparhasar84: checks 
nikolor: bets €0.10
stev@nin: folds 
sebaparhasar84: folds 
Uncalled bet (€0.10) returned to nikolor
nikolor collected €0.19 from pot
nikolor: doesn't show hand 
*** SUMMARY ***
Total pot €0.20 | Rake €0.01 
Board [Qc 3d 4s]
Seat 1: nikolor (button) collected (€0.19)
Seat 2: stev@nin (small blind) folded on the Flop
Seat 3: caduceus369 (big blind) folded before Flop
Seat 4: fantaasso folded before Flop (didn't bet)
Seat 5: sebaparhasar84 folded on the Flop



PokerStars Zoom Hand #258039565304:  Hold'em No Limit (€0.01/€0.02) [ADM ID: M62C03044AE79CRJ] - 2025/10/08 0:20:09 CET [2025/10/07 18:20:09 ET]
Table 'Sirio' 6-max Seat #1 is the button
Seat 1: nikolor (€2.28 in chips) 
Seat 2: fantaasso (€1.30 in chips) 
Seat 3: QUATTRODAME (€1.31 in chips) 
Seat 4: pistaKKio23 (€3.69 in chips) 
Seat 5: caduceus369 (€4.68 in chips) 
Seat 6: mashallahh (€2.88 in chips) 
fantaasso: posts small blind €0.01
QUATTRODAME: posts big blind €0.02
*** HOLE CARDS ***
Dealt to caduceus369 [6c As]
pistaKKio23: folds 
caduceus369: folds 
mashallahh: folds 
nikolor: folds 
fantaasso: folds 
Uncalled bet (€0.01) returned to QUATTRODAME
QUATTRODAME collected €0.02 from pot
QUATTRODAME: doesn't show hand 
*** SUMMARY ***
Total pot €0.02 | Rake €0 
Seat 1: nikolor (button) folded before Flop (didn't bet)
Seat 2: fantaasso (small blind) folded before Flop
Seat 3: QUATTRODAME (big blind) collected (€0.02)
Seat 4: pistaKKio23 folded before Flop (didn't bet)
Seat 5: caduceus369 folded before Flop (didn't bet)
Seat 6: mashallahh folded before Flop (didn't bet)



PokerStars Zoom Hand #258039563688:  Hold'em No Limit (€0.01/€0.02) [ADM ID: M62C03044AE79CRJ] - 2025/10/08 0:20:02 CET [2025/10/07 18:20:02 ET]
Table 'Sirio' 6-max Seat #1 is the button
Seat 1: caduceus369 (€4.68 in chips) 
Seat 2: mondie73100 (€4.67 in chips) 
Seat 3: Sobolanumm (€0.75 in chips) 
Seat 4: SaTheNuts_77 (€1 in chips) 
Seat 5: mashallahh (€2.88 in chips) 
mondie73100: posts small blind €0.01
Sobolanumm: posts big blind €0.02
*** HOLE CARDS ***
Dealt to caduceus369 [3d 2c]
SaTheNuts_77: raises €0.03 to €0.05
mashallahh: folds 
caduceus369: folds 
mondie73100: folds 
Sobolanumm: folds 
Uncalled bet (€0.03) returned to SaTheNuts_77
SaTheNuts_77 collected €0.05 from pot
SaTheNuts_77: doesn't show hand 
*** SUMMARY ***
Total pot €0.05 | Rake €0 
Seat 1: caduceus369 (button) folded before Flop (didn't bet)
Seat 2: mondie73100 (small blind) folded before Flop
Seat 3: Sobolanumm (big blind) folded before Flop
Seat 4: SaTheNuts_77 collected (€0.05)
Seat 5: mashallahh folded before Flop (didn't bet)



PokerStars Zoom Hand #258039568684:  Hold'em No Limit (€0.01/€0.02) [ADM ID: M62C03044AE79CRJ] - 2025/10/08 0:20:25 CET [2025/10/07 18:20:25 ET]
Table 'Sirio' 6-max Seat #1 is the button
Seat 1: scannabue212 (€1.42 in chips) 
Seat 2: pistaKKio23 (€1.89 in chips) 
Seat 3: caduceus369 (€4.67 in chips) 
Seat 4: fantaasso (€1.29 in chips) 
Seat 5: QUATTRODAME (€1.32 in chips) 
Seat 6: mashallahh (€2.10 in chips) 
pistaKKio23: posts small blind €0.01
caduceus369: posts big blind €0.02
*** HOLE CARDS ***
Dealt to caduceus369 [Kh Td]
fantaasso: folds 
QUATTRODAME: folds 
mashallahh: folds 
scannabue212: folds 
pistaKKio23: calls €0.01
caduceus369: checks 
*** FLOP *** [6s Jd Ks]
pistaKKio23: checks 
caduceus369: bets €0.02
pistaKKio23: folds 
Uncalled bet (€0.02) returned to caduceus369
caduceus369 collected €0.04 from pot
caduceus369: doesn't show hand 
*** SUMMARY ***
Total pot €0.04 | Rake €0 
Board [6s Jd Ks]
Seat 1: scannabue212 (button) folded before Flop (didn't bet)
Seat 2: pistaKKio23 (small blind) folded on the Flop
Seat 3: caduceus369 (big blind) collected (€0.04)
Seat 4: fantaasso folded before Flop (didn't bet)
Seat 5: QUATTRODAME folded before Flop (didn't bet)
Seat 6: mashallahh folded before Flop (didn't bet)



PokerStars Zoom Hand #258039566316:  Hold'em No Limit (€0.01/€0.02) [ADM ID: M62C03044AE79CRJ] - 2025/10/08 0:20:14 CET [2025/10/07 18:20:14 ET]
Table 'Sirio' 6-max Seat #1 is the button
Seat 1: fantaasso (€1.29 in chips) 
Seat 2: robertoH2O (€3.42 in chips) 
Seat 3: mashallahh (€2.88 in chips) 
Seat 4: caduceus369 (€4.68 in chips) 
Seat 5: pistaKKio23 (€3.69 in chips) 
Seat 6: IlDestro71 (€0.82 in chips) 
robertoH2O: posts small blind €0.01
mashallahh: posts big blind €0.02
*** HOLE CARDS ***
Dealt to caduceus369 [Ts 9h]
caduceus369: folds 
pistaKKio23: folds 
IlDestro71: calls €0.02
fantaasso: folds 
robertoH2O: raises €0.06 to €0.08
mashallahh: folds 
IlDestro71: calls €0.06
*** FLOP *** [Qc 8h Qs]
robertoH2O: checks 
IlDestro71: checks 
*** TURN *** [Qc 8h Qs] [9s]
robertoH2O: bets €0.09
IlDestro71: calls €0.09
*** RIVER *** [Qc 8h Qs 9s] [8d]
robertoH2O: checks 
IlDestro71: bets €0.12
robertoH2O: folds 
Uncalled bet (€0.12) returned to IlDestro71
IlDestro71 collected €0.35 from pot
IlDestro71: doesn't show hand 
*** SUMMARY ***
Total pot €0.36 | Rake €0.01 
Board [Qc 8h Qs 9s 8d]
Seat 1: fantaasso (button) folded before Flop (didn't bet)
Seat 2: robertoH2O (small blind) folded on the River
Seat 3: mashallahh (big blind) folded before Flop
Seat 4: caduceus369 folded before Flop (didn't bet)
Seat 5: pistaKKio23 folded before Flop (didn't bet)
Seat 6: IlDestro71 collected (€0.35)



PokerStars Zoom Hand #258039567364:  Hold'em No Limit (€0.01/€0.02) [ADM ID: M62C03044AE79CRJ] - 2025/10/08 0:20:19 CET [2025/10/07 18:20:19 ET]
Table 'Sirio' 6-max Seat #1 is the button
Seat 1: mondie73100 (€4.66 in chips) 
Seat 2: caduceus369 (€4.68 in chips) 
Seat 3: stev@nin (€6.24 in chips) 
Seat 4: vesper622 (€2.28 in chips) 
Seat 5: ADRIAN0_MEIS (€22.79 in chips) 
Seat 6: fantaasso (€1.29 in chips) 
caduceus369: posts small blind €0.01
stev@nin: posts big blind €0.02
*** HOLE CARDS ***
Dealt to caduceus369 [4s Qh]
vesper622: folds 
ADRIAN0_MEIS: folds 
fantaasso: folds 
mondie73100: raises €0.04 to €0.06
caduceus369: folds 
stev@nin: raises €0.15 to €0.21
mondie73100: raises €0.43 to €0.64
stev@nin: folds 
Uncalled bet (€0.43) returned to mondie73100
mondie73100 collected €0.43 from pot
mondie73100: doesn't show hand 
*** SUMMARY ***
Total pot €0.43 | Rake €0 
Seat 1: mondie73100 (button) collected (€0.43)
Seat 2: caduceus369 (small blind) folded before Flop
Seat 3: stev@nin (big blind) folded before Flop
Seat 4: vesper622 folded before Flop (didn't bet)
Seat 5: ADRIAN0_MEIS folded before Flop (didn't bet)
Seat 6: fantaasso folded before Flop (didn't bet)



PokerStars Zoom Hand #258039576298:  Hold'em No Limit (€0.01/€0.02) [ADM ID: M62C03044AE79CRJ] - 2025/10/08 0:21:01 CET [2025/10/07 18:21:01 ET]
Table 'Sirio' 6-max Seat #1 is the button
Seat 1: mondie73100 (€2.79 in chips) 
Seat 2: fccmp (€0.78 in chips) 
Seat 3: sebaparhasar84 (€1.82 in chips) 
Seat 4: SaTheNuts_77 (€1 in chips) 
Seat 5: caduceus369 (€4.69 in chips) 
fccmp: posts small blind €0.01
sebaparhasar84: posts big blind €0.02
*** HOLE CARDS ***
Dealt to caduceus369 [4c Js]
SaTheNuts_77: raises €0.05 to €0.07
caduceus369: folds 
mondie73100: folds 
fccmp: folds 
sebaparhasar84: folds 
Uncalled bet (€0.05) returned to SaTheNuts_77
SaTheNuts_77 collected €0.05 from pot
SaTheNuts_77: doesn't show hand 
*** SUMMARY ***
Total pot €0.05 | Rake €0 
Seat 1: mondie73100 (button) folded before Flop (didn't bet)
Seat 2: fccmp (small blind) folded before Flop
Seat 3: sebaparhasar84 (big blind) folded before Flop
Seat 4: SaTheNuts_77 collected (€0.05)
Seat 5: caduceus369 folded before Flop (didn't bet)



PokerStars Zoom Hand #258039577313:  Hold'em No Limit (€0.01/€0.02) [ADM ID: M62C03044AE79CRJ] - 2025/10/08 0:21:06 CET [2025/10/07 18:21:06 ET]
Table 'Sirio' 6-max Seat #1 is the button
Seat 1: pistaKKio23 (€1.87 in chips) 
Seat 2: mashallahh (€4.94 in chips) 
Seat 3: caduceus369 (€4.69 in chips) 
Seat 4: fccmp (€0.77 in chips) 
Seat 5: IlDestro71 (€1 in chips) 
mashallahh: posts small blind €0.01
caduceus369: posts big blind €0.02
*** HOLE CARDS ***
Dealt to caduceus369 [4d 2h]
fccmp: folds 
IlDestro71: calls €0.02
pistaKKio23: folds 
mashallahh: folds 
caduceus369: checks 
*** FLOP *** [Jc 9c 5s]
caduceus369: checks 
IlDestro71: checks 
*** TURN *** [Jc 9c 5s] [6d]
caduceus369: bets €0.02
IlDestro71: folds 
Uncalled bet (€0.02) returned to caduceus369
caduceus369 collected €0.05 from pot
caduceus369: doesn't show hand 
*** SUMMARY ***
Total pot €0.05 | Rake €0 
Board [Jc 9c 5s 6d]
Seat 1: pistaKKio23 (button) folded before Flop (didn't bet)
Seat 2: mashallahh (small blind) folded before Flop
Seat 3: caduceus369 (big blind) collected (€0.05)
Seat 4: fccmp folded before Flop (didn't bet)
Seat 5: IlDestro71 folded on the Turn



PokerStars Zoom Hand #258039587511:  Hold'em No Limit (€0.01/€0.02) [ADM ID: M62C03044AE79CRJ] - 2025/10/08 0:21:54 CET [2025/10/07 18:21:54 ET]
Table 'Sirio' 6-max Seat #1 is the button
Seat 1: mondie73100 (€4.89 in chips) 
Seat 2: caduceus369 (€4.72 in chips) 
Seat 3: vesper622 (€2.36 in chips) 
Seat 4: pistaKKio23 (€5.99 in chips) 
Seat 5: sebaparhasar84 (€1.80 in chips) 
caduceus369: posts small blind €0.01
vesper622: posts big blind €0.02
*** HOLE CARDS ***
Dealt to caduceus369 [7h Tc]
pistaKKio23: folds 
sebaparhasar84: folds 
mondie73100: folds 
caduceus369: folds 
Uncalled bet (€0.01) returned to vesper622
vesper622 collected €0.02 from pot
vesper622: doesn't show hand 
*** SUMMARY ***
Total pot €0.02 | Rake €0 
Seat 1: mondie73100 (button) folded before Flop (didn't bet)
Seat 2: caduceus369 (small blind) folded before Flop
Seat 3: vesper622 (big blind) collected (€0.02)
Seat 4: pistaKKio23 folded before Flop (didn't bet)
Seat 5: sebaparhasar84 folded before Flop (didn't bet)



PokerStars Zoom Hand #258039584845:  Hold'em No Limit (€0.01/€0.02) [ADM ID: M62C03044AE79CRJ] - 2025/10/08 0:21:42 CET [2025/10/07 18:21:42 ET]
Table 'Sirio' 6-max Seat #1 is the button
Seat 1: AlwaisToRun (€0.79 in chips) 
Seat 2: fantaasso (€1.23 in chips) 
Seat 3: QUATTRODAME (€1.26 in chips) 
Seat 4: caduceus369 (€4.72 in chips) 
Seat 5: mondie73100 (€3.05 in chips) 
Seat 6: mashallahh (€4.93 in chips) 
fantaasso: posts small blind €0.01
QUATTRODAME: posts big blind €0.02
*** HOLE CARDS ***
Dealt to caduceus369 [7d Jc]
caduceus369: folds 
mondie73100: folds 
mashallahh: folds 
AlwaisToRun: calls €0.02
fantaasso: calls €0.01
QUATTRODAME: checks 
*** FLOP *** [2h 9d Qh]
fantaasso: checks 
QUATTRODAME: checks 
AlwaisToRun: bets €0.02
fantaasso: calls €0.02
QUATTRODAME: folds 
*** TURN *** [2h 9d Qh] [4h]
fantaasso: checks 
AlwaisToRun: bets €0.06
fantaasso: calls €0.06
*** RIVER *** [2h 9d Qh 4h] [5s]
fantaasso: bets €0.11
AlwaisToRun: folds 
Uncalled bet (€0.11) returned to fantaasso
fantaasso collected €0.21 from pot
fantaasso: doesn't show hand 
*** SUMMARY ***
Total pot €0.22 | Rake €0.01 
Board [2h 9d Qh 4h 5s]
Seat 1: AlwaisToRun (button) folded on the River
Seat 2: fantaasso (small blind) collected (€0.21)
Seat 3: QUATTRODAME (big blind) folded on the Flop
Seat 4: caduceus369 folded before Flop (didn't bet)
Seat 5: mondie73100 folded before Flop (didn't bet)
Seat 6: mashallahh folded before Flop (didn't bet)



PokerStars Zoom Hand #258039583726:  Hold'em No Limit (€0.01/€0.02) [ADM ID: M62C03044AE79CRJ] - 2025/10/08 0:21:37 CET [2025/10/07 18:21:37 ET]
Table 'Sirio' 6-max Seat #1 is the button
Seat 1: IlDestro71 (€0.98 in chips) 
Seat 2: pistaKKio23 (€3.89 in chips) 
Seat 3: ADRIAN0_MEIS (€22.90 in chips) 
Seat 4: mondie73100 (€3.05 in chips) 
Seat 5: A_LUCCHESE_92 (€5.10 in chips) 
Seat 6: caduceus369 (€4.72 in chips) 
pistaKKio23: posts small blind €0.01
ADRIAN0_MEIS: posts big blind €0.02
*** HOLE CARDS ***
Dealt to caduceus369 [2s Tc]
mondie73100: folds 
A_LUCCHESE_92: folds 
caduceus369: folds 
IlDestro71: calls €0.02
pistaKKio23: calls €0.01
ADRIAN0_MEIS: checks 
*** FLOP *** [5s 3s Td]
pistaKKio23: checks 
ADRIAN0_MEIS: checks 
IlDestro71: checks 
*** TURN *** [5s 3s Td] [2c]
pistaKKio23: checks 
ADRIAN0_MEIS: checks 
IlDestro71: checks 
*** RIVER *** [5s 3s Td 2c] [Ks]
pistaKKio23: checks 
ADRIAN0_MEIS: checks 
IlDestro71: bets €0.04
pistaKKio23: folds 
ADRIAN0_MEIS: folds 
Uncalled bet (€0.04) returned to IlDestro71
IlDestro71 collected €0.06 from pot
IlDestro71: doesn't show hand 
*** SUMMARY ***
Total pot €0.06 | Rake €0 
Board [5s 3s Td 2c Ks]
Seat 1: IlDestro71 (button) collected (€0.06)
Seat 2: pistaKKio23 (small blind) folded on the River
Seat 3: ADRIAN0_MEIS (big blind) folded on the River
Seat 4: mondie73100 folded before Flop (didn't bet)
Seat 5: A_LUCCHESE_92 folded before Flop (didn't bet)
Seat 6: caduceus369 folded before Flop (didn't bet)



PokerStars Zoom Hand #258039589232:  Hold'em No Limit (€0.01/€0.02) [ADM ID: M62C03044AE79CRJ] - 2025/10/08 0:22:03 CET [2025/10/07 18:22:03 ET]
Table 'Sirio' 6-max Seat #1 is the button
Seat 1: caduceus369 (€4.71 in chips) 
Seat 2: sebaparhasar84 (€1.80 in chips) 
Seat 3: Sobolanumm (€0.73 in chips) 
Seat 4: fccmp (€0.74 in chips) 
Seat 5: QUATTRODAME (€1.24 in chips) 
sebaparhasar84: posts small blind €0.01
Sobolanumm: posts big blind €0.02
*** HOLE CARDS ***
Dealt to caduceus369 [6s 6c]
fccmp: folds 
QUATTRODAME: folds 
caduceus369: raises €0.04 to €0.06
sebaparhasar84: folds 
Sobolanumm: calls €0.04
*** FLOP *** [2d 9c 7s]
Sobolanumm: checks 
caduceus369: checks 
*** TURN *** [2d 9c 7s] [2c]
Sobolanumm: checks 
caduceus369: bets €0.04
Sobolanumm: folds 
Uncalled bet (€0.04) returned to caduceus369
caduceus369 collected €0.13 from pot
caduceus369: doesn't show hand 
*** SUMMARY ***
Total pot €0.13 | Rake €0 
Board [2d 9c 7s 2c]
Seat 1: caduceus369 (button) collected (€0.13)
Seat 2: sebaparhasar84 (small blind) folded before Flop
Seat 3: Sobolanumm (big blind) folded on the Turn
Seat 4: fccmp folded before Flop (didn't bet)
Seat 5: QUATTRODAME folded before Flop (didn't bet)



PokerStars Zoom Hand #258039597157:  Hold'em No Limit (€0.01/€0.02) [ADM ID: M62C03044AE79CRJ] - 2025/10/08 0:22:40 CET [2025/10/07 18:22:40 ET]
Table 'Sirio' 6-max Seat #1 is the button
Seat 1: ADRIAN0_MEIS (€22.88 in chips) 
Seat 2: QUATTRODAME (€1.24 in chips) 
Seat 3: fccmp (€0.74 in chips) 
Seat 4: SaTheNuts_77 (€0.89 in chips) 
Seat 5: caduceus369 (€4.78 in chips) 
Seat 6: Sobolanumm (€0.80 in chips) 
QUATTRODAME: posts small blind €0.01
fccmp: posts big blind €0.02
*** HOLE CARDS ***
Dealt to caduceus369 [4d 8h]
SaTheNuts_77: folds 
caduceus369: folds 
Sobolanumm: raises €0.78 to €0.80 and is all-in
ADRIAN0_MEIS: folds 
QUATTRODAME: folds 
fccmp: folds 
Uncalled bet (€0.78) returned to Sobolanumm
Sobolanumm collected €0.05 from pot
Sobolanumm: doesn't show hand 
*** SUMMARY ***
Total pot €0.05 | Rake €0 
Seat 1: ADRIAN0_MEIS (button) folded before Flop (didn't bet)
Seat 2: QUATTRODAME (small blind) folded before Flop
Seat 3: fccmp (big blind) folded before Flop
Seat 4: SaTheNuts_77 folded before Flop (didn't bet)
Seat 5: caduceus369 folded before Flop (didn't bet)
Seat 6: Sobolanumm collected (€0.05)



PokerStars Zoom Hand #258039585794:  Hold'em No Limit (€0.01/€0.02) [ADM ID: M62C03044AE79CRJ] - 2025/10/08 0:21:46 CET [2025/10/07 18:21:46 ET]
Table 'Sirio' 6-max Seat #1 is the button
Seat 1: vesper622 (€2.36 in chips) 
Seat 2: nikolor (€2.14 in chips) 
Seat 3: A_LUCCHESE_92 (€5.10 in chips) 
Seat 4: mashallahh (€4.93 in chips) 
Seat 5: sebaparhasar84 (€1.80 in chips) 
Seat 6: caduceus369 (€4.72 in chips) 
nikolor: posts small blind €0.01
A_LUCCHESE_92: posts big blind €0.02
*** HOLE CARDS ***
Dealt to caduceus369 [7h 3c]
mashallahh: folds 
sebaparhasar84: folds 
caduceus369: folds 
vesper622: folds 
nikolor: calls €0.01
A_LUCCHESE_92: checks 
*** FLOP *** [Ac Qs 5c]
nikolor: checks 
A_LUCCHESE_92: checks 
*** TURN *** [Ac Qs 5c] [9d]
nikolor: checks 
A_LUCCHESE_92: checks 
*** RIVER *** [Ac Qs 5c 9d] [Qh]
nikolor: bets €0.02
A_LUCCHESE_92: calls €0.02
*** SHOW DOWN ***
nikolor: shows [Jh 5d] (two pair, Queens and Fives)
A_LUCCHESE_92: shows [Qd 2d] (three of a kind, Queens)
A_LUCCHESE_92 collected €0.08 from pot
*** SUMMARY ***
Total pot €0.08 | Rake €0 
Board [Ac Qs 5c 9d Qh]
Seat 1: vesper622 (button) folded before Flop (didn't bet)
Seat 2: nikolor (small blind) showed [Jh 5d] and lost with two pair, Queens and Fives
Seat 3: A_LUCCHESE_92 (big blind) showed [Qd 2d] and won (€0.08) with three of a kind, Queens
Seat 4: mashallahh folded before Flop (didn't bet)
Seat 5: sebaparhasar84 folded before Flop (didn't bet)
Seat 6: caduceus369 folded before Flop (didn't bet)



PokerStars Zoom Hand #258039598343:  Hold'em No Limit (€0.01/€0.02) [ADM ID: M62C03044AE79CRJ] - 2025/10/08 0:22:46 CET [2025/10/07 18:22:46 ET]
Table 'Sirio' 6-max Seat #1 is the button
Seat 1: mondie73100 (€3.01 in chips) 
Seat 2: SaTheNuts_77 (€0.89 in chips) 
Seat 3: QUATTRODAME (€1.23 in chips) 
Seat 4: Nabbox471 (€0.87 in chips) 
Seat 5: caduceus369 (€4.78 in chips) 
Seat 6: AlwaisToRun (€0.72 in chips) 
SaTheNuts_77: posts small blind €0.01
QUATTRODAME: posts big blind €0.02
*** HOLE CARDS ***
Dealt to caduceus369 [5d 8h]
Nabbox471: folds 
caduceus369: folds 
AlwaisToRun: folds 
mondie73100: folds 
SaTheNuts_77: folds 
Uncalled bet (€0.01) returned to QUATTRODAME
QUATTRODAME collected €0.02 from pot
QUATTRODAME: doesn't show hand 
*** SUMMARY ***
Total pot €0.02 | Rake €0 
Seat 1: mondie73100 (button) folded before Flop (didn't bet)
Seat 2: SaTheNuts_77 (small blind) folded before Flop
Seat 3: QUATTRODAME (big blind) collected (€0.02)
Seat 4: Nabbox471 folded before Flop (didn't bet)
Seat 5: caduceus369 folded before Flop (didn't bet)
Seat 6: AlwaisToRun folded before Flop (didn't bet)



PokerStars Zoom Hand #258039600948:  Hold'em No Limit (€0.01/€0.02) [ADM ID: M62C03044AE79CRJ] - 2025/10/08 0:22:58 CET [2025/10/07 18:22:58 ET]
Table 'Sirio' 6-max Seat #1 is the button
Seat 1: mondie73100 (€2.77 in chips) 
Seat 2: scannabue212 (€1.54 in chips) 
Seat 3: caduceus369 (€4.78 in chips) 
Seat 4: sebaparhasar84 (€1.73 in chips) 
Seat 5: IlDestro71 (€1.05 in chips) 
scannabue212: posts small blind €0.01
caduceus369: posts big blind €0.02
*** HOLE CARDS ***
Dealt to caduceus369 [8c Kh]
sebaparhasar84: folds 
IlDestro71: folds 
mondie73100: folds 
scannabue212: folds 
Uncalled bet (€0.01) returned to caduceus369
caduceus369 collected €0.02 from pot
caduceus369: doesn't show hand 
*** SUMMARY ***
Total pot €0.02 | Rake €0 
Seat 1: mondie73100 (button) folded before Flop (didn't bet)
Seat 2: scannabue212 (small blind) folded before Flop
Seat 3: caduceus369 (big blind) collected (€0.02)
Seat 4: sebaparhasar84 folded before Flop (didn't bet)
Seat 5: IlDestro71 folded before Flop (didn't bet)



PokerStars Zoom Hand #258039599239:  Hold'em No Limit (€0.01/€0.02) [ADM ID: M62C03044AE79CRJ] - 2025/10/08 0:22:50 CET [2025/10/07 18:22:50 ET]
Table 'Sirio' 6-max Seat #1 is the button
Seat 1: Nabbox471 (€0.87 in chips) 
Seat 2: fccmp (€0.72 in chips) 
Seat 3: mashallahh (€4.93 in chips) 
Seat 4: caduceus369 (€4.78 in chips) 
Seat 5: mondie73100 (€4.88 in chips) 
fccmp: posts small blind €0.01
mashallahh: posts big blind €0.02
*** HOLE CARDS ***
Dealt to caduceus369 [4d Ah]
caduceus369: folds 
mondie73100: folds 
Nabbox471: raises €0.02 to €0.04
fccmp: raises €0.68 to €0.72 and is all-in
mashallahh: folds 
Nabbox471: folds 
Uncalled bet (€0.68) returned to fccmp
fccmp collected €0.10 from pot
fccmp: doesn't show hand 
*** SUMMARY ***
Total pot €0.10 | Rake €0 
Seat 1: Nabbox471 (button) folded before Flop
Seat 2: fccmp (small blind) collected (€0.10)
Seat 3: mashallahh (big blind) folded before Flop
Seat 4: caduceus369 folded before Flop (didn't bet)
Seat 5: mondie73100 folded before Flop (didn't bet)



PokerStars Zoom Hand #258039604013:  Hold'em No Limit (€0.01/€0.02) [ADM ID: M62C03044AE79CRJ] - 2025/10/08 0:23:13 CET [2025/10/07 18:23:13 ET]
Table 'Sirio' 6-max Seat #1 is the button
Seat 1: Ptrcam (€1.71 in chips) 
Seat 2: mondie73100 (€3.01 in chips) 
Seat 3: Poetto65 (€0.80 in chips) 
Seat 4: caduceus369 (€4.79 in chips) 
Seat 5: Nabbox471 (€0.83 in chips) 
mondie73100: posts small blind €0.01
Poetto65: posts big blind €0.02
*** HOLE CARDS ***
Dealt to caduceus369 [Ah Ac]
caduceus369: raises €0.04 to €0.06
Nabbox471: folds 
Ptrcam: calls €0.06
mondie73100: folds 
Poetto65: folds 
*** FLOP *** [6s 9c Jh]
caduceus369: checks 
Ptrcam: checks 
*** TURN *** [6s 9c Jh] [Qs]
caduceus369: bets €0.11
Ptrcam: calls €0.11
*** RIVER *** [6s 9c Jh Qs] [5d]
caduceus369: bets €0.26
Ptrcam: folds 
Uncalled bet (€0.26) returned to caduceus369
caduceus369 collected €0.35 from pot
caduceus369: doesn't show hand 
*** SUMMARY ***
Total pot €0.37 | Rake €0.02 
Board [6s 9c Jh Qs 5d]
Seat 1: Ptrcam (button) folded on the River
Seat 2: mondie73100 (small blind) folded before Flop
Seat 3: Poetto65 (big blind) folded before Flop
Seat 4: caduceus369 collected (€0.35)
Seat 5: Nabbox471 folded before Flop (didn't bet)



PokerStars Zoom Hand #258039614944:  Hold'em No Limit (€0.01/€0.02) [ADM ID: M62C03044AE79CRJ] - 2025/10/08 0:24:06 CET [2025/10/07 18:24:06 ET]
Table 'Sirio' 6-max Seat #1 is the button
Seat 1: jackdual (€1.02 in chips) 
Seat 2: caduceus369 (€4.97 in chips) 
Seat 3: mondie73100 (€3 in chips) 
Seat 4: nikolor (€1.95 in chips) 
Seat 5: QUATTRODAME (€1.24 in chips) 
Seat 6: mashallahh (€2.39 in chips) 
caduceus369: posts small blind €0.01
mondie73100: posts big blind €0.02
*** HOLE CARDS ***
Dealt to caduceus369 [2c 4d]
nikolor: folds 
QUATTRODAME: folds 
mashallahh: folds 
jackdual: raises €0.04 to €0.06
caduceus369: folds 
mondie73100: folds 
Uncalled bet (€0.04) returned to jackdual
jackdual collected €0.05 from pot
jackdual: doesn't show hand 
*** SUMMARY ***
Total pot €0.05 | Rake €0 
Seat 1: jackdual (button) collected (€0.05)
Seat 2: caduceus369 (small blind) folded before Flop
Seat 3: mondie73100 (big blind) folded before Flop
Seat 4: nikolor folded before Flop (didn't bet)
Seat 5: QUATTRODAME folded before Flop (didn't bet)
Seat 6: mashallahh folded before Flop (didn't bet)



PokerStars Zoom Hand #258039618028:  Hold'em No Limit (€0.01/€0.02) [ADM ID: M62C03044AE79CRJ] - 2025/10/08 0:24:20 CET [2025/10/07 18:24:20 ET]
Table 'Sirio' 6-max Seat #1 is the button
Seat 1: caduceus369 (€4.96 in chips) 
Seat 2: nikolor (€2.08 in chips) 
Seat 3: QUATTRODAME (€1.23 in chips) 
Seat 4: scannabue212 (€1.59 in chips) 
Seat 5: stev@nin (€4.54 in chips) 
Seat 6: Sobolanumm (€0.69 in chips) 
nikolor: posts small blind €0.01
QUATTRODAME: posts big blind €0.02
*** HOLE CARDS ***
Dealt to caduceus369 [Qd 9h]
scannabue212: folds 
stev@nin: raises €0.04 to €0.06
Sobolanumm: calls €0.06
caduceus369: folds 
nikolor: folds 
QUATTRODAME: calls €0.04
*** FLOP *** [Jd 5c Ad]
QUATTRODAME: checks 
stev@nin: bets €0.06
Sobolanumm: folds 
QUATTRODAME: calls €0.06
*** TURN *** [Jd 5c Ad] [7d]
QUATTRODAME: checks 
stev@nin: checks 
*** RIVER *** [Jd 5c Ad 7d] [7s]
QUATTRODAME: checks 
stev@nin: checks 
*** SHOW DOWN ***
QUATTRODAME: shows [4d 4c] (two pair, Sevens and Fours)
stev@nin: shows [Td Jh] (two pair, Jacks and Sevens)
stev@nin collected €0.30 from pot
*** SUMMARY ***
Total pot €0.31 | Rake €0.01 
Board [Jd 5c Ad 7d 7s]
Seat 1: caduceus369 (button) folded before Flop (didn't bet)
Seat 2: nikolor (small blind) folded before Flop
Seat 3: QUATTRODAME (big blind) showed [4d 4c] and lost with two pair, Sevens and Fours
Seat 4: scannabue212 folded before Flop (didn't bet)
Seat 5: stev@nin showed [Td Jh] and won (€0.30) with two pair, Jacks and Sevens
Seat 6: Sobolanumm folded on the Flop



PokerStars Zoom Hand #258039621221:  Hold'em No Limit (€0.01/€0.02) [ADM ID: M62C03044AE79CRJ] - 2025/10/08 0:24:36 CET [2025/10/07 18:24:36 ET]
Table 'Sirio' 6-max Seat #1 is the button
Seat 1: mashallahh (€2.39 in chips) 
Seat 2: robertoH2O (€3.59 in chips) 
Seat 3: stev@nin (€6.02 in chips) 
Seat 4: Nabbox471 (€0.89 in chips) 
Seat 5: caduceus369 (€4.96 in chips) 
Seat 6: fccmp (€0.75 in chips) 
robertoH2O: posts small blind €0.01
stev@nin: posts big blind €0.02
*** HOLE CARDS ***
Dealt to caduceus369 [8s 9c]
Nabbox471: calls €0.02
caduceus369: folds 
fccmp: folds 
mashallahh: folds 
robertoH2O: folds 
stev@nin: checks 
*** FLOP *** [9d 6c 4c]
stev@nin: checks 
Nabbox471: bets €0.02
stev@nin: folds 
Uncalled bet (€0.02) returned to Nabbox471
Nabbox471 collected €0.05 from pot
Nabbox471: doesn't show hand 
*** SUMMARY ***
Total pot €0.05 | Rake €0 
Board [9d 6c 4c]
Seat 1: mashallahh (button) folded before Flop (didn't bet)
Seat 2: robertoH2O (small blind) folded before Flop
Seat 3: stev@nin (big blind) folded on the Flop
Seat 4: Nabbox471 collected (€0.05)
Seat 5: caduceus369 folded before Flop (didn't bet)
Seat 6: fccmp folded before Flop (didn't bet)



PokerStars Zoom Hand #258039622358:  Hold'em No Limit (€0.01/€0.02) [ADM ID: M62C03044AE79CRJ] - 2025/10/08 0:24:42 CET [2025/10/07 18:24:42 ET]
Table 'Sirio' 6-max Seat #1 is the button
Seat 1: scannabue212 (€1.57 in chips) 
Seat 2: mondie73100 (€4.83 in chips) 
Seat 3: caduceus369 (€4.96 in chips) 
Seat 4: fccmp (€0.75 in chips) 
Seat 5: mashallahh (€4.93 in chips) 
Seat 6: nikolor (€2.07 in chips) 
mondie73100: posts small blind €0.01
caduceus369: posts big blind €0.02
*** HOLE CARDS ***
Dealt to caduceus369 [3s 6s]
fccmp: folds 
mashallahh: folds 
nikolor: folds 
scannabue212: calls €0.02
mondie73100: folds 
caduceus369: checks 
*** FLOP *** [6h Ks 7c]
caduceus369: checks 
scannabue212: bets €0.04
caduceus369: calls €0.04
*** TURN *** [6h Ks 7c] [5s]
caduceus369: checks 
scannabue212: bets €0.08
caduceus369: calls €0.08
*** RIVER *** [6h Ks 7c 5s] [7d]
caduceus369: checks 
scannabue212: bets €0.10
caduceus369: folds 
Uncalled bet (€0.10) returned to scannabue212
scannabue212 collected €0.28 from pot
scannabue212: doesn't show hand 
*** SUMMARY ***
Total pot €0.29 | Rake €0.01 
Board [6h Ks 7c 5s 7d]
Seat 1: scannabue212 (button) collected (€0.28)
Seat 2: mondie73100 (small blind) folded before Flop
Seat 3: caduceus369 (big blind) folded on the River
Seat 4: fccmp folded before Flop (didn't bet)
Seat 5: mashallahh folded before Flop (didn't bet)
Seat 6: nikolor folded before Flop (didn't bet)



PokerStars Zoom Hand #258039645426:  Hold'em No Limit (€0.01/€0.02) [ADM ID: M62C03044AE79CRJ] - 2025/10/08 0:26:32 CET [2025/10/07 18:26:32 ET]
Table 'Sirio' 6-max Seat #1 is the button
Seat 1: caduceus369 (€4.82 in chips) 
Seat 2: mashallahh (€4.97 in chips) 
Seat 3: Sobolanumm (€0.66 in chips) 
Seat 4: Poetto65 (€0.61 in chips) 
Seat 5: nikolor (€2.15 in chips) 
Seat 6: Nabbox471 (€0.89 in chips) 
mashallahh: posts small blind €0.01
Sobolanumm: posts big blind €0.02
*** HOLE CARDS ***
Dealt to caduceus369 [4d 7d]
Poetto65: folds 
nikolor: folds 
Nabbox471: folds 
caduceus369: folds 
mashallahh: folds 
Uncalled bet (€0.01) returned to Sobolanumm
Sobolanumm collected €0.02 from pot
Sobolanumm: doesn't show hand 
*** SUMMARY ***
Total pot €0.02 | Rake €0 
Seat 1: caduceus369 (button) folded before Flop (didn't bet)
Seat 2: mashallahh (small blind) folded before Flop
Seat 3: Sobolanumm (big blind) collected (€0.02)
Seat 4: Poetto65 folded before Flop (didn't bet)
Seat 5: nikolor folded before Flop (didn't bet)
Seat 6: Nabbox471 folded before Flop (didn't bet)



PokerStars Zoom Hand #258039646905:  Hold'em No Limit (€0.01/€0.02) [ADM ID: M62C03044AE79CRJ] - 2025/10/08 0:26:40 CET [2025/10/07 18:26:40 ET]
Table 'Sirio' 6-max Seat #1 is the button
Seat 1: Ptrcam (€1.96 in chips) 
Seat 2: caduceus369 (€4.82 in chips) 
Seat 3: Poetto65 (€0.61 in chips) 
Seat 4: mondie73100 (€4.74 in chips) 
Seat 5: Nabbox471 (€0.89 in chips) 
Seat 6: mashallahh (€4.96 in chips) 
caduceus369: posts small blind €0.01
Poetto65: posts big blind €0.02
*** HOLE CARDS ***
Dealt to caduceus369 [2c 2d]
mondie73100: folds 
Nabbox471: folds 
mashallahh: folds 
Ptrcam: folds 
caduceus369: calls €0.01
Poetto65: checks 
*** FLOP *** [Tc 4c Ac]
caduceus369: bets €0.02
Poetto65: folds 
Uncalled bet (€0.02) returned to caduceus369
caduceus369 collected €0.04 from pot
caduceus369: doesn't show hand 
*** SUMMARY ***
Total pot €0.04 | Rake €0 
Board [Tc 4c Ac]
Seat 1: Ptrcam (button) folded before Flop (didn't bet)
Seat 2: caduceus369 (small blind) collected (€0.04)
Seat 3: Poetto65 (big blind) folded on the Flop
Seat 4: mondie73100 folded before Flop (didn't bet)
Seat 5: Nabbox471 folded before Flop (didn't bet)
Seat 6: mashallahh folded before Flop (didn't bet)



PokerStars Zoom Hand #258039643469:  Hold'em No Limit (€0.01/€0.02) [ADM ID: M62C03044AE79CRJ] - 2025/10/08 0:26:23 CET [2025/10/07 18:26:23 ET]
Table 'Sirio' 6-max Seat #1 is the button
Seat 1: Sobolanumm (€0.66 in chips) 
Seat 2: fccmp (€0.73 in chips) 
Seat 3: QUATTRODAME (€1.07 in chips) 
Seat 4: caduceus369 (€4.82 in chips) 
Seat 5: scannabue212 (€1.71 in chips) 
Seat 6: A_LUCCHESE_92 (€4.81 in chips) 
fccmp: posts small blind €0.01
QUATTRODAME: posts big blind €0.02
*** HOLE CARDS ***
Dealt to caduceus369 [7s 3h]
caduceus369: folds 
scannabue212: calls €0.02
A_LUCCHESE_92 has timed out
A_LUCCHESE_92: folds 
Sobolanumm: folds 
fccmp: folds 
QUATTRODAME: checks 
*** FLOP *** [Ks Tc Qd]
QUATTRODAME: checks 
scannabue212: bets €0.04
QUATTRODAME: calls €0.04
*** TURN *** [Ks Tc Qd] [Kc]
QUATTRODAME: checks 
scannabue212: checks 
*** RIVER *** [Ks Tc Qd Kc] [4c]
QUATTRODAME: checks 
scannabue212: checks 
*** SHOW DOWN ***
QUATTRODAME: shows [9d Qc] (two pair, Kings and Queens)
scannabue212: mucks hand 
QUATTRODAME collected €0.13 from pot
*** SUMMARY ***
Total pot €0.13 | Rake €0 
Board [Ks Tc Qd Kc 4c]
Seat 1: Sobolanumm (button) folded before Flop (didn't bet)
Seat 2: fccmp (small blind) folded before Flop
Seat 3: QUATTRODAME (big blind) showed [9d Qc] and won (€0.13) with two pair, Kings and Queens
Seat 4: caduceus369 folded before Flop (didn't bet)
Seat 5: scannabue212 mucked [Ac Th]
Seat 6: A_LUCCHESE_92 folded before Flop (didn't bet)



PokerStars Zoom Hand #258039651636:  Hold'em No Limit (€0.01/€0.02) [ADM ID: M62C03044AE79CRJ] - 2025/10/08 0:27:03 CET [2025/10/07 18:27:03 ET]
Table 'Sirio' 6-max Seat #1 is the button
Seat 1: fccmp (€1.39 in chips) 
Seat 2: AlwaisToRun (€0.57 in chips) 
Seat 3: IlDestro71 (€0.37 in chips) 
Seat 4: stev@nin (€4.71 in chips) 
Seat 5: caduceus369 (€4.84 in chips) 
Seat 6: Sium12302 (€2 in chips) 
AlwaisToRun: posts small blind €0.01
IlDestro71: posts big blind €0.02
*** HOLE CARDS ***
Dealt to caduceus369 [Tc Ts]
stev@nin: raises €0.04 to €0.06
caduceus369: raises €0.12 to €0.18
Sium12302: folds 
fccmp: folds 
AlwaisToRun: folds 
IlDestro71: calls €0.16
stev@nin: raises €0.51 to €0.69
caduceus369: folds 
IlDestro71: calls €0.19 and is all-in
Uncalled bet (€0.32) returned to stev@nin
*** FLOP *** [8d 4c Ks]
*** TURN *** [8d 4c Ks] [Th]
*** RIVER *** [8d 4c Ks Th] [9d]
*** SHOW DOWN ***
IlDestro71: shows [9h Kh] (two pair, Kings and Nines)
stev@nin: shows [Ac Js] (high card Ace)
IlDestro71 collected €0.88 from pot
*** SUMMARY ***
Total pot €0.93 | Rake €0.05 
Board [8d 4c Ks Th 9d]
Seat 1: fccmp (button) folded before Flop (didn't bet)
Seat 2: AlwaisToRun (small blind) folded before Flop
Seat 3: IlDestro71 (big blind) showed [9h Kh] and won (€0.88) with two pair, Kings and Nines
Seat 4: stev@nin showed [Ac Js] and lost with high card Ace
Seat 5: caduceus369 folded before Flop
Seat 6: Sium12302 folded before Flop (didn't bet)



PokerStars Zoom Hand #258039661825:  Hold'em No Limit (€0.01/€0.02) [ADM ID: M62C03044AE79CRJ] - 2025/10/08 0:27:52 CET [2025/10/07 18:27:52 ET]
Table 'Sirio' 6-max Seat #1 is the button
Seat 1: mashallahh (€7.43 in chips) 
Seat 2: IlDestro71 (€0.88 in chips) 
Seat 3: stev@nin (€4.34 in chips) 
Seat 4: mondie73100 (€2.61 in chips) 
Seat 5: pistaKKio23 (€1.97 in chips) 
Seat 6: caduceus369 (€4.66 in chips) 
IlDestro71: posts small blind €0.01
stev@nin: posts big blind €0.02
*** HOLE CARDS ***
Dealt to caduceus369 [Ah Td]
mondie73100: folds 
pistaKKio23: folds 
caduceus369: raises €0.04 to €0.06
mashallahh: folds 
IlDestro71: calls €0.05
stev@nin: folds 
*** FLOP *** [Ks Jd 9s]
IlDestro71: checks 
caduceus369: checks 
*** TURN *** [Ks Jd 9s] [5d]
IlDestro71: checks 
caduceus369: bets €0.07
IlDestro71: calls €0.07
*** RIVER *** [Ks Jd 9s 5d] [3d]
IlDestro71: checks 
caduceus369: bets €0.14
IlDestro71: folds 
Uncalled bet (€0.14) returned to caduceus369
caduceus369 collected €0.27 from pot
caduceus369: doesn't show hand 
*** SUMMARY ***
Total pot €0.28 | Rake €0.01 
Board [Ks Jd 9s 5d 3d]
Seat 1: mashallahh (button) folded before Flop (didn't bet)
Seat 2: IlDestro71 (small blind) folded on the River
Seat 3: stev@nin (big blind) folded before Flop
Seat 4: mondie73100 folded before Flop (didn't bet)
Seat 5: pistaKKio23 folded before Flop (didn't bet)
Seat 6: caduceus369 collected (€0.27)



PokerStars Zoom Hand #258039675496:  Hold'em No Limit (€0.01/€0.02) [ADM ID: M62C03044AE79CRJ] - 2025/10/08 0:28:58 CET [2025/10/07 18:28:58 ET]
Table 'Sirio' 6-max Seat #1 is the button
Seat 1: vesper622 (€2.48 in chips) 
Seat 2: SaTheNuts_77 (€0.90 in chips) 
Seat 3: caduceus369 (€4.80 in chips) 
Seat 4: QUATTRODAME (€1.10 in chips) 
Seat 5: AlwaisToRun (€0.52 in chips) 
Seat 6: pistaKKio23 (€3.88 in chips) 
SaTheNuts_77: posts small blind €0.01
caduceus369: posts big blind €0.02
*** HOLE CARDS ***
Dealt to caduceus369 [Tc 6d]
QUATTRODAME: raises €0.04 to €0.06
AlwaisToRun: folds 
pistaKKio23: folds 
vesper622: folds 
SaTheNuts_77: raises €0.14 to €0.20
caduceus369: folds 
QUATTRODAME: raises €0.90 to €1.10 and is all-in
SaTheNuts_77: calls €0.70 and is all-in
Uncalled bet (€0.20) returned to QUATTRODAME
*** FLOP *** [3s Js 6c]
*** TURN *** [3s Js 6c] [Ks]
*** RIVER *** [3s Js 6c Ks] [Ts]
*** SHOW DOWN ***
SaTheNuts_77: shows [Ah Ac] (a pair of Aces)
QUATTRODAME: shows [9c 9d] (a pair of Nines)
SaTheNuts_77 collected €1.72 from pot
*** SUMMARY ***
Total pot €1.82 | Rake €0.10 
Board [3s Js 6c Ks Ts]
Seat 1: vesper622 (button) folded before Flop (didn't bet)
Seat 2: SaTheNuts_77 (small blind) showed [Ah Ac] and won (€1.72) with a pair of Aces
Seat 3: caduceus369 (big blind) folded before Flop
Seat 4: QUATTRODAME showed [9c 9d] and lost with a pair of Nines
Seat 5: AlwaisToRun folded before Flop (didn't bet)
Seat 6: pistaKKio23 folded before Flop (didn't bet)



PokerStars Zoom Hand #258039679958:  Hold'em No Limit (€0.01/€0.02) [ADM ID: M62C03044AE79CRJ] - 2025/10/08 0:29:19 CET [2025/10/07 18:29:19 ET]
Table 'Sirio' 6-max Seat #1 is the button
Seat 1: AlwaisToRun (€0.51 in chips) 
Seat 2: pistaKKio23 (€3.88 in chips) 
Seat 3: Sobolanumm (€0.62 in chips) 
Seat 4: Sium12302 (€1.97 in chips) 
Seat 5: fccmp (€1.36 in chips) 
Seat 6: caduceus369 (€4.78 in chips) 
pistaKKio23: posts small blind €0.01
Sobolanumm: posts big blind €0.02
*** HOLE CARDS ***
Dealt to caduceus369 [2s 5c]
Sium12302: folds 
fccmp: folds 
caduceus369: folds 
AlwaisToRun: folds 
pistaKKio23: calls €0.01
Sobolanumm: checks 
*** FLOP *** [9d 7c Ad]
pistaKKio23: checks 
Sobolanumm: checks 
*** TURN *** [9d 7c Ad] [Tc]
pistaKKio23: checks 
Sobolanumm: checks 
*** RIVER *** [9d 7c Ad Tc] [2c]
pistaKKio23: checks 
Sobolanumm: checks 
*** SHOW DOWN ***
pistaKKio23: shows [7s 4h] (a pair of Sevens)
Sobolanumm: shows [3s Ts] (a pair of Tens)
Sobolanumm collected €0.04 from pot
*** SUMMARY ***
Total pot €0.04 | Rake €0 
Board [9d 7c Ad Tc 2c]
Seat 1: AlwaisToRun (button) folded before Flop (didn't bet)
Seat 2: pistaKKio23 (small blind) showed [7s 4h] and lost with a pair of Sevens
Seat 3: Sobolanumm (big blind) showed [3s Ts] and won (€0.04) with a pair of Tens
Seat 4: Sium12302 folded before Flop (didn't bet)
Seat 5: fccmp folded before Flop (didn't bet)
Seat 6: caduceus369 folded before Flop (didn't bet)



PokerStars Zoom Hand #258039682908:  Hold'em No Limit (€0.01/€0.02) [ADM ID: M62C03044AE79CRJ] - 2025/10/08 0:29:34 CET [2025/10/07 18:29:34 ET]
Table 'Sirio' 6-max Seat #1 is the button
Seat 1: SaTheNuts_77 (€1.72 in chips) 
Seat 2: sebaparhasar84 (€2.01 in chips) 
Seat 3: QUATTRODAME (€0.20 in chips) 
Seat 4: caduceus369 (€4.77 in chips) 
Seat 5: Emm3B1 (€2.02 in chips) 
Seat 6: robertoH2O (€3.82 in chips) 
sebaparhasar84: posts small blind €0.01
QUATTRODAME: posts big blind €0.02
*** HOLE CARDS ***
Dealt to caduceus369 [Ks Ah]
caduceus369: raises €0.02 to €0.04
Emm3B1: folds 
robertoH2O: folds 
SaTheNuts_77: folds 
sebaparhasar84: folds 
QUATTRODAME: calls €0.02
*** FLOP *** [8h Qh Jh]
QUATTRODAME: bets €0.16 and is all-in
caduceus369: calls €0.16
*** TURN *** [8h Qh Jh] [As]
*** RIVER *** [8h Qh Jh As] [Ac]
*** SHOW DOWN ***
QUATTRODAME: shows [Qs 4d] (two pair, Aces and Queens)
caduceus369: shows [Ks Ah] (three of a kind, Aces)
caduceus369 collected €0.39 from pot
*** SUMMARY ***
Total pot €0.41 | Rake €0.02 
Board [8h Qh Jh As Ac]
Seat 1: SaTheNuts_77 (button) folded before Flop (didn't bet)
Seat 2: sebaparhasar84 (small blind) folded before Flop
Seat 3: QUATTRODAME (big blind) showed [Qs 4d] and lost with two pair, Aces and Queens
Seat 4: caduceus369 showed [Ks Ah] and won (€0.39) with three of a kind, Aces
Seat 5: Emm3B1 folded before Flop (didn't bet)
Seat 6: robertoH2O folded before Flop (didn't bet)



PokerStars Zoom Hand #258039677532:  Hold'em No Limit (€0.01/€0.02) [ADM ID: M62C03044AE79CRJ] - 2025/10/08 0:29:08 CET [2025/10/07 18:29:08 ET]
Table 'Sirio' 6-max Seat #1 is the button
Seat 1: caduceus369 (€4.78 in chips) 
Seat 2: vesper622 (€2.48 in chips) 
Seat 3: mondie73100 (€3.17 in chips) 
Seat 4: fantaasso (€1.44 in chips) 
Seat 5: Sobolanumm (€1.36 in chips) 
Seat 6: nikolor (€2.10 in chips) 
vesper622: posts small blind €0.01
mondie73100: posts big blind €0.02
*** HOLE CARDS ***
Dealt to caduceus369 [5h 6h]
fantaasso: folds 
Sobolanumm: folds 
nikolor has timed out
nikolor: folds 
caduceus369: folds 
vesper622: raises €0.02 to €0.04
mondie73100: calls €0.02
*** FLOP *** [Jh Ks 9s]
vesper622: checks 
mondie73100: checks 
*** TURN *** [Jh Ks 9s] [4c]
vesper622: checks 
mondie73100: bets €0.04
vesper622: calls €0.04
*** RIVER *** [Jh Ks 9s 4c] [Td]
vesper622: checks 
mondie73100: checks 
*** SHOW DOWN ***
vesper622: shows [2c Ac] (high card Ace)
mondie73100: shows [Th Jc] (two pair, Jacks and Tens)
mondie73100 collected €0.16 from pot
*** SUMMARY ***
Total pot €0.16 | Rake €0 
Board [Jh Ks 9s 4c Td]
Seat 1: caduceus369 (button) folded before Flop (didn't bet)
Seat 2: vesper622 (small blind) showed [2c Ac] and lost with high card Ace
Seat 3: mondie73100 (big blind) showed [Th Jc] and won (€0.16) with two pair, Jacks and Tens
Seat 4: fantaasso folded before Flop (didn't bet)
Seat 5: Sobolanumm folded before Flop (didn't bet)
Seat 6: nikolor folded before Flop (didn't bet)



PokerStars Zoom Hand #258039688484:  Hold'em No Limit (€0.01/€0.02) [ADM ID: M62C03044AE79CRJ] - 2025/10/08 0:30:01 CET [2025/10/07 18:30:01 ET]
Table 'Sirio' 6-max Seat #1 is the button
Seat 1: fccmp (€1.36 in chips) 
Seat 2: nikolor (€1.93 in chips) 
Seat 3: Trombinho (€0.80 in chips) 
Seat 4: caduceus369 (€4.96 in chips) 
Seat 5: pistaKKio23 (€4.40 in chips) 
Seat 6: mashallahh (€2.44 in chips) 
nikolor: posts small blind €0.01
Trombinho: posts big blind €0.02
*** HOLE CARDS ***
Dealt to caduceus369 [8c 5c]
caduceus369: folds 
pistaKKio23: folds 
mashallahh: folds 
fccmp: folds 
nikolor: folds 
Uncalled bet (€0.01) returned to Trombinho
Trombinho collected €0.02 from pot
Trombinho: doesn't show hand 
*** SUMMARY ***
Total pot €0.02 | Rake €0 
Seat 1: fccmp (button) folded before Flop (didn't bet)
Seat 2: nikolor (small blind) folded before Flop
Seat 3: Trombinho (big blind) collected (€0.02)
Seat 4: caduceus369 folded before Flop (didn't bet)
Seat 5: pistaKKio23 folded before Flop (didn't bet)
Seat 6: mashallahh folded before Flop (didn't bet)



PokerStars Zoom Hand #258039681536:  Hold'em No Limit (€0.01/€0.02) [ADM ID: M62C03044AE79CRJ] - 2025/10/08 0:29:27 CET [2025/10/07 18:29:27 ET]
Table 'Sirio' 6-max Seat #1 is the button
Seat 1: Poetto65 (€1.12 in chips) 
Seat 2: caduceus369 (€4.78 in chips) 
Seat 3: AlwaisToRun (€0.51 in chips) 
Seat 4: Coffeebreak96 (€1.60 in chips) 
Seat 5: stev@nin (€5.93 in chips) 
Seat 6: fccmp (€1.36 in chips) 
caduceus369: posts small blind €0.01
AlwaisToRun: posts big blind €0.02
*** HOLE CARDS ***
Dealt to caduceus369 [8h 2c]
Coffeebreak96: raises €0.02 to €0.04
stev@nin: calls €0.04
fccmp: folds 
Poetto65: calls €0.04
caduceus369: folds 
AlwaisToRun: folds 
*** FLOP *** [8d 4c Th]
Coffeebreak96: bets €0.06
stev@nin: calls €0.06
Poetto65: folds 
*** TURN *** [8d 4c Th] [2s]
Coffeebreak96: checks 
stev@nin: checks 
*** RIVER *** [8d 4c Th 2s] [2h]
Coffeebreak96: checks 
stev@nin: bets €0.18
Coffeebreak96: folds 
Uncalled bet (€0.18) returned to stev@nin
stev@nin collected €0.26 from pot
stev@nin: doesn't show hand 
*** SUMMARY ***
Total pot €0.27 | Rake €0.01 
Board [8d 4c Th 2s 2h]
Seat 1: Poetto65 (button) folded on the Flop
Seat 2: caduceus369 (small blind) folded before Flop
Seat 3: AlwaisToRun (big blind) folded before Flop
Seat 4: Coffeebreak96 folded on the River
Seat 5: stev@nin collected (€0.26)
Seat 6: fccmp folded before Flop (didn't bet)



PokerStars Zoom Hand #258039690838:  Hold'em No Limit (€0.01/€0.02) [ADM ID: M62C03044AE79CRJ] - 2025/10/08 0:30:13 CET [2025/10/07 18:30:13 ET]
Table 'Sirio' 6-max Seat #1 is the button
Seat 1: stev@nin (€4.26 in chips) 
Seat 2: Sium12302 (€1.91 in chips) 
Seat 3: Sobolanumm (€1.43 in chips) 
Seat 4: mashallahh (€2.48 in chips) 
Seat 5: nikolor (€1.97 in chips) 
Seat 6: caduceus369 (€4.96 in chips) 
Sium12302: posts small blind €0.01
Sobolanumm: posts big blind €0.02
*** HOLE CARDS ***
Dealt to caduceus369 [9c Ah]
mashallahh: folds 
nikolor: folds 
caduceus369: raises €0.04 to €0.06
stev@nin: folds 
Sium12302: calls €0.05
Sobolanumm: calls €0.04
*** FLOP *** [6s 2d 2s]
Sium12302: checks 
Sobolanumm: bets €0.09
caduceus369: folds 
Sium12302: calls €0.09
*** TURN *** [6s 2d 2s] [Tc]
Sium12302: checks 
Sobolanumm: bets €0.18
Sium12302: calls €0.18
*** RIVER *** [6s 2d 2s Tc] [8d]
Sium12302: checks 
Sobolanumm: checks 
*** SHOW DOWN ***
Sium12302: shows [9s Ks] (a pair of Deuces)
Sobolanumm: shows [5s Ts] (two pair, Tens and Deuces)
Sobolanumm collected €0.69 from pot
*** SUMMARY ***
Total pot €0.72 | Rake €0.03 
Board [6s 2d 2s Tc 8d]
Seat 1: stev@nin (button) folded before Flop (didn't bet)
Seat 2: Sium12302 (small blind) showed [9s Ks] and lost with a pair of Deuces
Seat 3: Sobolanumm (big blind) showed [5s Ts] and won (€0.69) with two pair, Tens and Deuces
Seat 4: mashallahh folded before Flop (didn't bet)
Seat 5: nikolor folded before Flop (didn't bet)
Seat 6: caduceus369 folded on the Flop



PokerStars Zoom Hand #258039700420:  Hold'em No Limit (€0.01/€0.02) [ADM ID: M62C03044AE79CRJ] - 2025/10/08 0:30:59 CET [2025/10/07 18:30:59 ET]
Table 'Sirio' 6-max Seat #1 is the button
Seat 1: fccmp (€1.34 in chips) 
Seat 2: caduceus369 (€4.88 in chips) 
Seat 3: robertoH2O (€3.79 in chips) 
Seat 4: Coffeebreak96 (€1.50 in chips) 
Seat 5: fantaasso (€2.01 in chips) 
Seat 6: mondie73100 (€2.63 in chips) 
caduceus369: posts small blind €0.01
robertoH2O: posts big blind €0.02
*** HOLE CARDS ***
Dealt to caduceus369 [Ks 6h]
Coffeebreak96: folds 
fantaasso: folds 
mondie73100: raises €0.04 to €0.06
fccmp: folds 
caduceus369: folds 
robertoH2O: folds 
Uncalled bet (€0.04) returned to mondie73100
mondie73100 collected €0.05 from pot
mondie73100: doesn't show hand 
*** SUMMARY ***
Total pot €0.05 | Rake €0 
Seat 1: fccmp (button) folded before Flop (didn't bet)
Seat 2: caduceus369 (small blind) folded before Flop
Seat 3: robertoH2O (big blind) folded before Flop
Seat 4: Coffeebreak96 folded before Flop (didn't bet)
Seat 5: fantaasso folded before Flop (didn't bet)
Seat 6: mondie73100 collected (€0.05)



PokerStars Zoom Hand #258039704942:  Hold'em No Limit (€0.01/€0.02) [ADM ID: M62C03044AE79CRJ] - 2025/10/08 0:31:21 CET [2025/10/07 18:31:21 ET]
Table 'Sirio' 6-max Seat #1 is the button
Seat 1: Trombinho (€0.79 in chips) 
Seat 2: nikolor (€1.95 in chips) 
Seat 3: fccmp (€1.33 in chips) 
Seat 4: Emm3B1 (€1.94 in chips) 
Seat 5: caduceus369 (€4.87 in chips) 
Seat 6: mondie73100 (€3.24 in chips) 
nikolor: posts small blind €0.01
fccmp: posts big blind €0.02
*** HOLE CARDS ***
Dealt to caduceus369 [3c Kh]
Emm3B1: folds 
caduceus369: folds 
mondie73100: folds 
Trombinho: calls €0.02
nikolor: folds 
fccmp: checks 
*** FLOP *** [Jc 3d 3s]
fccmp: checks 
Trombinho: bets €0.03
fccmp: folds 
Uncalled bet (€0.03) returned to Trombinho
Trombinho collected €0.05 from pot
Trombinho: doesn't show hand 
*** SUMMARY ***
Total pot €0.05 | Rake €0 
Board [Jc 3d 3s]
Seat 1: Trombinho (button) collected (€0.05)
Seat 2: nikolor (small blind) folded before Flop
Seat 3: fccmp (big blind) folded on the Flop
Seat 4: Emm3B1 folded before Flop (didn't bet)
Seat 5: caduceus369 folded before Flop (didn't bet)
Seat 6: mondie73100 folded before Flop (didn't bet)



PokerStars Zoom Hand #258039706145:  Hold'em No Limit (€0.01/€0.02) [ADM ID: M62C03044AE79CRJ] - 2025/10/08 0:31:27 CET [2025/10/07 18:31:27 ET]
Table 'Sirio' 6-max Seat #1 is the button
Seat 1: caduceus369 (€4.87 in chips) 
Seat 2: Emm3B1 (€1.94 in chips) 
Seat 3: nikolor (€1.92 in chips) 
Seat 4: Sobolanumm (€0.71 in chips) 
Seat 5: mondie73100 (€2.66 in chips) 
Seat 6: A_LUCCHESE_92 (€4.80 in chips) 
Emm3B1: posts small blind €0.01
nikolor: posts big blind €0.02
*** HOLE CARDS ***
Dealt to caduceus369 [Td Qh]
Sobolanumm: calls €0.02
mondie73100: folds 
A_LUCCHESE_92: folds 
caduceus369: calls €0.02
Emm3B1: folds 
nikolor: checks 
*** FLOP *** [5d 7s 3d]
nikolor: checks 
Sobolanumm: checks 
caduceus369: checks 
*** TURN *** [5d 7s 3d] [4h]
nikolor: checks 
Sobolanumm: checks 
caduceus369: checks 
*** RIVER *** [5d 7s 3d 4h] [2s]
nikolor: checks 
Sobolanumm: checks 
caduceus369: checks 
*** SHOW DOWN ***
nikolor: shows [Jh 3s] (a pair of Threes)
Sobolanumm: shows [5s Ks] (a pair of Fives)
caduceus369: mucks hand 
Sobolanumm collected €0.07 from pot
*** SUMMARY ***
Total pot €0.07 | Rake €0 
Board [5d 7s 3d 4h 2s]
Seat 1: caduceus369 (button) mucked [Td Qh]
Seat 2: Emm3B1 (small blind) folded before Flop
Seat 3: nikolor (big blind) showed [Jh 3s] and lost with a pair of Threes
Seat 4: Sobolanumm showed [5s Ks] and won (€0.07) with a pair of Fives
Seat 5: mondie73100 folded before Flop (didn't bet)
Seat 6: A_LUCCHESE_92 folded before Flop (didn't bet)



PokerStars Zoom Hand #258039716834:  Hold'em No Limit (€0.01/€0.02) [ADM ID: M62C03044AE79CRJ] - 2025/10/08 0:32:21 CET [2025/10/07 18:32:21 ET]
Table 'Sirio' 6-max Seat #1 is the button
Seat 1: mondie73100 (€5.94 in chips) 
Seat 2: Sobolanumm (€0.76 in chips) 
Seat 3: nikolor (€1.94 in chips) 
Seat 4: caduceus369 (€4.85 in chips) 
Seat 5: A_LUCCHESE_92 (€4.75 in chips) 
Seat 6: mashallahh (€7.62 in chips) 
Sobolanumm: posts small blind €0.01
nikolor: posts big blind €0.02
*** HOLE CARDS ***
Dealt to caduceus369 [8d Qc]
caduceus369: folds 
A_LUCCHESE_92: folds 
mashallahh: raises €0.04 to €0.06
mondie73100: folds 
Sobolanumm: folds 
nikolor: folds 
Uncalled bet (€0.04) returned to mashallahh
mashallahh collected €0.05 from pot
mashallahh: doesn't show hand 
*** SUMMARY ***
Total pot €0.05 | Rake €0 
Seat 1: mondie73100 (button) folded before Flop (didn't bet)
Seat 2: Sobolanumm (small blind) folded before Flop
Seat 3: nikolor (big blind) folded before Flop
Seat 4: caduceus369 folded before Flop (didn't bet)
Seat 5: A_LUCCHESE_92 folded before Flop (didn't bet)
Seat 6: mashallahh collected (€0.05)



PokerStars Zoom Hand #258039718416:  Hold'em No Limit (€0.01/€0.02) [ADM ID: M62C03044AE79CRJ] - 2025/10/08 0:32:29 CET [2025/10/07 18:32:29 ET]
Table 'Sirio' 6-max Seat #1 is the button
Seat 1: fantaasso (€1.97 in chips) 
Seat 2: ADRIAN0_MEIS (€25.87 in chips) 
Seat 3: stev@nin (€6.17 in chips) 
Seat 4: caduceus369 (€4.85 in chips) 
Seat 5: Sobolanumm (€0.75 in chips) 
Seat 6: xTheBulldogx (€0.83 in chips) 
ADRIAN0_MEIS: posts small blind €0.01
stev@nin: posts big blind €0.02
*** HOLE CARDS ***
Dealt to caduceus369 [6c Kc]
caduceus369: folds 
Sobolanumm: folds 
xTheBulldogx: folds 
fantaasso: folds 
ADRIAN0_MEIS: folds 
Uncalled bet (€0.01) returned to stev@nin
stev@nin collected €0.02 from pot
stev@nin: doesn't show hand 
*** SUMMARY ***
Total pot €0.02 | Rake €0 
Seat 1: fantaasso (button) folded before Flop (didn't bet)
Seat 2: ADRIAN0_MEIS (small blind) folded before Flop
Seat 3: stev@nin (big blind) collected (€0.02)
Seat 4: caduceus369 folded before Flop (didn't bet)
Seat 5: Sobolanumm folded before Flop (didn't bet)
Seat 6: xTheBulldogx folded before Flop (didn't bet)



PokerStars Zoom Hand #258039719792:  Hold'em No Limit (€0.01/€0.02) [ADM ID: M62C03044AE79CRJ] - 2025/10/08 0:32:36 CET [2025/10/07 18:32:36 ET]
Table 'Sirio' 6-max Seat #1 is the button
Seat 1: mondie73100 (€2.65 in chips) 
Seat 2: xTheBulldogx (€0.83 in chips) 
Seat 3: fantaasso (€1.97 in chips) 
Seat 4: fccmp (€1.33 in chips) 
Seat 5: nikolor (€1.90 in chips) 
Seat 6: caduceus369 (€4.85 in chips) 
xTheBulldogx: posts small blind €0.01
fantaasso: posts big blind €0.02
*** HOLE CARDS ***
Dealt to caduceus369 [Qd Ad]
fccmp: folds 
nikolor: folds 
caduceus369: raises €0.04 to €0.06
mondie73100: folds 
xTheBulldogx: folds 
fantaasso: folds 
Uncalled bet (€0.04) returned to caduceus369
caduceus369 collected €0.05 from pot
caduceus369: doesn't show hand 
*** SUMMARY ***
Total pot €0.05 | Rake €0 
Seat 1: mondie73100 (button) folded before Flop (didn't bet)
Seat 2: xTheBulldogx (small blind) folded before Flop
Seat 3: fantaasso (big blind) folded before Flop
Seat 4: fccmp folded before Flop (didn't bet)
Seat 5: nikolor folded before Flop (didn't bet)
Seat 6: caduceus369 collected (€0.05)



PokerStars Zoom Hand #258039697273:  Hold'em No Limit (€0.01/€0.02) [ADM ID: M62C03044AE79CRJ] - 2025/10/08 0:30:44 CET [2025/10/07 18:30:44 ET]
Table 'Sirio' 6-max Seat #1 is the button
Seat 1: fantaasso (€2.01 in chips) 
Seat 2: mashallahh (€2.44 in chips) 
Seat 3: caduceus369 (€4.90 in chips) 
Seat 4: robertoH2O (€3.79 in chips) 
Seat 5: Poetto65 (€1.07 in chips) 
Seat 6: vesper622 (€2.38 in chips) 
mashallahh: posts small blind €0.01
caduceus369: posts big blind €0.02
*** HOLE CARDS ***
Dealt to caduceus369 [Jc 4s]
robertoH2O: folds 
Poetto65: folds 
vesper622: raises €0.04 to €0.06
fantaasso: folds 
mashallahh: raises €0.12 to €0.18
caduceus369: folds 
vesper622: calls €0.12
*** FLOP *** [6s Qc 5s]
mashallahh: bets €0.28
vesper622: raises €0.28 to €0.56
mashallahh: calls €0.28
*** TURN *** [6s Qc 5s] [Qs]
mashallahh: checks 
vesper622: bets €0.50
mashallahh: calls €0.50
*** RIVER *** [6s Qc 5s Qs] [2c]
mashallahh: checks 
Poetto65 is disconnected 
vesper622: bets €1.14 and is all-in
mashallahh: calls €1.14
*** SHOW DOWN ***
vesper622: shows [Ad Qd] (three of a kind, Queens)
mashallahh: shows [Ah Tc] (a pair of Queens)
vesper622 collected €4.52 from pot
*** SUMMARY ***
Total pot €4.78 | Rake €0.26 
Board [6s Qc 5s Qs 2c]
Seat 1: fantaasso (button) folded before Flop (didn't bet)
Seat 2: mashallahh (small blind) showed [Ah Tc] and lost with a pair of Queens
Seat 3: caduceus369 (big blind) folded before Flop
Seat 4: robertoH2O folded before Flop (didn't bet)
Seat 5: Poetto65 folded before Flop (didn't bet)
Seat 6: vesper622 showed [Ad Qd] and won (€4.52) with three of a kind, Queens



PokerStars Zoom Hand #258039724118:  Hold'em No Limit (€0.01/€0.02) [ADM ID: M62C03044AE79CRJ] - 2025/10/08 0:32:57 CET [2025/10/07 18:32:57 ET]
Table 'Sirio' 6-max Seat #1 is the button
Seat 1: pistaKKio23 (€6.03 in chips) 
Seat 2: nikolor (€1.92 in chips) 
Seat 3: caduceus369 (€4.88 in chips) 
Seat 4: ADRIAN0_MEIS (€25.86 in chips) 
Seat 5: mondie73100 (€5.93 in chips) 
Seat 6: robertoH2O (€3.80 in chips) 
nikolor: posts small blind €0.01
caduceus369: posts big blind €0.02
*** HOLE CARDS ***
Dealt to caduceus369 [Qc Jc]
ADRIAN0_MEIS: folds 
mondie73100: folds 
robertoH2O: folds 
pistaKKio23: folds 
nikolor: raises €0.06 to €0.08
caduceus369: calls €0.06
*** FLOP *** [8d 3h Ts]
nikolor: checks 
caduceus369: checks 
*** TURN *** [8d 3h Ts] [7s]
nikolor: checks 
caduceus369: bets €0.02
nikolor: calls €0.02
*** RIVER *** [8d 3h Ts 7s] [Js]
nikolor: checks 
caduceus369: bets €0.14
nikolor: folds 
Uncalled bet (€0.14) returned to caduceus369
caduceus369 collected €0.19 from pot
caduceus369: doesn't show hand 
*** SUMMARY ***
Total pot €0.20 | Rake €0.01 
Board [8d 3h Ts 7s Js]
Seat 1: pistaKKio23 (button) folded before Flop (didn't bet)
Seat 2: nikolor (small blind) folded on the River
Seat 3: caduceus369 (big blind) collected (€0.19)
Seat 4: ADRIAN0_MEIS folded before Flop (didn't bet)
Seat 5: mondie73100 folded before Flop (didn't bet)
Seat 6: robertoH2O folded before Flop (didn't bet)



PokerStars Zoom Hand #258039739195:  Hold'em No Limit (€0.01/€0.02) [ADM ID: M62C03044AE79CRJ] - 2025/10/08 0:34:11 CET [2025/10/07 18:34:11 ET]
Table 'Sirio' 6-max Seat #1 is the button
Seat 1: Sobolanumm (€1.94 in chips) 
Seat 2: caduceus369 (€4.97 in chips) 
Seat 3: SaTheNuts_77 (€1.59 in chips) 
Seat 4: fccmp (€1.38 in chips) 
Seat 5: Trombinho (€1.04 in chips) 
Seat 6: nikolor (€1.82 in chips) 
caduceus369: posts small blind €0.01
SaTheNuts_77: posts big blind €0.02
*** HOLE CARDS ***
Dealt to caduceus369 [7d 2d]
fccmp: folds 
Trombinho: folds 
nikolor: folds 
Sobolanumm: folds 
caduceus369: folds 
Uncalled bet (€0.01) returned to SaTheNuts_77
SaTheNuts_77 collected €0.02 from pot
SaTheNuts_77: doesn't show hand 
*** SUMMARY ***
Total pot €0.02 | Rake €0 
Seat 1: Sobolanumm (button) folded before Flop (didn't bet)
Seat 2: caduceus369 (small blind) folded before Flop
Seat 3: SaTheNuts_77 (big blind) collected (€0.02)
Seat 4: fccmp folded before Flop (didn't bet)
Seat 5: Trombinho folded before Flop (didn't bet)
Seat 6: nikolor folded before Flop (didn't bet)



PokerStars Zoom Hand #258039741221:  Hold'em No Limit (€0.01/€0.02) [ADM ID: M62C03044AE79CRJ] - 2025/10/08 0:34:21 CET [2025/10/07 18:34:21 ET]
Table 'Sirio' 6-max Seat #1 is the button
Seat 1: caduceus369 (€4.96 in chips) 
Seat 2: Poetto65 (€0.93 in chips) 
Seat 3: pistaKKio23 (€3.86 in chips) 
Seat 4: Trombinho (€1.04 in chips) 
Seat 5: fccmp (€1.38 in chips) 
Seat 6: mondie73100 (€6.01 in chips) 
Poetto65: posts small blind €0.01
pistaKKio23: posts big blind €0.02
*** HOLE CARDS ***
Dealt to caduceus369 [Kd 9d]
Trombinho: folds 
fccmp: calls €0.02
mondie73100: folds 
caduceus369: raises €0.06 to €0.08
Poetto65: folds 
pistaKKio23: folds 
fccmp: raises €1.30 to €1.38 and is all-in
caduceus369: folds 
Uncalled bet (€1.30) returned to fccmp
fccmp collected €0.19 from pot
fccmp: doesn't show hand 
*** SUMMARY ***
Total pot €0.19 | Rake €0 
Seat 1: caduceus369 (button) folded before Flop
Seat 2: Poetto65 (small blind) folded before Flop
Seat 3: pistaKKio23 (big blind) folded before Flop
Seat 4: Trombinho folded before Flop (didn't bet)
Seat 5: fccmp collected (€0.19)
Seat 6: mondie73100 folded before Flop (didn't bet)



PokerStars Zoom Hand #258039748330:  Hold'em No Limit (€0.01/€0.02) [ADM ID: M62C03044AE79CRJ] - 2025/10/08 0:34:57 CET [2025/10/07 18:34:57 ET]
Table 'Sirio' 6-max Seat #1 is the button
Seat 1: mashallahh (€7.54 in chips) 
Seat 2: mondie73100 (€6.01 in chips) 
Seat 3: fccmp (€1.49 in chips) 
Seat 4: Poetto65 (€0.92 in chips) 
Seat 5: fantaasso (€1.80 in chips) 
Seat 6: caduceus369 (€4.88 in chips) 
mondie73100: posts small blind €0.01
fccmp: posts big blind €0.02
*** HOLE CARDS ***
Dealt to caduceus369 [9h As]
Poetto65: folds 
fantaasso: folds 
caduceus369: raises €0.04 to €0.06
mashallahh: folds 
mondie73100: folds 
fccmp: folds 
Uncalled bet (€0.04) returned to caduceus369
caduceus369 collected €0.05 from pot
caduceus369: doesn't show hand 
*** SUMMARY ***
Total pot €0.05 | Rake €0 
Seat 1: mashallahh (button) folded before Flop (didn't bet)
Seat 2: mondie73100 (small blind) folded before Flop
Seat 3: fccmp (big blind) folded before Flop
Seat 4: Poetto65 folded before Flop (didn't bet)
Seat 5: fantaasso folded before Flop (didn't bet)
Seat 6: caduceus369 collected (€0.05)



PokerStars Zoom Hand #258039747024:  Hold'em No Limit (€0.01/€0.02) [ADM ID: M62C03044AE79CRJ] - 2025/10/08 0:34:50 CET [2025/10/07 18:34:50 ET]
Table 'Sirio' 6-max Seat #1 is the button
Seat 1: nikolor (€2.48 in chips) 
Seat 2: pistaKKio23 (€5.99 in chips) 
Seat 3: vesper622 (€4.57 in chips) 
Seat 4: mashallahh (€7.54 in chips) 
Seat 5: caduceus369 (€4.88 in chips) 
Seat 6: Trombinho (€1.03 in chips) 
pistaKKio23: posts small blind €0.01
vesper622: posts big blind €0.02
*** HOLE CARDS ***
Dealt to caduceus369 [7s 6d]
mashallahh: folds 
caduceus369: folds 
Trombinho: folds 
nikolor: raises €0.04 to €0.06
pistaKKio23: folds 
vesper622: calls €0.04
*** FLOP *** [Jc 7c 2h]
vesper622: checks 
nikolor: checks 
*** TURN *** [Jc 7c 2h] [Kd]
vesper622: checks 
nikolor: checks 
*** RIVER *** [Jc 7c 2h Kd] [9h]
vesper622: bets €0.04
nikolor: folds 
Uncalled bet (€0.04) returned to vesper622
vesper622 collected €0.13 from pot
vesper622: doesn't show hand 
*** SUMMARY ***
Total pot €0.13 | Rake €0 
Board [Jc 7c 2h Kd 9h]
Seat 1: nikolor (button) folded on the River
Seat 2: pistaKKio23 (small blind) folded before Flop
Seat 3: vesper622 (big blind) collected (€0.13)
Seat 4: mashallahh folded before Flop (didn't bet)
Seat 5: caduceus369 folded before Flop (didn't bet)
Seat 6: Trombinho folded before Flop (didn't bet)



PokerStars Zoom Hand #258039752823:  Hold'em No Limit (€0.01/€0.02) [ADM ID: M62C03044AE79CRJ] - 2025/10/08 0:35:19 CET [2025/10/07 18:35:19 ET]
Table 'Sirio' 6-max Seat #1 is the button
Seat 1: nikolor (€1.81 in chips) 
Seat 2: Sobolanumm (€0.67 in chips) 
Seat 3: mondie73100 (€6 in chips) 
Seat 4: fantaasso (€1.79 in chips) 
Seat 5: caduceus369 (€4.91 in chips) 
Seat 6: IlDestro71 (€1.08 in chips) 
Sobolanumm: posts small blind €0.01
mondie73100: posts big blind €0.02
*** HOLE CARDS ***
Dealt to caduceus369 [Kd Js]
fantaasso: folds 
caduceus369: raises €0.04 to €0.06
IlDestro71: calls €0.06
nikolor: folds 
Sobolanumm: calls €0.05
mondie73100: folds 
*** FLOP *** [Jc 6s 9d]
Sobolanumm: checks 
caduceus369: bets €0.10
IlDestro71: calls €0.10
Sobolanumm: folds 
*** TURN *** [Jc 6s 9d] [7d]
caduceus369: checks 
IlDestro71: checks 
*** RIVER *** [Jc 6s 9d 7d] [7h]
caduceus369: bets €0.31
IlDestro71: folds 
Uncalled bet (€0.31) returned to caduceus369
caduceus369 collected €0.38 from pot
caduceus369: doesn't show hand 
*** SUMMARY ***
Total pot €0.40 | Rake €0.02 
Board [Jc 6s 9d 7d 7h]
Seat 1: nikolor (button) folded before Flop (didn't bet)
Seat 2: Sobolanumm (small blind) folded on the Flop
Seat 3: mondie73100 (big blind) folded before Flop
Seat 4: fantaasso folded before Flop (didn't bet)
Seat 5: caduceus369 collected (€0.38)
Seat 6: IlDestro71 folded on the River



PokerStars Zoom Hand #258039763416:  Hold'em No Limit (€0.01/€0.02) [ADM ID: M62C03044AE79CRJ] - 2025/10/08 0:36:12 CET [2025/10/07 18:36:12 ET]
Table 'Sirio' 6-max Seat #1 is the button
Seat 1: RRgalp (€1.97 in chips) 
Seat 2: Emm3B1 (€2.93 in chips) 
Seat 3: caduceus369 (€5.13 in chips) 
Seat 4: stev@nin (€4.34 in chips) 
Seat 5: nikolor (€2.23 in chips) 
Seat 6: fantaasso (€1.79 in chips) 
Emm3B1: posts small blind €0.01
caduceus369: posts big blind €0.02
*** HOLE CARDS ***
Dealt to caduceus369 [9s 9h]
stev@nin: folds 
nikolor: folds 
fantaasso: folds 
RRgalp: raises €0.04 to €0.06
Emm3B1: folds 
caduceus369: calls €0.04
*** FLOP *** [9c 5s 4h]
caduceus369: checks 
RRgalp: bets €0.07
caduceus369: calls €0.07
*** TURN *** [9c 5s 4h] [3c]
caduceus369: checks 
RRgalp: bets €0.13
caduceus369: calls €0.13
*** RIVER *** [9c 5s 4h 3c] [2h]
caduceus369: checks 
RRgalp: checks 
*** SHOW DOWN ***
caduceus369: shows [9s 9h] (three of a kind, Nines)
RRgalp: mucks hand 
caduceus369 collected €0.51 from pot
*** SUMMARY ***
Total pot €0.53 | Rake €0.02 
Board [9c 5s 4h 3c 2h]
Seat 1: RRgalp (button) mucked [3d 4s]
Seat 2: Emm3B1 (small blind) folded before Flop
Seat 3: caduceus369 (big blind) showed [9s 9h] and won (€0.51) with three of a kind, Nines
Seat 4: stev@nin folded before Flop (didn't bet)
Seat 5: nikolor folded before Flop (didn't bet)
Seat 6: fantaasso folded before Flop (didn't bet)



PokerStars Zoom Hand #258039778561:  Hold'em No Limit (€0.01/€0.02) [ADM ID: M62C03044AE79CRJ] - 2025/10/08 0:37:27 CET [2025/10/07 18:37:27 ET]
Table 'Sirio' 6-max Seat #1 is the button
Seat 1: nikolor (€1.79 in chips) 
Seat 2: caduceus369 (€5.38 in chips) 
Seat 3: stev@nin (€4.33 in chips) 
Seat 4: RRgalp (€1.71 in chips) 
Seat 5: fccmp (€1.57 in chips) 
Seat 6: Emm3B1 (€2.33 in chips) 
caduceus369: posts small blind €0.01
stev@nin: posts big blind €0.02
*** HOLE CARDS ***
Dealt to caduceus369 [Qh 4d]
RRgalp: raises €0.04 to €0.06
fccmp: folds 
Emm3B1: folds 
nikolor: folds 
caduceus369: folds 
stev@nin: folds 
Uncalled bet (€0.04) returned to RRgalp
RRgalp collected €0.05 from pot
RRgalp: doesn't show hand 
*** SUMMARY ***
Total pot €0.05 | Rake €0 
Seat 1: nikolor (button) folded before Flop (didn't bet)
Seat 2: caduceus369 (small blind) folded before Flop
Seat 3: stev@nin (big blind) folded before Flop
Seat 4: RRgalp collected (€0.05)
Seat 5: fccmp folded before Flop (didn't bet)
Seat 6: Emm3B1 folded before Flop (didn't bet)



PokerStars Zoom Hand #258039782224:  Hold'em No Limit (€0.01/€0.02) [ADM ID: M62C03044AE79CRJ] - 2025/10/08 0:37:45 CET [2025/10/07 18:37:45 ET]
Table 'Sirio' 6-max Seat #1 is the button
Seat 1: caduceus369 (€5.37 in chips) 
Seat 2: pistaKKio23 (€1.74 in chips) 
Seat 3: xTheBulldogx (€0.73 in chips) 
Seat 4: nikolor (€1.78 in chips) 
Seat 5: fccmp (€1.56 in chips) 
Seat 6: mashallahh (€7.56 in chips) 
pistaKKio23: posts small blind €0.01
xTheBulldogx: posts big blind €0.02
*** HOLE CARDS ***
Dealt to caduceus369 [Kd 2c]
nikolor: folds 
fccmp: calls €0.02
mashallahh: folds 
caduceus369: folds 
pistaKKio23: calls €0.01
xTheBulldogx: checks 
*** FLOP *** [5d Ts Ac]
pistaKKio23: checks 
xTheBulldogx: checks 
fccmp: bets €0.06
pistaKKio23: calls €0.06
xTheBulldogx: folds 
*** TURN *** [5d Ts Ac] [Ah]
pistaKKio23: checks 
fccmp: bets €0.18
pistaKKio23: folds 
Uncalled bet (€0.18) returned to fccmp
fccmp collected €0.18 from pot
fccmp: doesn't show hand 
*** SUMMARY ***
Total pot €0.18 | Rake €0 
Board [5d Ts Ac Ah]
Seat 1: caduceus369 (button) folded before Flop (didn't bet)
Seat 2: pistaKKio23 (small blind) folded on the Turn
Seat 3: xTheBulldogx (big blind) folded on the Flop
Seat 4: nikolor folded before Flop (didn't bet)
Seat 5: fccmp collected (€0.18)
Seat 6: mashallahh folded before Flop (didn't bet)



PokerStars Zoom Hand #258039784116:  Hold'em No Limit (€0.01/€0.02) [ADM ID: M62C03044AE79CRJ] - 2025/10/08 0:37:55 CET [2025/10/07 18:37:55 ET]
Table 'Sirio' 6-max Seat #1 is the button
Seat 1: vesper622 (€4.02 in chips) 
Seat 2: DrPigna95 (€1.49 in chips) 
Seat 3: stev@nin (€7.43 in chips) 
Seat 4: ADRIAN0_MEIS (€25.80 in chips) 
Seat 5: caduceus369 (€5.37 in chips) 
Seat 6: SaTheNuts_77 (€1.62 in chips) 
DrPigna95: posts small blind €0.01
stev@nin: posts big blind €0.02
*** HOLE CARDS ***
Dealt to caduceus369 [Td 9d]
ADRIAN0_MEIS: raises €0.04 to €0.06
caduceus369: calls €0.06
SaTheNuts_77: folds 
vesper622: folds 
DrPigna95: folds 
stev@nin: folds 
*** FLOP *** [8s 4h Js]
ADRIAN0_MEIS: checks 
caduceus369: bets €0.05
ADRIAN0_MEIS: calls €0.05
*** TURN *** [8s 4h Js] [2h]
ADRIAN0_MEIS: checks 
caduceus369: bets €0.12
ADRIAN0_MEIS: folds 
Uncalled bet (€0.12) returned to caduceus369
caduceus369 collected €0.24 from pot
caduceus369: doesn't show hand 
*** SUMMARY ***
Total pot €0.25 | Rake €0.01 
Board [8s 4h Js 2h]
Seat 1: vesper622 (button) folded before Flop (didn't bet)
Seat 2: DrPigna95 (small blind) folded before Flop
Seat 3: stev@nin (big blind) folded before Flop
Seat 4: ADRIAN0_MEIS folded on the Turn
Seat 5: caduceus369 collected (€0.24)
Seat 6: SaTheNuts_77 folded before Flop (didn't bet)



PokerStars Zoom Hand #258039796777:  Hold'em No Limit (€0.01/€0.02) [ADM ID: M62C03044AE79CRJ] - 2025/10/08 0:38:57 CET [2025/10/07 18:38:57 ET]
Table 'Sirio' 6-max Seat #1 is the button
Seat 1: SaTheNuts_77 (€1.58 in chips) 
Seat 2: fantaasso (€1.72 in chips) 
Seat 3: fccmp (€1.66 in chips) 
Seat 4: ADRIAN0_MEIS (€25.69 in chips) 
Seat 5: Coffeebreak96 (€1.76 in chips) 
Seat 6: caduceus369 (€5.50 in chips) 
fantaasso: posts small blind €0.01
fccmp: posts big blind €0.02
*** HOLE CARDS ***
Dealt to caduceus369 [3c 5d]
ADRIAN0_MEIS: folds 
Coffeebreak96: folds 
caduceus369: folds 
SaTheNuts_77: raises €0.03 to €0.05
fantaasso: calls €0.04
fccmp: folds 
*** FLOP *** [Td 8h Jd]
fantaasso: bets €0.06
SaTheNuts_77: folds 
Uncalled bet (€0.06) returned to fantaasso
fantaasso collected €0.12 from pot
fantaasso: doesn't show hand 
*** SUMMARY ***
Total pot €0.12 | Rake €0 
Board [Td 8h Jd]
Seat 1: SaTheNuts_77 (button) folded on the Flop
Seat 2: fantaasso (small blind) collected (€0.12)
Seat 3: fccmp (big blind) folded before Flop
Seat 4: ADRIAN0_MEIS folded before Flop (didn't bet)
Seat 5: Coffeebreak96 folded before Flop (didn't bet)
Seat 6: caduceus369 folded before Flop (didn't bet)



PokerStars Zoom Hand #258039797939:  Hold'em No Limit (€0.01/€0.02) [ADM ID: M62C03044AE79CRJ] - 2025/10/08 0:39:03 CET [2025/10/07 18:39:03 ET]
Table 'Sirio' 6-max Seat #1 is the button
Seat 1: euno77 (€1.30 in chips) 
Seat 2: AlwaisToRun (€1.08 in chips) 
Seat 3: A_LUCCHESE_92 (€4.95 in chips) 
Seat 4: caduceus369 (€5.50 in chips) 
Seat 5: nikolor (€1.79 in chips) 
Seat 6: ADRIAN0_MEIS (€25.69 in chips) 
AlwaisToRun: posts small blind €0.01
A_LUCCHESE_92: posts big blind €0.02
*** HOLE CARDS ***
Dealt to caduceus369 [3h Kc]
caduceus369: folds 
nikolor: raises €0.06 to €0.08
ADRIAN0_MEIS: folds 
euno77: folds 
AlwaisToRun: folds 
A_LUCCHESE_92: folds 
Uncalled bet (€0.06) returned to nikolor
nikolor collected €0.05 from pot
nikolor: doesn't show hand 
*** SUMMARY ***
Total pot €0.05 | Rake €0 
Seat 1: euno77 (button) folded before Flop (didn't bet)
Seat 2: AlwaisToRun (small blind) folded before Flop
Seat 3: A_LUCCHESE_92 (big blind) folded before Flop
Seat 4: caduceus369 folded before Flop (didn't bet)
Seat 5: nikolor collected (€0.05)
Seat 6: ADRIAN0_MEIS folded before Flop (didn't bet)



PokerStars Zoom Hand #258039799686:  Hold'em No Limit (€0.01/€0.02) [ADM ID: M62C03044AE79CRJ] - 2025/10/08 0:39:12 CET [2025/10/07 18:39:12 ET]
Table 'Sirio' 6-max Seat #1 is the button
Seat 1: stev@nin (€7.43 in chips) 
Seat 2: manuknife (€0.78 in chips) 
Seat 3: caduceus369 (€5.50 in chips) 
Seat 4: Sobolanumm (€0.55 in chips) 
Seat 5: fccmp (€1.64 in chips) 
Seat 6: euno77 (€1.30 in chips) 
manuknife: posts small blind €0.01
caduceus369: posts big blind €0.02
*** HOLE CARDS ***
Dealt to caduceus369 [8s Ac]
Sobolanumm: folds 
fccmp: folds 
euno77: calls €0.02
stev@nin: folds 
manuknife: folds 
caduceus369: checks 
*** FLOP *** [2c 8d 9s]
caduceus369: checks 
euno77: checks 
*** TURN *** [2c 8d 9s] [Jc]
caduceus369: checks 
euno77: checks 
*** RIVER *** [2c 8d 9s Jc] [8h]
caduceus369: bets €0.06
euno77: calls €0.06
*** SHOW DOWN ***
caduceus369: shows [8s Ac] (three of a kind, Eights)
euno77: mucks hand 
caduceus369 collected €0.17 from pot
*** SUMMARY ***
Total pot €0.17 | Rake €0 
Board [2c 8d 9s Jc 8h]
Seat 1: stev@nin (button) folded before Flop (didn't bet)
Seat 2: manuknife (small blind) folded before Flop
Seat 3: caduceus369 (big blind) showed [8s Ac] and won (€0.17) with three of a kind, Eights
Seat 4: Sobolanumm folded before Flop (didn't bet)
Seat 5: fccmp folded before Flop (didn't bet)
Seat 6: euno77 mucked [7h 9h]



PokerStars Zoom Hand #258039808240:  Hold'em No Limit (€0.01/€0.02) [ADM ID: M62C03044AE79CRJ] - 2025/10/08 0:39:55 CET [2025/10/07 18:39:55 ET]
Table 'Sirio' 6-max Seat #1 is the button
Seat 1: caduceus369 (€5.59 in chips) 
Seat 2: RRgalp (€1.81 in chips) 
Seat 3: mashallahh (€4.88 in chips) 
Seat 4: Poetto65 (€0.79 in chips) 
Seat 5: fantaasso (€1.82 in chips) 
Seat 6: pistaKKio23 (€6.11 in chips) 
RRgalp: posts small blind €0.01
mashallahh: posts big blind €0.02
*** HOLE CARDS ***
Dealt to caduceus369 [As 5s]
Poetto65: folds 
fantaasso: folds 
pistaKKio23: raises €0.04 to €0.06
caduceus369: calls €0.06
RRgalp: raises €0.12 to €0.18
mashallahh: folds 
pistaKKio23: calls €0.12
caduceus369: calls €0.12
*** FLOP *** [3s Ac Td]
RRgalp: checks 
pistaKKio23: checks 
caduceus369: bets €0.13
RRgalp: raises €0.40 to €0.53
pistaKKio23: folds 
caduceus369: folds 
Uncalled bet (€0.40) returned to RRgalp
RRgalp collected €0.78 from pot
RRgalp: doesn't show hand 
*** SUMMARY ***
Total pot €0.82 | Rake €0.04 
Board [3s Ac Td]
Seat 1: caduceus369 (button) folded on the Flop
Seat 2: RRgalp (small blind) collected (€0.78)
Seat 3: mashallahh (big blind) folded before Flop
Seat 4: Poetto65 folded before Flop (didn't bet)
Seat 5: fantaasso folded before Flop (didn't bet)
Seat 6: pistaKKio23 folded on the Flop



PokerStars Zoom Hand #258039826471:  Hold'em No Limit (€0.01/€0.02) [ADM ID: M62C03044AE79CRJ] - 2025/10/08 0:41:27 CET [2025/10/07 18:41:27 ET]
Table 'Sirio' 6-max Seat #1 is the button
Seat 1: RRgalp (€2.28 in chips) 
Seat 2: caduceus369 (€5.28 in chips) 
Seat 3: SaTheNuts_77 (€1.51 in chips) 
Seat 4: pistaKKio23 (€4.45 in chips) 
Seat 5: Poetto65 (€1.45 in chips) 
Seat 6: mashallahh (€2.03 in chips) 
caduceus369: posts small blind €0.01
SaTheNuts_77: posts big blind €0.02
*** HOLE CARDS ***
Dealt to caduceus369 [Kc 7d]
pistaKKio23: folds 
Poetto65: raises €0.17 to €0.19
mashallahh: folds 
RRgalp: folds 
caduceus369: folds 
SaTheNuts_77: folds 
Uncalled bet (€0.17) returned to Poetto65
Poetto65 collected €0.05 from pot
Poetto65: doesn't show hand 
*** SUMMARY ***
Total pot €0.05 | Rake €0 
Seat 1: RRgalp (button) folded before Flop (didn't bet)
Seat 2: caduceus369 (small blind) folded before Flop
Seat 3: SaTheNuts_77 (big blind) folded before Flop
Seat 4: pistaKKio23 folded before Flop (didn't bet)
Seat 5: Poetto65 collected (€0.05)
Seat 6: mashallahh folded before Flop (didn't bet)



PokerStars Zoom Hand #258039824737:  Hold'em No Limit (€0.01/€0.02) [ADM ID: M62C03044AE79CRJ] - 2025/10/08 0:41:18 CET [2025/10/07 18:41:18 ET]
Table 'Sirio' 6-max Seat #1 is the button
Seat 1: AlwaisToRun (€0.95 in chips) 
Seat 2: QUATTRODAME (€1.57 in chips) 
Seat 3: fccmp (€1.65 in chips) 
Seat 4: SaTheNuts_77 (€1.51 in chips) 
Seat 5: caduceus369 (€5.28 in chips) 
Seat 6: pistaKKio23 (€1.98 in chips) 
QUATTRODAME: posts small blind €0.01
fccmp: posts big blind €0.02
*** HOLE CARDS ***
Dealt to caduceus369 [Qd 8h]
SaTheNuts_77: folds 
caduceus369: folds 
pistaKKio23: folds 
AlwaisToRun: calls €0.02
QUATTRODAME: folds 
fccmp: checks 
*** FLOP *** [Kd 6c 7s]
fccmp: checks 
AlwaisToRun: checks 
*** TURN *** [Kd 6c 7s] [As]
fccmp: checks 
AlwaisToRun: bets €0.02
fccmp: folds 
Uncalled bet (€0.02) returned to AlwaisToRun
AlwaisToRun collected €0.05 from pot
AlwaisToRun: doesn't show hand 
*** SUMMARY ***
Total pot €0.05 | Rake €0 
Board [Kd 6c 7s As]
Seat 1: AlwaisToRun (button) collected (€0.05)
Seat 2: QUATTRODAME (small blind) folded before Flop
Seat 3: fccmp (big blind) folded on the Turn
Seat 4: SaTheNuts_77 folded before Flop (didn't bet)
Seat 5: caduceus369 folded before Flop (didn't bet)
Seat 6: pistaKKio23 folded before Flop (didn't bet)



PokerStars Zoom Hand #258039830076:  Hold'em No Limit (€0.01/€0.02) [ADM ID: M62C03044AE79CRJ] - 2025/10/08 0:41:45 CET [2025/10/07 18:41:45 ET]
Table 'Sirio' 6-max Seat #1 is the button
Seat 1: SaTheNuts_77 (€1.49 in chips) 
Seat 2: mashallahh (€2.03 in chips) 
Seat 3: caduceus369 (€5.27 in chips) 
Seat 4: DrPigna95 (€1.67 in chips) 
Seat 5: QUATTRODAME (€1.56 in chips) 
Seat 6: RRgalp (€2.28 in chips) 
mashallahh: posts small blind €0.01
caduceus369: posts big blind €0.02
*** HOLE CARDS ***
Dealt to caduceus369 [5d 3s]
DrPigna95: folds 
QUATTRODAME has timed out
QUATTRODAME: folds 
RRgalp: folds 
SaTheNuts_77: folds 
mashallahh: folds 
Uncalled bet (€0.01) returned to caduceus369
caduceus369 collected €0.02 from pot
caduceus369: doesn't show hand 
*** SUMMARY ***
Total pot €0.02 | Rake €0 
Seat 1: SaTheNuts_77 (button) folded before Flop (didn't bet)
Seat 2: mashallahh (small blind) folded before Flop
Seat 3: caduceus369 (big blind) collected (€0.02)
Seat 4: DrPigna95 folded before Flop (didn't bet)
Seat 5: QUATTRODAME folded before Flop (didn't bet)
Seat 6: RRgalp folded before Flop (didn't bet)



PokerStars Zoom Hand #258039828832:  Hold'em No Limit (€0.01/€0.02) [ADM ID: M62C03044AE79CRJ] - 2025/10/08 0:41:39 CET [2025/10/07 18:41:39 ET]
Table 'Sirio' 6-max Seat #1 is the button
Seat 1: QUATTRODAME (€1.56 in chips) 
Seat 2: pistaKKio23 (€4.45 in chips) 
Seat 3: fantaasso (€1.65 in chips) 
Seat 4: sebaparhasar84 (€2.38 in chips) 
Seat 5: DrPigna95 (€1.67 in chips) 
Seat 6: caduceus369 (€5.27 in chips) 
pistaKKio23: posts small blind €0.01
fantaasso: posts big blind €0.02
*** HOLE CARDS ***
Dealt to caduceus369 [8s Qd]
sebaparhasar84: calls €0.02
DrPigna95: folds 
caduceus369: folds 
QUATTRODAME: folds 
pistaKKio23: calls €0.01
fantaasso: checks 
*** FLOP *** [7d 8c 3h]
pistaKKio23: checks 
fantaasso: bets €0.03
sebaparhasar84: calls €0.03
pistaKKio23: folds 
*** TURN *** [7d 8c 3h] [Ad]
fantaasso: checks 
sebaparhasar84: checks 
*** RIVER *** [7d 8c 3h Ad] [7h]
fantaasso: checks 
sebaparhasar84: checks 
*** SHOW DOWN ***
fantaasso: shows [6d 8d] (two pair, Eights and Sevens)
sebaparhasar84: mucks hand 
fantaasso collected €0.12 from pot
*** SUMMARY ***
Total pot €0.12 | Rake €0 
Board [7d 8c 3h Ad 7h]
Seat 1: QUATTRODAME (button) folded before Flop (didn't bet)
Seat 2: pistaKKio23 (small blind) folded on the Flop
Seat 3: fantaasso (big blind) showed [6d 8d] and won (€0.12) with two pair, Eights and Sevens
Seat 4: sebaparhasar84 mucked [6s 6h]
Seat 5: DrPigna95 folded before Flop (didn't bet)
Seat 6: caduceus369 folded before Flop (didn't bet)



PokerStars Zoom Hand #258039827683:  Hold'em No Limit (€0.01/€0.02) [ADM ID: M62C03044AE79CRJ] - 2025/10/08 0:41:33 CET [2025/10/07 18:41:33 ET]
Table 'Sirio' 6-max Seat #1 is the button
Seat 1: IsyP99 (€1.37 in chips) 
Seat 2: pistaKKio23 (€1.98 in chips) 
Seat 3: A_LUCCHESE_92 (€4.91 in chips) 
Seat 4: caduceus369 (€5.27 in chips) 
Seat 5: sebaparhasar84 (€2.38 in chips) 
Seat 6: fantaasso (€1.65 in chips) 
pistaKKio23: posts small blind €0.01
A_LUCCHESE_92: posts big blind €0.02
*** HOLE CARDS ***
Dealt to caduceus369 [2d 6s]
caduceus369: folds 
sebaparhasar84: folds 
fantaasso: folds 
IsyP99: calls €0.02
pistaKKio23: calls €0.01
A_LUCCHESE_92: checks 
*** FLOP *** [9s Jd 9d]
pistaKKio23: checks 
A_LUCCHESE_92: checks 
IsyP99: checks 
*** TURN *** [9s Jd 9d] [Ks]
pistaKKio23: checks 
A_LUCCHESE_92: checks 
IsyP99: checks 
*** RIVER *** [9s Jd 9d Ks] [Ad]
pistaKKio23: checks 
A_LUCCHESE_92: checks 
IsyP99: bets €0.06
pistaKKio23: folds 
A_LUCCHESE_92: folds 
Uncalled bet (€0.06) returned to IsyP99
IsyP99 collected €0.06 from pot
IsyP99: doesn't show hand 
*** SUMMARY ***
Total pot €0.06 | Rake €0 
Board [9s Jd 9d Ks Ad]
Seat 1: IsyP99 (button) collected (€0.06)
Seat 2: pistaKKio23 (small blind) folded on the River
Seat 3: A_LUCCHESE_92 (big blind) folded on the River
Seat 4: caduceus369 folded before Flop (didn't bet)
Seat 5: sebaparhasar84 folded before Flop (didn't bet)
Seat 6: fantaasso folded before Flop (didn't bet)



PokerStars Zoom Hand #258039833990:  Hold'em No Limit (€0.01/€0.02) [ADM ID: M62C03044AE79CRJ] - 2025/10/08 0:42:05 CET [2025/10/07 18:42:05 ET]
Table 'Sirio' 6-max Seat #1 is the button
Seat 1: pistaKKio23 (€4.43 in chips) 
Seat 2: caduceus369 (€5.28 in chips) 
Seat 3: stev@nin (€7.62 in chips) 
Seat 4: PIRULO1235 (€1.68 in chips) 
Seat 5: xTheBulldogx (€0.56 in chips) 
Seat 6: SaTheNuts_77 (€1.48 in chips) 
caduceus369: posts small blind €0.01
stev@nin: posts big blind €0.02
*** HOLE CARDS ***
Dealt to caduceus369 [Jc Ac]
PIRULO1235: folds 
xTheBulldogx: folds 
SaTheNuts_77: folds 
pistaKKio23: folds 
caduceus369: raises €0.04 to €0.06
stev@nin: calls €0.04
*** FLOP *** [3h 2d 8d]
caduceus369: checks 
stev@nin: checks 
*** TURN *** [3h 2d 8d] [Jd]
caduceus369: checks 
stev@nin: checks 
*** RIVER *** [3h 2d 8d Jd] [9d]
caduceus369: bets €0.06
stev@nin: folds 
Uncalled bet (€0.06) returned to caduceus369
caduceus369 collected €0.12 from pot
caduceus369: doesn't show hand 
*** SUMMARY ***
Total pot €0.12 | Rake €0 
Board [3h 2d 8d Jd 9d]
Seat 1: pistaKKio23 (button) folded before Flop (didn't bet)
Seat 2: caduceus369 (small blind) collected (€0.12)
Seat 3: stev@nin (big blind) folded on the River
Seat 4: PIRULO1235 folded before Flop (didn't bet)
Seat 5: xTheBulldogx folded before Flop (didn't bet)
Seat 6: SaTheNuts_77 folded before Flop (didn't bet)



PokerStars Zoom Hand #258039846367:  Hold'em No Limit (€0.01/€0.02) [ADM ID: M62C03044AE79CRJ] - 2025/10/08 0:43:09 CET [2025/10/07 18:43:09 ET]
Table 'Sirio' 6-max Seat #1 is the button
Seat 1: caduceus369 (€5.34 in chips) 
Seat 2: Sobolanumm (€1.44 in chips) 
Seat 3: SaTheNuts_77 (€1.48 in chips) 
Seat 4: pistaKKio23 (€5.70 in chips) 
Seat 5: A_LUCCHESE_92 (€4.89 in chips) 
Seat 6: stev@nin (€7.56 in chips) 
Sobolanumm: posts small blind €0.01
SaTheNuts_77: posts big blind €0.02
*** HOLE CARDS ***
Dealt to caduceus369 [Ks Kh]
pistaKKio23: folds 
A_LUCCHESE_92: folds 
stev@nin: folds 
caduceus369: raises €0.04 to €0.06
Sobolanumm: folds 
SaTheNuts_77: folds 
Uncalled bet (€0.04) returned to caduceus369
caduceus369 collected €0.05 from pot
caduceus369: doesn't show hand 
*** SUMMARY ***
Total pot €0.05 | Rake €0 
Seat 1: caduceus369 (button) collected (€0.05)
Seat 2: Sobolanumm (small blind) folded before Flop
Seat 3: SaTheNuts_77 (big blind) folded before Flop
Seat 4: pistaKKio23 folded before Flop (didn't bet)
Seat 5: A_LUCCHESE_92 folded before Flop (didn't bet)
Seat 6: stev@nin folded before Flop (didn't bet)



PokerStars Zoom Hand #258039844812:  Hold'em No Limit (€0.01/€0.02) [ADM ID: M62C03044AE79CRJ] - 2025/10/08 0:43:01 CET [2025/10/07 18:43:01 ET]
Table 'Sirio' 6-max Seat #1 is the button
Seat 1: PIRULO1235 (€1.66 in chips) 
Seat 2: pistaKKio23 (€4.41 in chips) 
Seat 3: Coffeebreak96 (€2.25 in chips) 
Seat 4: caduceus369 (€5.34 in chips) 
Seat 5: mashallahh (€2 in chips) 
Seat 6: IlDestro71 (€0.68 in chips) 
pistaKKio23: posts small blind €0.01
Coffeebreak96: posts big blind €0.02
*** HOLE CARDS ***
Dealt to caduceus369 [7h 8c]
caduceus369: folds 
mashallahh: folds 
IlDestro71: calls €0.02
PIRULO1235: folds 
pistaKKio23: calls €0.01
Coffeebreak96: checks 
*** FLOP *** [Kh Qd 6d]
pistaKKio23: checks 
Coffeebreak96: checks 
IlDestro71: checks 
*** TURN *** [Kh Qd 6d] [Kd]
pistaKKio23: checks 
Coffeebreak96: checks 
IlDestro71: bets €0.02
pistaKKio23: folds 
Coffeebreak96: calls €0.02
*** RIVER *** [Kh Qd 6d Kd] [8h]
Coffeebreak96: checks 
IlDestro71: checks 
*** SHOW DOWN ***
Coffeebreak96: shows [3s 7d] (a pair of Kings)
IlDestro71: shows [Jc 7c] (a pair of Kings - Queen+Jack kicker)
IlDestro71 collected €0.10 from pot
*** SUMMARY ***
Total pot €0.10 | Rake €0 
Board [Kh Qd 6d Kd 8h]
Seat 1: PIRULO1235 (button) folded before Flop (didn't bet)
Seat 2: pistaKKio23 (small blind) folded on the Turn
Seat 3: Coffeebreak96 (big blind) showed [3s 7d] and lost with a pair of Kings
Seat 4: caduceus369 folded before Flop (didn't bet)
Seat 5: mashallahh folded before Flop (didn't bet)
Seat 6: IlDestro71 showed [Jc 7c] and won (€0.10) with a pair of Kings



PokerStars Zoom Hand #258039851938:  Hold'em No Limit (€0.01/€0.02) [ADM ID: M62C03044AE79CRJ] - 2025/10/08 0:43:37 CET [2025/10/07 18:43:37 ET]
Table 'Sirio' 6-max Seat #1 is the button
Seat 1: xTheBulldogx (€0.40 in chips) 
Seat 2: Poetto65 (€1.61 in chips) 
Seat 3: caduceus369 (€5.37 in chips) 
Seat 4: mashallahh (€8.06 in chips) 
Seat 5: SaTheNuts_77 (€1.46 in chips) 
Seat 6: pistaKKio23 (€2.02 in chips) 
Poetto65: posts small blind €0.01
caduceus369: posts big blind €0.02
*** HOLE CARDS ***
Dealt to caduceus369 [Ad 9d]
mashallahh: folds 
SaTheNuts_77: folds 
pistaKKio23: folds 
xTheBulldogx: raises €0.04 to €0.06
Poetto65: folds 
caduceus369: calls €0.04
*** FLOP *** [5h 8c Js]
caduceus369: checks 
xTheBulldogx: bets €0.06
caduceus369: folds 
Uncalled bet (€0.06) returned to xTheBulldogx
xTheBulldogx collected €0.13 from pot
xTheBulldogx: doesn't show hand 
*** SUMMARY ***
Total pot €0.13 | Rake €0 
Board [5h 8c Js]
Seat 1: xTheBulldogx (button) collected (€0.13)
Seat 2: Poetto65 (small blind) folded before Flop
Seat 3: caduceus369 (big blind) folded on the Flop
Seat 4: mashallahh folded before Flop (didn't bet)
Seat 5: SaTheNuts_77 folded before Flop (didn't bet)
Seat 6: pistaKKio23 folded before Flop (didn't bet)



PokerStars Zoom Hand #258039856268:  Hold'em No Limit (€0.01/€0.02) [ADM ID: M62C03044AE79CRJ] - 2025/10/08 0:44:00 CET [2025/10/07 18:44:00 ET]
Table 'Sirio' 6-max Seat #1 is the button
Seat 1: ADRIAN0_MEIS (€24.96 in chips) 
Seat 2: Coffeebreak96 (€2.21 in chips) 
Seat 3: mashallahh (€2.02 in chips) 
Seat 4: mondie73100 (€3.80 in chips) 
Seat 5: fccmp (€1.60 in chips) 
Seat 6: caduceus369 (€5.31 in chips) 
Coffeebreak96: posts small blind €0.01
mashallahh: posts big blind €0.02
*** HOLE CARDS ***
Dealt to caduceus369 [6d Js]
mondie73100: folds 
fccmp: folds 
caduceus369: folds 
ADRIAN0_MEIS: folds 
Coffeebreak96: folds 
Uncalled bet (€0.01) returned to mashallahh
mashallahh collected €0.02 from pot
mashallahh: doesn't show hand 
*** SUMMARY ***
Total pot €0.02 | Rake €0 
Seat 1: ADRIAN0_MEIS (button) folded before Flop (didn't bet)
Seat 2: Coffeebreak96 (small blind) folded before Flop
Seat 3: mashallahh (big blind) collected (€0.02)
Seat 4: mondie73100 folded before Flop (didn't bet)
Seat 5: fccmp folded before Flop (didn't bet)
Seat 6: caduceus369 folded before Flop (didn't bet)



PokerStars Zoom Hand #258039858574:  Hold'em No Limit (€0.01/€0.02) [ADM ID: M62C03044AE79CRJ] - 2025/10/08 0:44:12 CET [2025/10/07 18:44:12 ET]
Table 'Sirio' 6-max Seat #1 is the button
Seat 1: caduceus369 (€5.31 in chips) 
Seat 2: SaTheNuts_77 (€1.49 in chips) 
Seat 3: mondie73100 (€3.80 in chips) 
Seat 4: sebaparhasar84 (€2.32 in chips) 
Seat 5: Coffeebreak96 (€2.20 in chips) 
Seat 6: Poetto65 (€1.60 in chips) 
SaTheNuts_77: posts small blind €0.01
mondie73100: posts big blind €0.02
*** HOLE CARDS ***
Dealt to caduceus369 [Ac 5s]
sebaparhasar84: folds 
Coffeebreak96: folds 
Poetto65: folds 
caduceus369: raises €0.04 to €0.06
SaTheNuts_77: raises €0.14 to €0.20
mondie73100: folds 
caduceus369: folds 
Uncalled bet (€0.14) returned to SaTheNuts_77
SaTheNuts_77 collected €0.14 from pot
SaTheNuts_77: doesn't show hand 
*** SUMMARY ***
Total pot €0.14 | Rake €0 
Seat 1: caduceus369 (button) folded before Flop
Seat 2: SaTheNuts_77 (small blind) collected (€0.14)
Seat 3: mondie73100 (big blind) folded before Flop
Seat 4: sebaparhasar84 folded before Flop (didn't bet)
Seat 5: Coffeebreak96 folded before Flop (didn't bet)
Seat 6: Poetto65 folded before Flop (didn't bet)



PokerStars Zoom Hand #258039864176:  Hold'em No Limit (€0.01/€0.02) [ADM ID: M62C03044AE79CRJ] - 2025/10/08 0:44:41 CET [2025/10/07 18:44:41 ET]
Table 'Sirio' 6-max Seat #1 is the button
Seat 1: fantaasso (€1.68 in chips) 
Seat 2: mondie73100 (€3.78 in chips) 
Seat 3: ADRIAN0_MEIS (€24.96 in chips) 
Seat 4: pistaKKio23 (€2.01 in chips) 
Seat 5: caduceus369 (€5.25 in chips) 
Seat 6: mashallahh (€3.47 in chips) 
mondie73100: posts small blind €0.01
ADRIAN0_MEIS: posts big blind €0.02
*** HOLE CARDS ***
Dealt to caduceus369 [Kh 6s]
pistaKKio23: folds 
caduceus369: folds 
mashallahh: raises €0.04 to €0.06
fantaasso: folds 
mondie73100: folds 
ADRIAN0_MEIS: folds 
Uncalled bet (€0.04) returned to mashallahh
mashallahh collected €0.05 from pot
mashallahh: doesn't show hand 
*** SUMMARY ***
Total pot €0.05 | Rake €0 
Seat 1: fantaasso (button) folded before Flop (didn't bet)
Seat 2: mondie73100 (small blind) folded before Flop
Seat 3: ADRIAN0_MEIS (big blind) folded before Flop
Seat 4: pistaKKio23 folded before Flop (didn't bet)
Seat 5: caduceus369 folded before Flop (didn't bet)
Seat 6: mashallahh collected (€0.05)



PokerStars Zoom Hand #258039865962:  Hold'em No Limit (€0.01/€0.02) [ADM ID: M62C03044AE79CRJ] - 2025/10/08 0:44:50 CET [2025/10/07 18:44:50 ET]
Table 'Sirio' 6-max Seat #1 is the button
Seat 1: SaTheNuts_77 (€1.57 in chips) 
Seat 2: caduceus369 (€5.25 in chips) 
Seat 3: mashallahh (€8.05 in chips) 
Seat 4: pistaKKio23 (€2.01 in chips) 
Seat 5: stev@nin (€4.44 in chips) 
Seat 6: RRgalp (€2.49 in chips) 
caduceus369: posts small blind €0.01
mashallahh: posts big blind €0.02
*** HOLE CARDS ***
Dealt to caduceus369 [9c 5c]
pistaKKio23: folds 
stev@nin: raises €0.04 to €0.06
RRgalp: folds 
SaTheNuts_77: folds 
caduceus369: folds 
mashallahh: folds 
Uncalled bet (€0.04) returned to stev@nin
stev@nin collected €0.05 from pot
stev@nin: doesn't show hand 
*** SUMMARY ***
Total pot €0.05 | Rake €0 
Seat 1: SaTheNuts_77 (button) folded before Flop (didn't bet)
Seat 2: caduceus369 (small blind) folded before Flop
Seat 3: mashallahh (big blind) folded before Flop
Seat 4: pistaKKio23 folded before Flop (didn't bet)
Seat 5: stev@nin collected (€0.05)
Seat 6: RRgalp folded before Flop (didn't bet)



PokerStars Zoom Hand #258039869654:  Hold'em No Limit (€0.01/€0.02) [ADM ID: M62C03044AE79CRJ] - 2025/10/08 0:45:09 CET [2025/10/07 18:45:09 ET]
Table 'Sirio' 6-max Seat #1 is the button
Seat 1: bravo1270 (€0.80 in chips) 
Seat 2: DrPigna95 (€1.80 in chips) 
Seat 3: PIRULO1235 (€1.72 in chips) 
Seat 4: Emm3B1 (€2.35 in chips) 
Seat 5: caduceus369 (€5.24 in chips) 
Seat 6: fccmp (€1.55 in chips) 
DrPigna95: posts small blind €0.01
PIRULO1235: posts big blind €0.02
*** HOLE CARDS ***
Dealt to caduceus369 [3d 3h]
Emm3B1: raises €0.04 to €0.06
caduceus369: folds 
fccmp: folds 
bravo1270: folds 
DrPigna95: calls €0.05
PIRULO1235: folds 
*** FLOP *** [Ah Kh Qd]
DrPigna95: checks 
Emm3B1: bets €0.04
DrPigna95: folds 
Uncalled bet (€0.04) returned to Emm3B1
Emm3B1 collected €0.14 from pot
Emm3B1: doesn't show hand 
*** SUMMARY ***
Total pot €0.14 | Rake €0 
Board [Ah Kh Qd]
Seat 1: bravo1270 (button) folded before Flop (didn't bet)
Seat 2: DrPigna95 (small blind) folded on the Flop
Seat 3: PIRULO1235 (big blind) folded before Flop
Seat 4: Emm3B1 collected (€0.14)
Seat 5: caduceus369 folded before Flop (didn't bet)
Seat 6: fccmp folded before Flop (didn't bet)



PokerStars Zoom Hand #258039871797:  Hold'em No Limit (€0.01/€0.02) [ADM ID: M62C03044AE79CRJ] - 2025/10/08 0:45:20 CET [2025/10/07 18:45:20 ET]
Table 'Sirio' 6-max Seat #1 is the button
Seat 1: Coffeebreak96 (€2.13 in chips) 
Seat 2: stev@nin (€4.47 in chips) 
Seat 3: xebarpz4400 (€0.80 in chips) 
Seat 4: caduceus369 (€5.24 in chips) 
Seat 5: fccmp (€1.55 in chips) 
Seat 6: pistaKKio23 (€5.66 in chips) 
stev@nin: posts small blind €0.01
xebarpz4400: posts big blind €0.02
*** HOLE CARDS ***
Dealt to caduceus369 [8d 9s]
caduceus369: folds 
fccmp: folds 
pistaKKio23: folds 
Coffeebreak96: folds 
stev@nin: folds 
Uncalled bet (€0.01) returned to xebarpz4400
xebarpz4400 collected €0.02 from pot
xebarpz4400: doesn't show hand 
*** SUMMARY ***
Total pot €0.02 | Rake €0 
Seat 1: Coffeebreak96 (button) folded before Flop (didn't bet)
Seat 2: stev@nin (small blind) folded before Flop
Seat 3: xebarpz4400 (big blind) collected (€0.02)
Seat 4: caduceus369 folded before Flop (didn't bet)
Seat 5: fccmp folded before Flop (didn't bet)
Seat 6: pistaKKio23 folded before Flop (didn't bet)



PokerStars Zoom Hand #258039873723:  Hold'em No Limit (€0.01/€0.02) [ADM ID: M62C03044AE79CRJ] - 2025/10/08 0:45:30 CET [2025/10/07 18:45:30 ET]
Table 'Sirio' 6-max Seat #1 is the button
Seat 1: fccmp (€1.54 in chips) 
Seat 2: Poetto65 (€1.56 in chips) 
Seat 3: pistaKKio23 (€4.50 in chips) 
Seat 4: mashallahh (€3.49 in chips) 
Seat 5: Emm3B1 (€2.43 in chips) 
Seat 6: caduceus369 (€5.24 in chips) 
Poetto65: posts small blind €0.01
pistaKKio23: posts big blind €0.02
*** HOLE CARDS ***
Dealt to caduceus369 [6s 3d]
mashallahh: folds 
Emm3B1: folds 
caduceus369: folds 
fccmp: folds 
Poetto65: folds 
Uncalled bet (€0.01) returned to pistaKKio23
pistaKKio23 collected €0.02 from pot
pistaKKio23: doesn't show hand 
*** SUMMARY ***
Total pot €0.02 | Rake €0 
Seat 1: fccmp (button) folded before Flop (didn't bet)
Seat 2: Poetto65 (small blind) folded before Flop
Seat 3: pistaKKio23 (big blind) collected (€0.02)
Seat 4: mashallahh folded before Flop (didn't bet)
Seat 5: Emm3B1 folded before Flop (didn't bet)
Seat 6: caduceus369 folded before Flop (didn't bet)



PokerStars Zoom Hand #258039867764:  Hold'em No Limit (€0.01/€0.02) [ADM ID: M62C03044AE79CRJ] - 2025/10/08 0:44:59 CET [2025/10/07 18:44:59 ET]
Table 'Sirio' 6-max Seat #1 is the button
Seat 1: pistaKKio23 (€5.66 in chips) 
Seat 2: mondie73100 (€2.70 in chips) 
Seat 3: RRgalp (€2.49 in chips) 
Seat 4: caduceus369 (€5.24 in chips) 
Seat 5: fccmp (€1.55 in chips) 
Seat 6: xTheBulldogx (€0.45 in chips) 
mondie73100: posts small blind €0.01
RRgalp: posts big blind €0.02
*** HOLE CARDS ***
Dealt to caduceus369 [Kc 2c]
caduceus369: folds 
fccmp: folds 
xTheBulldogx: calls €0.02
pistaKKio23: folds 
mondie73100: calls €0.01
RRgalp: checks 
*** FLOP *** [As Qh 5d]
mondie73100: checks 
RRgalp: checks 
xTheBulldogx: bets €0.02
mondie73100: folds 
RRgalp: folds 
Uncalled bet (€0.02) returned to xTheBulldogx
xTheBulldogx collected €0.06 from pot
xTheBulldogx: doesn't show hand 
*** SUMMARY ***
Total pot €0.06 | Rake €0 
Board [As Qh 5d]
Seat 1: pistaKKio23 (button) folded before Flop (didn't bet)
Seat 2: mondie73100 (small blind) folded on the Flop
Seat 3: RRgalp (big blind) folded on the Flop
Seat 4: caduceus369 folded before Flop (didn't bet)
Seat 5: fccmp folded before Flop (didn't bet)
Seat 6: xTheBulldogx collected (€0.06)



PokerStars Zoom Hand #258039875430:  Hold'em No Limit (€0.01/€0.02) [ADM ID: M62C03044AE79CRJ] - 2025/10/08 0:45:39 CET [2025/10/07 18:45:39 ET]
Table 'Sirio' 6-max Seat #1 is the button
Seat 1: ADRIAN0_MEIS (€25.02 in chips) 
Seat 2: xebarpz4400 (€0.81 in chips) 
Seat 3: caduceus369 (€5.24 in chips) 
Seat 4: mashallahh (€2.03 in chips) 
Seat 5: pistaKKio23 (€5.66 in chips) 
Seat 6: stev@nin (€7.91 in chips) 
xebarpz4400: posts small blind €0.01
caduceus369: posts big blind €0.02
*** HOLE CARDS ***
Dealt to caduceus369 [7d Jh]
mashallahh: folds 
pistaKKio23: raises €0.02 to €0.04
stev@nin: folds 
ADRIAN0_MEIS: calls €0.04
xebarpz4400: folds 
caduceus369: calls €0.02
*** FLOP *** [7h 8h 3s]
caduceus369: checks 
pistaKKio23: bets €0.07
ADRIAN0_MEIS: calls €0.07
caduceus369: folds 
*** TURN *** [7h 8h 3s] [Qc]
pistaKKio23: checks 
ADRIAN0_MEIS: checks 
*** RIVER *** [7h 8h 3s Qc] [Jd]
pistaKKio23: checks 
ADRIAN0_MEIS: checks 
*** SHOW DOWN ***
pistaKKio23: shows [4h 4c] (a pair of Fours)
ADRIAN0_MEIS: shows [5c 5s] (a pair of Fives)
ADRIAN0_MEIS collected €0.26 from pot
*** SUMMARY ***
Total pot €0.27 | Rake €0.01 
Board [7h 8h 3s Qc Jd]
Seat 1: ADRIAN0_MEIS (button) showed [5c 5s] and won (€0.26) with a pair of Fives
Seat 2: xebarpz4400 (small blind) folded before Flop
Seat 3: caduceus369 (big blind) folded on the Flop
Seat 4: mashallahh folded before Flop (didn't bet)
Seat 5: pistaKKio23 showed [4h 4c] and lost with a pair of Fours
Seat 6: stev@nin folded before Flop (didn't bet)



PokerStars Zoom Hand #258039886551:  Hold'em No Limit (€0.01/€0.02) [ADM ID: M62C03044AE79CRJ] - 2025/10/08 0:46:36 CET [2025/10/07 18:46:36 ET]
Table 'Sirio' 6-max Seat #1 is the button
Seat 1: RRgalp (€2.46 in chips) 
Seat 2: pistaKKio23 (€5.55 in chips) 
Seat 3: ADRIAN0_MEIS (€25.17 in chips) 
Seat 4: caduceus369 (€5.20 in chips) 
Seat 5: SaTheNuts_77 (€1.60 in chips) 
Seat 6: mashallahh (€2 in chips) 
pistaKKio23: posts small blind €0.01
ADRIAN0_MEIS: posts big blind €0.02
*** HOLE CARDS ***
Dealt to caduceus369 [Ac 9s]
caduceus369: folds 
SaTheNuts_77: folds 
mashallahh: folds 
RRgalp: folds 
pistaKKio23: folds 
Uncalled bet (€0.01) returned to ADRIAN0_MEIS
ADRIAN0_MEIS collected €0.02 from pot
ADRIAN0_MEIS: doesn't show hand 
*** SUMMARY ***
Total pot €0.02 | Rake €0 
Seat 1: RRgalp (button) folded before Flop (didn't bet)
Seat 2: pistaKKio23 (small blind) folded before Flop
Seat 3: ADRIAN0_MEIS (big blind) collected (€0.02)
Seat 4: caduceus369 folded before Flop (didn't bet)
Seat 5: SaTheNuts_77 folded before Flop (didn't bet)
Seat 6: mashallahh folded before Flop (didn't bet)



PokerStars Zoom Hand #258039889040:  Hold'em No Limit (€0.01/€0.02) [ADM ID: M62C03044AE79CRJ] - 2025/10/08 0:46:49 CET [2025/10/07 18:46:49 ET]
Table 'Sirio' 6-max Seat #1 is the button
Seat 1: xebarpz4400 (€0.78 in chips) 
Seat 2: caduceus369 (€5.20 in chips) 
Seat 3: mashallahh (€4.86 in chips) 
Seat 4: sebaparhasar84 (€2.50 in chips) 
Seat 5: RRgalp (€2.46 in chips) 
Seat 6: Coffeebreak96 (€2.09 in chips) 
caduceus369: posts small blind €0.01
mashallahh: posts big blind €0.02
*** HOLE CARDS ***
Dealt to caduceus369 [7h Ad]
sebaparhasar84: folds 
RRgalp: folds 
Coffeebreak96: folds 
xebarpz4400: raises €0.02 to €0.04
caduceus369: folds 
mashallahh: folds 
Uncalled bet (€0.02) returned to xebarpz4400
xebarpz4400 collected €0.05 from pot
xebarpz4400: doesn't show hand 
*** SUMMARY ***
Total pot €0.05 | Rake €0 
Seat 1: xebarpz4400 (button) collected (€0.05)
Seat 2: caduceus369 (small blind) folded before Flop
Seat 3: mashallahh (big blind) folded before Flop
Seat 4: sebaparhasar84 folded before Flop (didn't bet)
Seat 5: RRgalp folded before Flop (didn't bet)
Seat 6: Coffeebreak96 folded before Flop (didn't bet)



PokerStars Zoom Hand #258039889994:  Hold'em No Limit (€0.01/€0.02) [ADM ID: M62C03044AE79CRJ] - 2025/10/08 0:46:54 CET [2025/10/07 18:46:54 ET]
Table 'Sirio' 6-max Seat #1 is the button
Seat 1: caduceus369 (€5.19 in chips) 
Seat 2: ADRIAN0_MEIS (€25.18 in chips) 
Seat 3: sebaparhasar84 (€2.50 in chips) 
Seat 4: IlDestro71 (€0.68 in chips) 
Seat 5: Coffeebreak96 (€2.09 in chips) 
Seat 6: fantaasso (€1.57 in chips) 
ADRIAN0_MEIS: posts small blind €0.01
sebaparhasar84: posts big blind €0.02
*** HOLE CARDS ***
Dealt to caduceus369 [8s Ks]
IlDestro71: calls €0.02
Coffeebreak96: folds 
fantaasso: folds 
caduceus369: raises €0.04 to €0.06
ADRIAN0_MEIS: folds 
sebaparhasar84: folds 
IlDestro71: folds 
Uncalled bet (€0.04) returned to caduceus369
caduceus369 collected €0.07 from pot
caduceus369: doesn't show hand 
*** SUMMARY ***
Total pot €0.07 | Rake €0 
Seat 1: caduceus369 (button) collected (€0.07)
Seat 2: ADRIAN0_MEIS (small blind) folded before Flop
Seat 3: sebaparhasar84 (big blind) folded before Flop
Seat 4: IlDestro71 folded before Flop
Seat 5: Coffeebreak96 folded before Flop (didn't bet)
Seat 6: fantaasso folded before Flop (didn't bet)



PokerStars Zoom Hand #258039894821:  Hold'em No Limit (€0.01/€0.02) [ADM ID: M62C03044AE79CRJ] - 2025/10/08 0:47:19 CET [2025/10/07 18:47:19 ET]
Table 'Sirio' 6-max Seat #1 is the button
Seat 1: PIRULO1235 (€2.32 in chips) 
Seat 2: fantaasso (€1.57 in chips) 
Seat 3: pistaKKio23 (€5.54 in chips) 
Seat 4: Coffeebreak96 (€2.12 in chips) 
Seat 5: mondie73100 (€2.65 in chips) 
Seat 6: caduceus369 (€5.24 in chips) 
fantaasso: posts small blind €0.01
pistaKKio23: posts big blind €0.02
*** HOLE CARDS ***
Dealt to caduceus369 [2c Kc]
Coffeebreak96: raises €0.02 to €0.04
mondie73100: folds 
caduceus369: folds 
PIRULO1235: folds 
fantaasso: folds 
pistaKKio23: folds 
Uncalled bet (€0.02) returned to Coffeebreak96
Coffeebreak96 collected €0.05 from pot
Coffeebreak96: doesn't show hand 
*** SUMMARY ***
Total pot €0.05 | Rake €0 
Seat 1: PIRULO1235 (button) folded before Flop (didn't bet)
Seat 2: fantaasso (small blind) folded before Flop
Seat 3: pistaKKio23 (big blind) folded before Flop
Seat 4: Coffeebreak96 collected (€0.05)
Seat 5: mondie73100 folded before Flop (didn't bet)
Seat 6: caduceus369 folded before Flop (didn't bet)



PokerStars Zoom Hand #258039895925:  Hold'em No Limit (€0.01/€0.02) [ADM ID: M62C03044AE79CRJ] - 2025/10/08 0:47:25 CET [2025/10/07 18:47:25 ET]
Table 'Sirio' 6-max Seat #1 is the button
Seat 1: bravo1270 (€0.77 in chips) 
Seat 2: PIRULO1235 (€2.32 in chips) 
Seat 3: caduceus369 (€5.24 in chips) 
Seat 4: mondie73100 (€2.65 in chips) 
Seat 5: xTheBulldogx (€0.31 in chips) 
Seat 6: sebaparhasar84 (€2.47 in chips) 
PIRULO1235: posts small blind €0.01
caduceus369: posts big blind €0.02
*** HOLE CARDS ***
Dealt to caduceus369 [2h 8c]
mondie73100: folds 
xTheBulldogx: folds 
sebaparhasar84: folds 
bravo1270: folds 
PIRULO1235: calls €0.01
caduceus369: checks 
*** FLOP *** [4d 9c 3c]
PIRULO1235: bets €0.02
caduceus369: folds 
Uncalled bet (€0.02) returned to PIRULO1235
PIRULO1235 collected €0.04 from pot
PIRULO1235: doesn't show hand 
*** SUMMARY ***
Total pot €0.04 | Rake €0 
Board [4d 9c 3c]
Seat 1: bravo1270 (button) folded before Flop (didn't bet)
Seat 2: PIRULO1235 (small blind) collected (€0.04)
Seat 3: caduceus369 (big blind) folded on the Flop
Seat 4: mondie73100 folded before Flop (didn't bet)
Seat 5: xTheBulldogx folded before Flop (didn't bet)
Seat 6: sebaparhasar84 folded before Flop (didn't bet)



PokerStars Zoom Hand #258039899940:  Hold'em No Limit (€0.01/€0.02) [ADM ID: M62C03044AE79CRJ] - 2025/10/08 0:47:46 CET [2025/10/07 18:47:46 ET]
Table 'Sirio' 6-max Seat #1 is the button
Seat 1: caduceus369 (€5.21 in chips) 
Seat 2: ADRIAN0_MEIS (€25.17 in chips) 
Seat 3: PIRULO1235 (€2.34 in chips) 
Seat 4: fantaasso (€1.56 in chips) 
Seat 5: sebaparhasar84 (€2.47 in chips) 
ADRIAN0_MEIS: posts small blind €0.01
PIRULO1235: posts big blind €0.02
*** HOLE CARDS ***
Dealt to caduceus369 [8d 4h]
fantaasso: folds 
sebaparhasar84: folds 
caduceus369: folds 
ADRIAN0_MEIS: folds 
Uncalled bet (€0.01) returned to PIRULO1235
PIRULO1235 collected €0.02 from pot
PIRULO1235: doesn't show hand 
*** SUMMARY ***
Total pot €0.02 | Rake €0 
Seat 1: caduceus369 (button) folded before Flop (didn't bet)
Seat 2: ADRIAN0_MEIS (small blind) folded before Flop
Seat 3: PIRULO1235 (big blind) collected (€0.02)
Seat 4: fantaasso folded before Flop (didn't bet)
Seat 5: sebaparhasar84 folded before Flop (didn't bet)



PokerStars Zoom Hand #258039898861:  Hold'em No Limit (€0.01/€0.02) [ADM ID: M62C03044AE79CRJ] - 2025/10/08 0:47:40 CET [2025/10/07 18:47:40 ET]
Table 'Sirio' 6-max Seat #1 is the button
Seat 1: IlDestro71 (€0.64 in chips) 
Seat 2: caduceus369 (€5.22 in chips) 
Seat 3: bravo1270 (€0.77 in chips) 
Seat 4: mashallahh (€8.07 in chips) 
Seat 5: sebaparhasar84 (€2.47 in chips) 
Seat 6: fantaasso (€1.56 in chips) 
caduceus369: posts small blind €0.01
bravo1270: posts big blind €0.02
*** HOLE CARDS ***
Dealt to caduceus369 [Qh 9c]
mashallahh: raises €0.04 to €0.06
sebaparhasar84: folds 
fantaasso: folds 
IlDestro71: folds 
caduceus369: folds 
bravo1270: calls €0.04
*** FLOP *** [6c Js 8h]
bravo1270: checks 
mashallahh: bets €0.09
bravo1270: calls €0.09
*** TURN *** [6c Js 8h] [7d]
bravo1270: checks 
mashallahh: checks 
*** RIVER *** [6c Js 8h 7d] [Jh]
bravo1270: checks 
mashallahh: checks 
*** SHOW DOWN ***
bravo1270: shows [8c Th] (two pair, Jacks and Eights)
mashallahh: mucks hand 
bravo1270 collected €0.30 from pot
*** SUMMARY ***
Total pot €0.31 | Rake €0.01 
Board [6c Js 8h 7d Jh]
Seat 1: IlDestro71 (button) folded before Flop (didn't bet)
Seat 2: caduceus369 (small blind) folded before Flop
Seat 3: bravo1270 (big blind) showed [8c Th] and won (€0.30) with two pair, Jacks and Eights
Seat 4: mashallahh mucked [Kc Ac]
Seat 5: sebaparhasar84 folded before Flop (didn't bet)
Seat 6: fantaasso folded before Flop (didn't bet)



PokerStars Zoom Hand #258039900900:  Hold'em No Limit (€0.01/€0.02) [ADM ID: M62C03044AE79CRJ] - 2025/10/08 0:47:51 CET [2025/10/07 18:47:51 ET]
Table 'Sirio' 6-max Seat #1 is the button
Seat 1: sebaparhasar84 (€2.47 in chips) 
Seat 2: IlDestro71 (€0.64 in chips) 
Seat 3: fantaasso (€1.56 in chips) 
Seat 4: mashallahh (€2.03 in chips) 
Seat 5: caduceus369 (€5.21 in chips) 
IlDestro71: posts small blind €0.01
fantaasso: posts big blind €0.02
*** HOLE CARDS ***
Dealt to caduceus369 [7c 5h]
mashallahh: folds 
caduceus369: folds 
sebaparhasar84: folds 
IlDestro71: calls €0.01
fantaasso: checks 
*** FLOP *** [Ks Ad 5d]
IlDestro71: checks 
fantaasso: checks 
*** TURN *** [Ks Ad 5d] [Kc]
IlDestro71: checks 
fantaasso: checks 
*** RIVER *** [Ks Ad 5d Kc] [Td]
IlDestro71: checks 
fantaasso: checks 
*** SHOW DOWN ***
IlDestro71: shows [3d 3h] (two pair, Kings and Threes)
fantaasso: mucks hand 
IlDestro71 collected €0.04 from pot
*** SUMMARY ***
Total pot €0.04 | Rake €0 
Board [Ks Ad 5d Kc Td]
Seat 1: sebaparhasar84 (button) folded before Flop (didn't bet)
Seat 2: IlDestro71 (small blind) showed [3d 3h] and won (€0.04) with two pair, Kings and Threes
Seat 3: fantaasso (big blind) mucked [2h 6c]
Seat 4: mashallahh folded before Flop (didn't bet)
Seat 5: caduceus369 folded before Flop (didn't bet)



PokerStars Zoom Hand #258039901800:  Hold'em No Limit (€0.01/€0.02) [ADM ID: M62C03044AE79CRJ] - 2025/10/08 0:47:56 CET [2025/10/07 18:47:56 ET]
Table 'Sirio' 6-max Seat #1 is the button
Seat 1: Poetto65 (€3.07 in chips) 
Seat 2: SaTheNuts_77 (€0.07 in chips) 
Seat 3: Redfire827 (€1.20 in chips) 
Seat 4: caduceus369 (€5.21 in chips) 
Seat 5: mashallahh (€2.03 in chips) 
Seat 6: RRgalp (€2.38 in chips) 
SaTheNuts_77: posts small blind €0.01
Redfire827: posts big blind €0.02
*** HOLE CARDS ***
Dealt to caduceus369 [Ks 2d]
caduceus369: folds 
mashallahh: folds 
RRgalp: folds 
Poetto65: folds 
SaTheNuts_77: raises €0.05 to €0.07 and is all-in
Redfire827: calls €0.05
*** FLOP *** [9d 5c 7s]
*** TURN *** [9d 5c 7s] [Ad]
*** RIVER *** [9d 5c 7s Ad] [Ah]
*** SHOW DOWN ***
SaTheNuts_77: shows [Qh Kc] (a pair of Aces)
Redfire827: shows [Tc Qd] (a pair of Aces - lower kicker)
SaTheNuts_77 collected €0.14 from pot
*** SUMMARY ***
Total pot €0.14 | Rake €0 
Board [9d 5c 7s Ad Ah]
Seat 1: Poetto65 (button) folded before Flop (didn't bet)
Seat 2: SaTheNuts_77 (small blind) showed [Qh Kc] and won (€0.14) with a pair of Aces
Seat 3: Redfire827 (big blind) showed [Tc Qd] and lost with a pair of Aces
Seat 4: caduceus369 folded before Flop (didn't bet)
Seat 5: mashallahh folded before Flop (didn't bet)
Seat 6: RRgalp folded before Flop (didn't bet)



PokerStars Zoom Hand #258039903005:  Hold'em No Limit (€0.01/€0.02) [ADM ID: M62C03044AE79CRJ] - 2025/10/08 0:48:02 CET [2025/10/07 18:48:02 ET]
Table 'Sirio' 6-max Seat #1 is the button
Seat 1: tygaa2294 (€0.90 in chips) 
Seat 2: RRgalp (€2.38 in chips) 
Seat 3: caduceus369 (€5.21 in chips) 
Seat 4: pistaKKio23 (€5.27 in chips) 
Seat 5: PIRULO1235 (€2.35 in chips) 
Seat 6: mondie73100 (€5.78 in chips) 
RRgalp: posts small blind €0.01
caduceus369: posts big blind €0.02
*** HOLE CARDS ***
Dealt to caduceus369 [4s 7c]
pistaKKio23: folds 
PIRULO1235: folds 
mondie73100: folds 
tygaa2294: raises €0.02 to €0.04
RRgalp: folds 
caduceus369: calls €0.02
*** FLOP *** [3d 8d 2d]
caduceus369: checks 
tygaa2294: bets €0.06
caduceus369: folds 
Uncalled bet (€0.06) returned to tygaa2294
tygaa2294 collected €0.09 from pot
tygaa2294: doesn't show hand 
*** SUMMARY ***
Total pot €0.09 | Rake €0 
Board [3d 8d 2d]
Seat 1: tygaa2294 (button) collected (€0.09)
Seat 2: RRgalp (small blind) folded before Flop
Seat 3: caduceus369 (big blind) folded on the Flop
Seat 4: pistaKKio23 folded before Flop (didn't bet)
Seat 5: PIRULO1235 folded before Flop (didn't bet)
Seat 6: mondie73100 folded before Flop (didn't bet)



PokerStars Zoom Hand #258039908345:  Hold'em No Limit (€0.01/€0.02) [ADM ID: M62C03044AE79CRJ] - 2025/10/08 0:48:30 CET [2025/10/07 18:48:30 ET]
Table 'Sirio' 6-max Seat #1 is the button
Seat 1: RRgalp (€2.34 in chips) 
Seat 2: caduceus369 (€5.17 in chips) 
Seat 3: Emm3B1 (€3.22 in chips) 
Seat 4: SaTheNuts_77 (€0.80 in chips) 
Seat 5: IlDestro71 (€0.64 in chips) 
Seat 6: mashallahh (€7.92 in chips) 
caduceus369: posts small blind €0.01
Emm3B1: posts big blind €0.02
*** HOLE CARDS ***
Dealt to caduceus369 [9h 8d]
SaTheNuts_77: folds 
IlDestro71: folds 
mashallahh: folds 
RRgalp: raises €0.04 to €0.06
caduceus369: folds 
Emm3B1: folds 
Uncalled bet (€0.04) returned to RRgalp
RRgalp collected €0.05 from pot
RRgalp: doesn't show hand 
*** SUMMARY ***
Total pot €0.05 | Rake €0 
Seat 1: RRgalp (button) collected (€0.05)
Seat 2: caduceus369 (small blind) folded before Flop
Seat 3: Emm3B1 (big blind) folded before Flop
Seat 4: SaTheNuts_77 folded before Flop (didn't bet)
Seat 5: IlDestro71 folded before Flop (didn't bet)
Seat 6: mashallahh folded before Flop (didn't bet)



PokerStars Zoom Hand #258039911139:  Hold'em No Limit (€0.01/€0.02) [ADM ID: M62C03044AE79CRJ] - 2025/10/08 0:48:45 CET [2025/10/07 18:48:45 ET]
Table 'Sirio' 6-max Seat #1 is the button
Seat 1: Coffeebreak96 (€2.36 in chips) 
Seat 2: sebaparhasar84 (€2.44 in chips) 
Seat 3: bravo1270 (€1.76 in chips) 
Seat 4: mondie73100 (€5.80 in chips) 
Seat 5: ADRIAN0_MEIS (€25.14 in chips) 
Seat 6: caduceus369 (€5.16 in chips) 
sebaparhasar84: posts small blind €0.01
bravo1270: posts big blind €0.02
*** HOLE CARDS ***
Dealt to caduceus369 [5c 6h]
mondie73100: folds 
ADRIAN0_MEIS: raises €0.05 to €0.07
caduceus369: folds 
Coffeebreak96: folds 
sebaparhasar84: calls €0.06
bravo1270: folds 
*** FLOP *** [Kh 4d 5s]
sebaparhasar84: checks 
ADRIAN0_MEIS: bets €0.16
sebaparhasar84: calls €0.16
*** TURN *** [Kh 4d 5s] [As]
sebaparhasar84: checks 
ADRIAN0_MEIS: bets €0.44
sebaparhasar84: raises €0.44 to €0.88
ADRIAN0_MEIS: raises €13.88 to €14.76
sebaparhasar84: calls €1.33 and is all-in
Uncalled bet (€12.55) returned to ADRIAN0_MEIS
*** RIVER *** [Kh 4d 5s As] [Qd]
*** SHOW DOWN ***
sebaparhasar84: shows [Ac Ks] (two pair, Aces and Kings)
ADRIAN0_MEIS: shows [Kd Ad] (two pair, Aces and Kings)
sebaparhasar84 collected €2.32 from pot
ADRIAN0_MEIS collected €2.32 from pot
*** SUMMARY ***
Total pot €4.90 | Rake €0.26 
Board [Kh 4d 5s As Qd]
Seat 1: Coffeebreak96 (button) folded before Flop (didn't bet)
Seat 2: sebaparhasar84 (small blind) showed [Ac Ks] and won (€2.32) with two pair, Aces and Kings
Seat 3: bravo1270 (big blind) folded before Flop
Seat 4: mondie73100 folded before Flop (didn't bet)
Seat 5: ADRIAN0_MEIS showed [Kd Ad] and won (€2.32) with two pair, Aces and Kings
Seat 6: caduceus369 folded before Flop (didn't bet)



PokerStars Zoom Hand #258039912014:  Hold'em No Limit (€0.01/€0.02) [ADM ID: M62C03044AE79CRJ] - 2025/10/08 0:48:49 CET [2025/10/07 18:48:49 ET]
Table 'Sirio' 6-max Seat #1 is the button
Seat 1: Redfire827 (€1.15 in chips) 
Seat 2: SaTheNuts_77 (€0.78 in chips) 
Seat 3: mondie73100 (€5.80 in chips) 
Seat 4: RRgalp (€2.37 in chips) 
Seat 5: caduceus369 (€5.16 in chips) 
Seat 6: Coffeebreak96 (€2.36 in chips) 
SaTheNuts_77: posts small blind €0.01
mondie73100: posts big blind €0.02
*** HOLE CARDS ***
Dealt to caduceus369 [8h 8d]
RRgalp: raises €0.04 to €0.06
caduceus369: calls €0.06
Coffeebreak96: folds 
Redfire827: folds 
SaTheNuts_77: folds 
mondie73100: folds 
*** FLOP *** [Td As Qd]
RRgalp: checks 
caduceus369: checks 
*** TURN *** [Td As Qd] [8c]
RRgalp: checks 
caduceus369: bets €0.05
RRgalp: folds 
Uncalled bet (€0.05) returned to caduceus369
caduceus369 collected €0.15 from pot
caduceus369: doesn't show hand 
*** SUMMARY ***
Total pot €0.15 | Rake €0 
Board [Td As Qd 8c]
Seat 1: Redfire827 (button) folded before Flop (didn't bet)
Seat 2: SaTheNuts_77 (small blind) folded before Flop
Seat 3: mondie73100 (big blind) folded before Flop
Seat 4: RRgalp folded on the Turn
Seat 5: caduceus369 collected (€0.15)
Seat 6: Coffeebreak96 folded before Flop (didn't bet)



PokerStars Zoom Hand #258039927181:  Hold'em No Limit (€0.01/€0.02) [ADM ID: M62C03044AE79CRJ] - 2025/10/08 0:50:09 CET [2025/10/07 18:50:09 ET]
Table 'Sirio' 6-max Seat #1 is the button
Seat 1: SaTheNuts_77 (€0.61 in chips) 
Seat 2: fccmp (€1.99 in chips) 
Seat 3: RRgalp (€2.30 in chips) 
Seat 4: caduceus369 (€5.25 in chips) 
Seat 5: IlDestro71 (€0.66 in chips) 
Seat 6: Emm3B1 (€3.32 in chips) 
fccmp: posts small blind €0.01
RRgalp: posts big blind €0.02
*** HOLE CARDS ***
Dealt to caduceus369 [4h Ac]
caduceus369: folds 
IlDestro71: folds 
Emm3B1: raises €0.04 to €0.06
SaTheNuts_77: raises €0.15 to €0.21
fccmp: folds 
RRgalp: folds 
Emm3B1: folds 
Uncalled bet (€0.15) returned to SaTheNuts_77
SaTheNuts_77 collected €0.15 from pot
SaTheNuts_77: doesn't show hand 
*** SUMMARY ***
Total pot €0.15 | Rake €0 
Seat 1: SaTheNuts_77 (button) collected (€0.15)
Seat 2: fccmp (small blind) folded before Flop
Seat 3: RRgalp (big blind) folded before Flop
Seat 4: caduceus369 folded before Flop (didn't bet)
Seat 5: IlDestro71 folded before Flop (didn't bet)
Seat 6: Emm3B1 folded before Flop



PokerStars Zoom Hand #258039928220:  Hold'em No Limit (€0.01/€0.02) [ADM ID: M62C03044AE79CRJ] - 2025/10/08 0:50:14 CET [2025/10/07 18:50:14 ET]
Table 'Sirio' 6-max Seat #1 is the button
Seat 1: caduceus369 (€5.25 in chips) 
Seat 2: mondie73100 (€5.81 in chips) 
Seat 3: fccmp (€1.98 in chips) 
Seat 4: pistaKKio23 (€5.57 in chips) 
Seat 5: AlwaisToRun (€1.75 in chips) 
Seat 6: IsyP99 (€0.48 in chips) 
mondie73100: posts small blind €0.01
fccmp: posts big blind €0.02
*** HOLE CARDS ***
Dealt to caduceus369 [Qd 7c]
IsyP99 is disconnected 
pistaKKio23: raises €0.04 to €0.06
AlwaisToRun: folds 
IsyP99 has timed out while disconnected
IsyP99: folds 
caduceus369: folds 
mondie73100: folds 
fccmp: folds 
Uncalled bet (€0.04) returned to pistaKKio23
pistaKKio23 collected €0.05 from pot
pistaKKio23: doesn't show hand 
pistaKKio23 is disconnected 
*** SUMMARY ***
Total pot €0.05 | Rake €0 
Seat 1: caduceus369 (button) folded before Flop (didn't bet)
Seat 2: mondie73100 (small blind) folded before Flop
Seat 3: fccmp (big blind) folded before Flop
Seat 4: pistaKKio23 collected (€0.05)
Seat 5: AlwaisToRun folded before Flop (didn't bet)
Seat 6: IsyP99 folded before Flop (didn't bet)



PokerStars Zoom Hand #258039930108:  Hold'em No Limit (€0.01/€0.02) [ADM ID: M62C03044AE79CRJ] - 2025/10/08 0:50:24 CET [2025/10/07 18:50:24 ET]
Table 'Sirio' 6-max Seat #1 is the button
Seat 1: fccmp (€1.96 in chips) 
Seat 2: PIRULO1235 (€2.26 in chips) 
Seat 3: SaTheNuts_77 (€0.70 in chips) 
Seat 4: Emm3B1 (€3.26 in chips) 
Seat 5: RRgalp (€2.28 in chips) 
Seat 6: caduceus369 (€5.25 in chips) 
PIRULO1235: posts small blind €0.01
SaTheNuts_77: posts big blind €0.02
*** HOLE CARDS ***
Dealt to caduceus369 [6c 7c]
Emm3B1: folds 
RRgalp: folds 
caduceus369: folds 
fccmp: folds 
PIRULO1235: calls €0.01
SaTheNuts_77: checks 
*** FLOP *** [4d 8d 9d]
PIRULO1235: bets €0.06
SaTheNuts_77: folds 
Uncalled bet (€0.06) returned to PIRULO1235
PIRULO1235 collected €0.04 from pot
PIRULO1235: doesn't show hand 
*** SUMMARY ***
Total pot €0.04 | Rake €0 
Board [4d 8d 9d]
Seat 1: fccmp (button) folded before Flop (didn't bet)
Seat 2: PIRULO1235 (small blind) collected (€0.04)
Seat 3: SaTheNuts_77 (big blind) folded on the Flop
Seat 4: Emm3B1 folded before Flop (didn't bet)
Seat 5: RRgalp folded before Flop (didn't bet)
Seat 6: caduceus369 folded before Flop (didn't bet)



PokerStars Zoom Hand #258039935103:  Hold'em No Limit (€0.01/€0.02) [ADM ID: M62C03044AE79CRJ] - 2025/10/08 0:50:50 CET [2025/10/07 18:50:50 ET]
Table 'Sirio' 6-max Seat #1 is the button
Seat 1: Emm3B1 (€3.23 in chips) 
Seat 2: fccmp (€1.96 in chips) 
Seat 3: caduceus369 (€5.25 in chips) 
Seat 4: fantaasso (€1.52 in chips) 
Seat 5: manuknife (€0.79 in chips) 
Seat 6: IlDestro71 (€0.65 in chips) 
fccmp: posts small blind €0.01
caduceus369: posts big blind €0.02
*** HOLE CARDS ***
Dealt to caduceus369 [Jd 9d]
fantaasso: folds 
manuknife: folds 
IlDestro71: calls €0.02
Emm3B1: folds 
fccmp: folds 
caduceus369: checks 
*** FLOP *** [Kd 4h 4s]
caduceus369: checks 
IlDestro71: checks 
*** TURN *** [Kd 4h 4s] [8s]
caduceus369: bets €0.02
IlDestro71: calls €0.02
*** RIVER *** [Kd 4h 4s 8s] [Th]
caduceus369: bets €0.11
IlDestro71: raises €0.11 to €0.22
caduceus369: folds 
Uncalled bet (€0.11) returned to IlDestro71
IlDestro71 collected €0.30 from pot
IlDestro71: doesn't show hand 
*** SUMMARY ***
Total pot €0.31 | Rake €0.01 
Board [Kd 4h 4s 8s Th]
Seat 1: Emm3B1 (button) folded before Flop (didn't bet)
Seat 2: fccmp (small blind) folded before Flop
Seat 3: caduceus369 (big blind) folded on the River
Seat 4: fantaasso folded before Flop (didn't bet)
Seat 5: manuknife folded before Flop (didn't bet)
Seat 6: IlDestro71 collected (€0.30)



PokerStars Zoom Hand #258039947405:  Hold'em No Limit (€0.01/€0.02) [ADM ID: M62C03044AE79CRJ] - 2025/10/08 0:51:55 CET [2025/10/07 18:51:55 ET]
Table 'Sirio' 6-max Seat #1 is the button
Seat 1: mondie73100 (€5.83 in chips) 
Seat 2: caduceus369 (€5.10 in chips) 
Seat 3: xTheBulldogx (€1.70 in chips) 
Seat 4: SiMoOoOo93 (€1.94 in chips) 
Seat 5: mashallahh (€7.80 in chips) 
Seat 6: dellas3131 (€2.02 in chips) 
caduceus369: posts small blind €0.01
xTheBulldogx: posts big blind €0.02
*** HOLE CARDS ***
Dealt to caduceus369 [2h 7c]
SiMoOoOo93: folds 
mashallahh: folds 
dellas3131: folds 
mondie73100: folds 
caduceus369: folds 
Uncalled bet (€0.01) returned to xTheBulldogx
xTheBulldogx collected €0.02 from pot
xTheBulldogx: doesn't show hand 
*** SUMMARY ***
Total pot €0.02 | Rake €0 
Seat 1: mondie73100 (button) folded before Flop (didn't bet)
Seat 2: caduceus369 (small blind) folded before Flop
Seat 3: xTheBulldogx (big blind) collected (€0.02)
Seat 4: SiMoOoOo93 folded before Flop (didn't bet)
Seat 5: mashallahh folded before Flop (didn't bet)
Seat 6: dellas3131 folded before Flop (didn't bet)



PokerStars Zoom Hand #258039949903:  Hold'em No Limit (€0.01/€0.02) [ADM ID: M62C03044AE79CRJ] - 2025/10/08 0:52:07 CET [2025/10/07 18:52:07 ET]
Table 'Sirio' 6-max Seat #1 is the button
Seat 1: caduceus369 (€5.09 in chips) 
Seat 2: SebaRapy14 (€3.25 in chips) 
Seat 3: fccmp (€1.93 in chips) 
Seat 4: SiMoOoOo93 (€1.92 in chips) 
Seat 5: fantaasso (€1.61 in chips) 
Seat 6: PIRULO1235 (€2.24 in chips) 
SebaRapy14: posts small blind €0.01
fccmp: posts big blind €0.02
*** HOLE CARDS ***
Dealt to caduceus369 [5h Kh]
SiMoOoOo93: folds 
fantaasso: folds 
PIRULO1235: folds 
caduceus369: raises €0.04 to €0.06
SebaRapy14: raises €0.22 to €0.28
fccmp: folds 
caduceus369: folds 
Uncalled bet (€0.22) returned to SebaRapy14
SebaRapy14 collected €0.14 from pot
SebaRapy14: doesn't show hand 
*** SUMMARY ***
Total pot €0.14 | Rake €0 
Seat 1: caduceus369 (button) folded before Flop
Seat 2: SebaRapy14 (small blind) collected (€0.14)
Seat 3: fccmp (big blind) folded before Flop
Seat 4: SiMoOoOo93 folded before Flop (didn't bet)
Seat 5: fantaasso folded before Flop (didn't bet)
Seat 6: PIRULO1235 folded before Flop (didn't bet)



PokerStars Zoom Hand #258039954153:  Hold'em No Limit (€0.01/€0.02) [ADM ID: M62C03044AE79CRJ] - 2025/10/08 0:52:30 CET [2025/10/07 18:52:30 ET]
Table 'Sirio' 6-max Seat #1 is the button
Seat 1: fccmp (€1.90 in chips) 
Seat 2: SaTheNuts_77 (€1.32 in chips) 
Seat 3: SebaRapy14 (€7.32 in chips) 
Seat 4: mashallahh (€3.81 in chips) 
Seat 5: caduceus369 (€5.03 in chips) 
Seat 6: Emm3B1 (€3.18 in chips) 
SaTheNuts_77: posts small blind €0.01
SebaRapy14: posts big blind €0.02
*** HOLE CARDS ***
Dealt to caduceus369 [8h Th]
mashallahh: folds 
caduceus369: folds 
Emm3B1: folds 
fccmp: folds 
SaTheNuts_77: folds 
Uncalled bet (€0.01) returned to SebaRapy14
SebaRapy14 collected €0.02 from pot
SebaRapy14: doesn't show hand 
*** SUMMARY ***
Total pot €0.02 | Rake €0 
Seat 1: fccmp (button) folded before Flop (didn't bet)
Seat 2: SaTheNuts_77 (small blind) folded before Flop
Seat 3: SebaRapy14 (big blind) collected (€0.02)
Seat 4: mashallahh folded before Flop (didn't bet)
Seat 5: caduceus369 folded before Flop (didn't bet)
Seat 6: Emm3B1 folded before Flop (didn't bet)



PokerStars Zoom Hand #258039955530:  Hold'em No Limit (€0.01/€0.02) [ADM ID: M62C03044AE79CRJ] - 2025/10/08 0:52:38 CET [2025/10/07 18:52:38 ET]
Table 'Sirio' 6-max Seat #1 is the button
Seat 1: Emm3B1 (€3.17 in chips) 
Seat 2: GF1401 (€1.01 in chips) 
Seat 3: SaTheNuts_77 (€1.31 in chips) 
Seat 4: mashallahh (€7.81 in chips) 
Seat 5: caduceus369 (€5.03 in chips) 
Seat 6: fccmp (€1.90 in chips) 
GF1401: posts small blind €0.01
SaTheNuts_77: posts big blind €0.02
*** HOLE CARDS ***
Dealt to caduceus369 [3c Jd]
mashallahh: folds 
caduceus369: folds 
fccmp: folds 
Emm3B1: folds 
GF1401: calls €0.01
SaTheNuts_77: raises €0.06 to €0.08
GF1401: calls €0.06
*** FLOP *** [9c Jc 8h]
GF1401: checks 
SaTheNuts_77: checks 
*** TURN *** [9c Jc 8h] [Jh]
GF1401: bets €0.02
SaTheNuts_77: raises €0.14 to €0.16
GF1401: folds 
Uncalled bet (€0.14) returned to SaTheNuts_77
SaTheNuts_77 collected €0.19 from pot
SaTheNuts_77: doesn't show hand 
*** SUMMARY ***
Total pot €0.20 | Rake €0.01 
Board [9c Jc 8h Jh]
Seat 1: Emm3B1 (button) folded before Flop (didn't bet)
Seat 2: GF1401 (small blind) folded on the Turn
Seat 3: SaTheNuts_77 (big blind) collected (€0.19)
Seat 4: mashallahh folded before Flop (didn't bet)
Seat 5: caduceus369 folded before Flop (didn't bet)
Seat 6: fccmp folded before Flop (didn't bet)



PokerStars Zoom Hand #258039957336:  Hold'em No Limit (€0.01/€0.02) [ADM ID: M62C03044AE79CRJ] - 2025/10/08 0:52:47 CET [2025/10/07 18:52:47 ET]
Table 'Sirio' 6-max Seat #1 is the button
Seat 1: mondie73100 (€3.36 in chips) 
Seat 2: caduceus369 (€5.03 in chips) 
Seat 3: dellas3131 (€2.03 in chips) 
Seat 4: ADRIAN0_MEIS (€24.55 in chips) 
Seat 5: mashallahh (€2.28 in chips) 
caduceus369: posts small blind €0.01
dellas3131: posts big blind €0.02
*** HOLE CARDS ***
Dealt to caduceus369 [9s Qs]
ADRIAN0_MEIS: folds 
mashallahh: raises €0.04 to €0.06
mondie73100: folds 
caduceus369: folds 
dellas3131: folds 
Uncalled bet (€0.04) returned to mashallahh
mashallahh collected €0.05 from pot
mashallahh: doesn't show hand 
*** SUMMARY ***
Total pot €0.05 | Rake €0 
Seat 1: mondie73100 (button) folded before Flop (didn't bet)
Seat 2: caduceus369 (small blind) folded before Flop
Seat 3: dellas3131 (big blind) folded before Flop
Seat 4: ADRIAN0_MEIS folded before Flop (didn't bet)
Seat 5: mashallahh collected (€0.05)



PokerStars Zoom Hand #258039956236:  Hold'em No Limit (€0.01/€0.02) [ADM ID: M62C03044AE79CRJ] - 2025/10/08 0:52:42 CET [2025/10/07 18:52:42 ET]
Table 'Sirio' 6-max Seat #1 is the button
Seat 1: SebaRapy14 (€7.33 in chips) 
Seat 2: fccmp (€1.90 in chips) 
Seat 3: Emm3B1 (€3.17 in chips) 
Seat 4: mondie73100 (€3.36 in chips) 
Seat 5: ADRIAN0_MEIS (€24.55 in chips) 
Seat 6: caduceus369 (€5.03 in chips) 
fccmp: posts small blind €0.01
Emm3B1: posts big blind €0.02
*** HOLE CARDS ***
Dealt to caduceus369 [2s 7d]
mondie73100: folds 
ADRIAN0_MEIS: folds 
caduceus369: folds 
SebaRapy14: raises €0.04 to €0.06
fccmp: folds 
Emm3B1: calls €0.04
*** FLOP *** [4h 3c 2d]
Emm3B1: checks 
SebaRapy14: bets €0.07
Emm3B1: calls €0.07
*** TURN *** [4h 3c 2d] [Jd]
Emm3B1: checks 
SebaRapy14: bets €0.18
Emm3B1: calls €0.18
*** RIVER *** [4h 3c 2d Jd] [Qc]
Emm3B1: checks 
SebaRapy14: checks 
*** SHOW DOWN ***
Emm3B1: shows [As 6h] (high card Ace)
SebaRapy14: shows [Tc Th] (a pair of Tens)
SebaRapy14 collected €0.60 from pot
*** SUMMARY ***
Total pot €0.63 | Rake €0.03 
Board [4h 3c 2d Jd Qc]
Seat 1: SebaRapy14 (button) showed [Tc Th] and won (€0.60) with a pair of Tens
Seat 2: fccmp (small blind) folded before Flop
Seat 3: Emm3B1 (big blind) showed [As 6h] and lost with high card Ace
Seat 4: mondie73100 folded before Flop (didn't bet)
Seat 5: ADRIAN0_MEIS folded before Flop (didn't bet)
Seat 6: caduceus369 folded before Flop (didn't bet)



PokerStars Zoom Hand #258039965003:  Hold'em No Limit (€0.01/€0.02) [ADM ID: M62C03044AE79CRJ] - 2025/10/08 0:53:28 CET [2025/10/07 18:53:28 ET]
Table 'Sirio' 6-max Seat #1 is the button
Seat 1: caduceus369 (€5 in chips) 
Seat 2: MammAnnAILovey (€0.15 in chips) 
Seat 3: SiMoOoOo93 (€1.72 in chips) 
Seat 4: SebaRapy14 (€3.52 in chips) 
Seat 5: fantaasso (€1.55 in chips) 
Seat 6: SaTheNuts_77 (€1.39 in chips) 
MammAnnAILovey: posts small blind €0.01
SiMoOoOo93: posts big blind €0.02
*** HOLE CARDS ***
Dealt to caduceus369 [6s 8s]
SebaRapy14: raises €0.04 to €0.06
fantaasso: folds 
SaTheNuts_77: folds 
caduceus369: folds 
MammAnnAILovey: folds 
SiMoOoOo93: folds 
Uncalled bet (€0.04) returned to SebaRapy14
SebaRapy14 collected €0.05 from pot
SebaRapy14: doesn't show hand 
*** SUMMARY ***
Total pot €0.05 | Rake €0 
Seat 1: caduceus369 (button) folded before Flop (didn't bet)
Seat 2: MammAnnAILovey (small blind) folded before Flop
Seat 3: SiMoOoOo93 (big blind) folded before Flop
Seat 4: SebaRapy14 collected (€0.05)
Seat 5: fantaasso folded before Flop (didn't bet)
Seat 6: SaTheNuts_77 folded before Flop (didn't bet)



PokerStars Zoom Hand #258039963968:  Hold'em No Limit (€0.01/€0.02) [ADM ID: M62C03044AE79CRJ] - 2025/10/08 0:53:23 CET [2025/10/07 18:53:23 ET]
Table 'Sirio' 6-max Seat #1 is the button
Seat 1: PIRULO1235 (€2.25 in chips) 
Seat 2: fccmp (€1.87 in chips) 
Seat 3: GF1401 (€0.91 in chips) 
Seat 4: SaTheNuts_77 (€1.39 in chips) 
Seat 5: caduceus369 (€5 in chips) 
Seat 6: ADRIAN0_MEIS (€24.55 in chips) 
fccmp: posts small blind €0.01
GF1401: posts big blind €0.02
*** HOLE CARDS ***
Dealt to caduceus369 [2h Qh]
SaTheNuts_77: folds 
caduceus369: folds 
ADRIAN0_MEIS: folds 
PIRULO1235: calls €0.02
fccmp: folds 
GF1401: checks 
*** FLOP *** [8s 2s 9s]
GF1401: checks 
PIRULO1235: checks 
*** TURN *** [8s 2s 9s] [7s]
GF1401: bets €0.02
PIRULO1235: calls €0.02
*** RIVER *** [8s 2s 9s 7s] [5s]
GF1401: bets €0.02
PIRULO1235: calls €0.02
*** SHOW DOWN ***
GF1401: shows [Kh 2d] (a flush, Nine high)
PIRULO1235: shows [3h 7h] (a flush, Nine high)
GF1401 collected €0.07 from pot
PIRULO1235 collected €0.06 from pot
*** SUMMARY ***
Total pot €0.13 | Rake €0 
Board [8s 2s 9s 7s 5s]
Seat 1: PIRULO1235 (button) showed [3h 7h] and won (€0.06) with a flush, Nine high
Seat 2: fccmp (small blind) folded before Flop
Seat 3: GF1401 (big blind) showed [Kh 2d] and won (€0.07) with a flush, Nine high
Seat 4: SaTheNuts_77 folded before Flop (didn't bet)
Seat 5: caduceus369 folded before Flop (didn't bet)
Seat 6: ADRIAN0_MEIS folded before Flop (didn't bet)



PokerStars Zoom Hand #258039966309:  Hold'em No Limit (€0.01/€0.02) [ADM ID: M62C03044AE79CRJ] - 2025/10/08 0:53:35 CET [2025/10/07 18:53:35 ET]
Table 'Sirio' 6-max Seat #1 is the button
Seat 1: tygaa2294 (€2.20 in chips) 
Seat 2: SiMoOoOo93 (€1.70 in chips) 
Seat 3: mashallahh (€4.43 in chips) 
Seat 4: caduceus369 (€5 in chips) 
Seat 5: MammAnnAILovey (€0.14 in chips) 
Seat 6: dellas3131 (€2.08 in chips) 
SiMoOoOo93: posts small blind €0.01
mashallahh: posts big blind €0.02
*** HOLE CARDS ***
Dealt to caduceus369 [Ah 3d]
caduceus369: folds 
MammAnnAILovey: folds 
dellas3131: raises €0.05 to €0.07
tygaa2294: folds 
SiMoOoOo93: folds 
mashallahh: folds 
Uncalled bet (€0.05) returned to dellas3131
dellas3131 collected €0.05 from pot
dellas3131: doesn't show hand 
*** SUMMARY ***
Total pot €0.05 | Rake €0 
Seat 1: tygaa2294 (button) folded before Flop (didn't bet)
Seat 2: SiMoOoOo93 (small blind) folded before Flop
Seat 3: mashallahh (big blind) folded before Flop
Seat 4: caduceus369 folded before Flop (didn't bet)
Seat 5: MammAnnAILovey folded before Flop (didn't bet)
Seat 6: dellas3131 collected (€0.05)



PokerStars Zoom Hand #258039968296:  Hold'em No Limit (€0.01/€0.02) [ADM ID: M62C03044AE79CRJ] - 2025/10/08 0:53:46 CET [2025/10/07 18:53:46 ET]
Table 'Sirio' 6-max Seat #1 is the button
Seat 1: SiMoOoOo93 (€1.69 in chips) 
Seat 2: sebaparhasar84 (€2.31 in chips) 
Seat 3: mashallahh (€7.95 in chips) 
Seat 4: caduceus369 (€4.98 in chips) 
Seat 5: fantaasso (€1.55 in chips) 
sebaparhasar84: posts small blind €0.01
mashallahh: posts big blind €0.02
*** HOLE CARDS ***
Dealt to caduceus369 [3d 9s]
caduceus369: folds 
fantaasso: folds 
SiMoOoOo93: raises €0.02 to €0.04
sebaparhasar84: folds 
mashallahh: folds 
Uncalled bet (€0.02) returned to SiMoOoOo93
SiMoOoOo93 collected €0.05 from pot
SiMoOoOo93: doesn't show hand 
*** SUMMARY ***
Total pot €0.05 | Rake €0 
Seat 1: SiMoOoOo93 (button) collected (€0.05)
Seat 2: sebaparhasar84 (small blind) folded before Flop
Seat 3: mashallahh (big blind) folded before Flop
Seat 4: caduceus369 folded before Flop (didn't bet)
Seat 5: fantaasso folded before Flop (didn't bet)



PokerStars Zoom Hand #258039959694:  Hold'em No Limit (€0.01/€0.02) [ADM ID: M62C03044AE79CRJ] - 2025/10/08 0:53:00 CET [2025/10/07 18:53:00 ET]
Table 'Sirio' 6-max Seat #1 is the button
Seat 1: GF1401 (€0.91 in chips) 
Seat 2: dellas3131 (€2.01 in chips) 
Seat 3: caduceus369 (€5.02 in chips) 
Seat 4: Coffeebreak96 (€2.59 in chips) 
Seat 5: fccmp (€1.87 in chips) 
Seat 6: PIRULO1235 (€2.24 in chips) 
dellas3131: posts small blind €0.01
caduceus369: posts big blind €0.02
*** HOLE CARDS ***
Dealt to caduceus369 [4d Ad]
Coffeebreak96: raises €0.02 to €0.04
fccmp: folds 
PIRULO1235: folds 
GF1401: folds 
dellas3131: raises €0.10 to €0.14
caduceus369: folds 
Coffeebreak96: raises €0.10 to €0.24
dellas3131: calls €0.10
*** FLOP *** [Td 3c Kc]
dellas3131: checks 
Coffeebreak96: bets €0.24
dellas3131: calls €0.24
*** TURN *** [Td 3c Kc] [6c]
dellas3131: bets €0.65
Coffeebreak96: calls €0.65
*** RIVER *** [Td 3c Kc 6c] [3d]
dellas3131: bets €0.88 and is all-in
Coffeebreak96: calls €0.88
PIRULO1235 is disconnected 
*** SHOW DOWN ***
dellas3131: shows [Qs As] (a pair of Threes)
Coffeebreak96: shows [Ah Ac] (two pair, Aces and Threes)
Coffeebreak96 collected €3.82 from pot
*** SUMMARY ***
Total pot €4.04 | Rake €0.22 
Board [Td 3c Kc 6c 3d]
Seat 1: GF1401 (button) folded before Flop (didn't bet)
Seat 2: dellas3131 (small blind) showed [Qs As] and lost with a pair of Threes
Seat 3: caduceus369 (big blind) folded before Flop
Seat 4: Coffeebreak96 showed [Ah Ac] and won (€3.82) with two pair, Aces and Threes
Seat 5: fccmp folded before Flop (didn't bet)
Seat 6: PIRULO1235 folded before Flop (didn't bet)



PokerStars Zoom Hand #258039970235:  Hold'em No Limit (€0.01/€0.02) [ADM ID: M62C03044AE79CRJ] - 2025/10/08 0:53:56 CET [2025/10/07 18:53:56 ET]
Table 'Sirio' 6-max Seat #1 is the button
Seat 1: mashallahh (€7.93 in chips) 
Seat 2: caduceus369 (€4.98 in chips) 
Seat 3: xebarpz4400 (€0.59 in chips) 
Seat 4: SaTheNuts_77 (€1.40 in chips) 
Seat 5: sebaparhasar84 (€2.30 in chips) 
caduceus369: posts small blind €0.01
xebarpz4400: posts big blind €0.02
*** HOLE CARDS ***
Dealt to caduceus369 [4s Ts]
SaTheNuts_77: folds 
sebaparhasar84: folds 
mashallahh: folds 
caduceus369: folds 
Uncalled bet (€0.01) returned to xebarpz4400
xebarpz4400 collected €0.02 from pot
xebarpz4400: doesn't show hand 
*** SUMMARY ***
Total pot €0.02 | Rake €0 
Seat 1: mashallahh (button) folded before Flop (didn't bet)
Seat 2: caduceus369 (small blind) folded before Flop
Seat 3: xebarpz4400 (big blind) collected (€0.02)
Seat 4: SaTheNuts_77 folded before Flop (didn't bet)
Seat 5: sebaparhasar84 folded before Flop (didn't bet)



PokerStars Zoom Hand #258039967299:  Hold'em No Limit (€0.01/€0.02) [ADM ID: M62C03044AE79CRJ] - 2025/10/08 0:53:40 CET [2025/10/07 18:53:40 ET]
Table 'Sirio' 6-max Seat #1 is the button
Seat 1: ADRIAN0_MEIS (€24.55 in chips) 
Seat 2: tygaa2294 (€2.20 in chips) 
Seat 3: caduceus369 (€5 in chips) 
Seat 4: SebaRapy14 (€3.55 in chips) 
Seat 5: MammAnnAILovey (€0.14 in chips) 
Seat 6: SiMoOoOo93 (€1.69 in chips) 
tygaa2294: posts small blind €0.01
caduceus369: posts big blind €0.02
*** HOLE CARDS ***
Dealt to caduceus369 [2c 3d]
SebaRapy14: raises €0.04 to €0.06
MammAnnAILovey: folds 
SiMoOoOo93: folds 
ADRIAN0_MEIS: folds 
tygaa2294: calls €0.05
caduceus369: folds 
*** FLOP *** [9c 3s 6h]
tygaa2294: checks 
SebaRapy14: checks 
*** TURN *** [9c 3s 6h] [4c]
tygaa2294: bets €0.06
SebaRapy14: folds 
Uncalled bet (€0.06) returned to tygaa2294
tygaa2294 collected €0.14 from pot
tygaa2294: doesn't show hand 
*** SUMMARY ***
Total pot €0.14 | Rake €0 
Board [9c 3s 6h 4c]
Seat 1: ADRIAN0_MEIS (button) folded before Flop (didn't bet)
Seat 2: tygaa2294 (small blind) collected (€0.14)
Seat 3: caduceus369 (big blind) folded before Flop
Seat 4: SebaRapy14 folded on the Turn
Seat 5: MammAnnAILovey folded before Flop (didn't bet)
Seat 6: SiMoOoOo93 folded before Flop (didn't bet)



PokerStars Zoom Hand #258039969179:  Hold'em No Limit (€0.01/€0.02) [ADM ID: M62C03044AE79CRJ] - 2025/10/08 0:53:50 CET [2025/10/07 18:53:50 ET]
Table 'Sirio' 6-max Seat #1 is the button
Seat 1: caduceus369 (€4.98 in chips) 
Seat 2: GF1401 (€0.92 in chips) 
Seat 3: MammAnnAILovey (€0.14 in chips) 
Seat 4: PIRULO1235 (€2.25 in chips) 
Seat 5: SaTheNuts_77 (€1.40 in chips) 
Seat 6: ADRIAN0_MEIS (€24.55 in chips) 
GF1401: posts small blind €0.01
MammAnnAILovey: posts big blind €0.02
*** HOLE CARDS ***
Dealt to caduceus369 [5c 6d]
PIRULO1235: calls €0.02
SaTheNuts_77: folds 
ADRIAN0_MEIS: folds 
caduceus369: folds 
PIRULO1235 is disconnected 
GF1401: raises €0.12 to €0.14
MammAnnAILovey: folds 
PIRULO1235 has timed out while disconnected
PIRULO1235: folds 
Uncalled bet (€0.12) returned to GF1401
GF1401 collected €0.06 from pot
GF1401: doesn't show hand 
*** SUMMARY ***
Total pot €0.06 | Rake €0 
Seat 1: caduceus369 (button) folded before Flop (didn't bet)
Seat 2: GF1401 (small blind) collected (€0.06)
Seat 3: MammAnnAILovey (big blind) folded before Flop
Seat 4: PIRULO1235 folded before Flop
Seat 5: SaTheNuts_77 folded before Flop (didn't bet)
Seat 6: ADRIAN0_MEIS folded before Flop (didn't bet)



PokerStars Zoom Hand #258039972906:  Hold'em No Limit (€0.01/€0.02) [ADM ID: M62C03044AE79CRJ] - 2025/10/08 0:54:10 CET [2025/10/07 18:54:10 ET]
Table 'Sirio' 6-max Seat #1 is the button
Seat 1: caduceus369 (€4.97 in chips) 
Seat 2: sebaparhasar84 (€2.30 in chips) 
Seat 3: SebaRapy14 (€3.49 in chips) 
Seat 4: tygaa2294 (€2.28 in chips) 
Seat 5: dellas3131 (€2 in chips) 
sebaparhasar84: posts small blind €0.01
SebaRapy14: posts big blind €0.02
*** HOLE CARDS ***
Dealt to caduceus369 [6h Jd]
tygaa2294: raises €0.02 to €0.04
dellas3131: raises €0.11 to €0.15
caduceus369: folds 
sebaparhasar84: folds 
SebaRapy14: folds 
tygaa2294: calls €0.11
*** FLOP *** [4d 5h Js]
tygaa2294: checks 
dellas3131: checks 
*** TURN *** [4d 5h Js] [2s]
tygaa2294: checks 
dellas3131: checks 
*** RIVER *** [4d 5h Js 2s] [Kd]
tygaa2294: bets €0.02
dellas3131: raises €0.26 to €0.28
tygaa2294: calls €0.26
*** SHOW DOWN ***
dellas3131: shows [Td Ad] (high card Ace)
tygaa2294: shows [9d Kc] (a pair of Kings)
tygaa2294 collected €0.85 from pot
*** SUMMARY ***
Total pot €0.89 | Rake €0.04 
Board [4d 5h Js 2s Kd]
Seat 1: caduceus369 (button) folded before Flop (didn't bet)
Seat 2: sebaparhasar84 (small blind) folded before Flop
Seat 3: SebaRapy14 (big blind) folded before Flop
Seat 4: tygaa2294 showed [9d Kc] and won (€0.85) with a pair of Kings
Seat 5: dellas3131 showed [Td Ad] and lost with high card Ace



PokerStars Zoom Hand #258039972016:  Hold'em No Limit (€0.01/€0.02) [ADM ID: M62C03044AE79CRJ] - 2025/10/08 0:54:05 CET [2025/10/07 18:54:05 ET]
Table 'Sirio' 6-max Seat #1 is the button
Seat 1: xebarpz4400 (€0.60 in chips) 
Seat 2: MammAnnAILovey (€0.12 in chips) 
Seat 3: dellas3131 (€2.11 in chips) 
Seat 4: sebaparhasar84 (€2.30 in chips) 
Seat 5: caduceus369 (€4.97 in chips) 
Seat 6: Coffeebreak96 (€4.40 in chips) 
MammAnnAILovey: posts small blind €0.01
dellas3131: posts big blind €0.02
*** HOLE CARDS ***
Dealt to caduceus369 [6d Qd]
sebaparhasar84: folds 
caduceus369: folds 
Coffeebreak96: raises €0.02 to €0.04
xebarpz4400: calls €0.04
MammAnnAILovey: folds 
dellas3131: folds 
*** FLOP *** [4s 3c 9d]
Coffeebreak96: checks 
xebarpz4400: checks 
*** TURN *** [4s 3c 9d] [6s]
Coffeebreak96: checks 
xebarpz4400: checks 
*** RIVER *** [4s 3c 9d 6s] [4d]
Coffeebreak96: bets €0.02
xebarpz4400: calls €0.02
*** SHOW DOWN ***
Coffeebreak96: shows [Ks Ts] (a pair of Fours)
xebarpz4400: mucks hand 
Coffeebreak96 collected €0.15 from pot
*** SUMMARY ***
Total pot €0.15 | Rake €0 
Board [4s 3c 9d 6s 4d]
Seat 1: xebarpz4400 (button) mucked [Qc Js]
Seat 2: MammAnnAILovey (small blind) folded before Flop
Seat 3: dellas3131 (big blind) folded before Flop
Seat 4: sebaparhasar84 folded before Flop (didn't bet)
Seat 5: caduceus369 folded before Flop (didn't bet)
Seat 6: Coffeebreak96 showed [Ks Ts] and won (€0.15) with a pair of Fours



PokerStars Zoom Hand #258039971085:  Hold'em No Limit (€0.01/€0.02) [ADM ID: M62C03044AE79CRJ] - 2025/10/08 0:54:00 CET [2025/10/07 18:54:00 ET]
Table 'Sirio' 6-max Seat #1 is the button
Seat 1: sebaparhasar84 (€2.30 in chips) 
Seat 2: SaTheNuts_77 (€1.40 in chips) 
Seat 3: SiMoOoOo93 (€1.72 in chips) 
Seat 4: mashallahh (€7.93 in chips) 
Seat 5: dellas3131 (€2 in chips) 
Seat 6: caduceus369 (€4.97 in chips) 
SaTheNuts_77: posts small blind €0.01
SiMoOoOo93: posts big blind €0.02
*** HOLE CARDS ***
Dealt to caduceus369 [Th 2d]
mashallahh: folds 
dellas3131: folds 
caduceus369: folds 
sebaparhasar84: folds 
SaTheNuts_77: raises €0.05 to €0.07
SiMoOoOo93: raises €0.14 to €0.21
SaTheNuts_77: calls €0.14
*** FLOP *** [5h Js 3d]
SaTheNuts_77: checks 
SiMoOoOo93: bets €0.18
SaTheNuts_77: calls €0.18
*** TURN *** [5h Js 3d] [4d]
SaTheNuts_77: checks 
SiMoOoOo93: bets €0.37
SaTheNuts_77: calls €0.37
*** RIVER *** [5h Js 3d 4d] [2h]
SaTheNuts_77: bets €0.64 and is all-in
SiMoOoOo93: calls €0.64
*** SHOW DOWN ***
SaTheNuts_77: shows [Ad 4c] (a straight, Ace to Five)
SiMoOoOo93: shows [Kh Kd] (a pair of Kings)
SaTheNuts_77 collected €2.65 from pot
*** SUMMARY ***
Total pot €2.80 | Rake €0.15 
Board [5h Js 3d 4d 2h]
Seat 1: sebaparhasar84 (button) folded before Flop (didn't bet)
Seat 2: SaTheNuts_77 (small blind) showed [Ad 4c] and won (€2.65) with a straight, Ace to Five
Seat 3: SiMoOoOo93 (big blind) showed [Kh Kd] and lost with a pair of Kings
Seat 4: mashallahh folded before Flop (didn't bet)
Seat 5: dellas3131 folded before Flop (didn't bet)
Seat 6: caduceus369 folded before Flop (didn't bet)



PokerStars Zoom Hand #258039974434:  Hold'em No Limit (€0.01/€0.02) [ADM ID: M62C03044AE79CRJ] - 2025/10/08 0:54:18 CET [2025/10/07 18:54:18 ET]
Table 'Sirio' 6-max Seat #1 is the button
Seat 1: MammAnnAILovey (€0.11 in chips) 
Seat 2: SebaRapy14 (€3.47 in chips) 
Seat 3: caduceus369 (€4.97 in chips) 
Seat 4: mashallahh (€7.93 in chips) 
Seat 5: ADRIAN0_MEIS (€24.55 in chips) 
SebaRapy14: posts small blind €0.01
caduceus369: posts big blind €0.02
*** HOLE CARDS ***
Dealt to caduceus369 [7c 7h]
mashallahh: folds 
ADRIAN0_MEIS: folds 
MammAnnAILovey: raises €0.09 to €0.11 and is all-in
SebaRapy14: calls €0.10
caduceus369: calls €0.09
*** FLOP *** [6c Jd 3s]
SebaRapy14: checks 
caduceus369: checks 
*** TURN *** [6c Jd 3s] [8c]
SebaRapy14: checks 
caduceus369: checks 
*** RIVER *** [6c Jd 3s 8c] [6d]
SebaRapy14: checks 
caduceus369: checks 
*** SHOW DOWN ***
SebaRapy14: shows [2h 2d] (two pair, Sixes and Deuces)
caduceus369: shows [7c 7h] (two pair, Sevens and Sixes)
MammAnnAILovey: mucks hand 
caduceus369 collected €0.32 from pot
*** SUMMARY ***
Total pot €0.33 | Rake €0.01 
Board [6c Jd 3s 8c 6d]
Seat 1: MammAnnAILovey (button) mucked [Td Qd]
Seat 2: SebaRapy14 (small blind) showed [2h 2d] and lost with two pair, Sixes and Deuces
Seat 3: caduceus369 (big blind) showed [7c 7h] and won (€0.32) with two pair, Sevens and Sixes
Seat 4: mashallahh folded before Flop (didn't bet)
Seat 5: ADRIAN0_MEIS folded before Flop (didn't bet)



PokerStars Zoom Hand #258039985370:  Hold'em No Limit (€0.01/€0.02) [ADM ID: M62C03044AE79CRJ] - 2025/10/08 0:55:20 CET [2025/10/07 18:55:20 ET]
Table 'Sirio' 6-max Seat #1 is the button
Seat 1: SebaRapy14 (€3.36 in chips) 
Seat 2: mashallahh (€4.50 in chips) 
Seat 3: fantaasso (€1.47 in chips) 
Seat 4: sebaparhasar84 (€2.25 in chips) 
Seat 5: dellas3131 (€2.09 in chips) 
Seat 6: caduceus369 (€5.18 in chips) 
mashallahh: posts small blind €0.01
fantaasso: posts big blind €0.02
*** HOLE CARDS ***
Dealt to caduceus369 [2c 7s]
sebaparhasar84: folds 
dellas3131: raises €0.05 to €0.07
caduceus369: folds 
SebaRapy14: folds 
mashallahh: folds 
fantaasso: folds 
Uncalled bet (€0.05) returned to dellas3131
dellas3131 collected €0.05 from pot
dellas3131: doesn't show hand 
*** SUMMARY ***
Total pot €0.05 | Rake €0 
Seat 1: SebaRapy14 (button) folded before Flop (didn't bet)
Seat 2: mashallahh (small blind) folded before Flop
Seat 3: fantaasso (big blind) folded before Flop
Seat 4: sebaparhasar84 folded before Flop (didn't bet)
Seat 5: dellas3131 collected (€0.05)
Seat 6: caduceus369 folded before Flop (didn't bet)



PokerStars Zoom Hand #258039986348:  Hold'em No Limit (€0.01/€0.02) [ADM ID: M62C03044AE79CRJ] - 2025/10/08 0:55:28 CET [2025/10/07 18:55:28 ET]
Table 'Sirio' 6-max Seat #1 is the button
Seat 1: SebaRapy14 (€3.36 in chips) 
Seat 2: caduceus369 (€5.18 in chips) 
Seat 3: mashallahh (€3.77 in chips) 
Seat 4: sebaparhasar84 (€2.25 in chips) 
Seat 5: SiMoOoOo93 (€0.26 in chips) 
Seat 6: fccmp (€1.80 in chips) 
caduceus369: posts small blind €0.01
mashallahh: posts big blind €0.02
*** HOLE CARDS ***
Dealt to caduceus369 [4s Ac]
sebaparhasar84: folds 
SiMoOoOo93: folds 
fccmp: folds 
SebaRapy14: folds 
caduceus369: folds 
Uncalled bet (€0.01) returned to mashallahh
mashallahh collected €0.02 from pot
mashallahh: doesn't show hand 
*** SUMMARY ***
Total pot €0.02 | Rake €0 
Seat 1: SebaRapy14 (button) folded before Flop (didn't bet)
Seat 2: caduceus369 (small blind) folded before Flop
Seat 3: mashallahh (big blind) collected (€0.02)
Seat 4: sebaparhasar84 folded before Flop (didn't bet)
Seat 5: SiMoOoOo93 folded before Flop (didn't bet)
Seat 6: fccmp folded before Flop (didn't bet)



PokerStars Zoom Hand #258039989243:  Hold'em No Limit (€0.01/€0.02) [ADM ID: M62C03044AE79CRJ] - 2025/10/08 0:55:49 CET [2025/10/07 18:55:49 ET]
Table 'Sirio' 6-max Seat #1 is the button
Seat 1: QUATTRODAME (€2.04 in chips) 
Seat 2: fantaasso (€1.45 in chips) 
Seat 3: SebaRapy14 (€3.36 in chips) 
Seat 4: caduceus369 (€5.17 in chips) 
Seat 5: mashallahh (€3.78 in chips) 
Seat 6: Emm3B1 (€2.85 in chips) 
fantaasso: posts small blind €0.01
SebaRapy14: posts big blind €0.02
*** HOLE CARDS ***
Dealt to caduceus369 [6d 4s]
caduceus369: folds 
mashallahh: folds 
Emm3B1: folds 
QUATTRODAME: folds 
fantaasso: folds 
Uncalled bet (€0.01) returned to SebaRapy14
SebaRapy14 collected €0.02 from pot
SebaRapy14: doesn't show hand 
*** SUMMARY ***
Total pot €0.02 | Rake €0 
Seat 1: QUATTRODAME (button) folded before Flop (didn't bet)
Seat 2: fantaasso (small blind) folded before Flop
Seat 3: SebaRapy14 (big blind) collected (€0.02)
Seat 4: caduceus369 folded before Flop (didn't bet)
Seat 5: mashallahh folded before Flop (didn't bet)
Seat 6: Emm3B1 folded before Flop (didn't bet)



PokerStars Zoom Hand #258039987972:  Hold'em No Limit (€0.01/€0.02) [ADM ID: M62C03044AE79CRJ] - 2025/10/08 0:55:39 CET [2025/10/07 18:55:39 ET]
Table 'Sirio' 6-max Seat #1 is the button
Seat 1: SaTheNuts_77 (€2.73 in chips) 
Seat 2: xebarpz4400 (€0.75 in chips) 
Seat 3: SiMoOoOo93 (€0.26 in chips) 
Seat 4: fccmp (€1.79 in chips) 
Seat 5: caduceus369 (€5.17 in chips) 
xebarpz4400: posts small blind €0.01
SiMoOoOo93: posts big blind €0.02
*** HOLE CARDS ***
Dealt to caduceus369 [4h 9c]
fccmp: folds 
caduceus369: folds 
SaTheNuts_77: folds 
xebarpz4400: raises €0.04 to €0.06
SiMoOoOo93: calls €0.04
*** FLOP *** [5d 2c Td]
xebarpz4400: bets €0.06
SiMoOoOo93: calls €0.06
*** TURN *** [5d 2c Td] [3h]
xebarpz4400: bets €0.12
SiMoOoOo93: calls €0.12
*** RIVER *** [5d 2c Td 3h] [9d]
xebarpz4400: checks 
SiMoOoOo93: bets €0.02 and is all-in
xebarpz4400: calls €0.02
*** SHOW DOWN ***
SiMoOoOo93: shows [Jd Th] (a pair of Tens)
xebarpz4400: shows [Qd As] (high card Ace)
SiMoOoOo93 collected €0.50 from pot
*** SUMMARY ***
Total pot €0.52 | Rake €0.02 
Board [5d 2c Td 3h 9d]
Seat 1: SaTheNuts_77 (button) folded before Flop (didn't bet)
Seat 2: xebarpz4400 (small blind) showed [Qd As] and lost with high card Ace
Seat 3: SiMoOoOo93 (big blind) showed [Jd Th] and won (€0.50) with a pair of Tens
Seat 4: fccmp folded before Flop (didn't bet)
Seat 5: caduceus369 folded before Flop (didn't bet)



PokerStars Zoom Hand #258039988815:  Hold'em No Limit (€0.01/€0.02) [ADM ID: M62C03044AE79CRJ] - 2025/10/08 0:55:45 CET [2025/10/07 18:55:45 ET]
Table 'Sirio' 6-max Seat #1 is the button
Seat 1: fccmp (€1.79 in chips) 
Seat 2: SaTheNuts_77 (€2.73 in chips) 
Seat 3: mashallahh (€4.49 in chips) 
Seat 4: caduceus369 (€5.17 in chips) 
Seat 5: fantaasso (€1.45 in chips) 
SaTheNuts_77: posts small blind €0.01
mashallahh: posts big blind €0.02
*** HOLE CARDS ***
Dealt to caduceus369 [8c Qd]
caduceus369: folds 
fantaasso: folds 
fccmp: calls €0.02
SaTheNuts_77: folds 
mashallahh: checks 
*** FLOP *** [8d Jh 6d]
mashallahh: bets €0.04
fccmp: calls €0.04
*** TURN *** [8d Jh 6d] [3s]
mashallahh: checks 
fccmp: checks 
*** RIVER *** [8d Jh 6d 3s] [4h]
mashallahh: checks 
fccmp: bets €0.07
mashallahh: folds 
Uncalled bet (€0.07) returned to fccmp
fccmp collected €0.13 from pot
fccmp: doesn't show hand 
*** SUMMARY ***
Total pot €0.13 | Rake €0 
Board [8d Jh 6d 3s 4h]
Seat 1: fccmp (button) collected (€0.13)
Seat 2: SaTheNuts_77 (small blind) folded before Flop
Seat 3: mashallahh (big blind) folded on the River
Seat 4: caduceus369 folded before Flop (didn't bet)
Seat 5: fantaasso folded before Flop (didn't bet)



PokerStars Zoom Hand #258039989928:  Hold'em No Limit (€0.01/€0.02) [ADM ID: M62C03044AE79CRJ] - 2025/10/08 0:55:54 CET [2025/10/07 18:55:54 ET]
Table 'Sirio' 6-max Seat #1 is the button
Seat 1: Emm3B1 (€2.85 in chips) 
Seat 2: caduceus369 (€5.17 in chips) 
Seat 3: Agbtano (€1.16 in chips) 
Seat 4: QUATTRODAME (€2.04 in chips) 
Seat 5: Soooooni (€2.21 in chips) 
Seat 6: SaTheNuts_77 (€2.72 in chips) 
caduceus369: posts small blind €0.01
Agbtano: posts big blind €0.02
*** HOLE CARDS ***
Dealt to caduceus369 [Qs Ad]
QUATTRODAME: folds 
Soooooni: raises €0.04 to €0.06
SaTheNuts_77: folds 
Emm3B1: folds 
caduceus369: raises €0.12 to €0.18
Agbtano: folds 
Soooooni: raises €0.36 to €0.54
caduceus369: calls €0.36
*** FLOP *** [8c Js 2h]
caduceus369: checks 
Soooooni: bets €0.26
caduceus369: calls €0.26
*** TURN *** [8c Js 2h] [Th]
caduceus369: bets €0.51
Soooooni: raises €0.90 to €1.41 and is all-in
caduceus369: folds 
Uncalled bet (€0.90) returned to Soooooni
Soooooni collected €2.50 from pot
Soooooni: doesn't show hand 
*** SUMMARY ***
Total pot €2.64 | Rake €0.14 
Board [8c Js 2h Th]
Seat 1: Emm3B1 (button) folded before Flop (didn't bet)
Seat 2: caduceus369 (small blind) folded on the Turn
Seat 3: Agbtano (big blind) folded before Flop
Seat 4: QUATTRODAME folded before Flop (didn't bet)
Seat 5: Soooooni collected (€2.50)
Seat 6: SaTheNuts_77 folded before Flop (didn't bet)



PokerStars Zoom Hand #258040000588:  Hold'em No Limit (€0.01/€0.02) [ADM ID: M62C03044AE79CRJ] - 2025/10/08 0:57:10 CET [2025/10/07 18:57:10 ET]
Table 'Sirio' 6-max Seat #1 is the button
Seat 1: Emm3B1 (€2.80 in chips) 
Seat 2: mashallahh (€2.69 in chips) 
Seat 3: caduceus369 (€3.86 in chips) 
Seat 4: Soooooni (€3.40 in chips) 
Seat 5: SiMoOoOo93 (€0.51 in chips) 
Seat 6: tygaa2294 (€2.66 in chips) 
mashallahh: posts small blind €0.01
caduceus369: posts big blind €0.02
*** HOLE CARDS ***
Dealt to caduceus369 [2s Ah]
Soooooni: folds 
SiMoOoOo93: folds 
tygaa2294: folds 
Emm3B1: raises €0.04 to €0.06
mashallahh: folds 
caduceus369: folds 
Uncalled bet (€0.04) returned to Emm3B1
Emm3B1 collected €0.05 from pot
Emm3B1: doesn't show hand 
*** SUMMARY ***
Total pot €0.05 | Rake €0 
Seat 1: Emm3B1 (button) collected (€0.05)
Seat 2: mashallahh (small blind) folded before Flop
Seat 3: caduceus369 (big blind) folded before Flop
Seat 4: Soooooni folded before Flop (didn't bet)
Seat 5: SiMoOoOo93 folded before Flop (didn't bet)
Seat 6: tygaa2294 folded before Flop (didn't bet)



PokerStars Zoom Hand #258040002141:  Hold'em No Limit (€0.01/€0.02) [ADM ID: M62C03044AE79CRJ] - 2025/10/08 0:57:21 CET [2025/10/07 18:57:21 ET]
Table 'Sirio' 6-max Seat #1 is the button
Seat 1: caduceus369 (€3.84 in chips) 
Seat 2: tygaa2294 (€2.66 in chips) 
Seat 3: SiMoOoOo93 (€0.51 in chips) 
Seat 4: SaTheNuts_77 (€2.68 in chips) 
Seat 5: patrick0708 (€0.78 in chips) 
Seat 6: mashallahh (€3.62 in chips) 
tygaa2294: posts small blind €0.01
SiMoOoOo93: posts big blind €0.02
*** HOLE CARDS ***
Dealt to caduceus369 [8s Kd]
SaTheNuts_77: folds 
patrick0708: folds 
mashallahh: folds 
caduceus369: folds 
tygaa2294: folds 
Uncalled bet (€0.01) returned to SiMoOoOo93
SiMoOoOo93 collected €0.02 from pot
SiMoOoOo93: doesn't show hand 
*** SUMMARY ***
Total pot €0.02 | Rake €0 
Seat 1: caduceus369 (button) folded before Flop (didn't bet)
Seat 2: tygaa2294 (small blind) folded before Flop
Seat 3: SiMoOoOo93 (big blind) collected (€0.02)
Seat 4: SaTheNuts_77 folded before Flop (didn't bet)
Seat 5: patrick0708 folded before Flop (didn't bet)
Seat 6: mashallahh folded before Flop (didn't bet)



PokerStars Zoom Hand #258040003686:  Hold'em No Limit (€0.01/€0.02) [ADM ID: M62C03044AE79CRJ] - 2025/10/08 0:57:32 CET [2025/10/07 18:57:32 ET]
Table 'Sirio' 6-max Seat #1 is the button
Seat 1: gitikappa (€0.87 in chips) 
Seat 2: Emm3B1 (€2.83 in chips) 
Seat 3: xTheBulldogx (€1.10 in chips) 
Seat 4: SaTheNuts_77 (€2.67 in chips) 
Seat 5: Agbtano (€1.11 in chips) 
Seat 6: caduceus369 (€3.84 in chips) 
Emm3B1: posts small blind €0.01
xTheBulldogx: posts big blind €0.02
*** HOLE CARDS ***
Dealt to caduceus369 [8c 9s]
SaTheNuts_77: folds 
Agbtano: folds 
caduceus369: folds 
gitikappa: raises €0.02 to €0.04
Emm3B1: folds 
xTheBulldogx: calls €0.02
*** FLOP *** [Jc Ts 2h]
xTheBulldogx: checks 
gitikappa: bets €0.02
xTheBulldogx: folds 
Uncalled bet (€0.02) returned to gitikappa
gitikappa collected €0.09 from pot
gitikappa: doesn't show hand 
*** SUMMARY ***
Total pot €0.09 | Rake €0 
Board [Jc Ts 2h]
Seat 1: gitikappa (button) collected (€0.09)
Seat 2: Emm3B1 (small blind) folded before Flop
Seat 3: xTheBulldogx (big blind) folded on the Flop
Seat 4: SaTheNuts_77 folded before Flop (didn't bet)
Seat 5: Agbtano folded before Flop (didn't bet)
Seat 6: caduceus369 folded before Flop (didn't bet)



PokerStars Zoom Hand #258040005268:  Hold'em No Limit (€0.01/€0.02) [ADM ID: M62C03044AE79CRJ] - 2025/10/08 0:57:44 CET [2025/10/07 18:57:44 ET]
Table 'Sirio' 6-max Seat #1 is the button
Seat 1: QUATTRODAME (€2.08 in chips) 
Seat 2: KKKfold (€0.78 in chips) 
Seat 3: mashallahh (€7.98 in chips) 
Seat 4: dellas3131 (€2.35 in chips) 
Seat 5: caduceus369 (€3.84 in chips) 
Seat 6: patrick0708 (€0.77 in chips) 
KKKfold: posts small blind €0.01
mashallahh: posts big blind €0.02
*** HOLE CARDS ***
Dealt to caduceus369 [Ks Kd]
dellas3131: folds 
caduceus369: raises €0.04 to €0.06
patrick0708: folds 
QUATTRODAME: folds 
KKKfold: folds 
mashallahh: folds 
Uncalled bet (€0.04) returned to caduceus369
caduceus369 collected €0.05 from pot
caduceus369: doesn't show hand 
*** SUMMARY ***
Total pot €0.05 | Rake €0 
Seat 1: QUATTRODAME (button) folded before Flop (didn't bet)
Seat 2: KKKfold (small blind) folded before Flop
Seat 3: mashallahh (big blind) folded before Flop
Seat 4: dellas3131 folded before Flop (didn't bet)
Seat 5: caduceus369 collected (€0.05)
Seat 6: patrick0708 folded before Flop (didn't bet)



PokerStars Zoom Hand #258040010155:  Hold'em No Limit (€0.01/€0.02) [ADM ID: M62C03044AE79CRJ] - 2025/10/08 0:58:18 CET [2025/10/07 18:58:18 ET]
Table 'Sirio' 6-max Seat #1 is the button
Seat 1: mashallahh (€2.66 in chips) 
Seat 2: caduceus369 (€3.87 in chips) 
Seat 3: SebaRapy14 (€8.41 in chips) 
Seat 4: IlDestro71 (€0.67 in chips) 
Seat 5: KKKfold (€0.86 in chips) 
Seat 6: fantaasso (€1.53 in chips) 
caduceus369: posts small blind €0.01
SebaRapy14: posts big blind €0.02
*** HOLE CARDS ***
Dealt to caduceus369 [2d 3h]
IlDestro71: calls €0.02
KKKfold: folds 
fantaasso: folds 
mashallahh: folds 
caduceus369: folds 
SebaRapy14: checks 
*** FLOP *** [Kh 3d 7h]
SebaRapy14: checks 
IlDestro71: checks 
*** TURN *** [Kh 3d 7h] [Qh]
SebaRapy14: checks 
IlDestro71: checks 
*** RIVER *** [Kh 3d 7h Qh] [Jd]
SebaRapy14: checks 
IlDestro71: bets €0.02
SebaRapy14: folds 
Uncalled bet (€0.02) returned to IlDestro71
IlDestro71 collected €0.05 from pot
IlDestro71: doesn't show hand 
*** SUMMARY ***
Total pot €0.05 | Rake €0 
Board [Kh 3d 7h Qh Jd]
Seat 1: mashallahh (button) folded before Flop (didn't bet)
Seat 2: caduceus369 (small blind) folded before Flop
Seat 3: SebaRapy14 (big blind) folded on the River
Seat 4: IlDestro71 collected (€0.05)
Seat 5: KKKfold folded before Flop (didn't bet)
Seat 6: fantaasso folded before Flop (didn't bet)



PokerStars Zoom Hand #258040011297:  Hold'em No Limit (€0.01/€0.02) [ADM ID: M62C03044AE79CRJ] - 2025/10/08 0:58:26 CET [2025/10/07 18:58:26 ET]
Table 'Sirio' 6-max Seat #1 is the button
Seat 1: mashallahh (€7.99 in chips) 
Seat 2: Agbtano (€1.21 in chips) 
Seat 3: caduceus369 (€3.86 in chips) 
Seat 4: SebaRapy14 (€2.23 in chips) 
Seat 5: QUATTRODAME (€2.08 in chips) 
Seat 6: dellas3131 (€2.32 in chips) 
Agbtano: posts small blind €0.01
caduceus369: posts big blind €0.02
*** HOLE CARDS ***
Dealt to caduceus369 [Ac 5d]
SebaRapy14: folds 
QUATTRODAME: folds 
dellas3131: raises €0.05 to €0.07
mashallahh: folds 
Agbtano: calls €0.06
caduceus369: folds 
*** FLOP *** [Kd 3h 7c]
Agbtano: bets €0.08
dellas3131: raises €0.23 to €0.31
Agbtano: folds 
Uncalled bet (€0.23) returned to dellas3131
dellas3131 collected €0.31 from pot
dellas3131: doesn't show hand 
*** SUMMARY ***
Total pot €0.32 | Rake €0.01 
Board [Kd 3h 7c]
Seat 1: mashallahh (button) folded before Flop (didn't bet)
Seat 2: Agbtano (small blind) folded on the Flop
Seat 3: caduceus369 (big blind) folded before Flop
Seat 4: SebaRapy14 folded before Flop (didn't bet)
Seat 5: QUATTRODAME folded before Flop (didn't bet)
Seat 6: dellas3131 collected (€0.31)



PokerStars Zoom Hand #258040007777:  Hold'em No Limit (€0.01/€0.02) [ADM ID: M62C03044AE79CRJ] - 2025/10/08 0:58:01 CET [2025/10/07 18:58:01 ET]
Table 'Sirio' 6-max Seat #1 is the button
Seat 1: SaTheNuts_77 (€2.68 in chips) 
Seat 2: QUATTRODAME (€2.06 in chips) 
Seat 3: sebaparhasar84 (€2.20 in chips) 
Seat 4: mashallahh (€2.66 in chips) 
Seat 5: caduceus369 (€3.87 in chips) 
Seat 6: non dire così (€1.19 in chips) 
QUATTRODAME: posts small blind €0.01
sebaparhasar84: posts big blind €0.02
*** HOLE CARDS ***
Dealt to caduceus369 [Kh 4h]
mashallahh: folds 
caduceus369: folds 
non dire così: calls €0.02
SaTheNuts_77: raises €0.07 to €0.09
QUATTRODAME: folds 
sebaparhasar84: folds 
non dire così: raises €0.07 to €0.16
SaTheNuts_77: calls €0.07
*** FLOP *** [4d 3s 7h]
non dire così: checks 
SaTheNuts_77: checks 
*** TURN *** [4d 3s 7h] [2c]
non dire così: bets €0.06
SaTheNuts_77: calls €0.06
*** RIVER *** [4d 3s 7h 2c] [9s]
non dire così: bets €0.45
SaTheNuts_77: folds 
Uncalled bet (€0.45) returned to non dire così
non dire così collected €0.45 from pot
non dire così: doesn't show hand 
*** SUMMARY ***
Total pot €0.47 | Rake €0.02 
Board [4d 3s 7h 2c 9s]
Seat 1: SaTheNuts_77 (button) folded on the River
Seat 2: QUATTRODAME (small blind) folded before Flop
Seat 3: sebaparhasar84 (big blind) folded before Flop
Seat 4: mashallahh folded before Flop (didn't bet)
Seat 5: caduceus369 folded before Flop (didn't bet)
Seat 6: non dire così collected (€0.45)



PokerStars Zoom Hand #258040016789:  Hold'em No Limit (€0.01/€0.02) [ADM ID: M62C03044AE79CRJ] - 2025/10/08 0:59:06 CET [2025/10/07 18:59:06 ET]
Table 'Sirio' 6-max Seat #1 is the button
Seat 1: Genny040893 (€0.34 in chips) 
Seat 2: amicoakira (€0.97 in chips) 
Seat 3: patrick0708 (€0.75 in chips) 
Seat 4: caduceus369 (€3.84 in chips) 
Seat 5: PIRULO1235 (€2.23 in chips) 
Seat 6: SaTheNuts_77 (€2.45 in chips) 
amicoakira: posts small blind €0.01
patrick0708: posts big blind €0.02
*** HOLE CARDS ***
Dealt to caduceus369 [2s Ts]
caduceus369: folds 
PIRULO1235: folds 
SaTheNuts_77: folds 
Genny040893: raises €0.02 to €0.04
amicoakira: folds 
patrick0708: folds 
Uncalled bet (€0.02) returned to Genny040893
Genny040893 collected €0.05 from pot
Genny040893: doesn't show hand 
*** SUMMARY ***
Total pot €0.05 | Rake €0 
Seat 1: Genny040893 (button) collected (€0.05)
Seat 2: amicoakira (small blind) folded before Flop
Seat 3: patrick0708 (big blind) folded before Flop
Seat 4: caduceus369 folded before Flop (didn't bet)
Seat 5: PIRULO1235 folded before Flop (didn't bet)
Seat 6: SaTheNuts_77 folded before Flop (didn't bet)



PokerStars Zoom Hand #258040013093:  Hold'em No Limit (€0.01/€0.02) [ADM ID: M62C03044AE79CRJ] - 2025/10/08 0:58:39 CET [2025/10/07 18:58:39 ET]
Table 'Sirio' 6-max Seat #1 is the button
Seat 1: caduceus369 (€3.84 in chips) 
Seat 2: QUATTRODAME (€2.08 in chips) 
Seat 3: SebaRapy14 (€2.23 in chips) 
Seat 4: fantaasso (€1.52 in chips) 
Seat 5: mashallahh (€7.99 in chips) 
QUATTRODAME: posts small blind €0.01
SebaRapy14: posts big blind €0.02
*** HOLE CARDS ***
Dealt to caduceus369 [Jd 2h]
fantaasso: folds 
mashallahh: folds 
caduceus369: folds 
QUATTRODAME: raises €2.06 to €2.08 and is all-in
SebaRapy14: calls €2.06
*** FLOP *** [Tc Kh 4h]
*** TURN *** [Tc Kh 4h] [Kd]
*** RIVER *** [Tc Kh 4h Kd] [7d]
*** SHOW DOWN ***
QUATTRODAME: shows [Kc Ah] (three of a kind, Kings)
SebaRapy14: shows [Jh Js] (two pair, Kings and Jacks)
QUATTRODAME collected €3.94 from pot
*** SUMMARY ***
Total pot €4.16 | Rake €0.22 
Board [Tc Kh 4h Kd 7d]
Seat 1: caduceus369 (button) folded before Flop (didn't bet)
Seat 2: QUATTRODAME (small blind) showed [Kc Ah] and won (€3.94) with three of a kind, Kings
Seat 3: SebaRapy14 (big blind) showed [Jh Js] and lost with two pair, Kings and Jacks
Seat 4: fantaasso folded before Flop (didn't bet)
Seat 5: mashallahh folded before Flop (didn't bet)



PokerStars Zoom Hand #258040017540:  Hold'em No Limit (€0.01/€0.02) [ADM ID: M62C03044AE79CRJ] - 2025/10/08 0:59:12 CET [2025/10/07 18:59:12 ET]
Table 'Sirio' 6-max Seat #1 is the button
Seat 1: PIRULO1235 (€2.23 in chips) 
Seat 2: KKKfold (€0.84 in chips) 
Seat 3: caduceus369 (€3.84 in chips) 
Seat 4: SebaRapy14 (€8.39 in chips) 
Seat 5: dellas3131 (€2.48 in chips) 
Seat 6: sebaparhasar84 (€2.20 in chips) 
KKKfold: posts small blind €0.01
caduceus369: posts big blind €0.02
*** HOLE CARDS ***
Dealt to caduceus369 [7c Td]
SebaRapy14: raises €0.04 to €0.06
dellas3131: folds 
sebaparhasar84: folds 
PIRULO1235: calls €0.06
KKKfold: calls €0.05
caduceus369: folds 
*** FLOP *** [Qc 4d 4s]
KKKfold: checks 
SebaRapy14: bets €0.10
PIRULO1235: folds 
KKKfold: folds 
Uncalled bet (€0.10) returned to SebaRapy14
SebaRapy14 collected €0.19 from pot
SebaRapy14: doesn't show hand 
*** SUMMARY ***
Total pot €0.20 | Rake €0.01 
Board [Qc 4d 4s]
Seat 1: PIRULO1235 (button) folded on the Flop
Seat 2: KKKfold (small blind) folded on the Flop
Seat 3: caduceus369 (big blind) folded before Flop
Seat 4: SebaRapy14 collected (€0.19)
Seat 5: dellas3131 folded before Flop (didn't bet)
Seat 6: sebaparhasar84 folded before Flop (didn't bet)



PokerStars Zoom Hand #258040014513:  Hold'em No Limit (€0.01/€0.02) [ADM ID: M62C03044AE79CRJ] - 2025/10/08 0:58:50 CET [2025/10/07 18:58:50 ET]
Table 'Sirio' 6-max Seat #1 is the button
Seat 1: IlDestro71 (€0.70 in chips) 
Seat 2: xebarpz4400 (€0.60 in chips) 
Seat 3: Agbtano (€1.06 in chips) 
Seat 4: tygaa2294 (€2.80 in chips) 
Seat 5: gitikappa (€0.89 in chips) 
Seat 6: caduceus369 (€3.84 in chips) 
xebarpz4400: posts small blind €0.01
Agbtano: posts big blind €0.02
*** HOLE CARDS ***
Dealt to caduceus369 [4c Ad]
tygaa2294: raises €0.02 to €0.04
gitikappa: folds 
caduceus369: folds 
IlDestro71: folds 
xebarpz4400: calls €0.03
Agbtano: folds 
*** FLOP *** [Qc 8s 4s]
xebarpz4400: bets €0.02
tygaa2294: raises €0.04 to €0.06
xebarpz4400: calls €0.04
*** TURN *** [Qc 8s 4s] [6s]
xebarpz4400: checks 
tygaa2294: bets €0.02
xebarpz4400: calls €0.02
*** RIVER *** [Qc 8s 4s 6s] [8d]
xebarpz4400: bets €0.13
tygaa2294: raises €0.51 to €0.64
xebarpz4400: folds 
Uncalled bet (€0.51) returned to tygaa2294
tygaa2294 collected €0.50 from pot
tygaa2294: doesn't show hand 
*** SUMMARY ***
Total pot €0.52 | Rake €0.02 
Board [Qc 8s 4s 6s 8d]
Seat 1: IlDestro71 (button) folded before Flop (didn't bet)
Seat 2: xebarpz4400 (small blind) folded on the River
Seat 3: Agbtano (big blind) folded before Flop
Seat 4: tygaa2294 collected (€0.50)
Seat 5: gitikappa folded before Flop (didn't bet)
Seat 6: caduceus369 folded before Flop (didn't bet)



PokerStars Zoom Hand #258040020235:  Hold'em No Limit (€0.01/€0.02) [ADM ID: M62C03044AE79CRJ] - 2025/10/08 0:59:31 CET [2025/10/07 18:59:31 ET]
Table 'Sirio' 6-max Seat #1 is the button
Seat 1: patrick0708 (€0.72 in chips) 
Seat 2: caduceus369 (€3.82 in chips) 
Seat 3: SaTheNuts_77 (€2.45 in chips) 
Seat 4: dellas3131 (€2.48 in chips) 
Seat 5: mashallahh (€3.62 in chips) 
Seat 6: Genny040893 (€0.36 in chips) 
caduceus369: posts small blind €0.01
SaTheNuts_77: posts big blind €0.02
*** HOLE CARDS ***
Dealt to caduceus369 [6c Kd]
dellas3131: folds 
mashallahh: folds 
Genny040893: folds 
patrick0708: raises €0.02 to €0.04
caduceus369: folds 
SaTheNuts_77: folds 
Uncalled bet (€0.02) returned to patrick0708
patrick0708 collected €0.05 from pot
patrick0708: doesn't show hand 
*** SUMMARY ***
Total pot €0.05 | Rake €0 
Seat 1: patrick0708 (button) collected (€0.05)
Seat 2: caduceus369 (small blind) folded before Flop
Seat 3: SaTheNuts_77 (big blind) folded before Flop
Seat 4: dellas3131 folded before Flop (didn't bet)
Seat 5: mashallahh folded before Flop (didn't bet)
Seat 6: Genny040893 folded before Flop (didn't bet)



PokerStars Zoom Hand #258040019210:  Hold'em No Limit (€0.01/€0.02) [ADM ID: M62C03044AE79CRJ] - 2025/10/08 0:59:24 CET [2025/10/07 18:59:24 ET]
Table 'Sirio' 6-max Seat #1 is the button
Seat 1: caduceus369 (€3.82 in chips) 
Seat 2: Genny040893 (€0.37 in chips) 
Seat 3: ADRIAN0_MEIS (€24.07 in chips) 
Seat 4: dellas3131 (€2.48 in chips) 
Seat 5: SaTheNuts_77 (€2.45 in chips) 
Seat 6: manuknife (€0.93 in chips) 
Genny040893: posts small blind €0.01
ADRIAN0_MEIS: posts big blind €0.02
*** HOLE CARDS ***
Dealt to caduceus369 [2d Qd]
dellas3131: folds 
SaTheNuts_77: folds 
manuknife: calls €0.02
caduceus369: folds 
Genny040893: folds 
ADRIAN0_MEIS: checks 
*** FLOP *** [Jd 5c Kc]
ADRIAN0_MEIS: checks 
manuknife: checks 
*** TURN *** [Jd 5c Kc] [5h]
ADRIAN0_MEIS: checks 
manuknife: bets €0.02
ADRIAN0_MEIS: folds 
Uncalled bet (€0.02) returned to manuknife
manuknife collected €0.05 from pot
manuknife: doesn't show hand 
*** SUMMARY ***
Total pot €0.05 | Rake €0 
Board [Jd 5c Kc 5h]
Seat 1: caduceus369 (button) folded before Flop (didn't bet)
Seat 2: Genny040893 (small blind) folded before Flop
Seat 3: ADRIAN0_MEIS (big blind) folded on the Turn
Seat 4: dellas3131 folded before Flop (didn't bet)
Seat 5: SaTheNuts_77 folded before Flop (didn't bet)
Seat 6: manuknife collected (€0.05)



PokerStars Zoom Hand #258040015896:  Hold'em No Limit (€0.01/€0.02) [ADM ID: M62C03044AE79CRJ] - 2025/10/08 0:59:00 CET [2025/10/07 18:59:00 ET]
Table 'Sirio' 6-max Seat #1 is the button
Seat 1: ADRIAN0_MEIS (€24.07 in chips) 
Seat 2: dellas3131 (€2.13 in chips) 
Seat 3: IlDestro71 (€0.70 in chips) 
Seat 4: caduceus369 (€3.84 in chips) 
Seat 5: patrick0708 (€0.75 in chips) 
Seat 6: winsper79 (€2.67 in chips) 
dellas3131: posts small blind €0.01
IlDestro71: posts big blind €0.02
*** HOLE CARDS ***
Dealt to caduceus369 [Jc 4s]
caduceus369: folds 
patrick0708: folds 
winsper79: raises €0.03 to €0.05
ADRIAN0_MEIS: folds 
dellas3131: calls €0.04
IlDestro71: calls €0.03
*** FLOP *** [6d Qd Jd]
dellas3131: bets €0.09
IlDestro71: folds 
winsper79: calls €0.09
*** TURN *** [6d Qd Jd] [Ts]
dellas3131: bets €0.19
winsper79: calls €0.19
*** RIVER *** [6d Qd Jd Ts] [2s]
dellas3131: bets €0.22
winsper79: raises €2.12 to €2.34 and is all-in
dellas3131: calls €1.58 and is all-in
Uncalled bet (€0.54) returned to winsper79
*** SHOW DOWN ***
winsper79: shows [Ad 7d] (a flush, Ace high)
dellas3131: shows [6s 6c] (three of a kind, Sixes)
winsper79 collected €4.08 from pot
*** SUMMARY ***
Total pot €4.31 | Rake €0.23 
Board [6d Qd Jd Ts 2s]
Seat 1: ADRIAN0_MEIS (button) folded before Flop (didn't bet)
Seat 2: dellas3131 (small blind) showed [6s 6c] and lost with three of a kind, Sixes
Seat 3: IlDestro71 (big blind) folded on the Flop
Seat 4: caduceus369 folded before Flop (didn't bet)
Seat 5: patrick0708 folded before Flop (didn't bet)
Seat 6: winsper79 showed [Ad 7d] and won (€4.08) with a flush, Ace high



PokerStars Zoom Hand #258040022279:  Hold'em No Limit (€0.01/€0.02) [ADM ID: M62C03044AE79CRJ] - 2025/10/08 0:59:46 CET [2025/10/07 18:59:46 ET]
Table 'Sirio' 6-max Seat #1 is the button
Seat 1: Agbtano (€1.99 in chips) 
Seat 2: SebaRapy14 (€8.52 in chips) 
Seat 3: Soooooni (€3.22 in chips) 
Seat 4: caduceus369 (€3.81 in chips) 
Seat 5: amicoakira (€0.96 in chips) 
Seat 6: xebarpz4400 (€0.35 in chips) 
SebaRapy14: posts small blind €0.01
Soooooni: posts big blind €0.02
*** HOLE CARDS ***
Dealt to caduceus369 [Qc Kc]
caduceus369: raises €0.04 to €0.06
amicoakira: calls €0.06
xebarpz4400: calls €0.06
Agbtano: calls €0.06
SebaRapy14: folds 
Soooooni: calls €0.04
*** FLOP *** [Ks 3c 7c]
Soooooni: checks 
caduceus369: bets €0.10
amicoakira: folds 
xebarpz4400: folds 
Agbtano: raises €0.25 to €0.35
Soooooni: folds 
caduceus369: calls €0.25
*** TURN *** [Ks 3c 7c] [3d]
caduceus369: checks 
Agbtano: bets €0.48
caduceus369: calls €0.48
*** RIVER *** [Ks 3c 7c 3d] [Js]
caduceus369: bets €1.40
Agbtano: calls €1.10 and is all-in
Uncalled bet (€0.30) returned to caduceus369
*** SHOW DOWN ***
caduceus369: shows [Qc Kc] (two pair, Kings and Threes)
Agbtano: shows [Td Kh] (two pair, Kings and Threes - lower kicker)
caduceus369 collected €3.95 from pot
*** SUMMARY ***
Total pot €4.17 | Rake €0.22 
Board [Ks 3c 7c 3d Js]
Seat 1: Agbtano (button) showed [Td Kh] and lost with two pair, Kings and Threes
Seat 2: SebaRapy14 (small blind) folded before Flop
Seat 3: Soooooni (big blind) folded on the Flop
Seat 4: caduceus369 showed [Qc Kc] and won (€3.95) with two pair, Kings and Threes
Seat 5: amicoakira folded on the Flop
Seat 6: xebarpz4400 folded on the Flop



PokerStars Zoom Hand #258040040256:  Hold'em No Limit (€0.01/€0.02) [ADM ID: M62C03044AE79CRJ] - 2025/10/08 1:01:38 CET [2025/10/07 19:01:38 ET]
Table 'Sirio' 6-max Seat #1 is the button
Seat 1: PIRULO1235 (€1.79 in chips) 
Seat 2: mashallahh (€2 in chips) 
Seat 3: caduceus369 (€5.77 in chips) 
Seat 4: patrick0708 (€0.70 in chips) 
Seat 5: Agbtano (€1.50 in chips) 
Seat 6: Coffeebreak96 (€3.42 in chips) 
mashallahh: posts small blind €0.01
caduceus369: posts big blind €0.02
*** HOLE CARDS ***
Dealt to caduceus369 [4c 2h]
patrick0708: folds 
Agbtano: folds 
Coffeebreak96: raises €0.02 to €0.04
PIRULO1235: folds 
mashallahh: folds 
caduceus369: folds 
Uncalled bet (€0.02) returned to Coffeebreak96
Coffeebreak96 collected €0.05 from pot
Coffeebreak96: doesn't show hand 
*** SUMMARY ***
Total pot €0.05 | Rake €0 
Seat 1: PIRULO1235 (button) folded before Flop (didn't bet)
Seat 2: mashallahh (small blind) folded before Flop
Seat 3: caduceus369 (big blind) folded before Flop
Seat 4: patrick0708 folded before Flop (didn't bet)
Seat 5: Agbtano folded before Flop (didn't bet)
Seat 6: Coffeebreak96 collected (€0.05)



PokerStars Zoom Hand #258040039534:  Hold'em No Limit (€0.01/€0.02) [ADM ID: M62C03044AE79CRJ] - 2025/10/08 1:01:34 CET [2025/10/07 19:01:34 ET]
Table 'Sirio' 6-max Seat #1 is the button
Seat 1: QUATTRODAME (€3.85 in chips) 
Seat 2: Coffeebreak96 (€3.43 in chips) 
Seat 3: KKKfold (€0.69 in chips) 
Seat 4: caduceus369 (€5.77 in chips) 
Seat 5: SebaRapy14 (€8.83 in chips) 
Seat 6: tygaa2294 (€3.94 in chips) 
Coffeebreak96: posts small blind €0.01
KKKfold: posts big blind €0.02
*** HOLE CARDS ***
Dealt to caduceus369 [6s 2d]
caduceus369: folds 
SebaRapy14: folds 
tygaa2294: folds 
QUATTRODAME: raises €0.02 to €0.04
Coffeebreak96: folds 
KKKfold: raises €0.03 to €0.07
QUATTRODAME: calls €0.03
*** FLOP *** [7s Tc 5d]
KKKfold: bets €0.10
QUATTRODAME: raises €0.35 to €0.45
KKKfold: raises €0.17 to €0.62 and is all-in
QUATTRODAME: calls €0.17
*** TURN *** [7s Tc 5d] [Kd]
*** RIVER *** [7s Tc 5d Kd] [Jc]
*** SHOW DOWN ***
KKKfold: shows [4d 6d] (high card King)
QUATTRODAME: shows [Td As] (a pair of Tens)
QUATTRODAME collected €1.32 from pot
*** SUMMARY ***
Total pot €1.39 | Rake €0.07 
Board [7s Tc 5d Kd Jc]
Seat 1: QUATTRODAME (button) showed [Td As] and won (€1.32) with a pair of Tens
Seat 2: Coffeebreak96 (small blind) folded before Flop
Seat 3: KKKfold (big blind) showed [4d 6d] and lost with high card King
Seat 4: caduceus369 folded before Flop (didn't bet)
Seat 5: SebaRapy14 folded before Flop (didn't bet)
Seat 6: tygaa2294 folded before Flop (didn't bet)



PokerStars Zoom Hand #258040038698:  Hold'em No Limit (€0.01/€0.02) [ADM ID: M62C03044AE79CRJ] - 2025/10/08 1:01:30 CET [2025/10/07 19:01:30 ET]
Table 'Sirio' 6-max Seat #1 is the button
Seat 1: SebaRapy14 (€2.10 in chips) 
Seat 2: fantaasso (€1.56 in chips) 
Seat 3: xebarpz4400 (€0.56 in chips) 
Seat 4: QUATTRODAME (€3.85 in chips) 
Seat 5: caduceus369 (€5.77 in chips) 
Seat 6: Coffeebreak96 (€3.43 in chips) 
fantaasso: posts small blind €0.01
xebarpz4400: posts big blind €0.02
*** HOLE CARDS ***
Dealt to caduceus369 [2c 6c]
QUATTRODAME: folds 
caduceus369: folds 
Coffeebreak96: folds 
SebaRapy14: raises €0.04 to €0.06
fantaasso: folds 
xebarpz4400: calls €0.04
*** FLOP *** [7d 9s 5d]
xebarpz4400: checks 
SebaRapy14: bets €0.08
xebarpz4400: calls €0.08
*** TURN *** [7d 9s 5d] [6h]
xebarpz4400: checks 
SebaRapy14: checks 
*** RIVER *** [7d 9s 5d 6h] [8d]
xebarpz4400: bets €0.14
SebaRapy14: raises €0.38 to €0.52
xebarpz4400: calls €0.28 and is all-in
Uncalled bet (€0.10) returned to SebaRapy14
*** SHOW DOWN ***
SebaRapy14: shows [6d Qd] (a flush, Queen high)
xebarpz4400: shows [Kd 8h] (a straight, Five to Nine)
SebaRapy14 collected €1.07 from pot
*** SUMMARY ***
Total pot €1.13 | Rake €0.06 
Board [7d 9s 5d 6h 8d]
Seat 1: SebaRapy14 (button) showed [6d Qd] and won (€1.07) with a flush, Queen high
Seat 2: fantaasso (small blind) folded before Flop
Seat 3: xebarpz4400 (big blind) showed [Kd 8h] and lost with a straight, Five to Nine
Seat 4: QUATTRODAME folded before Flop (didn't bet)
Seat 5: caduceus369 folded before Flop (didn't bet)
Seat 6: Coffeebreak96 folded before Flop (didn't bet)



PokerStars Zoom Hand #258040044525:  Hold'em No Limit (€0.01/€0.02) [ADM ID: M62C03044AE79CRJ] - 2025/10/08 1:02:01 CET [2025/10/07 19:02:01 ET]
Table 'Sirio' 6-max Seat #1 is the button
Seat 1: caduceus369 (€5.75 in chips) 
Seat 2: winsper79 (€4.65 in chips) 
Seat 3: mashallahh (€3.65 in chips) 
Seat 4: Soooooni (€3.84 in chips) 
Seat 5: Coffeebreak96 (€3.45 in chips) 
Seat 6: IlDestro71 (€0.37 in chips) 
winsper79: posts small blind €0.01
mashallahh: posts big blind €0.02
*** HOLE CARDS ***
Dealt to caduceus369 [9h Qd]
Soooooni: folds 
Coffeebreak96: folds 
IlDestro71: folds 
caduceus369: raises €0.04 to €0.06
winsper79: folds 
mashallahh: calls €0.04
*** FLOP *** [Kd Td Qc]
mashallahh has timed out
mashallahh: checks 
caduceus369: bets €0.04
mashallahh: calls €0.04
*** TURN *** [Kd Td Qc] [7d]
mashallahh: checks 
caduceus369: checks 
*** RIVER *** [Kd Td Qc 7d] [7s]
mashallahh: checks 
caduceus369: bets €0.07
mashallahh: folds 
Uncalled bet (€0.07) returned to caduceus369
caduceus369 collected €0.20 from pot
caduceus369: doesn't show hand 
*** SUMMARY ***
Total pot €0.21 | Rake €0.01 
Board [Kd Td Qc 7d 7s]
Seat 1: caduceus369 (button) collected (€0.20)
Seat 2: winsper79 (small blind) folded before Flop
Seat 3: mashallahh (big blind) folded on the River
Seat 4: Soooooni folded before Flop (didn't bet)
Seat 5: Coffeebreak96 folded before Flop (didn't bet)
Seat 6: IlDestro71 folded before Flop (didn't bet)



PokerStars Zoom Hand #258040070759:  Hold'em No Limit (€0.01/€0.02) [ADM ID: M62C03044AE79CRJ] - 2025/10/08 1:04:28 CET [2025/10/07 19:04:28 ET]
Table 'Sirio' 6-max Seat #1 is the button
Seat 1: gitikappa (€0.96 in chips) 
Seat 2: QUATTRODAME (€4.42 in chips) 
Seat 3: IlDestro71 (€0.31 in chips) 
Seat 4: SebaRapy14 (€2.91 in chips) 
Seat 5: ADRIAN0_MEIS (€23.03 in chips) 
Seat 6: caduceus369 (€5.84 in chips) 
QUATTRODAME: posts small blind €0.01
IlDestro71: posts big blind €0.02
*** HOLE CARDS ***
Dealt to caduceus369 [As 9h]
SebaRapy14: folds 
ADRIAN0_MEIS: raises €0.05 to €0.07
caduceus369: folds 
gitikappa: folds 
QUATTRODAME: folds 
IlDestro71: folds 
Uncalled bet (€0.05) returned to ADRIAN0_MEIS
ADRIAN0_MEIS collected €0.05 from pot
ADRIAN0_MEIS: doesn't show hand 
*** SUMMARY ***
Total pot €0.05 | Rake €0 
Seat 1: gitikappa (button) folded before Flop (didn't bet)
Seat 2: QUATTRODAME (small blind) folded before Flop
Seat 3: IlDestro71 (big blind) folded before Flop
Seat 4: SebaRapy14 folded before Flop (didn't bet)
Seat 5: ADRIAN0_MEIS collected (€0.05)
Seat 6: caduceus369 folded before Flop (didn't bet)



PokerStars Zoom Hand #258040077911:  Hold'em No Limit (€0.01/€0.02) [ADM ID: M62C03044AE79CRJ] - 2025/10/08 1:05:08 CET [2025/10/07 19:05:08 ET]
Table 'Sirio' 6-max Seat #1 is the button
Seat 1: fantaasso (€1.31 in chips) 
Seat 2: caduceus369 (€5.82 in chips) 
Seat 3: SebaRapy14 (€8.81 in chips) 
Seat 4: mashallahh (€8.35 in chips) 
Seat 5: PIRULO1235 (€1.99 in chips) 
caduceus369: posts small blind €0.01
SebaRapy14: posts big blind €0.02
*** HOLE CARDS ***
Dealt to caduceus369 [Ah Td]
mashallahh: folds 
PIRULO1235: folds 
fantaasso: folds 
caduceus369: folds 
Uncalled bet (€0.01) returned to SebaRapy14
SebaRapy14 collected €0.02 from pot
SebaRapy14: doesn't show hand 
*** SUMMARY ***
Total pot €0.02 | Rake €0 
Seat 1: fantaasso (button) folded before Flop (didn't bet)
Seat 2: caduceus369 (small blind) folded before Flop
Seat 3: SebaRapy14 (big blind) collected (€0.02)
Seat 4: mashallahh folded before Flop (didn't bet)
Seat 5: PIRULO1235 folded before Flop (didn't bet)



PokerStars Zoom Hand #258040074785:  Hold'em No Limit (€0.01/€0.02) [ADM ID: M62C03044AE79CRJ] - 2025/10/08 1:04:51 CET [2025/10/07 19:04:51 ET]
Table 'Sirio' 6-max Seat #1 is the button
Seat 1: QUATTRODAME (€4.39 in chips) 
Seat 2: patrick0708 (€0.72 in chips) 
Seat 3: caduceus369 (€5.84 in chips) 
Seat 4: gitikappa (€0.96 in chips) 
Seat 5: manuknife (€0.75 in chips) 
patrick0708: posts small blind €0.01
caduceus369: posts big blind €0.02
*** HOLE CARDS ***
Dealt to caduceus369 [2s Jh]
gitikappa: raises €0.02 to €0.04
manuknife: calls €0.04
QUATTRODAME: calls €0.04
patrick0708: folds 
caduceus369: folds 
*** FLOP *** [9s 8d Qd]
gitikappa: bets €0.05
manuknife: calls €0.05
QUATTRODAME: folds 
*** TURN *** [9s 8d Qd] [7h]
gitikappa: bets €0.15
manuknife: folds 
Uncalled bet (€0.15) returned to gitikappa
gitikappa collected €0.24 from pot
gitikappa: doesn't show hand 
*** SUMMARY ***
Total pot €0.25 | Rake €0.01 
Board [9s 8d Qd 7h]
Seat 1: QUATTRODAME (button) folded on the Flop
Seat 2: patrick0708 (small blind) folded before Flop
Seat 3: caduceus369 (big blind) folded before Flop
Seat 4: gitikappa collected (€0.24)
Seat 5: manuknife folded on the Turn



PokerStars Zoom Hand #258040073337:  Hold'em No Limit (€0.01/€0.02) [ADM ID: M62C03044AE79CRJ] - 2025/10/08 1:04:43 CET [2025/10/07 19:04:43 ET]
Table 'Sirio' 6-max Seat #1 is the button
Seat 1: mashallahh (€4.12 in chips) 
Seat 2: winsper79 (€5.23 in chips) 
Seat 3: SebaRapy14 (€2.91 in chips) 
Seat 4: fantaasso (€1.32 in chips) 
Seat 5: caduceus369 (€5.84 in chips) 
winsper79: posts small blind €0.01
SebaRapy14: posts big blind €0.02
*** HOLE CARDS ***
Dealt to caduceus369 [Kc 5h]
fantaasso: folds 
caduceus369: folds 
mashallahh: raises €0.04 to €0.06
winsper79: calls €0.05
SebaRapy14: calls €0.04
*** FLOP *** [8d Ks 8h]
winsper79: checks 
SebaRapy14: checks 
mashallahh: bets €0.14
winsper79: calls €0.14
SebaRapy14: folds 
*** TURN *** [8d Ks 8h] [Jc]
winsper79: checks 
mashallahh: checks 
*** RIVER *** [8d Ks 8h Jc] [7h]
winsper79: bets €0.08
mashallahh: calls €0.08
*** SHOW DOWN ***
winsper79: shows [Kd Tc] (two pair, Kings and Eights)
mashallahh: mucks hand 
winsper79 collected €0.59 from pot
*** SUMMARY ***
Total pot €0.62 | Rake €0.03 
Board [8d Ks 8h Jc 7h]
Seat 1: mashallahh (button) mucked [Td Js]
Seat 2: winsper79 (small blind) showed [Kd Tc] and won (€0.59) with two pair, Kings and Eights
Seat 3: SebaRapy14 (big blind) folded on the Flop
Seat 4: fantaasso folded before Flop (didn't bet)
Seat 5: caduceus369 folded before Flop (didn't bet)



PokerStars Zoom Hand #258040068484:  Hold'em No Limit (€0.01/€0.02) [ADM ID: M62C03044AE79CRJ] - 2025/10/08 1:04:15 CET [2025/10/07 19:04:15 ET]
Table 'Sirio' 6-max Seat #1 is the button
Seat 1: FVBMF (€0.70 in chips) 
Seat 2: caduceus369 (€5.85 in chips) 
Seat 3: Zeeebbiiiiii778 (€1.96 in chips) 
Seat 4: mashallahh (€4.12 in chips) 
Seat 5: fantaasso (€1.31 in chips) 
Seat 6: xTheBulldogx (€0.70 in chips) 
caduceus369: posts small blind €0.01
Zeeebbiiiiii778: posts big blind €0.02
*** HOLE CARDS ***
Dealt to caduceus369 [Ac 2s]
mashallahh: folds 
fantaasso: folds 
xTheBulldogx: calls €0.02
FVBMF: calls €0.02
caduceus369: folds 
Zeeebbiiiiii778 has timed out
Zeeebbiiiiii778: checks 
*** FLOP *** [Qd 6d Kh]
Zeeebbiiiiii778: checks 
xTheBulldogx: checks 
FVBMF: bets €0.02
Zeeebbiiiiii778: folds 
xTheBulldogx: calls €0.02
*** TURN *** [Qd 6d Kh] [Td]
xTheBulldogx: checks 
FVBMF: checks 
*** RIVER *** [Qd 6d Kh Td] [Ah]
xTheBulldogx: bets €0.12
FVBMF: folds 
Uncalled bet (€0.12) returned to xTheBulldogx
xTheBulldogx collected €0.11 from pot
xTheBulldogx: doesn't show hand 
*** SUMMARY ***
Total pot €0.11 | Rake €0 
Board [Qd 6d Kh Td Ah]
Seat 1: FVBMF (button) folded on the River
Seat 2: caduceus369 (small blind) folded before Flop
Seat 3: Zeeebbiiiiii778 (big blind) folded on the Flop
Seat 4: mashallahh folded before Flop (didn't bet)
Seat 5: fantaasso folded before Flop (didn't bet)
Seat 6: xTheBulldogx collected (€0.11)



PokerStars Zoom Hand #258040084473:  Hold'em No Limit (€0.01/€0.02) [ADM ID: M62C03044AE79CRJ] - 2025/10/08 1:05:45 CET [2025/10/07 19:05:45 ET]
Table 'Sirio' 6-max Seat #1 is the button
Seat 1: caduceus369 (€5.81 in chips) 
Seat 2: Coffeebreak96 (€1.98 in chips) 
Seat 3: FVBMF (€0.66 in chips) 
Seat 4: winsper79 (€5.54 in chips) 
Seat 5: amicoakira (€1.48 in chips) 
Coffeebreak96: posts small blind €0.01
FVBMF: posts big blind €0.02
*** HOLE CARDS ***
Dealt to caduceus369 [2c 8h]
winsper79: folds 
amicoakira: calls €0.02
caduceus369: folds 
Coffeebreak96: folds 
FVBMF: checks 
*** FLOP *** [Js 6h 8c]
FVBMF: checks 
amicoakira: bets €0.08
FVBMF: folds 
Uncalled bet (€0.08) returned to amicoakira
FVBMF is disconnected 
amicoakira collected €0.05 from pot
amicoakira: doesn't show hand 
*** SUMMARY ***
Total pot €0.05 | Rake €0 
Board [Js 6h 8c]
Seat 1: caduceus369 (button) folded before Flop (didn't bet)
Seat 2: Coffeebreak96 (small blind) folded before Flop
Seat 3: FVBMF (big blind) folded on the Flop
Seat 4: winsper79 folded before Flop (didn't bet)
Seat 5: amicoakira collected (€0.05)



PokerStars Zoom Hand #258040080197:  Hold'em No Limit (€0.01/€0.02) [ADM ID: M62C03044AE79CRJ] - 2025/10/08 1:05:21 CET [2025/10/07 19:05:21 ET]
Table 'Sirio' 6-max Seat #1 is the button
Seat 1: caduceus369 (€5.81 in chips) 
Seat 2: SebaRapy14 (€2.85 in chips) 
Seat 3: sebaparhasar84 (€2.52 in chips) 
Seat 4: ADRIAN0_MEIS (€23.03 in chips) 
Seat 5: Agbtano (€0.88 in chips) 
Seat 6: IlDestro71 (€0.27 in chips) 
SebaRapy14: posts small blind €0.01
sebaparhasar84: posts big blind €0.02
*** HOLE CARDS ***
Dealt to caduceus369 [7s 5c]
ADRIAN0_MEIS: folds 
Agbtano: folds 
IlDestro71: calls €0.02
caduceus369: folds 
SebaRapy14: calls €0.01
sebaparhasar84: checks 
*** FLOP *** [Qh 2d Kd]
SebaRapy14: checks 
sebaparhasar84: checks 
IlDestro71: checks 
*** TURN *** [Qh 2d Kd] [6h]
SebaRapy14: checks 
sebaparhasar84: checks 
IlDestro71: bets €0.02
SebaRapy14: calls €0.02
sebaparhasar84: folds 
*** RIVER *** [Qh 2d Kd 6h] [6s]
SebaRapy14: checks 
IlDestro71: bets €0.02
SebaRapy14: calls €0.02
*** SHOW DOWN ***
IlDestro71: shows [4c Kc] (two pair, Kings and Sixes)
SebaRapy14: mucks hand 
IlDestro71 collected €0.14 from pot
*** SUMMARY ***
Total pot €0.14 | Rake €0 
Board [Qh 2d Kd 6h 6s]
Seat 1: caduceus369 (button) folded before Flop (didn't bet)
Seat 2: SebaRapy14 (small blind) mucked [Qs 8s]
Seat 3: sebaparhasar84 (big blind) folded on the Turn
Seat 4: ADRIAN0_MEIS folded before Flop (didn't bet)
Seat 5: Agbtano folded before Flop (didn't bet)
Seat 6: IlDestro71 showed [4c Kc] and won (€0.14) with two pair, Kings and Sixes



PokerStars Zoom Hand #258040083291:  Hold'em No Limit (€0.01/€0.02) [ADM ID: M62C03044AE79CRJ] - 2025/10/08 1:05:38 CET [2025/10/07 19:05:38 ET]
Table 'Sirio' 6-max Seat #1 is the button
Seat 1: Zeeebbiiiiii778 (€1.87 in chips) 
Seat 2: mashallahh (€3.65 in chips) 
Seat 3: gitikappa (€1.11 in chips) 
Seat 4: SaTheNuts_77 (€2.22 in chips) 
Seat 5: SebaRapy14 (€8.81 in chips) 
Seat 6: caduceus369 (€5.81 in chips) 
mashallahh: posts small blind €0.01
gitikappa: posts big blind €0.02
*** HOLE CARDS ***
Dealt to caduceus369 [2s Ts]
SaTheNuts_77: raises €0.03 to €0.05
SebaRapy14: raises €0.13 to €0.18
caduceus369: folds 
Zeeebbiiiiii778: folds 
mashallahh: folds 
gitikappa: folds 
SaTheNuts_77: calls €0.13
*** FLOP *** [Qc 8c Kd]
SaTheNuts_77: checks 
SebaRapy14: bets €0.19
SaTheNuts_77: calls €0.19
*** TURN *** [Qc 8c Kd] [7d]
SaTheNuts_77: checks 
SebaRapy14: bets €0.41
SaTheNuts_77: folds 
Uncalled bet (€0.41) returned to SebaRapy14
SebaRapy14 collected €0.73 from pot
SebaRapy14: doesn't show hand 
*** SUMMARY ***
Total pot €0.77 | Rake €0.04 
Board [Qc 8c Kd 7d]
Seat 1: Zeeebbiiiiii778 (button) folded before Flop (didn't bet)
Seat 2: mashallahh (small blind) folded before Flop
Seat 3: gitikappa (big blind) folded before Flop
Seat 4: SaTheNuts_77 folded on the Turn
Seat 5: SebaRapy14 collected (€0.73)
Seat 6: caduceus369 folded before Flop (didn't bet)



PokerStars Zoom Hand #258040086336:  Hold'em No Limit (€0.01/€0.02) [ADM ID: M62C03044AE79CRJ] - 2025/10/08 1:05:55 CET [2025/10/07 19:05:55 ET]
Table 'Sirio' 6-max Seat #1 is the button
Seat 1: patrick0708 (€0.69 in chips) 
Seat 2: QUATTRODAME (€4.36 in chips) 
Seat 3: winsper79 (€5.54 in chips) 
Seat 4: Zeeebbiiiiii778 (€1.93 in chips) 
Seat 5: caduceus369 (€5.81 in chips) 
QUATTRODAME: posts small blind €0.01
winsper79: posts big blind €0.02
*** HOLE CARDS ***
Dealt to caduceus369 [Ad 7c]
Zeeebbiiiiii778: raises €0.03 to €0.05
caduceus369: folds 
patrick0708: folds 
QUATTRODAME: folds 
winsper79: calls €0.03
*** FLOP *** [6c 3h 7h]
winsper79: checks 
Zeeebbiiiiii778: bets €0.03
winsper79: calls €0.03
*** TURN *** [6c 3h 7h] [2h]
winsper79: checks 
Zeeebbiiiiii778: checks 
*** RIVER *** [6c 3h 7h 2h] [8s]
winsper79: bets €0.06
Zeeebbiiiiii778: folds 
Uncalled bet (€0.06) returned to winsper79
winsper79 collected €0.17 from pot
winsper79: doesn't show hand 
*** SUMMARY ***
Total pot €0.17 | Rake €0 
Board [6c 3h 7h 2h 8s]
Seat 1: patrick0708 (button) folded before Flop (didn't bet)
Seat 2: QUATTRODAME (small blind) folded before Flop
Seat 3: winsper79 (big blind) collected (€0.17)
Seat 4: Zeeebbiiiiii778 folded on the River
Seat 5: caduceus369 folded before Flop (didn't bet)



PokerStars Zoom Hand #258040093808:  Hold'em No Limit (€0.01/€0.02) [ADM ID: M62C03044AE79CRJ] - 2025/10/08 1:06:37 CET [2025/10/07 19:06:37 ET]
Table 'Sirio' 6-max Seat #1 is the button
Seat 1: gitikappa (€1.09 in chips) 
Seat 2: caduceus369 (€5.79 in chips) 
Seat 3: ADRIAN0_MEIS (€23.12 in chips) 
Seat 4: amicoakira (€1.51 in chips) 
Seat 5: SebaRapy14 (€9.17 in chips) 
caduceus369: posts small blind €0.01
ADRIAN0_MEIS: posts big blind €0.02
*** HOLE CARDS ***
Dealt to caduceus369 [9d 6c]
amicoakira: folds 
SebaRapy14: folds 
gitikappa: folds 
caduceus369: folds 
Uncalled bet (€0.01) returned to ADRIAN0_MEIS
ADRIAN0_MEIS collected €0.02 from pot
ADRIAN0_MEIS: doesn't show hand 
*** SUMMARY ***
Total pot €0.02 | Rake €0 
Seat 1: gitikappa (button) folded before Flop (didn't bet)
Seat 2: caduceus369 (small blind) folded before Flop
Seat 3: ADRIAN0_MEIS (big blind) collected (€0.02)
Seat 4: amicoakira folded before Flop (didn't bet)
Seat 5: SebaRapy14 folded before Flop (didn't bet)



PokerStars Zoom Hand #258040094441:  Hold'em No Limit (€0.01/€0.02) [ADM ID: M62C03044AE79CRJ] - 2025/10/08 1:06:41 CET [2025/10/07 19:06:41 ET]
Table 'Sirio' 6-max Seat #1 is the button
Seat 1: SebaRapy14 (€9.17 in chips) 
Seat 2: gitikappa (€1.09 in chips) 
Seat 3: patrick0708 (€1.30 in chips) 
Seat 4: AlexvmITA (€0.19 in chips) 
Seat 5: caduceus369 (€5.78 in chips) 
Seat 6: winsper79 (€5.63 in chips) 
gitikappa: posts small blind €0.01
patrick0708: posts big blind €0.02
*** HOLE CARDS ***
Dealt to caduceus369 [9h Js]
AlexvmITA: folds 
caduceus369: folds 
winsper79: folds 
SebaRapy14: folds 
gitikappa: calls €0.01
patrick0708: checks 
*** FLOP *** [7c 7d 8c]
gitikappa: bets €0.02
patrick0708: folds 
Uncalled bet (€0.02) returned to gitikappa
gitikappa collected €0.04 from pot
gitikappa: doesn't show hand 
*** SUMMARY ***
Total pot €0.04 | Rake €0 
Board [7c 7d 8c]
Seat 1: SebaRapy14 (button) folded before Flop (didn't bet)
Seat 2: gitikappa (small blind) collected (€0.04)
Seat 3: patrick0708 (big blind) folded on the Flop
Seat 4: AlexvmITA folded before Flop (didn't bet)
Seat 5: caduceus369 folded before Flop (didn't bet)
Seat 6: winsper79 folded before Flop (didn't bet)



PokerStars Zoom Hand #258040087709:  Hold'em No Limit (€0.01/€0.02) [ADM ID: M62C03044AE79CRJ] - 2025/10/08 1:06:03 CET [2025/10/07 19:06:03 ET]
Table 'Sirio' 6-max Seat #1 is the button
Seat 1: xTheBulldogx (€0.75 in chips) 
Seat 2: patrick0708 (€0.69 in chips) 
Seat 3: caduceus369 (€5.81 in chips) 
Seat 4: Coffeebreak96 (€1.97 in chips) 
Seat 5: fantaasso (€1.31 in chips) 
patrick0708: posts small blind €0.01
caduceus369: posts big blind €0.02
*** HOLE CARDS ***
Dealt to caduceus369 [5h 9c]
Coffeebreak96: folds 
fantaasso: raises €0.04 to €0.06
xTheBulldogx: calls €0.06
patrick0708: folds 
caduceus369: folds 
*** FLOP *** [3d Ts 8s]
fantaasso: checks 
xTheBulldogx: checks 
*** TURN *** [3d Ts 8s] [Ah]
fantaasso: bets €0.08
xTheBulldogx: calls €0.08
*** RIVER *** [3d Ts 8s Ah] [6s]
fantaasso: checks 
xTheBulldogx: bets €0.18
fantaasso: calls €0.18
*** SHOW DOWN ***
xTheBulldogx: shows [Kc Qs] (high card Ace)
fantaasso: shows [5c Ac] (a pair of Aces)
fantaasso collected €0.64 from pot
*** SUMMARY ***
Total pot €0.67 | Rake €0.03 
Board [3d Ts 8s Ah 6s]
Seat 1: xTheBulldogx (button) showed [Kc Qs] and lost with high card Ace
Seat 2: patrick0708 (small blind) folded before Flop
Seat 3: caduceus369 (big blind) folded before Flop
Seat 4: Coffeebreak96 folded before Flop (didn't bet)
Seat 5: fantaasso showed [5c Ac] and won (€0.64) with a pair of Aces



PokerStars Zoom Hand #258040095484:  Hold'em No Limit (€0.01/€0.02) [ADM ID: M62C03044AE79CRJ] - 2025/10/08 1:06:47 CET [2025/10/07 19:06:47 ET]
Table 'Sirio' 6-max Seat #1 is the button
Seat 1: sebaparhasar84 (€2.47 in chips) 
Seat 2: xebarpz4400 (€0.83 in chips) 
Seat 3: AlexvmITA (€0.19 in chips) 
Seat 4: caduceus369 (€5.78 in chips) 
Seat 5: ADRIAN0_MEIS (€23.13 in chips) 
Seat 6: Zeeebbiiiiii778 (€1.83 in chips) 
xebarpz4400: posts small blind €0.01
AlexvmITA: posts big blind €0.02
*** HOLE CARDS ***
Dealt to caduceus369 [8c 5d]
caduceus369: folds 
ADRIAN0_MEIS: raises €0.05 to €0.07
Zeeebbiiiiii778: folds 
sebaparhasar84: folds 
xebarpz4400: folds 
AlexvmITA: raises €0.12 to €0.19 and is all-in
ADRIAN0_MEIS: calls €0.12
*** FLOP *** [3d Js 2d]
*** TURN *** [3d Js 2d] [Jc]
*** RIVER *** [3d Js 2d Jc] [9d]
*** SHOW DOWN ***
AlexvmITA: shows [9s Ad] (two pair, Jacks and Nines)
ADRIAN0_MEIS: shows [As Kc] (a pair of Jacks)
AlexvmITA collected €0.37 from pot
*** SUMMARY ***
Total pot €0.39 | Rake €0.02 
Board [3d Js 2d Jc 9d]
Seat 1: sebaparhasar84 (button) folded before Flop (didn't bet)
Seat 2: xebarpz4400 (small blind) folded before Flop
Seat 3: AlexvmITA (big blind) showed [9s Ad] and won (€0.37) with two pair, Jacks and Nines
Seat 4: caduceus369 folded before Flop (didn't bet)
Seat 5: ADRIAN0_MEIS showed [As Kc] and lost with a pair of Jacks
Seat 6: Zeeebbiiiiii778 folded before Flop (didn't bet)



PokerStars Zoom Hand #258040096912:  Hold'em No Limit (€0.01/€0.02) [ADM ID: M62C03044AE79CRJ] - 2025/10/08 1:06:55 CET [2025/10/07 19:06:55 ET]
Table 'Sirio' 6-max Seat #1 is the button
Seat 1: xebarpz4400 (€0.82 in chips) 
Seat 2: Giuggiola64 (€0.57 in chips) 
Seat 3: Coffeebreak96 (€2.20 in chips) 
Seat 4: caduceus369 (€5.78 in chips) 
Seat 5: sebaparhasar84 (€2.47 in chips) 
Seat 6: SaTheNuts_77 (€1.82 in chips) 
Giuggiola64: posts small blind €0.01
Coffeebreak96: posts big blind €0.02
*** HOLE CARDS ***
Dealt to caduceus369 [Th 6d]
caduceus369: folds 
sebaparhasar84: calls €0.02
SaTheNuts_77: folds 
xebarpz4400: calls €0.02
Giuggiola64: calls €0.01
Coffeebreak96: checks 
*** FLOP *** [Jc Kh 8c]
Giuggiola64: bets €0.02
Coffeebreak96: calls €0.02
sebaparhasar84: calls €0.02
xebarpz4400: calls €0.02
*** TURN *** [Jc Kh 8c] [7s]
Giuggiola64: bets €0.04
Coffeebreak96: folds 
sebaparhasar84: calls €0.04
xebarpz4400: calls €0.04
*** RIVER *** [Jc Kh 8c 7s] [3c]
Giuggiola64: bets €0.08
sebaparhasar84: folds 
xebarpz4400: calls €0.08
*** SHOW DOWN ***
Giuggiola64: shows [8d Kc] (two pair, Kings and Eights)
xebarpz4400: shows [7c 6c] (a flush, Jack high)
xebarpz4400 collected €0.42 from pot
*** SUMMARY ***
Total pot €0.44 | Rake €0.02 
Board [Jc Kh 8c 7s 3c]
Seat 1: xebarpz4400 (button) showed [7c 6c] and won (€0.42) with a flush, Jack high
Seat 2: Giuggiola64 (small blind) showed [8d Kc] and lost with two pair, Kings and Eights
Seat 3: Coffeebreak96 (big blind) folded on the Turn
Seat 4: caduceus369 folded before Flop (didn't bet)
Seat 5: sebaparhasar84 folded on the River
Seat 6: SaTheNuts_77 folded before Flop (didn't bet)



PokerStars Zoom Hand #258040098105:  Hold'em No Limit (€0.01/€0.02) [ADM ID: M62C03044AE79CRJ] - 2025/10/08 1:07:02 CET [2025/10/07 19:07:02 ET]
Table 'Sirio' 6-max Seat #1 is the button
Seat 1: SaTheNuts_77 (€1.82 in chips) 
Seat 2: Agbtano (€0.72 in chips) 
Seat 3: caduceus369 (€5.78 in chips) 
Seat 4: FVBMF (€0.53 in chips) 
Seat 5: PIRULO1235 (€2.07 in chips) 
Agbtano: posts small blind €0.01
caduceus369: posts big blind €0.02
*** HOLE CARDS ***
Dealt to caduceus369 [8c 6c]
FVBMF: calls €0.02
PIRULO1235: folds 
SaTheNuts_77: calls €0.02
Agbtano: raises €0.08 to €0.10
caduceus369: folds 
FVBMF: folds 
SaTheNuts_77: calls €0.08
*** FLOP *** [Qs 9s Ts]
Agbtano: bets €0.23
SaTheNuts_77: raises €0.23 to €0.46
Agbtano: calls €0.23
*** TURN *** [Qs 9s Ts] [Jd]
Agbtano: checks 
SaTheNuts_77: bets €0.17
Agbtano: calls €0.16 and is all-in
Uncalled bet (€0.01) returned to SaTheNuts_77
*** RIVER *** [Qs 9s Ts Jd] [Js]
*** SHOW DOWN ***
Agbtano: shows [Ah 9h] (two pair, Jacks and Nines)
SaTheNuts_77: shows [Tc 9c] (two pair, Jacks and Tens)
SaTheNuts_77 collected €1.40 from pot
*** SUMMARY ***
Total pot €1.48 | Rake €0.08 
Board [Qs 9s Ts Jd Js]
Seat 1: SaTheNuts_77 (button) showed [Tc 9c] and won (€1.40) with two pair, Jacks and Tens
Seat 2: Agbtano (small blind) showed [Ah 9h] and lost with two pair, Jacks and Nines
Seat 3: caduceus369 (big blind) folded before Flop
Seat 4: FVBMF folded before Flop
Seat 5: PIRULO1235 folded before Flop (didn't bet)



PokerStars Zoom Hand #258040100209:  Hold'em No Limit (€0.01/€0.02) [ADM ID: M62C03044AE79CRJ] - 2025/10/08 1:07:14 CET [2025/10/07 19:07:14 ET]
Table 'Sirio' 6-max Seat #1 is the button
Seat 1: caduceus369 (€5.76 in chips) 
Seat 2: Zeeebbiiiiii778 (€1.83 in chips) 
Seat 3: PIRULO1235 (€2.06 in chips) 
Seat 4: fantaasso (€1.63 in chips) 
Seat 5: xTheBulldogx (€0.43 in chips) 
Zeeebbiiiiii778: posts small blind €0.01
PIRULO1235: posts big blind €0.02
*** HOLE CARDS ***
Dealt to caduceus369 [Ks Kh]
fantaasso: raises €0.04 to €0.06
xTheBulldogx: raises €0.37 to €0.43 and is all-in
caduceus369: raises €1.01 to €1.44
Zeeebbiiiiii778: folds 
PIRULO1235: folds 
fantaasso: folds 
Uncalled bet (€1.01) returned to caduceus369
*** FLOP *** [3h Th Tc]
*** TURN *** [3h Th Tc] [8h]
*** RIVER *** [3h Th Tc 8h] [Jd]
*** SHOW DOWN ***
xTheBulldogx: shows [Ah Qs] (a pair of Tens)
caduceus369: shows [Ks Kh] (two pair, Kings and Tens)
caduceus369 collected €0.90 from pot
*** SUMMARY ***
Total pot €0.95 | Rake €0.05 
Board [3h Th Tc 8h Jd]
Seat 1: caduceus369 (button) showed [Ks Kh] and won (€0.90) with two pair, Kings and Tens
Seat 2: Zeeebbiiiiii778 (small blind) folded before Flop
Seat 3: PIRULO1235 (big blind) folded before Flop
Seat 4: fantaasso folded before Flop
Seat 5: xTheBulldogx showed [Ah Qs] and lost with a pair of Tens



PokerStars Zoom Hand #258040106938:  Hold'em No Limit (€0.01/€0.02) [ADM ID: M62C03044AE79CRJ] - 2025/10/08 1:07:51 CET [2025/10/07 19:07:51 ET]
Table 'Sirio' 6-max Seat #1 is the button
Seat 1: SebaRapy14 (€2.48 in chips) 
Seat 2: patrick0708 (€1.39 in chips) 
Seat 3: SaTheNuts_77 (€2.50 in chips) 
Seat 4: Agbtano (€1 in chips) 
Seat 5: caduceus369 (€6.22 in chips) 
Seat 6: PIRULO1235 (€2.09 in chips) 
patrick0708: posts small blind €0.01
SaTheNuts_77: posts big blind €0.02
*** HOLE CARDS ***
Dealt to caduceus369 [As 3s]
Agbtano: folds 
caduceus369: raises €0.04 to €0.06
PIRULO1235: raises €2.03 to €2.09 and is all-in
SebaRapy14: folds 
patrick0708: folds 
SaTheNuts_77: folds 
caduceus369: folds 
Uncalled bet (€2.03) returned to PIRULO1235
PIRULO1235 collected €0.15 from pot
PIRULO1235: doesn't show hand 
*** SUMMARY ***
Total pot €0.15 | Rake €0 
Seat 1: SebaRapy14 (button) folded before Flop (didn't bet)
Seat 2: patrick0708 (small blind) folded before Flop
Seat 3: SaTheNuts_77 (big blind) folded before Flop
Seat 4: Agbtano folded before Flop (didn't bet)
Seat 5: caduceus369 folded before Flop
Seat 6: PIRULO1235 collected (€0.15)



PokerStars Zoom Hand #258040106326:  Hold'em No Limit (€0.01/€0.02) [ADM ID: M62C03044AE79CRJ] - 2025/10/08 1:07:48 CET [2025/10/07 19:07:48 ET]
Table 'Sirio' 6-max Seat #1 is the button
Seat 1: QUATTRODAME (€4.53 in chips) 
Seat 2: caduceus369 (€6.23 in chips) 
Seat 3: fantaasso (€1.57 in chips) 
Seat 4: gitikappa (€1.07 in chips) 
Seat 5: SaTheNuts_77 (€2.50 in chips) 
caduceus369: posts small blind €0.01
fantaasso: posts big blind €0.02
*** HOLE CARDS ***
Dealt to caduceus369 [2s 6c]
gitikappa: raises €0.02 to €0.04
SaTheNuts_77: folds 
QUATTRODAME: calls €0.04
caduceus369: folds 
fantaasso: calls €0.02
*** FLOP *** [9h 3c 9s]
fantaasso: checks 
gitikappa: checks 
QUATTRODAME: checks 
*** TURN *** [9h 3c 9s] [5s]
fantaasso: checks 
gitikappa: bets €0.05
QUATTRODAME: folds 
fantaasso: folds 
Uncalled bet (€0.05) returned to gitikappa
gitikappa collected €0.13 from pot
gitikappa: doesn't show hand 
*** SUMMARY ***
Total pot €0.13 | Rake €0 
Board [9h 3c 9s 5s]
Seat 1: QUATTRODAME (button) folded on the Turn
Seat 2: caduceus369 (small blind) folded before Flop
Seat 3: fantaasso (big blind) folded on the Turn
Seat 4: gitikappa collected (€0.13)
Seat 5: SaTheNuts_77 folded before Flop (didn't bet)



PokerStars Zoom Hand #258040109951:  Hold'em No Limit (€0.01/€0.02) [ADM ID: M62C03044AE79CRJ] - 2025/10/08 1:08:08 CET [2025/10/07 19:08:08 ET]
Table 'Sirio' 6-max Seat #1 is the button
Seat 1: SebaRapy14 (€2.47 in chips) 
Seat 2: SaTheNuts_77 (€2.48 in chips) 
Seat 3: ADRIAN0_MEIS (€22.93 in chips) 
Seat 4: caduceus369 (€6.16 in chips) 
Seat 5: Giuggiola64 (€0.39 in chips) 
SaTheNuts_77: posts small blind €0.01
ADRIAN0_MEIS: posts big blind €0.02
*** HOLE CARDS ***
Dealt to caduceus369 [9h 2s]
caduceus369: folds 
Giuggiola64: calls €0.02
SebaRapy14: folds 
SaTheNuts_77: raises €0.05 to €0.07
ADRIAN0_MEIS: folds 
Giuggiola64: calls €0.05
*** FLOP *** [Kc 5c 6s]
SaTheNuts_77: checks 
Giuggiola64: checks 
*** TURN *** [Kc 5c 6s] [Qs]
SaTheNuts_77: checks 
Giuggiola64: checks 
*** RIVER *** [Kc 5c 6s Qs] [Ks]
SaTheNuts_77: checks 
Giuggiola64: bets €0.02
SaTheNuts_77: calls €0.02
*** SHOW DOWN ***
Giuggiola64: shows [Ad Tc] (a pair of Kings)
SaTheNuts_77: shows [6d Ac] (two pair, Kings and Sixes)
SaTheNuts_77 collected €0.19 from pot
*** SUMMARY ***
Total pot €0.20 | Rake €0.01 
Board [Kc 5c 6s Qs Ks]
Seat 1: SebaRapy14 (button) folded before Flop (didn't bet)
Seat 2: SaTheNuts_77 (small blind) showed [6d Ac] and won (€0.19) with two pair, Kings and Sixes
Seat 3: ADRIAN0_MEIS (big blind) folded before Flop
Seat 4: caduceus369 folded before Flop (didn't bet)
Seat 5: Giuggiola64 showed [Ad Tc] and lost with a pair of Kings



PokerStars Zoom Hand #258040111716:  Hold'em No Limit (€0.01/€0.02) [ADM ID: M62C03044AE79CRJ] - 2025/10/08 1:08:18 CET [2025/10/07 19:08:18 ET]
Table 'Sirio' 6-max Seat #1 is the button
Seat 1: PIRULO1235 (€2.18 in chips) 
Seat 2: sebaparhasar84 (€2.23 in chips) 
Seat 3: SebaRapy14 (€2.47 in chips) 
Seat 4: caduceus369 (€6.16 in chips) 
Seat 5: manuknife (€1.65 in chips) 
sebaparhasar84: posts small blind €0.01
SebaRapy14: posts big blind €0.02
*** HOLE CARDS ***
Dealt to caduceus369 [Ad 6s]
caduceus369: raises €0.04 to €0.06
manuknife: folds 
PIRULO1235: folds 
sebaparhasar84: folds 
SebaRapy14: calls €0.04
*** FLOP *** [Ks 4s Qd]
SebaRapy14: checks 
caduceus369: bets €0.04
SebaRapy14: calls €0.04
*** TURN *** [Ks 4s Qd] [9s]
SebaRapy14: checks 
caduceus369: checks 
*** RIVER *** [Ks 4s Qd 9s] [Js]
SebaRapy14: checks 
caduceus369: checks 
*** SHOW DOWN ***
SebaRapy14: shows [Kh 9d] (two pair, Kings and Nines)
caduceus369: shows [Ad 6s] (a flush, King high)
caduceus369 collected €0.20 from pot
*** SUMMARY ***
Total pot €0.21 | Rake €0.01 
Board [Ks 4s Qd 9s Js]
Seat 1: PIRULO1235 (button) folded before Flop (didn't bet)
Seat 2: sebaparhasar84 (small blind) folded before Flop
Seat 3: SebaRapy14 (big blind) showed [Kh 9d] and lost with two pair, Kings and Nines
Seat 4: caduceus369 showed [Ad 6s] and won (€0.20) with a flush, King high
Seat 5: manuknife folded before Flop (didn't bet)



PokerStars Zoom Hand #258040119362:  Hold'em No Limit (€0.01/€0.02) [ADM ID: M62C03044AE79CRJ] - 2025/10/08 1:09:00 CET [2025/10/07 19:09:00 ET]
Table 'Sirio' 6-max Seat #1 is the button
Seat 1: Zeeebbiiiiii778 (€2.15 in chips) 
Seat 2: Giuggiola64 (€0.28 in chips) 
Seat 3: caduceus369 (€6.26 in chips) 
Seat 4: SaTheNuts_77 (€2.58 in chips) 
Seat 5: Agbtano (€0.96 in chips) 
Seat 6: SebaRapy14 (€2.37 in chips) 
Giuggiola64: posts small blind €0.01
caduceus369: posts big blind €0.02
*** HOLE CARDS ***
Dealt to caduceus369 [6s As]
SaTheNuts_77: folds 
Agbtano: raises €0.05 to €0.07
SebaRapy14: folds 
Zeeebbiiiiii778: raises €0.15 to €0.22
Giuggiola64: folds 
caduceus369: folds 
Agbtano: folds 
Uncalled bet (€0.15) returned to Zeeebbiiiiii778
Zeeebbiiiiii778 collected €0.17 from pot
Zeeebbiiiiii778: doesn't show hand 
*** SUMMARY ***
Total pot €0.17 | Rake €0 
Seat 1: Zeeebbiiiiii778 (button) collected (€0.17)
Seat 2: Giuggiola64 (small blind) folded before Flop
Seat 3: caduceus369 (big blind) folded before Flop
Seat 4: SaTheNuts_77 folded before Flop (didn't bet)
Seat 5: Agbtano folded before Flop
Seat 6: SebaRapy14 folded before Flop (didn't bet)



PokerStars Zoom Hand #258040123024:  Hold'em No Limit (€0.01/€0.02) [ADM ID: M62C03044AE79CRJ] - 2025/10/08 1:09:21 CET [2025/10/07 19:09:21 ET]
Table 'Sirio' 6-max Seat #1 is the button
Seat 1: caduceus369 (€6.24 in chips) 
Seat 2: Agbtano (€0.89 in chips) 
Seat 3: Giuggiola64 (€0.26 in chips) 
Seat 4: PIRULO1235 (€2.20 in chips) 
Seat 5: SebaRapy14 (€2.37 in chips) 
Agbtano: posts small blind €0.01
Giuggiola64: posts big blind €0.02
*** HOLE CARDS ***
Dealt to caduceus369 [2h 9c]
PIRULO1235: folds 
SebaRapy14: folds 
caduceus369: folds 
Agbtano: folds 
Uncalled bet (€0.01) returned to Giuggiola64
Giuggiola64 collected €0.02 from pot
Giuggiola64: doesn't show hand 
*** SUMMARY ***
Total pot €0.02 | Rake €0 
Seat 1: caduceus369 (button) folded before Flop (didn't bet)
Seat 2: Agbtano (small blind) folded before Flop
Seat 3: Giuggiola64 (big blind) collected (€0.02)
Seat 4: PIRULO1235 folded before Flop (didn't bet)
Seat 5: SebaRapy14 folded before Flop (didn't bet)



PokerStars Zoom Hand #258040124638:  Hold'em No Limit (€0.01/€0.02) [ADM ID: M62C03044AE79CRJ] - 2025/10/08 1:09:30 CET [2025/10/07 19:09:30 ET]
Table 'Sirio' 6-max Seat #1 is the button
Seat 1: SebaRapy14 (€2.37 in chips) 
Seat 2: caduceus369 (€6.24 in chips) 
Seat 3: Agbtano (€0.88 in chips) 
Seat 4: QUATTRODAME (€4.45 in chips) 
Seat 5: PIRULO1235 (€2.20 in chips) 
caduceus369: posts small blind €0.01
Agbtano: posts big blind €0.02
*** HOLE CARDS ***
Dealt to caduceus369 [Jc 4s]
QUATTRODAME: folds 
PIRULO1235: raises €0.08 to €0.10
SebaRapy14: folds 
caduceus369: folds 
Agbtano: raises €0.21 to €0.31
PIRULO1235: calls €0.21
*** FLOP *** [6c 3s 3d]
Agbtano: bets €0.57 and is all-in
PIRULO1235: calls €0.57
*** TURN *** [6c 3s 3d] [Ac]
*** RIVER *** [6c 3s 3d Ac] [Js]
*** SHOW DOWN ***
Agbtano: shows [Kd Qc] (a pair of Threes)
PIRULO1235: shows [Jd Qh] (two pair, Jacks and Threes)
PIRULO1235 collected €1.68 from pot
*** SUMMARY ***
Total pot €1.77 | Rake €0.09 
Board [6c 3s 3d Ac Js]
Seat 1: SebaRapy14 (button) folded before Flop (didn't bet)
Seat 2: caduceus369 (small blind) folded before Flop
Seat 3: Agbtano (big blind) showed [Kd Qc] and lost with a pair of Threes
Seat 4: QUATTRODAME folded before Flop (didn't bet)
Seat 5: PIRULO1235 showed [Jd Qh] and won (€1.68) with two pair, Jacks and Threes



PokerStars Zoom Hand #258040125374:  Hold'em No Limit (€0.01/€0.02) [ADM ID: M62C03044AE79CRJ] - 2025/10/08 1:09:34 CET [2025/10/07 19:09:34 ET]
Table 'Sirio' 6-max Seat #1 is the button
Seat 1: Giuggiola64 (€0.27 in chips) 
Seat 2: gitikappa (€1.76 in chips) 
Seat 3: Coffeebreak96 (€2.03 in chips) 
Seat 4: sebaparhasar84 (€1.58 in chips) 
Seat 5: caduceus369 (€6.23 in chips) 
Seat 6: SebaRapy14 (€2.37 in chips) 
gitikappa: posts small blind €0.01
Coffeebreak96: posts big blind €0.02
*** HOLE CARDS ***
Dealt to caduceus369 [Ad 4d]
sebaparhasar84: folds 
caduceus369: folds 
SebaRapy14: raises €0.04 to €0.06
Giuggiola64: folds 
gitikappa: folds 
Coffeebreak96: folds 
Uncalled bet (€0.04) returned to SebaRapy14
SebaRapy14 collected €0.05 from pot
SebaRapy14: doesn't show hand 
*** SUMMARY ***
Total pot €0.05 | Rake €0 
Seat 1: Giuggiola64 (button) folded before Flop (didn't bet)
Seat 2: gitikappa (small blind) folded before Flop
Seat 3: Coffeebreak96 (big blind) folded before Flop
Seat 4: sebaparhasar84 folded before Flop (didn't bet)
Seat 5: caduceus369 folded before Flop (didn't bet)
Seat 6: SebaRapy14 collected (€0.05)



PokerStars Zoom Hand #258040129282:  Hold'em No Limit (€0.01/€0.02) [ADM ID: M62C03044AE79CRJ] - 2025/10/08 1:09:56 CET [2025/10/07 19:09:56 ET]
Table 'Sirio' 6-max Seat #1 is the button
Seat 1: Coffeebreak96 (€2.01 in chips) 
Seat 2: manuknife (€1.61 in chips) 
Seat 3: caduceus369 (€6.23 in chips) 
Seat 4: Giuggiola64 (€0.27 in chips) 
manuknife: posts small blind €0.01
caduceus369: posts big blind €0.02
*** HOLE CARDS ***
Dealt to caduceus369 [7c Kd]
Giuggiola64: folds 
Coffeebreak96: folds 
manuknife: calls €0.01
caduceus369: raises €0.06 to €0.08
manuknife: calls €0.06
*** FLOP *** [2h 5s As]
manuknife: checks 
caduceus369: bets €0.05
manuknife: folds 
Uncalled bet (€0.05) returned to caduceus369
caduceus369 collected €0.16 from pot
caduceus369: doesn't show hand 
*** SUMMARY ***
Total pot €0.16 | Rake €0 
Board [2h 5s As]
Seat 1: Coffeebreak96 (button) folded before Flop (didn't bet)
Seat 2: manuknife (small blind) folded on the Flop
Seat 3: caduceus369 (big blind) collected (€0.16)
Seat 4: Giuggiola64 folded before Flop (didn't bet)



PokerStars Zoom Hand #258040133693:  Hold'em No Limit (€0.01/€0.02) [ADM ID: M62C03044AE79CRJ] - 2025/10/08 1:10:21 CET [2025/10/07 19:10:21 ET]
Table 'Sirio' 6-max Seat #1 is the button
Seat 1: caduceus369 (€6.31 in chips) 
Seat 2: Zeeebbiiiiii778 (€2.23 in chips) 
Seat 3: PIRULO1235 (€3 in chips) 
Seat 4: SebaRapy14 (€9.23 in chips) 
Seat 5: fantaasso (€1.62 in chips) 
Zeeebbiiiiii778: posts small blind €0.01
PIRULO1235: posts big blind €0.02
*** HOLE CARDS ***
Dealt to caduceus369 [6h 3c]
SebaRapy14: folds 
fantaasso: folds 
caduceus369: folds 
Zeeebbiiiiii778: raises €0.04 to €0.06
PIRULO1235: folds 
Uncalled bet (€0.04) returned to Zeeebbiiiiii778
Zeeebbiiiiii778 collected €0.04 from pot
Zeeebbiiiiii778: doesn't show hand 
*** SUMMARY ***
Total pot €0.04 | Rake €0 
Seat 1: caduceus369 (button) folded before Flop (didn't bet)
Seat 2: Zeeebbiiiiii778 (small blind) collected (€0.04)
Seat 3: PIRULO1235 (big blind) folded before Flop
Seat 4: SebaRapy14 folded before Flop (didn't bet)
Seat 5: fantaasso folded before Flop (didn't bet)



PokerStars Zoom Hand #258040135080:  Hold'em No Limit (€0.01/€0.02) [ADM ID: M62C03044AE79CRJ] - 2025/10/08 1:10:29 CET [2025/10/07 19:10:29 ET]
Table 'Sirio' 6-max Seat #1 is the button
Seat 1: patrick0708 (€1.35 in chips) 
Seat 2: fantaasso (€1.62 in chips) 
Seat 3: SebaRapy14 (€9.23 in chips) 
Seat 4: caduceus369 (€6.31 in chips) 
Seat 5: SaTheNuts_77 (€2.15 in chips) 
fantaasso: posts small blind €0.01
SebaRapy14: posts big blind €0.02
*** HOLE CARDS ***
Dealt to caduceus369 [6d 2d]
caduceus369: folds 
SaTheNuts_77: raises €0.03 to €0.05
patrick0708: folds 
fantaasso: folds 
SebaRapy14: folds 
Uncalled bet (€0.03) returned to SaTheNuts_77
SaTheNuts_77 collected €0.05 from pot
SaTheNuts_77: doesn't show hand 
*** SUMMARY ***
Total pot €0.05 | Rake €0 
Seat 1: patrick0708 (button) folded before Flop (didn't bet)
Seat 2: fantaasso (small blind) folded before Flop
Seat 3: SebaRapy14 (big blind) folded before Flop
Seat 4: caduceus369 folded before Flop (didn't bet)
Seat 5: SaTheNuts_77 collected (€0.05)



PokerStars Zoom Hand #258040136145:  Hold'em No Limit (€0.01/€0.02) [ADM ID: M62C03044AE79CRJ] - 2025/10/08 1:10:36 CET [2025/10/07 19:10:36 ET]
Table 'Sirio' 6-max Seat #1 is the button
Seat 1: IlDestro71 (€0.74 in chips) 
Seat 2: PIRULO1235 (€2.98 in chips) 
Seat 3: patrick0708 (€1.35 in chips) 
Seat 4: caduceus369 (€6.31 in chips) 
Seat 5: Zeeebbiiiiii778 (€2.25 in chips) 
PIRULO1235: posts small blind €0.01
patrick0708: posts big blind €0.02
*** HOLE CARDS ***
Dealt to caduceus369 [Ts 9d]
caduceus369: folds 
Zeeebbiiiiii778: raises €0.04 to €0.06
IlDestro71: calls €0.06
PIRULO1235: folds 
patrick0708: folds 
*** FLOP *** [4h 6s 4s]
Zeeebbiiiiii778: bets €0.06
IlDestro71: folds 
Uncalled bet (€0.06) returned to Zeeebbiiiiii778
Zeeebbiiiiii778 collected €0.15 from pot
Zeeebbiiiiii778: doesn't show hand 
*** SUMMARY ***
Total pot €0.15 | Rake €0 
Board [4h 6s 4s]
Seat 1: IlDestro71 (button) folded on the Flop
Seat 2: PIRULO1235 (small blind) folded before Flop
Seat 3: patrick0708 (big blind) folded before Flop
Seat 4: caduceus369 folded before Flop (didn't bet)
Seat 5: Zeeebbiiiiii778 collected (€0.15)



PokerStars Zoom Hand #258040137244:  Hold'em No Limit (€0.01/€0.02) [ADM ID: M62C03044AE79CRJ] - 2025/10/08 1:10:42 CET [2025/10/07 19:10:42 ET]
Table 'Sirio' 6-max Seat #1 is the button
Seat 1: fantaasso (€1.61 in chips) 
Seat 2: Zeeebbiiiiii778 (€2 in chips) 
Seat 3: manuknife (€1.56 in chips) 
Seat 4: SebaRapy14 (€9.21 in chips) 
Seat 5: caduceus369 (€6.31 in chips) 
Zeeebbiiiiii778: posts small blind €0.01
manuknife: posts big blind €0.02
*** HOLE CARDS ***
Dealt to caduceus369 [Ts As]
SebaRapy14: folds 
caduceus369: raises €0.04 to €0.06
fantaasso: folds 
Zeeebbiiiiii778: folds 
manuknife: folds 
Uncalled bet (€0.04) returned to caduceus369
caduceus369 collected €0.05 from pot
caduceus369: doesn't show hand 
*** SUMMARY ***
Total pot €0.05 | Rake €0 
Seat 1: fantaasso (button) folded before Flop (didn't bet)
Seat 2: Zeeebbiiiiii778 (small blind) folded before Flop
Seat 3: manuknife (big blind) folded before Flop
Seat 4: SebaRapy14 folded before Flop (didn't bet)
Seat 5: caduceus369 collected (€0.05)



PokerStars Zoom Hand #258040141992:  Hold'em No Limit (€0.01/€0.02) [ADM ID: M62C03044AE79CRJ] - 2025/10/08 1:11:09 CET [2025/10/07 19:11:09 ET]
Table 'Sirio' 6-max Seat #1 is the button
Seat 1: Zeeebbiiiiii778 (€2.32 in chips) 
Seat 2: caduceus369 (€6.34 in chips) 
Seat 3: QUATTRODAME (€4.28 in chips) 
Seat 4: patrick0708 (€1.40 in chips) 
Seat 5: manuknife (€1.54 in chips) 
caduceus369: posts small blind €0.01
QUATTRODAME: posts big blind €0.02
*** HOLE CARDS ***
Dealt to caduceus369 [6h 9h]
patrick0708: folds 
manuknife: folds 
Zeeebbiiiiii778: raises €0.03 to €0.05
caduceus369: folds 
QUATTRODAME: folds 
Uncalled bet (€0.03) returned to Zeeebbiiiiii778
Zeeebbiiiiii778 collected €0.05 from pot
Zeeebbiiiiii778: doesn't show hand 
*** SUMMARY ***
Total pot €0.05 | Rake €0 
Seat 1: Zeeebbiiiiii778 (button) collected (€0.05)
Seat 2: caduceus369 (small blind) folded before Flop
Seat 3: QUATTRODAME (big blind) folded before Flop
Seat 4: patrick0708 folded before Flop (didn't bet)
Seat 5: manuknife folded before Flop (didn't bet)



PokerStars Zoom Hand #258040143471:  Hold'em No Limit (€0.01/€0.02) [ADM ID: M62C03044AE79CRJ] - 2025/10/08 1:11:17 CET [2025/10/07 19:11:17 ET]
Table 'Sirio' 6-max Seat #1 is the button
Seat 1: gitikappa (€1.68 in chips) 
Seat 2: PIRULO1235 (€3 in chips) 
Seat 3: caduceus369 (€6.33 in chips) 
Seat 4: Coffeebreak96 (€1.85 in chips) 
PIRULO1235: posts small blind €0.01
caduceus369: posts big blind €0.02
*** HOLE CARDS ***
Dealt to caduceus369 [6h Qh]
Coffeebreak96: folds 
gitikappa: raises €0.02 to €0.04
PIRULO1235: folds 
caduceus369: calls €0.02
*** FLOP *** [Qd 3s 3c]
caduceus369: checks 
gitikappa: bets €0.05
caduceus369: calls €0.05
*** TURN *** [Qd 3s 3c] [9s]
caduceus369: checks 
gitikappa: bets €0.07
caduceus369: calls €0.07
*** RIVER *** [Qd 3s 3c 9s] [Ac]
caduceus369: bets €0.16
gitikappa: calls €0.16
*** SHOW DOWN ***
caduceus369: shows [6h Qh] (two pair, Queens and Threes)
gitikappa: shows [4d Ad] (two pair, Aces and Threes)
gitikappa collected €0.62 from pot
*** SUMMARY ***
Total pot €0.65 | Rake €0.03 
Board [Qd 3s 3c 9s Ac]
Seat 1: gitikappa (button) showed [4d Ad] and won (€0.62) with two pair, Aces and Threes
Seat 2: PIRULO1235 (small blind) folded before Flop
Seat 3: caduceus369 (big blind) showed [6h Qh] and lost with two pair, Queens and Threes
Seat 4: Coffeebreak96 folded before Flop (didn't bet)



PokerStars Zoom Hand #258040156603:  Hold'em No Limit (€0.01/€0.02) [ADM ID: M62C03044AE79CRJ] - 2025/10/08 1:12:32 CET [2025/10/07 19:12:32 ET]
Table 'Sirio' 6-max Seat #1 is the button
Seat 1: SiMoOoOo93 (€0.51 in chips) 
Seat 2: sebaparhasar84 (€1.81 in chips) 
Seat 3: gitikappa (€1.98 in chips) 
Seat 4: Agbtano (€1.34 in chips) 
Seat 5: caduceus369 (€6 in chips) 
sebaparhasar84: posts small blind €0.01
gitikappa: posts big blind €0.02
*** HOLE CARDS ***
Dealt to caduceus369 [2c Tc]
Agbtano: raises €0.05 to €0.07
caduceus369: folds 
SiMoOoOo93: folds 
sebaparhasar84: folds 
gitikappa: folds 
Uncalled bet (€0.05) returned to Agbtano
Agbtano collected €0.05 from pot
Agbtano: doesn't show hand 
*** SUMMARY ***
Total pot €0.05 | Rake €0 
Seat 1: SiMoOoOo93 (button) folded before Flop (didn't bet)
Seat 2: sebaparhasar84 (small blind) folded before Flop
Seat 3: gitikappa (big blind) folded before Flop
Seat 4: Agbtano collected (€0.05)
Seat 5: caduceus369 folded before Flop (didn't bet)



PokerStars Zoom Hand #258040154694:  Hold'em No Limit (€0.01/€0.02) [ADM ID: M62C03044AE79CRJ] - 2025/10/08 1:12:21 CET [2025/10/07 19:12:21 ET]
Table 'Sirio' 6-max Seat #1 is the button
Seat 1: caduceus369 (€6.01 in chips) 
Seat 2: Giuggiola64 (€0.29 in chips) 
Seat 3: fantaasso (€1.66 in chips) 
Seat 4: gitikappa (€1.98 in chips) 
Giuggiola64: posts small blind €0.01
fantaasso: posts big blind €0.02
*** HOLE CARDS ***
Dealt to caduceus369 [2s 4c]
gitikappa: folds 
caduceus369: folds 
Giuggiola64: calls €0.01
fantaasso: raises €0.02 to €0.04
Giuggiola64: calls €0.02
*** FLOP *** [3s Jh 4s]
Giuggiola64: checks 
fantaasso: bets €0.04
Giuggiola64: calls €0.04
*** TURN *** [3s Jh 4s] [8c]
Giuggiola64: checks 
fantaasso: bets €0.14
Giuggiola64: calls €0.14
*** RIVER *** [3s Jh 4s 8c] [2c]
Giuggiola64: bets €0.07 and is all-in
fantaasso: calls €0.07
*** SHOW DOWN ***
Giuggiola64: shows [Jd Kd] (a pair of Jacks)
fantaasso: shows [Qc Qd] (a pair of Queens)
fantaasso collected €0.55 from pot
*** SUMMARY ***
Total pot €0.58 | Rake €0.03 
Board [3s Jh 4s 8c 2c]
Seat 1: caduceus369 (button) folded before Flop (didn't bet)
Seat 2: Giuggiola64 (small blind) showed [Jd Kd] and lost with a pair of Jacks
Seat 3: fantaasso (big blind) showed [Qc Qd] and won (€0.55) with a pair of Queens
Seat 4: gitikappa folded before Flop (didn't bet)



PokerStars Zoom Hand #258040158820:  Hold'em No Limit (€0.01/€0.02) [ADM ID: M62C03044AE79CRJ] - 2025/10/08 1:12:45 CET [2025/10/07 19:12:45 ET]
Table 'Sirio' 6-max Seat #1 is the button
Seat 1: Agbtano (€1.37 in chips) 
Seat 2: QUATTRODAME (€4.12 in chips) 
Seat 3: SaTheNuts_77 (€2.54 in chips) 
Seat 4: caduceus369 (€6 in chips) 
Seat 5: PIRULO1235 (€3.03 in chips) 
QUATTRODAME: posts small blind €0.01
SaTheNuts_77: posts big blind €0.02
*** HOLE CARDS ***
Dealt to caduceus369 [Qc Kd]
caduceus369: raises €0.04 to €0.06
PIRULO1235: folds 
Agbtano: folds 
QUATTRODAME: folds 
SaTheNuts_77: folds 
Uncalled bet (€0.04) returned to caduceus369
caduceus369 collected €0.05 from pot
caduceus369: doesn't show hand 
*** SUMMARY ***
Total pot €0.05 | Rake €0 
Seat 1: Agbtano (button) folded before Flop (didn't bet)
Seat 2: QUATTRODAME (small blind) folded before Flop
Seat 3: SaTheNuts_77 (big blind) folded before Flop
Seat 4: caduceus369 collected (€0.05)
Seat 5: PIRULO1235 folded before Flop (didn't bet)



PokerStars Zoom Hand #258040157413:  Hold'em No Limit (€0.01/€0.02) [ADM ID: M62C03044AE79CRJ] - 2025/10/08 1:12:37 CET [2025/10/07 19:12:37 ET]
Table 'Sirio' 6-max Seat #1 is the button
Seat 1: caduceus369 (€6 in chips) 
Seat 2: SiMoOoOo93 (€0.51 in chips) 
Seat 3: ADRIAN0_MEIS (€22.93 in chips) 
Seat 4: SebaRapy14 (€2.17 in chips) 
Seat 5: sebaparhasar84 (€1.80 in chips) 
SiMoOoOo93: posts small blind €0.01
ADRIAN0_MEIS: posts big blind €0.02
*** HOLE CARDS ***
Dealt to caduceus369 [Jh 6d]
SebaRapy14: folds 
sebaparhasar84: calls €0.02
caduceus369: folds 
SiMoOoOo93: raises €0.06 to €0.08
ADRIAN0_MEIS: folds 
sebaparhasar84: folds 
Uncalled bet (€0.06) returned to SiMoOoOo93
SiMoOoOo93 collected €0.06 from pot
SiMoOoOo93: doesn't show hand 
*** SUMMARY ***
Total pot €0.06 | Rake €0 
Seat 1: caduceus369 (button) folded before Flop (didn't bet)
Seat 2: SiMoOoOo93 (small blind) collected (€0.06)
Seat 3: ADRIAN0_MEIS (big blind) folded before Flop
Seat 4: SebaRapy14 folded before Flop (didn't bet)
Seat 5: sebaparhasar84 folded before Flop



PokerStars Zoom Hand #258040155599:  Hold'em No Limit (€0.01/€0.02) [ADM ID: M62C03044AE79CRJ] - 2025/10/08 1:12:26 CET [2025/10/07 19:12:26 ET]
Table 'Sirio' 6-max Seat #1 is the button
Seat 1: SebaRapy14 (€2.17 in chips) 
Seat 2: caduceus369 (€6.01 in chips) 
Seat 3: Scicli2000 (€1.53 in chips) 
Seat 4: Zeeebbiiiiii778 (€2.32 in chips) 
Seat 5: gitikappa (€1.98 in chips) 
Seat 6: sebaparhasar84 (€1.81 in chips) 
caduceus369: posts small blind €0.01
Scicli2000: posts big blind €0.02
*** HOLE CARDS ***
Dealt to caduceus369 [2c 9c]
Zeeebbiiiiii778: raises €0.03 to €0.05
gitikappa: folds 
sebaparhasar84: folds 
SebaRapy14: folds 
caduceus369: folds 
Scicli2000: raises €1.48 to €1.53 and is all-in
Zeeebbiiiiii778: calls €1.48
*** FLOP *** [3h 4d As]
*** TURN *** [3h 4d As] [5h]
*** RIVER *** [3h 4d As 5h] [9h]
*** SHOW DOWN ***
Scicli2000: shows [Ad Qc] (a pair of Aces)
Zeeebbiiiiii778: shows [Qd Ac] (a pair of Aces)
Scicli2000 collected €1.46 from pot
Zeeebbiiiiii778 collected €1.45 from pot
*** SUMMARY ***
Total pot €3.07 | Rake €0.16 
Board [3h 4d As 5h 9h]
Seat 1: SebaRapy14 (button) folded before Flop (didn't bet)
Seat 2: caduceus369 (small blind) folded before Flop
Seat 3: Scicli2000 (big blind) showed [Ad Qc] and won (€1.46) with a pair of Aces
Seat 4: Zeeebbiiiiii778 showed [Qd Ac] and won (€1.45) with a pair of Aces
Seat 5: gitikappa folded before Flop (didn't bet)
Seat 6: sebaparhasar84 folded before Flop (didn't bet)



PokerStars Zoom Hand #258040162506:  Hold'em No Limit (€0.01/€0.02) [ADM ID: M62C03044AE79CRJ] - 2025/10/08 1:13:06 CET [2025/10/07 19:13:06 ET]
Table 'Sirio' 6-max Seat #1 is the button
Seat 1: SebaRapy14 (€2.18 in chips) 
Seat 2: SaTheNuts_77 (€2.52 in chips) 
Seat 3: caduceus369 (€6.02 in chips) 
Seat 4: PIRULO1235 (€3.02 in chips) 
Seat 5: Giuggiola64 (€0.80 in chips) 
Seat 6: sebaparhasar84 (€1.76 in chips) 
SaTheNuts_77: posts small blind €0.01
caduceus369: posts big blind €0.02
*** HOLE CARDS ***
Dealt to caduceus369 [5h 6h]
PIRULO1235: calls €0.02
Giuggiola64: calls €0.02
sebaparhasar84: folds 
SebaRapy14: folds 
SaTheNuts_77: calls €0.01
caduceus369: checks 
*** FLOP *** [Qd Td 2c]
SaTheNuts_77: checks 
caduceus369: checks 
PIRULO1235: bets €0.04
Giuggiola64: calls €0.04
SaTheNuts_77: folds 
caduceus369: folds 
*** TURN *** [Qd Td 2c] [3s]
PIRULO1235: bets €0.02
Giuggiola64: folds 
Uncalled bet (€0.02) returned to PIRULO1235
PIRULO1235 collected €0.16 from pot
PIRULO1235: doesn't show hand 
*** SUMMARY ***
Total pot €0.16 | Rake €0 
Board [Qd Td 2c 3s]
Seat 1: SebaRapy14 (button) folded before Flop (didn't bet)
Seat 2: SaTheNuts_77 (small blind) folded on the Flop
Seat 3: caduceus369 (big blind) folded on the Flop
Seat 4: PIRULO1235 collected (€0.16)
Seat 5: Giuggiola64 folded on the Turn
Seat 6: sebaparhasar84 folded before Flop (didn't bet)



PokerStars Zoom Hand #258040161206:  Hold'em No Limit (€0.01/€0.02) [ADM ID: M62C03044AE79CRJ] - 2025/10/08 1:12:59 CET [2025/10/07 19:12:59 ET]
Table 'Sirio' 6-max Seat #1 is the button
Seat 1: ADRIAN0_MEIS (€22.90 in chips) 
Seat 2: caduceus369 (€6.03 in chips) 
Seat 3: SiMoOoOo93 (€0.55 in chips) 
Seat 4: SaTheNuts_77 (€2.52 in chips) 
Seat 5: QUATTRODAME (€4.09 in chips) 
Seat 6: PIRULO1235 (€3.02 in chips) 
caduceus369: posts small blind €0.01
SiMoOoOo93: posts big blind €0.02
*** HOLE CARDS ***
Dealt to caduceus369 [7s 3h]
SaTheNuts_77: folds 
QUATTRODAME: raises €0.02 to €0.04
PIRULO1235: folds 
ADRIAN0_MEIS: raises €0.11 to €0.15
caduceus369: folds 
SiMoOoOo93: folds 
QUATTRODAME: calls €0.11
*** FLOP *** [2s 3d Td]
QUATTRODAME: checks 
ADRIAN0_MEIS: bets €0.18
QUATTRODAME: calls €0.18
*** TURN *** [2s 3d Td] [Qh]
QUATTRODAME: checks 
ADRIAN0_MEIS: bets €0.36
QUATTRODAME: folds 
Uncalled bet (€0.36) returned to ADRIAN0_MEIS
ADRIAN0_MEIS collected €0.66 from pot
ADRIAN0_MEIS: doesn't show hand 
*** SUMMARY ***
Total pot €0.69 | Rake €0.03 
Board [2s 3d Td Qh]
Seat 1: ADRIAN0_MEIS (button) collected (€0.66)
Seat 2: caduceus369 (small blind) folded before Flop
Seat 3: SiMoOoOo93 (big blind) folded before Flop
Seat 4: SaTheNuts_77 folded before Flop (didn't bet)
Seat 5: QUATTRODAME folded on the Turn
Seat 6: PIRULO1235 folded before Flop (didn't bet)



PokerStars Zoom Hand #258040166220:  Hold'em No Limit (€0.01/€0.02) [ADM ID: M62C03044AE79CRJ] - 2025/10/08 1:13:27 CET [2025/10/07 19:13:27 ET]
Table 'Sirio' 6-max Seat #1 is the button
Seat 1: patrick0708 (€1.26 in chips) 
Seat 2: SebaRapy14 (€8.72 in chips) 
Seat 3: Zeeebbiiiiii778 (€2.24 in chips) 
Seat 4: fantaasso (€1.91 in chips) 
Seat 5: SaTheNuts_77 (€2.50 in chips) 
Seat 6: caduceus369 (€6 in chips) 
SebaRapy14: posts small blind €0.01
Zeeebbiiiiii778: posts big blind €0.02
*** HOLE CARDS ***
Dealt to caduceus369 [2d 4s]
fantaasso: folds 
SaTheNuts_77: raises €0.05 to €0.07
caduceus369: folds 
patrick0708: folds 
SebaRapy14: folds 
Zeeebbiiiiii778: folds 
Uncalled bet (€0.05) returned to SaTheNuts_77
SaTheNuts_77 collected €0.05 from pot
SaTheNuts_77: doesn't show hand 
*** SUMMARY ***
Total pot €0.05 | Rake €0 
Seat 1: patrick0708 (button) folded before Flop (didn't bet)
Seat 2: SebaRapy14 (small blind) folded before Flop
Seat 3: Zeeebbiiiiii778 (big blind) folded before Flop
Seat 4: fantaasso folded before Flop (didn't bet)
Seat 5: SaTheNuts_77 collected (€0.05)
Seat 6: caduceus369 folded before Flop (didn't bet)



PokerStars Zoom Hand #258040167055:  Hold'em No Limit (€0.01/€0.02) [ADM ID: M62C03044AE79CRJ] - 2025/10/08 1:13:32 CET [2025/10/07 19:13:32 ET]
Table 'Sirio' 6-max Seat #1 is the button
Seat 1: Coffeebreak96 (€2.08 in chips) 
Seat 2: patrick0708 (€1.26 in chips) 
Seat 3: PIRULO1235 (€3.12 in chips) 
Seat 4: caduceus369 (€6 in chips) 
Seat 5: Giuggiola64 (€0.74 in chips) 
patrick0708: posts small blind €0.01
PIRULO1235: posts big blind €0.02
*** HOLE CARDS ***
Dealt to caduceus369 [2d Qs]
caduceus369: folds 
Giuggiola64: calls €0.02
Coffeebreak96: folds 
patrick0708: folds 
PIRULO1235: checks 
*** FLOP *** [Ah 4d 4h]
PIRULO1235: checks 
Giuggiola64: checks 
*** TURN *** [Ah 4d 4h] [As]
PIRULO1235: checks 
Giuggiola64: checks 
*** RIVER *** [Ah 4d 4h As] [2h]
PIRULO1235: checks 
Giuggiola64: checks 
*** SHOW DOWN ***
PIRULO1235: shows [9s 3s] (two pair, Aces and Fours)
Giuggiola64: shows [Tc Jd] (two pair, Aces and Fours - Jack kicker)
Giuggiola64 collected €0.05 from pot
*** SUMMARY ***
Total pot €0.05 | Rake €0 
Board [Ah 4d 4h As 2h]
Seat 1: Coffeebreak96 (button) folded before Flop (didn't bet)
Seat 2: patrick0708 (small blind) folded before Flop
Seat 3: PIRULO1235 (big blind) showed [9s 3s] and lost with two pair, Aces and Fours
Seat 4: caduceus369 folded before Flop (didn't bet)
Seat 5: Giuggiola64 showed [Tc Jd] and won (€0.05) with two pair, Aces and Fours



PokerStars Zoom Hand #258040168316:  Hold'em No Limit (€0.01/€0.02) [ADM ID: M62C03044AE79CRJ] - 2025/10/08 1:13:39 CET [2025/10/07 19:13:39 ET]
Table 'Sirio' 6-max Seat #1 is the button
Seat 1: caduceus369 (€6 in chips) 
Seat 2: Agbtano (€1.41 in chips) 
Seat 3: ADRIAN0_MEIS (€23.23 in chips) 
Seat 4: manuknife (€1.40 in chips) 
Seat 5: SiMoOoOo93 (€0.51 in chips) 
Agbtano: posts small blind €0.01
ADRIAN0_MEIS: posts big blind €0.02
*** HOLE CARDS ***
Dealt to caduceus369 [6c Ad]
manuknife: folds 
SiMoOoOo93: raises €0.02 to €0.04
caduceus369: folds 
Agbtano: folds 
ADRIAN0_MEIS: folds 
Uncalled bet (€0.02) returned to SiMoOoOo93
SiMoOoOo93 collected €0.05 from pot
SiMoOoOo93: doesn't show hand 
*** SUMMARY ***
Total pot €0.05 | Rake €0 
Seat 1: caduceus369 (button) folded before Flop (didn't bet)
Seat 2: Agbtano (small blind) folded before Flop
Seat 3: ADRIAN0_MEIS (big blind) folded before Flop
Seat 4: manuknife folded before Flop (didn't bet)
Seat 5: SiMoOoOo93 collected (€0.05)



PokerStars Zoom Hand #258040171089:  Hold'em No Limit (€0.01/€0.02) [ADM ID: M62C03044AE79CRJ] - 2025/10/08 1:13:55 CET [2025/10/07 19:13:55 ET]
Table 'Sirio' 6-max Seat #1 is the button
Seat 1: TimeDead (€0.63 in chips) 
Seat 2: jhonnystecco8 (€2.10 in chips) 
Seat 3: Giuggiola64 (€0.77 in chips) 
Seat 4: Zeeebbiiiiii778 (€1.94 in chips) 
Seat 5: caduceus369 (€5.99 in chips) 
jhonnystecco8: posts small blind €0.01
Giuggiola64: posts big blind €0.02
*** HOLE CARDS ***
Dealt to caduceus369 [9d 4s]
Zeeebbiiiiii778 has timed out
Zeeebbiiiiii778: folds 
caduceus369: folds 
TimeDead: calls €0.02
jhonnystecco8: folds 
Giuggiola64: checks 
*** FLOP *** [2h 8c 8h]
Giuggiola64: checks 
TimeDead: checks 
*** TURN *** [2h 8c 8h] [3d]
Giuggiola64: bets €0.02
TimeDead: calls €0.02
*** RIVER *** [2h 8c 8h 3d] [7h]
Giuggiola64: bets €0.02
TimeDead: calls €0.02
*** SHOW DOWN ***
Giuggiola64: shows [As 3s] (two pair, Eights and Threes)
TimeDead: shows [Ac 3h] (two pair, Eights and Threes)
Giuggiola64 collected €0.07 from pot
TimeDead collected €0.06 from pot
*** SUMMARY ***
Total pot €0.13 | Rake €0 
Board [2h 8c 8h 3d 7h]
Seat 1: TimeDead (button) showed [Ac 3h] and won (€0.06) with two pair, Eights and Threes
Seat 2: jhonnystecco8 (small blind) folded before Flop
Seat 3: Giuggiola64 (big blind) showed [As 3s] and won (€0.07) with two pair, Eights and Threes
Seat 4: Zeeebbiiiiii778 folded before Flop (didn't bet)
Seat 5: caduceus369 folded before Flop (didn't bet)



PokerStars Zoom Hand #258040169874:  Hold'em No Limit (€0.01/€0.02) [ADM ID: M62C03044AE79CRJ] - 2025/10/08 1:13:48 CET [2025/10/07 19:13:48 ET]
Table 'Sirio' 6-max Seat #1 is the button
Seat 1: sebaparhasar84 (€1.71 in chips) 
Seat 2: caduceus369 (€6 in chips) 
Seat 3: SebaRapy14 (€8.71 in chips) 
Seat 4: manuknife (€1.40 in chips) 
Seat 5: patrick0708 (€1.23 in chips) 
caduceus369: posts small blind €0.01
SebaRapy14: posts big blind €0.02
*** HOLE CARDS ***
Dealt to caduceus369 [Td 8h]
manuknife: folds 
patrick0708: folds 
sebaparhasar84: calls €0.02
caduceus369: folds 
SebaRapy14: checks 
*** FLOP *** [Qh Jd Qs]
SebaRapy14: checks 
sebaparhasar84: checks 
*** TURN *** [Qh Jd Qs] [9c]
SebaRapy14: checks 
sebaparhasar84: checks 
*** RIVER *** [Qh Jd Qs 9c] [8c]
SebaRapy14: checks 
sebaparhasar84: bets €0.40
SebaRapy14: folds 
Uncalled bet (€0.40) returned to sebaparhasar84
sebaparhasar84 collected €0.05 from pot
sebaparhasar84: doesn't show hand 
*** SUMMARY ***
Total pot €0.05 | Rake €0 
Board [Qh Jd Qs 9c 8c]
Seat 1: sebaparhasar84 (button) collected (€0.05)
Seat 2: caduceus369 (small blind) folded before Flop
Seat 3: SebaRapy14 (big blind) folded on the River
Seat 4: manuknife folded before Flop (didn't bet)
Seat 5: patrick0708 folded before Flop (didn't bet)



PokerStars Zoom Hand #258040173066:  Hold'em No Limit (€0.01/€0.02) [ADM ID: M62C03044AE79CRJ] - 2025/10/08 1:14:07 CET [2025/10/07 19:14:07 ET]
Table 'Sirio' 6-max Seat #1 is the button
Seat 1: jhonnystecco8 (€2.09 in chips) 
Seat 2: SiMoOoOo93 (€0.54 in chips) 
Seat 3: caduceus369 (€5.99 in chips) 
Seat 4: QUATTRODAME (€3.85 in chips) 
Seat 5: PIRULO1235 (€3.09 in chips) 
Seat 6: gitikappa (€2.13 in chips) 
SiMoOoOo93: posts small blind €0.01
caduceus369: posts big blind €0.02
*** HOLE CARDS ***
Dealt to caduceus369 [2d Jh]
QUATTRODAME: folds 
PIRULO1235: folds 
gitikappa: raises €0.02 to €0.04
jhonnystecco8: folds 
SiMoOoOo93: calls €0.03
caduceus369: folds 
*** FLOP *** [6h Kd 5c]
SiMoOoOo93: checks 
gitikappa: bets €0.03
SiMoOoOo93: folds 
Uncalled bet (€0.03) returned to gitikappa
gitikappa collected €0.10 from pot
gitikappa: doesn't show hand 
*** SUMMARY ***
Total pot €0.10 | Rake €0 
Board [6h Kd 5c]
Seat 1: jhonnystecco8 (button) folded before Flop (didn't bet)
Seat 2: SiMoOoOo93 (small blind) folded on the Flop
Seat 3: caduceus369 (big blind) folded before Flop
Seat 4: QUATTRODAME folded before Flop (didn't bet)
Seat 5: PIRULO1235 folded before Flop (didn't bet)
Seat 6: gitikappa collected (€0.10)



PokerStars Zoom Hand #258040175509:  Hold'em No Limit (€0.01/€0.02) [ADM ID: M62C03044AE79CRJ] - 2025/10/08 1:14:20 CET [2025/10/07 19:14:20 ET]
Table 'Sirio' 6-max Seat #1 is the button
Seat 1: patrick0708 (€1.20 in chips) 
Seat 2: ADRIAN0_MEIS (€23.24 in chips) 
Seat 3: PIRULO1235 (€3.09 in chips) 
Seat 4: caduceus369 (€5.97 in chips) 
Seat 5: Zeeebbiiiiii778 (€2.21 in chips) 
ADRIAN0_MEIS: posts small blind €0.01
PIRULO1235: posts big blind €0.02
*** HOLE CARDS ***
Dealt to caduceus369 [5s 8h]
caduceus369: folds 
Zeeebbiiiiii778: folds 
patrick0708: calls €0.02
ADRIAN0_MEIS: folds 
PIRULO1235: checks 
*** FLOP *** [5c Jh Kc]
PIRULO1235: bets €0.03
patrick0708: folds 
Uncalled bet (€0.03) returned to PIRULO1235
PIRULO1235 collected €0.05 from pot
PIRULO1235: doesn't show hand 
*** SUMMARY ***
Total pot €0.05 | Rake €0 
Board [5c Jh Kc]
Seat 1: patrick0708 (button) folded on the Flop
Seat 2: ADRIAN0_MEIS (small blind) folded before Flop
Seat 3: PIRULO1235 (big blind) collected (€0.05)
Seat 4: caduceus369 folded before Flop (didn't bet)
Seat 5: Zeeebbiiiiii778 folded before Flop (didn't bet)



PokerStars Zoom Hand #258040176070:  Hold'em No Limit (€0.01/€0.02) [ADM ID: M62C03044AE79CRJ] - 2025/10/08 1:14:24 CET [2025/10/07 19:14:24 ET]
Table 'Sirio' 6-max Seat #1 is the button
Seat 1: Giuggiola64 (€0.78 in chips) 
Seat 2: IlDestro71 (€1.49 in chips) 
Seat 3: Zeeebbiiiiii778 (€1.93 in chips) 
Seat 4: caduceus369 (€5.97 in chips) 
Seat 5: SebaRapy14 (€2.20 in chips) 
Seat 6: TimeDead (€0.63 in chips) 
IlDestro71: posts small blind €0.01
Zeeebbiiiiii778: posts big blind €0.02
*** HOLE CARDS ***
Dealt to caduceus369 [Jc Tc]
caduceus369: raises €0.04 to €0.06
SebaRapy14: folds 
TimeDead: folds 
Giuggiola64: calls €0.06
IlDestro71: calls €0.05
Zeeebbiiiiii778: calls €0.04
*** FLOP *** [3d 5d Qc]
IlDestro71: bets €0.02
Zeeebbiiiiii778: folds 
caduceus369: folds 
Giuggiola64: calls €0.02
*** TURN *** [3d 5d Qc] [4h]
IlDestro71: checks 
Giuggiola64: checks 
*** RIVER *** [3d 5d Qc 4h] [Qd]
IlDestro71: bets €0.02
Giuggiola64: raises €0.06 to €0.08
IlDestro71: calls €0.06
*** SHOW DOWN ***
Giuggiola64: shows [8h 8s] (two pair, Queens and Eights)
IlDestro71: shows [Ac Ad] (two pair, Aces and Queens)
IlDestro71 collected €0.42 from pot
*** SUMMARY ***
Total pot €0.44 | Rake €0.02 
Board [3d 5d Qc 4h Qd]
Seat 1: Giuggiola64 (button) showed [8h 8s] and lost with two pair, Queens and Eights
Seat 2: IlDestro71 (small blind) showed [Ac Ad] and won (€0.42) with two pair, Aces and Queens
Seat 3: Zeeebbiiiiii778 (big blind) folded on the Flop
Seat 4: caduceus369 folded on the Flop
Seat 5: SebaRapy14 folded before Flop (didn't bet)
Seat 6: TimeDead folded before Flop (didn't bet)



PokerStars Zoom Hand #258040181887:  Hold'em No Limit (€0.01/€0.02) [ADM ID: M62C03044AE79CRJ] - 2025/10/08 1:14:57 CET [2025/10/07 19:14:57 ET]
Table 'Sirio' 6-max Seat #1 is the button
Seat 1: caduceus369 (€5.91 in chips) 
Seat 2: QUATTRODAME (€3.83 in chips) 
Seat 3: fantaasso (€1.94 in chips) 
Seat 4: Coffeebreak96 (€2.01 in chips) 
Seat 5: patrick0708 (€1.18 in chips) 
Seat 6: SebaRapy14 (€2.19 in chips) 
QUATTRODAME: posts small blind €0.01
fantaasso: posts big blind €0.02
*** HOLE CARDS ***
Dealt to caduceus369 [5c 7h]
Coffeebreak96: folds 
patrick0708: raises €0.02 to €0.04
SebaRapy14: raises €0.10 to €0.14
caduceus369: folds 
QUATTRODAME: folds 
fantaasso: folds 
patrick0708: folds 
Uncalled bet (€0.10) returned to SebaRapy14
SebaRapy14 collected €0.11 from pot
SebaRapy14: doesn't show hand 
*** SUMMARY ***
Total pot €0.11 | Rake €0 
Seat 1: caduceus369 (button) folded before Flop (didn't bet)
Seat 2: QUATTRODAME (small blind) folded before Flop
Seat 3: fantaasso (big blind) folded before Flop
Seat 4: Coffeebreak96 folded before Flop (didn't bet)
Seat 5: patrick0708 folded before Flop
Seat 6: SebaRapy14 collected (€0.11)



PokerStars Zoom Hand #258040185470:  Hold'em No Limit (€0.01/€0.02) [ADM ID: M62C03044AE79CRJ] - 2025/10/08 1:15:17 CET [2025/10/07 19:15:17 ET]
Table 'Sirio' 6-max Seat #1 is the button
Seat 1: jhonnystecco8 (€2.13 in chips) 
Seat 2: SaTheNuts_77 (€2.44 in chips) 
Seat 3: Scicli2000 (€0.82 in chips) 
Seat 4: ADRIAN0_MEIS (€23.21 in chips) 
Seat 5: fantaasso (€1.91 in chips) 
Seat 6: caduceus369 (€5.88 in chips) 
SaTheNuts_77: posts small blind €0.01
Scicli2000: posts big blind €0.02
*** HOLE CARDS ***
Dealt to caduceus369 [3c Qs]
ADRIAN0_MEIS: folds 
fantaasso: folds 
caduceus369: folds 
jhonnystecco8: folds 
SaTheNuts_77: folds 
Uncalled bet (€0.01) returned to Scicli2000
Scicli2000 collected €0.02 from pot
Scicli2000: doesn't show hand 
*** SUMMARY ***
Total pot €0.02 | Rake €0 
Seat 1: jhonnystecco8 (button) folded before Flop (didn't bet)
Seat 2: SaTheNuts_77 (small blind) folded before Flop
Seat 3: Scicli2000 (big blind) collected (€0.02)
Seat 4: ADRIAN0_MEIS folded before Flop (didn't bet)
Seat 5: fantaasso folded before Flop (didn't bet)
Seat 6: caduceus369 folded before Flop (didn't bet)



PokerStars Zoom Hand #258040184146:  Hold'em No Limit (€0.01/€0.02) [ADM ID: M62C03044AE79CRJ] - 2025/10/08 1:15:10 CET [2025/10/07 19:15:10 ET]
Table 'Sirio' 6-max Seat #1 is the button
Seat 1: Agbtano (€1.30 in chips) 
Seat 2: fantaasso (€1.92 in chips) 
Seat 3: caduceus369 (€5.90 in chips) 
Seat 4: TimeDead (€0.60 in chips) 
Seat 5: manuknife (€1.55 in chips) 
Seat 6: SaTheNuts_77 (€2.44 in chips) 
fantaasso: posts small blind €0.01
caduceus369: posts big blind €0.02
*** HOLE CARDS ***
Dealt to caduceus369 [2d 8c]
TimeDead: raises €0.04 to €0.06
manuknife: calls €0.06
SaTheNuts_77: folds 
Agbtano: calls €0.06
fantaasso: folds 
caduceus369: folds 
*** FLOP *** [As 3c Jd]
TimeDead: checks 
manuknife: checks 
Agbtano: checks 
*** TURN *** [As 3c Jd] [Jh]
TimeDead: checks 
manuknife: checks 
Agbtano: bets €0.20
TimeDead: raises €0.34 to €0.54 and is all-in
manuknife: folds 
Agbtano: calls €0.34
*** RIVER *** [As 3c Jd Jh] [4s]
*** SHOW DOWN ***
TimeDead: shows [Qs Jc] (three of a kind, Jacks)
Agbtano: shows [Td Js] (three of a kind, Jacks - lower kicker)
TimeDead collected €1.22 from pot
*** SUMMARY ***
Total pot €1.29 | Rake €0.07 
Board [As 3c Jd Jh 4s]
Seat 1: Agbtano (button) showed [Td Js] and lost with three of a kind, Jacks
Seat 2: fantaasso (small blind) folded before Flop
Seat 3: caduceus369 (big blind) folded before Flop
Seat 4: TimeDead showed [Qs Jc] and won (€1.22) with three of a kind, Jacks
Seat 5: manuknife folded on the Turn
Seat 6: SaTheNuts_77 folded before Flop (didn't bet)



PokerStars Zoom Hand #258040188462:  Hold'em No Limit (€0.01/€0.02) [ADM ID: M62C03044AE79CRJ] - 2025/10/08 1:15:34 CET [2025/10/07 19:15:34 ET]
Table 'Sirio' 6-max Seat #1 is the button
Seat 1: manuknife (€1.49 in chips) 
Seat 2: Coffeebreak96 (€1.95 in chips) 
Seat 3: patrick0708 (€1.14 in chips) 
Seat 4: SaTheNuts_77 (€2.43 in chips) 
Seat 5: caduceus369 (€5.88 in chips) 
Seat 6: Scicli2000 (€0.83 in chips) 
Coffeebreak96: posts small blind €0.01
patrick0708: posts big blind €0.02
*** HOLE CARDS ***
Dealt to caduceus369 [Jc Ts]
SaTheNuts_77: folds 
caduceus369: folds 
Scicli2000: raises €0.81 to €0.83 and is all-in
manuknife: folds 
Coffeebreak96: folds 
patrick0708: folds 
Uncalled bet (€0.81) returned to Scicli2000
Scicli2000 collected €0.05 from pot
Scicli2000: doesn't show hand 
*** SUMMARY ***
Total pot €0.05 | Rake €0 
Seat 1: manuknife (button) folded before Flop (didn't bet)
Seat 2: Coffeebreak96 (small blind) folded before Flop
Seat 3: patrick0708 (big blind) folded before Flop
Seat 4: SaTheNuts_77 folded before Flop (didn't bet)
Seat 5: caduceus369 folded before Flop (didn't bet)
Seat 6: Scicli2000 collected (€0.05)



PokerStars Zoom Hand #258040182659:  Hold'em No Limit (€0.01/€0.02) [ADM ID: M62C03044AE79CRJ] - 2025/10/08 1:15:01 CET [2025/10/07 19:15:01 ET]
Table 'Sirio' 6-max Seat #1 is the button
Seat 1: ADRIAN0_MEIS (€23.21 in chips) 
Seat 2: caduceus369 (€5.91 in chips) 
Seat 3: QUATTRODAME (€3.82 in chips) 
Seat 4: sebaparhasar84 (€1.72 in chips) 
Seat 5: TimeDead (€0.60 in chips) 
Seat 6: Coffeebreak96 (€2.01 in chips) 
caduceus369: posts small blind €0.01
QUATTRODAME: posts big blind €0.02
*** HOLE CARDS ***
Dealt to caduceus369 [2s 8s]
sebaparhasar84: raises €0.04 to €0.06
TimeDead: folds 
Coffeebreak96: calls €0.06
ADRIAN0_MEIS: folds 
caduceus369: folds 
QUATTRODAME: calls €0.04
*** FLOP *** [Ac 9d Jc]
QUATTRODAME: checks 
sebaparhasar84: bets €0.18
Coffeebreak96: folds 
QUATTRODAME: calls €0.18
*** TURN *** [Ac 9d Jc] [2h]
QUATTRODAME: checks 
sebaparhasar84: bets €0.52
QUATTRODAME: calls €0.52
*** RIVER *** [Ac 9d Jc 2h] [9c]
QUATTRODAME: checks 
sebaparhasar84: bets €0.96 and is all-in
QUATTRODAME: calls €0.96
*** SHOW DOWN ***
sebaparhasar84: shows [Ah Qh] (two pair, Aces and Nines)
QUATTRODAME: shows [8c Qc] (a flush, Ace high)
QUATTRODAME collected €3.32 from pot
*** SUMMARY ***
Total pot €3.51 | Rake €0.19 
Board [Ac 9d Jc 2h 9c]
Seat 1: ADRIAN0_MEIS (button) folded before Flop (didn't bet)
Seat 2: caduceus369 (small blind) folded before Flop
Seat 3: QUATTRODAME (big blind) showed [8c Qc] and won (€3.32) with a flush, Ace high
Seat 4: sebaparhasar84 showed [Ah Qh] and lost with two pair, Aces and Nines
Seat 5: TimeDead folded before Flop (didn't bet)
Seat 6: Coffeebreak96 folded on the Flop



PokerStars Zoom Hand #258040190430:  Hold'em No Limit (€0.01/€0.02) [ADM ID: M62C03044AE79CRJ] - 2025/10/08 1:15:46 CET [2025/10/07 19:15:46 ET]
Table 'Sirio' 6-max Seat #1 is the button
Seat 1: Screwzor (€2 in chips) 
Seat 2: caduceus369 (€5.88 in chips) 
Seat 3: Coffeebreak96 (€1.94 in chips) 
Seat 4: fantaasso (€1.99 in chips) 
Seat 5: Zeeebbiiiiii778 (€1.75 in chips) 
caduceus369: posts small blind €0.01
Coffeebreak96: posts big blind €0.02
*** HOLE CARDS ***
Dealt to caduceus369 [2h Kd]
fantaasso: folds 
Zeeebbiiiiii778: folds 
Screwzor: folds 
caduceus369: folds 
Uncalled bet (€0.01) returned to Coffeebreak96
Coffeebreak96 collected €0.02 from pot
Coffeebreak96: doesn't show hand 
*** SUMMARY ***
Total pot €0.02 | Rake €0 
Seat 1: Screwzor (button) folded before Flop (didn't bet)
Seat 2: caduceus369 (small blind) folded before Flop
Seat 3: Coffeebreak96 (big blind) collected (€0.02)
Seat 4: fantaasso folded before Flop (didn't bet)
Seat 5: Zeeebbiiiiii778 folded before Flop (didn't bet)



PokerStars Zoom Hand #258040189296:  Hold'em No Limit (€0.01/€0.02) [ADM ID: M62C03044AE79CRJ] - 2025/10/08 1:15:39 CET [2025/10/07 19:15:39 ET]
Table 'Sirio' 6-max Seat #1 is the button
Seat 1: TimeDead (€1.22 in chips) 
Seat 2: Screwzor (€2 in chips) 
Seat 3: buscofan (€2 in chips) 
Seat 4: jhonnystecco8 (€2.13 in chips) 
Seat 5: caduceus369 (€5.88 in chips) 
Seat 6: Agbtano (€0.70 in chips) 
Screwzor: posts small blind €0.01
buscofan: posts big blind €0.02
*** HOLE CARDS ***
Dealt to caduceus369 [Qh 7d]
jhonnystecco8: folds 
caduceus369: folds 
Agbtano: folds 
TimeDead: calls €0.02
Screwzor: folds 
buscofan: checks 
*** FLOP *** [Th Kd 4s]
buscofan: checks 
TimeDead: bets €0.05
buscofan: folds 
Uncalled bet (€0.05) returned to TimeDead
TimeDead collected €0.05 from pot
TimeDead: doesn't show hand 
*** SUMMARY ***
Total pot €0.05 | Rake €0 
Board [Th Kd 4s]
Seat 1: TimeDead (button) collected (€0.05)
Seat 2: Screwzor (small blind) folded before Flop
Seat 3: buscofan (big blind) folded on the Flop
Seat 4: jhonnystecco8 folded before Flop (didn't bet)
Seat 5: caduceus369 folded before Flop (didn't bet)
Seat 6: Agbtano folded before Flop (didn't bet)



PokerStars Zoom Hand #258040191706:  Hold'em No Limit (€0.01/€0.02) [ADM ID: M62C03044AE79CRJ] - 2025/10/08 1:15:53 CET [2025/10/07 19:15:53 ET]
Table 'Sirio' 6-max Seat #1 is the button
Seat 1: PIRULO1235 (€3 in chips) 
Seat 2: Screwzor (€2.02 in chips) 
Seat 3: caduceus369 (€5.87 in chips) 
Seat 4: Giuggiola64 (€0.54 in chips) 
Seat 5: SebaRapy14 (€8.91 in chips) 
Screwzor: posts small blind €0.01
caduceus369: posts big blind €0.02
*** HOLE CARDS ***
Dealt to caduceus369 [Jh 3c]
Giuggiola64: calls €0.02
SebaRapy14: folds 
PIRULO1235: calls €0.02
Screwzor: folds 
caduceus369: checks 
*** FLOP *** [9s 4d 8h]
caduceus369: checks 
Giuggiola64: checks 
PIRULO1235: bets €0.04
caduceus369: folds 
Giuggiola64: folds 
Uncalled bet (€0.04) returned to PIRULO1235
PIRULO1235 collected €0.07 from pot
PIRULO1235: doesn't show hand 
*** SUMMARY ***
Total pot €0.07 | Rake €0 
Board [9s 4d 8h]
Seat 1: PIRULO1235 (button) collected (€0.07)
Seat 2: Screwzor (small blind) folded before Flop
Seat 3: caduceus369 (big blind) folded on the Flop
Seat 4: Giuggiola64 folded on the Flop
Seat 5: SebaRapy14 folded before Flop (didn't bet)



PokerStars Zoom Hand #258040187135:  Hold'em No Limit (€0.01/€0.02) [ADM ID: M62C03044AE79CRJ] - 2025/10/08 1:15:27 CET [2025/10/07 19:15:27 ET]
Table 'Sirio' 6-max Seat #1 is the button
Seat 1: caduceus369 (€5.88 in chips) 
Seat 2: ADRIAN0_MEIS (€23.21 in chips) 
Seat 3: Screwzor (€2 in chips) 
Seat 4: patrick0708 (€1.14 in chips) 
Seat 5: SebaRapy14 (€2.26 in chips) 
ADRIAN0_MEIS: posts small blind €0.01
Screwzor: posts big blind €0.02
*** HOLE CARDS ***
Dealt to caduceus369 [4s 2d]
patrick0708: folds 
SebaRapy14: raises €0.04 to €0.06
caduceus369: folds 
ADRIAN0_MEIS: raises €0.14 to €0.20
Screwzor: folds 
SebaRapy14: calls €0.14
*** FLOP *** [8s 7s As]
ADRIAN0_MEIS: bets €0.22
SebaRapy14: calls €0.22
*** TURN *** [8s 7s As] [Qd]
ADRIAN0_MEIS: bets €0.45
SebaRapy14: folds 
Uncalled bet (€0.45) returned to ADRIAN0_MEIS
ADRIAN0_MEIS collected €0.82 from pot
ADRIAN0_MEIS: doesn't show hand 
*** SUMMARY ***
Total pot €0.86 | Rake €0.04 
Board [8s 7s As Qd]
Seat 1: caduceus369 (button) folded before Flop (didn't bet)
Seat 2: ADRIAN0_MEIS (small blind) collected (€0.82)
Seat 3: Screwzor (big blind) folded before Flop
Seat 4: patrick0708 folded before Flop (didn't bet)
Seat 5: SebaRapy14 folded on the Turn



PokerStars Zoom Hand #258040194743:  Hold'em No Limit (€0.01/€0.02) [ADM ID: M62C03044AE79CRJ] - 2025/10/08 1:16:10 CET [2025/10/07 19:16:10 ET]
Table 'Sirio' 6-max Seat #1 is the button
Seat 1: Agbtano (€1.34 in chips) 
Seat 2: SebaRapy14 (€8.92 in chips) 
Seat 3: Screwzor (€2.03 in chips) 
Seat 4: caduceus369 (€5.85 in chips) 
Seat 5: SiMoOoOo93 (€0.72 in chips) 
Seat 6: IlDestro71 (€1.72 in chips) 
SebaRapy14: posts small blind €0.01
Screwzor: posts big blind €0.02
*** HOLE CARDS ***
Dealt to caduceus369 [7s 5s]
caduceus369: folds 
SiMoOoOo93: folds 
IlDestro71: calls €0.02
Agbtano: folds 
SebaRapy14: folds 
Screwzor: checks 
*** FLOP *** [As Ah 8h]
Screwzor: checks 
IlDestro71: checks 
*** TURN *** [As Ah 8h] [5d]
Screwzor: checks 
IlDestro71: bets €0.02
Screwzor: folds 
Uncalled bet (€0.02) returned to IlDestro71
IlDestro71 collected €0.05 from pot
IlDestro71: doesn't show hand 
*** SUMMARY ***
Total pot €0.05 | Rake €0 
Board [As Ah 8h 5d]
Seat 1: Agbtano (button) folded before Flop (didn't bet)
Seat 2: SebaRapy14 (small blind) folded before Flop
Seat 3: Screwzor (big blind) folded on the Turn
Seat 4: caduceus369 folded before Flop (didn't bet)
Seat 5: SiMoOoOo93 folded before Flop (didn't bet)
Seat 6: IlDestro71 collected (€0.05)



PokerStars Zoom Hand #258040197083:  Hold'em No Limit (€0.01/€0.02) [ADM ID: M62C03044AE79CRJ] - 2025/10/08 1:16:24 CET [2025/10/07 19:16:24 ET]
Table 'Sirio' 6-max Seat #1 is the button
Seat 1: SebaRapy14 (€8.91 in chips) 
Seat 2: SiMoOoOo93 (€0.70 in chips) 
Seat 3: SaTheNuts_77 (€2.45 in chips) 
Seat 4: caduceus369 (€5.85 in chips) 
Seat 5: jhonnystecco8 (€2.13 in chips) 
Seat 6: Zeeebbiiiiii778 (€1.76 in chips) 
SiMoOoOo93: posts small blind €0.01
SaTheNuts_77: posts big blind €0.02
*** HOLE CARDS ***
Dealt to caduceus369 [Ac 6c]
caduceus369: raises €0.04 to €0.06
jhonnystecco8: folds 
Zeeebbiiiiii778: folds 
SebaRapy14: calls €0.06
SiMoOoOo93: folds 
SaTheNuts_77: calls €0.04
*** FLOP *** [8s 6h 7c]
SaTheNuts_77: checks 
caduceus369: checks 
SebaRapy14: checks 
*** TURN *** [8s 6h 7c] [Js]
SaTheNuts_77: checks 
caduceus369: checks 
SebaRapy14: bets €0.12
SaTheNuts_77: calls €0.12
caduceus369: folds 
*** RIVER *** [8s 6h 7c Js] [3s]
SaTheNuts_77: checks 
SebaRapy14: bets €0.23
SaTheNuts_77: folds 
Uncalled bet (€0.23) returned to SebaRapy14
SebaRapy14 collected €0.41 from pot
SebaRapy14: doesn't show hand 
*** SUMMARY ***
Total pot €0.43 | Rake €0.02 
Board [8s 6h 7c Js 3s]
Seat 1: SebaRapy14 (button) collected (€0.41)
Seat 2: SiMoOoOo93 (small blind) folded before Flop
Seat 3: SaTheNuts_77 (big blind) folded on the River
Seat 4: caduceus369 folded on the Turn
Seat 5: jhonnystecco8 folded before Flop (didn't bet)
Seat 6: Zeeebbiiiiii778 folded before Flop (didn't bet)



PokerStars Zoom Hand #258040206571:  Hold'em No Limit (€0.01/€0.02) [ADM ID: M62C03044AE79CRJ] - 2025/10/08 1:17:20 CET [2025/10/07 19:17:20 ET]
Table 'Sirio' 6-max Seat #1 is the button
Seat 1: SaTheNuts_77 (€2.27 in chips) 
Seat 2: Agbtano (€1.47 in chips) 
Seat 3: gitikappa (€2.20 in chips) 
Seat 4: manuknife (€1.18 in chips) 
Seat 5: SebaRapy14 (€9.14 in chips) 
Seat 6: caduceus369 (€5.79 in chips) 
Agbtano: posts small blind €0.01
gitikappa: posts big blind €0.02
*** HOLE CARDS ***
Dealt to caduceus369 [3c 6h]
manuknife: folds 
SebaRapy14: folds 
caduceus369: folds 
SaTheNuts_77: raises €0.05 to €0.07
Agbtano: calls €0.06
gitikappa: folds 
*** FLOP *** [9h 8d Ts]
Agbtano: checks 
SaTheNuts_77: checks 
*** TURN *** [9h 8d Ts] [Qh]
Agbtano: checks 
SaTheNuts_77: bets €0.05
Agbtano: calls €0.05
*** RIVER *** [9h 8d Ts Qh] [8h]
Agbtano: checks 
SaTheNuts_77: checks 
*** SHOW DOWN ***
Agbtano: shows [8c 7d] (three of a kind, Eights)
SaTheNuts_77: mucks hand 
Agbtano collected €0.25 from pot
*** SUMMARY ***
Total pot €0.26 | Rake €0.01 
Board [9h 8d Ts Qh 8h]
Seat 1: SaTheNuts_77 (button) mucked [Ad 2c]
Seat 2: Agbtano (small blind) showed [8c 7d] and won (€0.25) with three of a kind, Eights
Seat 3: gitikappa (big blind) folded before Flop
Seat 4: manuknife folded before Flop (didn't bet)
Seat 5: SebaRapy14 folded before Flop (didn't bet)
Seat 6: caduceus369 folded before Flop (didn't bet)



PokerStars Zoom Hand #258040207238:  Hold'em No Limit (€0.01/€0.02) [ADM ID: M62C03044AE79CRJ] - 2025/10/08 1:17:24 CET [2025/10/07 19:17:24 ET]
Table 'Sirio' 6-max Seat #1 is the button
Seat 1: caduceus369 (€5.79 in chips) 
Seat 2: PIRULO1235 (€2.87 in chips) 
Seat 3: manuknife (€1.18 in chips) 
Seat 4: SebaRapy14 (€9.14 in chips) 
Seat 5: Giuggiola64 (€0.60 in chips) 
Seat 6: Screwzor (€2 in chips) 
PIRULO1235: posts small blind €0.01
manuknife: posts big blind €0.02
*** HOLE CARDS ***
Dealt to caduceus369 [Jd Qs]
SebaRapy14: raises €0.04 to €0.06
Giuggiola64: folds 
Screwzor: calls €0.06
caduceus369: calls €0.06
PIRULO1235: folds 
manuknife: calls €0.04
*** FLOP *** [9s Kd 7c]
manuknife: checks 
SebaRapy14: bets €0.10
Screwzor: folds 
caduceus369: calls €0.10
manuknife: folds 
*** TURN *** [9s Kd 7c] [As]
SebaRapy14: bets €0.28
caduceus369: raises €0.46 to €0.74
SebaRapy14: calls €0.46
*** RIVER *** [9s Kd 7c As] [Td]
SebaRapy14: checks 
caduceus369: bets €2.29
SebaRapy14: calls €2.29
*** SHOW DOWN ***
caduceus369: shows [Jd Qs] (a straight, Ten to Ace)
SebaRapy14: mucks hand 
caduceus369 collected €6.16 from pot
*** SUMMARY ***
Total pot €6.51 | Rake €0.35 
Board [9s Kd 7c As Td]
Seat 1: caduceus369 (button) showed [Jd Qs] and won (€6.16) with a straight, Ten to Ace
Seat 2: PIRULO1235 (small blind) folded before Flop
Seat 3: manuknife (big blind) folded on the Flop
Seat 4: SebaRapy14 mucked [7d 7s]
Seat 5: Giuggiola64 folded before Flop (didn't bet)
Seat 6: Screwzor folded on the Flop



PokerStars Zoom Hand #258040223445:  Hold'em No Limit (€0.01/€0.02) [ADM ID: M62C03044AE79CRJ] - 2025/10/08 1:18:57 CET [2025/10/07 19:18:57 ET]
Table 'Sirio' 6-max Seat #1 is the button
Seat 1: SebaRapy14 (€5.95 in chips) 
Seat 2: Wildag00 (€2.03 in chips) 
Seat 3: SiMoOoOo93 (€0.43 in chips) 
Seat 4: IlDestro71 (€1.77 in chips) 
Seat 5: caduceus369 (€8.76 in chips) 
Seat 6: Coffeebreak96 (€1.82 in chips) 
Wildag00: posts small blind €0.01
SiMoOoOo93: posts big blind €0.02
*** HOLE CARDS ***
Dealt to caduceus369 [7s 6d]
IlDestro71: folds 
caduceus369: folds 
Coffeebreak96: raises €0.02 to €0.04
SebaRapy14: folds 
Wildag00: calls €0.03
SiMoOoOo93: folds 
*** FLOP *** [9h 4d As]
Wildag00: checks 
Coffeebreak96: bets €0.04
Wildag00: folds 
Uncalled bet (€0.04) returned to Coffeebreak96
Coffeebreak96 collected €0.10 from pot
Coffeebreak96: doesn't show hand 
*** SUMMARY ***
Total pot €0.10 | Rake €0 
Board [9h 4d As]
Seat 1: SebaRapy14 (button) folded before Flop (didn't bet)
Seat 2: Wildag00 (small blind) folded on the Flop
Seat 3: SiMoOoOo93 (big blind) folded before Flop
Seat 4: IlDestro71 folded before Flop (didn't bet)
Seat 5: caduceus369 folded before Flop (didn't bet)
Seat 6: Coffeebreak96 collected (€0.10)



PokerStars Zoom Hand #258040224734:  Hold'em No Limit (€0.01/€0.02) [ADM ID: M62C03044AE79CRJ] - 2025/10/08 1:19:05 CET [2025/10/07 19:19:05 ET]
Table 'Sirio' 6-max Seat #1 is the button
Seat 1: Vinsent811 (€1.21 in chips) 
Seat 2: PIRULO1235 (€2.74 in chips) 
Seat 3: caduceus369 (€8.76 in chips) 
Seat 4: Giuggiola64 (€0.70 in chips) 
Seat 5: ormaxam (€2.03 in chips) 
Seat 6: SaTheNuts_77 (€2.26 in chips) 
PIRULO1235: posts small blind €0.01
caduceus369: posts big blind €0.02
*** HOLE CARDS ***
Dealt to caduceus369 [Ks 4s]
Giuggiola64: folds 
ormaxam: folds 
SaTheNuts_77: raises €0.03 to €0.05
Vinsent811: folds 
PIRULO1235: calls €0.04
caduceus369: calls €0.03
*** FLOP *** [6s 3c 3s]
PIRULO1235: checks 
caduceus369: bets €0.05
SaTheNuts_77: raises €0.12 to €0.17
PIRULO1235: folds 
caduceus369: folds 
Uncalled bet (€0.12) returned to SaTheNuts_77
SaTheNuts_77 collected €0.24 from pot
SaTheNuts_77: doesn't show hand 
*** SUMMARY ***
Total pot €0.25 | Rake €0.01 
Board [6s 3c 3s]
Seat 1: Vinsent811 (button) folded before Flop (didn't bet)
Seat 2: PIRULO1235 (small blind) folded on the Flop
Seat 3: caduceus369 (big blind) folded on the Flop
Seat 4: Giuggiola64 folded before Flop (didn't bet)
Seat 5: ormaxam folded before Flop (didn't bet)
Seat 6: SaTheNuts_77 collected (€0.24)



PokerStars Zoom Hand #258040229531:  Hold'em No Limit (€0.01/€0.02) [ADM ID: M62C03044AE79CRJ] - 2025/10/08 1:19:33 CET [2025/10/07 19:19:33 ET]
Table 'Sirio' 6-max Seat #1 is the button
Seat 1: Vinsent811 (€1.15 in chips) 
Seat 2: caduceus369 (€8.66 in chips) 
Seat 3: SebaRapy14 (€6.04 in chips) 
Seat 4: ormaxam (€2 in chips) 
Seat 5: Zeeebbiiiiii778 (€1.97 in chips) 
Seat 6: DRAGONE67 (€2.12 in chips) 
caduceus369: posts small blind €0.01
SebaRapy14: posts big blind €0.02
*** HOLE CARDS ***
Dealt to caduceus369 [Ad Ac]
ormaxam: folds 
Zeeebbiiiiii778: folds 
DRAGONE67: folds 
Vinsent811: folds 
caduceus369: raises €0.08 to €0.10
SebaRapy14: raises €5.94 to €6.04 and is all-in
caduceus369: calls €5.94
*** FLOP *** [4c Jh Ts]
*** TURN *** [4c Jh Ts] [7h]
*** RIVER *** [4c Jh Ts 7h] [3d]
*** SHOW DOWN ***
caduceus369: shows [Ad Ac] (a pair of Aces)
SebaRapy14: shows [Qs Ah] (high card Ace)
caduceus369 collected €11.42 from pot
*** SUMMARY ***
Total pot €12.08 | Rake €0.66 
Board [4c Jh Ts 7h 3d]
Seat 1: Vinsent811 (button) folded before Flop (didn't bet)
Seat 2: caduceus369 (small blind) showed [Ad Ac] and won (€11.42) with a pair of Aces
Seat 3: SebaRapy14 (big blind) showed [Qs Ah] and lost with high card Ace
Seat 4: ormaxam folded before Flop (didn't bet)
Seat 5: Zeeebbiiiiii778 folded before Flop (didn't bet)
Seat 6: DRAGONE67 folded before Flop (didn't bet)



PokerStars Zoom Hand #258040235924:  Hold'em No Limit (€0.01/€0.02) [ADM ID: M62C03044AE79CRJ] - 2025/10/08 1:20:10 CET [2025/10/07 19:20:10 ET]
Table 'Sirio' 6-max Seat #1 is the button
Seat 1: Wildag00 (€2.05 in chips) 
Seat 2: Zeeebbiiiiii778 (€1.65 in chips) 
Seat 3: DRAGONE67 (€2.23 in chips) 
Seat 4: buscofan (€2.23 in chips) 
Seat 5: QUATTRODAME (€5.75 in chips) 
Seat 6: caduceus369 (€14.04 in chips) 
Zeeebbiiiiii778: posts small blind €0.01
DRAGONE67: posts big blind €0.02
*** HOLE CARDS ***
Dealt to caduceus369 [5h Qh]
buscofan: folds 
QUATTRODAME: folds 
caduceus369: folds 
Wildag00: raises €0.04 to €0.06
Zeeebbiiiiii778: raises €0.16 to €0.22
DRAGONE67: folds 
Wildag00: folds 
Uncalled bet (€0.16) returned to Zeeebbiiiiii778
Zeeebbiiiiii778 collected €0.14 from pot
Zeeebbiiiiii778: doesn't show hand 
*** SUMMARY ***
Total pot €0.14 | Rake €0 
Seat 1: Wildag00 (button) folded before Flop
Seat 2: Zeeebbiiiiii778 (small blind) collected (€0.14)
Seat 3: DRAGONE67 (big blind) folded before Flop
Seat 4: buscofan folded before Flop (didn't bet)
Seat 5: QUATTRODAME folded before Flop (didn't bet)
Seat 6: caduceus369 folded before Flop (didn't bet)



PokerStars Zoom Hand #258040234560:  Hold'em No Limit (€0.01/€0.02) [ADM ID: M62C03044AE79CRJ] - 2025/10/08 1:20:02 CET [2025/10/07 19:20:02 ET]
Table 'Sirio' 6-max Seat #1 is the button
Seat 1: patrick0708 (€2.06 in chips) 
Seat 2: IlDestro71 (€1.74 in chips) 
Seat 3: Screwzor (€2 in chips) 
Seat 4: caduceus369 (€14.04 in chips) 
Seat 5: ADRIAN0_MEIS (€23.52 in chips) 
Seat 6: SiMoOoOo93 (€0.67 in chips) 
IlDestro71: posts small blind €0.01
Screwzor: posts big blind €0.02
*** HOLE CARDS ***
Dealt to caduceus369 [8c Qd]
caduceus369: folds 
ADRIAN0_MEIS: folds 
SiMoOoOo93: folds 
patrick0708: folds 
IlDestro71: calls €0.01
Screwzor: checks 
*** FLOP *** [Qc Kc Td]
IlDestro71: checks 
Screwzor: checks 
*** TURN *** [Qc Kc Td] [Jh]
IlDestro71: checks 
Screwzor: checks 
*** RIVER *** [Qc Kc Td Jh] [5s]
IlDestro71: bets €0.02
Screwzor is disconnected 
Screwzor has timed out while disconnected
Screwzor: folds 
Uncalled bet (€0.02) returned to IlDestro71
IlDestro71 collected €0.04 from pot
IlDestro71: doesn't show hand 
*** SUMMARY ***
Total pot €0.04 | Rake €0 
Board [Qc Kc Td Jh 5s]
Seat 1: patrick0708 (button) folded before Flop (didn't bet)
Seat 2: IlDestro71 (small blind) collected (€0.04)
Seat 3: Screwzor (big blind) folded on the River
Seat 4: caduceus369 folded before Flop (didn't bet)
Seat 5: ADRIAN0_MEIS folded before Flop (didn't bet)
Seat 6: SiMoOoOo93 folded before Flop (didn't bet)



PokerStars Zoom Hand #258040238353:  Hold'em No Limit (€0.01/€0.02) [ADM ID: M62C03044AE79CRJ] - 2025/10/08 1:20:24 CET [2025/10/07 19:20:24 ET]
Table 'Sirio' 6-max Seat #1 is the button
Seat 1: manuknife (€1.18 in chips) 
Seat 2: Giuggiola64 (€1.33 in chips) 
Seat 3: buscofan (€2.23 in chips) 
Seat 4: DRAGONE67 (€2.21 in chips) 
Seat 5: caduceus369 (€14.04 in chips) 
Seat 6: xebarpz4400 (€0.79 in chips) 
Giuggiola64: posts small blind €0.01
buscofan: posts big blind €0.02
*** HOLE CARDS ***
Dealt to caduceus369 [Jh Kd]
DRAGONE67: folds 
caduceus369: raises €0.04 to €0.06
xebarpz4400: calls €0.06
manuknife: folds 
Giuggiola64: folds 
buscofan: calls €0.04
*** FLOP *** [7h 3h 2c]
buscofan: checks 
caduceus369: checks 
xebarpz4400: checks 
*** TURN *** [7h 3h 2c] [Kc]
buscofan: bets €0.12
caduceus369: calls €0.12
xebarpz4400: folds 
*** RIVER *** [7h 3h 2c Kc] [6c]
buscofan: checks 
caduceus369: bets €0.22
buscofan: folds 
Uncalled bet (€0.22) returned to caduceus369
caduceus369 collected €0.41 from pot
caduceus369: doesn't show hand 
*** SUMMARY ***
Total pot €0.43 | Rake €0.02 
Board [7h 3h 2c Kc 6c]
Seat 1: manuknife (button) folded before Flop (didn't bet)
Seat 2: Giuggiola64 (small blind) folded before Flop
Seat 3: buscofan (big blind) folded on the River
Seat 4: DRAGONE67 folded before Flop (didn't bet)
Seat 5: caduceus369 collected (€0.41)
Seat 6: xebarpz4400 folded on the Turn



PokerStars Zoom Hand #258040246759:  Hold'em No Limit (€0.01/€0.02) [ADM ID: M62C03044AE79CRJ] - 2025/10/08 1:21:14 CET [2025/10/07 19:21:14 ET]
Table 'Sirio' 6-max Seat #1 is the button
Seat 1: caduceus369 (€14.27 in chips) 
Seat 2: dellas3131 (€2 in chips) 
Seat 3: buscofan (€2.05 in chips) 
Seat 4: Wildag00 (€1.91 in chips) 
Seat 5: ormaxam (€2.20 in chips) 
Seat 6: PIRULO1235 (€2.37 in chips) 
dellas3131: posts small blind €0.01
buscofan: posts big blind €0.02
*** HOLE CARDS ***
Dealt to caduceus369 [4h 9s]
Wildag00: folds 
ormaxam: folds 
PIRULO1235: calls €0.02
caduceus369: folds 
dellas3131: raises €0.08 to €0.10
buscofan: folds 
PIRULO1235: calls €0.08
*** FLOP *** [7d 5d Kc]
dellas3131: bets €0.15
PIRULO1235: calls €0.15
*** TURN *** [7d 5d Kc] [9h]
dellas3131: checks 
PIRULO1235: bets €0.24
dellas3131: folds 
Uncalled bet (€0.24) returned to PIRULO1235
PIRULO1235 collected €0.50 from pot
PIRULO1235: doesn't show hand 
*** SUMMARY ***
Total pot €0.52 | Rake €0.02 
Board [7d 5d Kc 9h]
Seat 1: caduceus369 (button) folded before Flop (didn't bet)
Seat 2: dellas3131 (small blind) folded on the Turn
Seat 3: buscofan (big blind) folded before Flop
Seat 4: Wildag00 folded before Flop (didn't bet)
Seat 5: ormaxam folded before Flop (didn't bet)
Seat 6: PIRULO1235 collected (€0.50)



PokerStars Zoom Hand #258040250074:  Hold'em No Limit (€0.01/€0.02) [ADM ID: M62C03044AE79CRJ] - 2025/10/08 1:21:33 CET [2025/10/07 19:21:33 ET]
Table 'Sirio' 6-max Seat #1 is the button
Seat 1: QUATTRODAME (€5.59 in chips) 
Seat 2: caduceus369 (€14.27 in chips) 
Seat 3: Sium12302 (€2.19 in chips) 
Seat 4: SaTheNuts_77 (€2.55 in chips) 
Seat 5: Wildag00 (€2.02 in chips) 
Seat 6: ADRIAN0_MEIS (€23.49 in chips) 
caduceus369: posts small blind €0.01
Sium12302: posts big blind €0.02
*** HOLE CARDS ***
Dealt to caduceus369 [Qh 8c]
SaTheNuts_77: raises €0.03 to €0.05
Wildag00: folds 
ADRIAN0_MEIS: calls €0.05
QUATTRODAME: folds 
caduceus369: folds 
Sium12302: folds 
*** FLOP *** [Ad As 5d]
SaTheNuts_77: bets €0.07
ADRIAN0_MEIS: folds 
Uncalled bet (€0.07) returned to SaTheNuts_77
SaTheNuts_77 collected €0.13 from pot
SaTheNuts_77: doesn't show hand 
*** SUMMARY ***
Total pot €0.13 | Rake €0 
Board [Ad As 5d]
Seat 1: QUATTRODAME (button) folded before Flop (didn't bet)
Seat 2: caduceus369 (small blind) folded before Flop
Seat 3: Sium12302 (big blind) folded before Flop
Seat 4: SaTheNuts_77 collected (€0.13)
Seat 5: Wildag00 folded before Flop (didn't bet)
Seat 6: ADRIAN0_MEIS folded on the Flop



PokerStars Zoom Hand #258040249190:  Hold'em No Limit (€0.01/€0.02) [ADM ID: M62C03044AE79CRJ] - 2025/10/08 1:21:28 CET [2025/10/07 19:21:28 ET]
Table 'Sirio' 6-max Seat #1 is the button
Seat 1: Giuggiola64 (€1.31 in chips) 
Seat 2: patrick0708 (€2.09 in chips) 
Seat 3: DRAGONE67 (€2.17 in chips) 
Seat 4: Sium12302 (€2.19 in chips) 
Seat 5: caduceus369 (€14.27 in chips) 
Seat 6: alff85 (€1.52 in chips) 
patrick0708: posts small blind €0.01
DRAGONE67: posts big blind €0.02
*** HOLE CARDS ***
Dealt to caduceus369 [9h 8c]
Sium12302: folds 
caduceus369: folds 
alff85: calls €0.02
Giuggiola64: calls €0.02
patrick0708: calls €0.01
DRAGONE67: checks 
*** FLOP *** [Ts 2c 8h]
patrick0708: checks 
DRAGONE67: checks 
alff85: checks 
Giuggiola64: bets €0.02
patrick0708: folds 
DRAGONE67: calls €0.02
alff85: calls €0.02
*** TURN *** [Ts 2c 8h] [Ks]
DRAGONE67: checks 
alff85: checks 
Giuggiola64: checks 
*** RIVER *** [Ts 2c 8h Ks] [9c]
DRAGONE67: bets €0.02
alff85: raises €0.09 to €0.11
Giuggiola64: folds 
DRAGONE67: folds 
Uncalled bet (€0.09) returned to alff85
alff85 collected €0.18 from pot
alff85: doesn't show hand 
*** SUMMARY ***
Total pot €0.18 | Rake €0 
Board [Ts 2c 8h Ks 9c]
Seat 1: Giuggiola64 (button) folded on the River
Seat 2: patrick0708 (small blind) folded on the Flop
Seat 3: DRAGONE67 (big blind) folded on the River
Seat 4: Sium12302 folded before Flop (didn't bet)
Seat 5: caduceus369 folded before Flop (didn't bet)
Seat 6: alff85 collected (€0.18)



PokerStars Zoom Hand #258040253007:  Hold'em No Limit (€0.01/€0.02) [ADM ID: M62C03044AE79CRJ] - 2025/10/08 1:21:50 CET [2025/10/07 19:21:50 ET]
Table 'Sirio' 6-max Seat #1 is the button
Seat 1: Wildag00 (€2.02 in chips) 
Seat 2: fantaasso (€1.86 in chips) 
Seat 3: caduceus369 (€14.26 in chips) 
Seat 4: Coffeebreak96 (€1.76 in chips) 
Seat 5: buscofan (€2.03 in chips) 
Seat 6: QUATTRODAME (€5.59 in chips) 
fantaasso: posts small blind €0.01
caduceus369: posts big blind €0.02
*** HOLE CARDS ***
Dealt to caduceus369 [6h Js]
Coffeebreak96: raises €0.02 to €0.04
buscofan: folds 
QUATTRODAME: folds 
Wildag00: folds 
fantaasso: folds 
caduceus369: calls €0.02
*** FLOP *** [8h Ah 4h]
caduceus369: bets €0.04
Coffeebreak96: calls €0.04
*** TURN *** [8h Ah 4h] [4d]
caduceus369: checks 
Coffeebreak96: bets €0.09
caduceus369: folds 
Uncalled bet (€0.09) returned to Coffeebreak96
Coffeebreak96 collected €0.17 from pot
Coffeebreak96: doesn't show hand 
*** SUMMARY ***
Total pot €0.17 | Rake €0 
Board [8h Ah 4h 4d]
Seat 1: Wildag00 (button) folded before Flop (didn't bet)
Seat 2: fantaasso (small blind) folded before Flop
Seat 3: caduceus369 (big blind) folded on the Turn
Seat 4: Coffeebreak96 collected (€0.17)
Seat 5: buscofan folded before Flop (didn't bet)
Seat 6: QUATTRODAME folded before Flop (didn't bet)



PokerStars Zoom Hand #258040259243:  Hold'em No Limit (€0.01/€0.02) [ADM ID: M62C03044AE79CRJ] - 2025/10/08 1:22:26 CET [2025/10/07 19:22:26 ET]
Table 'Sirio' 6-max Seat #1 is the button
Seat 1: caduceus369 (€14.18 in chips) 
Seat 2: Zeeebbiiiiii778 (€2.19 in chips) 
Seat 3: jhonnystecco8 (€2.56 in chips) 
Seat 4: buscofan (€2 in chips) 
Seat 5: QUATTRODAME (€5.63 in chips) 
Seat 6: Wildag00 (€1.88 in chips) 
Zeeebbiiiiii778: posts small blind €0.01
jhonnystecco8: posts big blind €0.02
*** HOLE CARDS ***
Dealt to caduceus369 [5h 5s]
buscofan: folds 
QUATTRODAME: folds 
Wildag00: folds 
caduceus369: raises €0.04 to €0.06
Zeeebbiiiiii778: folds 
jhonnystecco8: folds 
Uncalled bet (€0.04) returned to caduceus369
caduceus369 collected €0.05 from pot
caduceus369: doesn't show hand 
*** SUMMARY ***
Total pot €0.05 | Rake €0 
Seat 1: caduceus369 (button) collected (€0.05)
Seat 2: Zeeebbiiiiii778 (small blind) folded before Flop
Seat 3: jhonnystecco8 (big blind) folded before Flop
Seat 4: buscofan folded before Flop (didn't bet)
Seat 5: QUATTRODAME folded before Flop (didn't bet)
Seat 6: Wildag00 folded before Flop (didn't bet)



PokerStars Zoom Hand #258040257842:  Hold'em No Limit (€0.01/€0.02) [ADM ID: M62C03044AE79CRJ] - 2025/10/08 1:22:18 CET [2025/10/07 19:22:18 ET]
Table 'Sirio' 6-max Seat #1 is the button
Seat 1: buscofan (€2.02 in chips) 
Seat 2: Giuggiola64 (€1.27 in chips) 
Seat 3: alff85 (€1.64 in chips) 
Seat 4: DRAGONE67 (€2.11 in chips) 
Seat 5: ADRIAN0_MEIS (€23.42 in chips) 
Seat 6: caduceus369 (€14.18 in chips) 
Giuggiola64: posts small blind €0.01
alff85: posts big blind €0.02
*** HOLE CARDS ***
Dealt to caduceus369 [Ts 5s]
DRAGONE67: folds 
ADRIAN0_MEIS: folds 
caduceus369: folds 
buscofan: raises €0.04 to €0.06
Giuggiola64: folds 
alff85: calls €0.04
*** FLOP *** [9d 9s 5c]
alff85: checks 
buscofan: bets €0.06
alff85: calls €0.06
*** TURN *** [9d 9s 5c] [Qc]
alff85: checks 
buscofan: checks 
*** RIVER *** [9d 9s 5c Qc] [4d]
alff85: bets €0.12
buscofan: calls €0.12
*** SHOW DOWN ***
alff85: shows [Ad Kh] (a pair of Nines)
buscofan: shows [2c 2h] (two pair, Nines and Deuces)
buscofan collected €0.47 from pot
*** SUMMARY ***
Total pot €0.49 | Rake €0.02 
Board [9d 9s 5c Qc 4d]
Seat 1: buscofan (button) showed [2c 2h] and won (€0.47) with two pair, Nines and Deuces
Seat 2: Giuggiola64 (small blind) folded before Flop
Seat 3: alff85 (big blind) showed [Ad Kh] and lost with a pair of Nines
Seat 4: DRAGONE67 folded before Flop (didn't bet)
Seat 5: ADRIAN0_MEIS folded before Flop (didn't bet)
Seat 6: caduceus369 folded before Flop (didn't bet)



PokerStars Zoom Hand #258040262463:  Hold'em No Limit (€0.01/€0.02) [ADM ID: M62C03044AE79CRJ] - 2025/10/08 1:22:45 CET [2025/10/07 19:22:45 ET]
Table 'Sirio' 6-max Seat #1 is the button
Seat 1: xebarpz4400 (€0.22 in chips) 
Seat 2: manuknife (€1.47 in chips) 
Seat 3: caduceus369 (€14.21 in chips) 
Seat 4: IlDestro71 (€1.92 in chips) 
Seat 5: jhonnystecco8 (€2.53 in chips) 
manuknife: posts small blind €0.01
caduceus369: posts big blind €0.02
*** HOLE CARDS ***
Dealt to caduceus369 [5h Th]
IlDestro71: calls €0.02
jhonnystecco8: folds 
xebarpz4400: raises €0.20 to €0.22 and is all-in
manuknife: folds 
caduceus369: folds 
IlDestro71: calls €0.20
*** FLOP *** [8s 8c 6h]
*** TURN *** [8s 8c 6h] [6d]
*** RIVER *** [8s 8c 6h 6d] [9c]
*** SHOW DOWN ***
IlDestro71: shows [Ts Jd] (two pair, Eights and Sixes)
xebarpz4400: shows [Js Ac] (two pair, Eights and Sixes - Ace kicker)
xebarpz4400 collected €0.45 from pot
*** SUMMARY ***
Total pot €0.47 | Rake €0.02 
Board [8s 8c 6h 6d 9c]
Seat 1: xebarpz4400 (button) showed [Js Ac] and won (€0.45) with two pair, Eights and Sixes
Seat 2: manuknife (small blind) folded before Flop
Seat 3: caduceus369 (big blind) folded before Flop
Seat 4: IlDestro71 showed [Ts Jd] and lost with two pair, Eights and Sixes
Seat 5: jhonnystecco8 folded before Flop (didn't bet)



PokerStars Zoom Hand #258040264463:  Hold'em No Limit (€0.01/€0.02) [ADM ID: M62C03044AE79CRJ] - 2025/10/08 1:22:56 CET [2025/10/07 19:22:56 ET]
Table 'Sirio' 6-max Seat #1 is the button
Seat 1: ADRIAN0_MEIS (€23.42 in chips) 
Seat 2: caduceus369 (€14.19 in chips) 
Seat 3: Sium12302 (€1.92 in chips) 
Seat 4: Zeeebbiiiiii778 (€1.79 in chips) 
Seat 5: manuknife (€1.46 in chips) 
Seat 6: Wildag00 (€1.97 in chips) 
caduceus369: posts small blind €0.01
Sium12302: posts big blind €0.02
*** HOLE CARDS ***
Dealt to caduceus369 [9s Td]
Zeeebbiiiiii778: folds 
manuknife: calls €0.02
Wildag00: folds 
ADRIAN0_MEIS: folds 
caduceus369: folds 
Sium12302: checks 
*** FLOP *** [9c 8h 3c]
Sium12302: checks 
manuknife: checks 
*** TURN *** [9c 8h 3c] [4d]
Sium12302: checks 
manuknife: checks 
*** RIVER *** [9c 8h 3c 4d] [Jd]
Sium12302: checks 
manuknife: checks 
*** SHOW DOWN ***
Sium12302: shows [4h 5s] (a pair of Fours)
manuknife: mucks hand 
Sium12302 collected €0.05 from pot
*** SUMMARY ***
Total pot €0.05 | Rake €0 
Board [9c 8h 3c 4d Jd]
Seat 1: ADRIAN0_MEIS (button) folded before Flop (didn't bet)
Seat 2: caduceus369 (small blind) folded before Flop
Seat 3: Sium12302 (big blind) showed [4h 5s] and won (€0.05) with a pair of Fours
Seat 4: Zeeebbiiiiii778 folded before Flop (didn't bet)
Seat 5: manuknife mucked [Th Kd]
Seat 6: Wildag00 folded before Flop (didn't bet)



PokerStars Zoom Hand #258040266988:  Hold'em No Limit (€0.01/€0.02) [ADM ID: M62C03044AE79CRJ] - 2025/10/08 1:23:11 CET [2025/10/07 19:23:11 ET]
Table 'Sirio' 6-max Seat #1 is the button
Seat 1: pallagorio (€1.17 in chips) 
Seat 2: IlDestro71 (€1.70 in chips) 
Seat 3: xebarpz4400 (€0.45 in chips) 
Seat 4: caduceus369 (€14.18 in chips) 
Seat 5: ADRIAN0_MEIS (€23.42 in chips) 
IlDestro71: posts small blind €0.01
xebarpz4400: posts big blind €0.02
*** HOLE CARDS ***
Dealt to caduceus369 [Qd 5d]
caduceus369: folds 
ADRIAN0_MEIS: folds 
pallagorio: folds 
IlDestro71: calls €0.01
xebarpz4400: raises €0.02 to €0.04
IlDestro71: calls €0.02
*** FLOP *** [4s 6c 2h]
IlDestro71: checks 
xebarpz4400: bets €0.04
IlDestro71: calls €0.04
*** TURN *** [4s 6c 2h] [Jd]
IlDestro71: checks 
xebarpz4400: checks 
*** RIVER *** [4s 6c 2h Jd] [2s]
IlDestro71: bets €0.02
xebarpz4400: calls €0.02
*** SHOW DOWN ***
IlDestro71: shows [6d Ac] (two pair, Sixes and Deuces)
xebarpz4400: shows [7c 7h] (two pair, Sevens and Deuces)
xebarpz4400 collected €0.19 from pot
*** SUMMARY ***
Total pot €0.20 | Rake €0.01 
Board [4s 6c 2h Jd 2s]
Seat 1: pallagorio (button) folded before Flop (didn't bet)
Seat 2: IlDestro71 (small blind) showed [6d Ac] and lost with two pair, Sixes and Deuces
Seat 3: xebarpz4400 (big blind) showed [7c 7h] and won (€0.19) with two pair, Sevens and Deuces
Seat 4: caduceus369 folded before Flop (didn't bet)
Seat 5: ADRIAN0_MEIS folded before Flop (didn't bet)



PokerStars Zoom Hand #258040273296:  Hold'em No Limit (€0.01/€0.02) [ADM ID: M62C03044AE79CRJ] - 2025/10/08 1:23:48 CET [2025/10/07 19:23:48 ET]
Table 'Sirio' 6-max Seat #1 is the button
Seat 1: Sium12302 (€1.95 in chips) 
Seat 2: ADRIAN0_MEIS (€23.42 in chips) 
Seat 3: caduceus369 (€14.18 in chips) 
Seat 4: jhonnystecco8 (€2.50 in chips) 
Seat 5: PIRULO1235 (€2.73 in chips) 
ADRIAN0_MEIS: posts small blind €0.01
caduceus369: posts big blind €0.02
*** HOLE CARDS ***
Dealt to caduceus369 [9c 4h]
jhonnystecco8: folds 
PIRULO1235: folds 
Sium12302: folds 
ADRIAN0_MEIS: folds 
Uncalled bet (€0.01) returned to caduceus369
caduceus369 collected €0.02 from pot
caduceus369: doesn't show hand 
*** SUMMARY ***
Total pot €0.02 | Rake €0 
Seat 1: Sium12302 (button) folded before Flop (didn't bet)
Seat 2: ADRIAN0_MEIS (small blind) folded before Flop
Seat 3: caduceus369 (big blind) collected (€0.02)
Seat 4: jhonnystecco8 folded before Flop (didn't bet)
Seat 5: PIRULO1235 folded before Flop (didn't bet)



PokerStars Zoom Hand #258040270988:  Hold'em No Limit (€0.01/€0.02) [ADM ID: M62C03044AE79CRJ] - 2025/10/08 1:23:34 CET [2025/10/07 19:23:34 ET]
Table 'Sirio' 6-max Seat #1 is the button
Seat 1: DRAGONE67 (€2.23 in chips) 
Seat 2: Vinsent811 (€0.93 in chips) 
Seat 3: ormaxam (€2 in chips) 
Seat 4: gitikappa (€2.03 in chips) 
Seat 5: QUATTRODAME (€5.57 in chips) 
Seat 6: caduceus369 (€14.18 in chips) 
Vinsent811: posts small blind €0.01
ormaxam: posts big blind €0.02
*** HOLE CARDS ***
Dealt to caduceus369 [2h Qs]
gitikappa: folds 
QUATTRODAME: raises €0.02 to €0.04
caduceus369: folds 
DRAGONE67: folds 
Vinsent811: calls €0.03
ormaxam: calls €0.02
*** FLOP *** [5c 2d 6d]
Vinsent811: checks 
ormaxam: checks 
QUATTRODAME: checks 
*** TURN *** [5c 2d 6d] [3h]
Vinsent811: checks 
ormaxam: checks 
QUATTRODAME: checks 
*** RIVER *** [5c 2d 6d 3h] [3s]
Vinsent811: checks 
ormaxam: checks 
QUATTRODAME: checks 
*** SHOW DOWN ***
Vinsent811: shows [5h Qh] (two pair, Fives and Threes)
ormaxam: mucks hand 
QUATTRODAME: mucks hand 
Vinsent811 collected €0.12 from pot
*** SUMMARY ***
Total pot €0.12 | Rake €0 
Board [5c 2d 6d 3h 3s]
Seat 1: DRAGONE67 (button) folded before Flop (didn't bet)
Seat 2: Vinsent811 (small blind) showed [5h Qh] and won (€0.12) with two pair, Fives and Threes
Seat 3: ormaxam (big blind) mucked [7s 9h]
Seat 4: gitikappa folded before Flop (didn't bet)
Seat 5: QUATTRODAME mucked [Kc 8c]
Seat 6: caduceus369 folded before Flop (didn't bet)



PokerStars Zoom Hand #258040268591:  Hold'em No Limit (€0.01/€0.02) [ADM ID: M62C03044AE79CRJ] - 2025/10/08 1:23:21 CET [2025/10/07 19:23:21 ET]
Table 'Sirio' 6-max Seat #1 is the button
Seat 1: caduceus369 (€14.18 in chips) 
Seat 2: jhonnystecco8 (€2.51 in chips) 
Seat 3: buscofan (€2.25 in chips) 
Seat 4: Zeeebbiiiiii778 (€2.18 in chips) 
Seat 5: pallagorio (€1.17 in chips) 
Seat 6: patrick0708 (€2.01 in chips) 
jhonnystecco8: posts small blind €0.01
buscofan: posts big blind €0.02
*** HOLE CARDS ***
Dealt to caduceus369 [6d 4d]
Zeeebbiiiiii778: folds 
pallagorio: raises €0.02 to €0.04
patrick0708: calls €0.04
caduceus369: folds 
jhonnystecco8: folds 
buscofan: calls €0.02
*** FLOP *** [Ad Qd 9s]
buscofan: checks 
pallagorio: checks 
patrick0708: checks 
*** TURN *** [Ad Qd 9s] [Qc]
buscofan: bets €0.10
pallagorio: folds 
patrick0708: calls €0.10
*** RIVER *** [Ad Qd 9s Qc] [2h]
buscofan: bets €0.32
patrick0708: calls €0.32
*** SHOW DOWN ***
buscofan: shows [Td Jh] (a pair of Queens)
patrick0708: shows [Ah Jc] (two pair, Aces and Queens)
patrick0708 collected €0.92 from pot
*** SUMMARY ***
Total pot €0.97 | Rake €0.05 
Board [Ad Qd 9s Qc 2h]
Seat 1: caduceus369 (button) folded before Flop (didn't bet)
Seat 2: jhonnystecco8 (small blind) folded before Flop
Seat 3: buscofan (big blind) showed [Td Jh] and lost with a pair of Queens
Seat 4: Zeeebbiiiiii778 folded before Flop (didn't bet)
Seat 5: pallagorio folded on the Turn
Seat 6: patrick0708 showed [Ah Jc] and won (€0.92) with two pair, Aces and Queens



PokerStars Zoom Hand #258040272254:  Hold'em No Limit (€0.01/€0.02) [ADM ID: M62C03044AE79CRJ] - 2025/10/08 1:23:42 CET [2025/10/07 19:23:42 ET]
Table 'Sirio' 6-max Seat #1 is the button
Seat 1: ADRIAN0_MEIS (€23.42 in chips) 
Seat 2: Zeeebbiiiiii778 (€1.79 in chips) 
Seat 3: manuknife (€1.44 in chips) 
Seat 4: caduceus369 (€14.18 in chips) 
Seat 5: PIRULO1235 (€2.73 in chips) 
Zeeebbiiiiii778: posts small blind €0.01
manuknife: posts big blind €0.02
*** HOLE CARDS ***
Dealt to caduceus369 [9d 5c]
caduceus369: folds 
PIRULO1235: folds 
ADRIAN0_MEIS: folds 
Zeeebbiiiiii778: raises €0.04 to €0.06
manuknife: calls €0.04
*** FLOP *** [2h Ah 5s]
Zeeebbiiiiii778: bets €0.05
manuknife: folds 
Uncalled bet (€0.05) returned to Zeeebbiiiiii778
Zeeebbiiiiii778 collected €0.12 from pot
Zeeebbiiiiii778: doesn't show hand 
*** SUMMARY ***
Total pot €0.12 | Rake €0 
Board [2h Ah 5s]
Seat 1: ADRIAN0_MEIS (button) folded before Flop (didn't bet)
Seat 2: Zeeebbiiiiii778 (small blind) collected (€0.12)
Seat 3: manuknife (big blind) folded on the Flop
Seat 4: caduceus369 folded before Flop (didn't bet)
Seat 5: PIRULO1235 folded before Flop (didn't bet)



PokerStars Zoom Hand #258040269413:  Hold'em No Limit (€0.01/€0.02) [ADM ID: M62C03044AE79CRJ] - 2025/10/08 1:23:25 CET [2025/10/07 19:23:25 ET]
Table 'Sirio' 6-max Seat #1 is the button
Seat 1: jhonnystecco8 (€2.50 in chips) 
Seat 2: DRAGONE67 (€2.24 in chips) 
Seat 3: Zeeebbiiiiii778 (€2.18 in chips) 
Seat 4: Giuggiola64 (€1.18 in chips) 
Seat 5: caduceus369 (€14.18 in chips) 
Seat 6: ADRIAN0_MEIS (€23.42 in chips) 
DRAGONE67: posts small blind €0.01
Zeeebbiiiiii778: posts big blind €0.02
*** HOLE CARDS ***
Dealt to caduceus369 [Tc 6d]
Giuggiola64: calls €0.02
caduceus369: folds 
ADRIAN0_MEIS: folds 
jhonnystecco8: folds 
DRAGONE67: folds 
Zeeebbiiiiii778: checks 
*** FLOP *** [8c 4h 5c]
Zeeebbiiiiii778: checks 
Giuggiola64: checks 
*** TURN *** [8c 4h 5c] [9c]
Zeeebbiiiiii778: checks 
Giuggiola64: bets €0.02
Zeeebbiiiiii778: folds 
Uncalled bet (€0.02) returned to Giuggiola64
Giuggiola64 collected €0.05 from pot
Giuggiola64: doesn't show hand 
*** SUMMARY ***
Total pot €0.05 | Rake €0 
Board [8c 4h 5c 9c]
Seat 1: jhonnystecco8 (button) folded before Flop (didn't bet)
Seat 2: DRAGONE67 (small blind) folded before Flop
Seat 3: Zeeebbiiiiii778 (big blind) folded on the Turn
Seat 4: Giuggiola64 collected (€0.05)
Seat 5: caduceus369 folded before Flop (didn't bet)
Seat 6: ADRIAN0_MEIS folded before Flop (didn't bet)



PokerStars Zoom Hand #258040275188:  Hold'em No Limit (€0.01/€0.02) [ADM ID: M62C03044AE79CRJ] - 2025/10/08 1:23:59 CET [2025/10/07 19:23:59 ET]
Table 'Sirio' 6-max Seat #1 is the button
Seat 1: PIRULO1235 (€2.71 in chips) 
Seat 2: caduceus369 (€14.19 in chips) 
Seat 3: jhonnystecco8 (€2.50 in chips) 
Seat 4: pallagorio (€1.13 in chips) 
Seat 5: ADRIAN0_MEIS (€23.41 in chips) 
caduceus369: posts small blind €0.01
jhonnystecco8: posts big blind €0.02
*** HOLE CARDS ***
Dealt to caduceus369 [2h 5c]
pallagorio: raises €0.02 to €0.04
ADRIAN0_MEIS: folds 
PIRULO1235: raises €0.02 to €0.06
caduceus369: folds 
jhonnystecco8: folds 
pallagorio: calls €0.02
*** FLOP *** [6d 9c 3h]
pallagorio: checks 
PIRULO1235: checks 
*** TURN *** [6d 9c 3h] [Js]
pallagorio: checks 
PIRULO1235: bets €0.02
pallagorio: folds 
Uncalled bet (€0.02) returned to PIRULO1235
PIRULO1235 collected €0.15 from pot
PIRULO1235: doesn't show hand 
*** SUMMARY ***
Total pot €0.15 | Rake €0 
Board [6d 9c 3h Js]
Seat 1: PIRULO1235 (button) collected (€0.15)
Seat 2: caduceus369 (small blind) folded before Flop
Seat 3: jhonnystecco8 (big blind) folded before Flop
Seat 4: pallagorio folded on the Turn
Seat 5: ADRIAN0_MEIS folded before Flop (didn't bet)



PokerStars Zoom Hand #258040276798:  Hold'em No Limit (€0.01/€0.02) [ADM ID: M62C03044AE79CRJ] - 2025/10/08 1:24:09 CET [2025/10/07 19:24:09 ET]
Table 'Sirio' 6-max Seat #1 is the button
Seat 1: manuknife (€1.38 in chips) 
Seat 2: QUATTRODAME (€5.53 in chips) 
Seat 3: muhozhuk788 (€2 in chips) 
Seat 4: caduceus369 (€14.18 in chips) 
Seat 5: Zeeebbiiiiii778 (€1.85 in chips) 
Seat 6: Giuggiola64 (€1.21 in chips) 
QUATTRODAME: posts small blind €0.01
muhozhuk788: posts big blind €0.02
*** HOLE CARDS ***
Dealt to caduceus369 [9h 6h]
caduceus369: folds 
Zeeebbiiiiii778: folds 
Giuggiola64: folds 
manuknife: calls €0.02
QUATTRODAME: calls €0.01
muhozhuk788: raises €0.08 to €0.10
manuknife: folds 
QUATTRODAME: folds 
Uncalled bet (€0.08) returned to muhozhuk788
muhozhuk788 collected €0.06 from pot
muhozhuk788: doesn't show hand 
*** SUMMARY ***
Total pot €0.06 | Rake €0 
Seat 1: manuknife (button) folded before Flop
Seat 2: QUATTRODAME (small blind) folded before Flop
Seat 3: muhozhuk788 (big blind) collected (€0.06)
Seat 4: caduceus369 folded before Flop (didn't bet)
Seat 5: Zeeebbiiiiii778 folded before Flop (didn't bet)
Seat 6: Giuggiola64 folded before Flop (didn't bet)



PokerStars Zoom Hand #258040277527:  Hold'em No Limit (€0.01/€0.02) [ADM ID: M62C03044AE79CRJ] - 2025/10/08 1:24:13 CET [2025/10/07 19:24:13 ET]
Table 'Sirio' 6-max Seat #1 is the button
Seat 1: caduceus369 (€14.18 in chips) 
Seat 2: xebarpz4400 (€0.54 in chips) 
Seat 3: IlDestro71 (€1.60 in chips) 
Seat 4: patrick0708 (€2.47 in chips) 
Seat 5: Giuggiola64 (€1.21 in chips) 
Seat 6: Coffeebreak96 (€2.05 in chips) 
xebarpz4400: posts small blind €0.01
IlDestro71: posts big blind €0.02
*** HOLE CARDS ***
Dealt to caduceus369 [6s Ts]
patrick0708: folds 
Giuggiola64: calls €0.02
Coffeebreak96: folds 
caduceus369: folds 
xebarpz4400: folds 
IlDestro71: checks 
*** FLOP *** [Qh 5s 7d]
IlDestro71: checks 
Giuggiola64: checks 
*** TURN *** [Qh 5s 7d] [2c]
IlDestro71: checks 
Giuggiola64: checks 
*** RIVER *** [Qh 5s 7d 2c] [9s]
IlDestro71: checks 
Giuggiola64: checks 
*** SHOW DOWN ***
IlDestro71: shows [3d Js] (high card Queen)
Giuggiola64: mucks hand 
IlDestro71 collected €0.05 from pot
*** SUMMARY ***
Total pot €0.05 | Rake €0 
Board [Qh 5s 7d 2c 9s]
Seat 1: caduceus369 (button) folded before Flop (didn't bet)
Seat 2: xebarpz4400 (small blind) folded before Flop
Seat 3: IlDestro71 (big blind) showed [3d Js] and won (€0.05) with high card Queen
Seat 4: patrick0708 folded before Flop (didn't bet)
Seat 5: Giuggiola64 mucked [Td 4d]
Seat 6: Coffeebreak96 folded before Flop (didn't bet)



PokerStars Zoom Hand #258040280931:  Hold'em No Limit (€0.01/€0.02) [ADM ID: M62C03044AE79CRJ] - 2025/10/08 1:24:33 CET [2025/10/07 19:24:33 ET]
Table 'Sirio' 6-max Seat #1 is the button
Seat 1: ADRIAN0_MEIS (€23.41 in chips) 
Seat 2: caduceus369 (€14.18 in chips) 
Seat 3: pallagorio (€1.07 in chips) 
Seat 4: Zeeebbiiiiii778 (€1.85 in chips) 
Seat 5: gitikappa (€2.07 in chips) 
Seat 6: PIRULO1235 (€2.79 in chips) 
caduceus369: posts small blind €0.01
pallagorio: posts big blind €0.02
*** HOLE CARDS ***
Dealt to caduceus369 [2c 2h]
Zeeebbiiiiii778: folds 
gitikappa: folds 
PIRULO1235: folds 
ADRIAN0_MEIS: raises €0.03 to €0.05
caduceus369: folds 
pallagorio: folds 
Uncalled bet (€0.03) returned to ADRIAN0_MEIS
ADRIAN0_MEIS collected €0.05 from pot
ADRIAN0_MEIS: doesn't show hand 
*** SUMMARY ***
Total pot €0.05 | Rake €0 
Seat 1: ADRIAN0_MEIS (button) collected (€0.05)
Seat 2: caduceus369 (small blind) folded before Flop
Seat 3: pallagorio (big blind) folded before Flop
Seat 4: Zeeebbiiiiii778 folded before Flop (didn't bet)
Seat 5: gitikappa folded before Flop (didn't bet)
Seat 6: PIRULO1235 folded before Flop (didn't bet)



PokerStars Zoom Hand #258040278908:  Hold'em No Limit (€0.01/€0.02) [ADM ID: M62C03044AE79CRJ] - 2025/10/08 1:24:21 CET [2025/10/07 19:24:21 ET]
Table 'Sirio' 6-max Seat #1 is the button
Seat 1: xebarpz4400 (€0.53 in chips) 
Seat 2: PIRULO1235 (€2.80 in chips) 
Seat 3: patrick0708 (€2.47 in chips) 
Seat 4: Wildag00 (€1.85 in chips) 
Seat 5: manuknife (€1.36 in chips) 
Seat 6: caduceus369 (€14.18 in chips) 
PIRULO1235: posts small blind €0.01
patrick0708: posts big blind €0.02
*** HOLE CARDS ***
Dealt to caduceus369 [7d 5s]
Wildag00: folds 
manuknife: calls €0.02
caduceus369: folds 
xebarpz4400: calls €0.02
PIRULO1235: folds 
patrick0708: checks 
*** FLOP *** [2d 4c Kh]
patrick0708: checks 
manuknife: checks 
xebarpz4400: checks 
*** TURN *** [2d 4c Kh] [3h]
patrick0708: checks 
manuknife: checks 
xebarpz4400: checks 
*** RIVER *** [2d 4c Kh 3h] [3d]
patrick0708: checks 
manuknife: checks 
xebarpz4400: checks 
*** SHOW DOWN ***
patrick0708: shows [8c 7h] (a pair of Threes)
manuknife: shows [Th Jh] (a pair of Threes - King+Jack kicker)
xebarpz4400: mucks hand 
manuknife collected €0.07 from pot
*** SUMMARY ***
Total pot €0.07 | Rake €0 
Board [2d 4c Kh 3h 3d]
Seat 1: xebarpz4400 (button) mucked [6d 9d]
Seat 2: PIRULO1235 (small blind) folded before Flop
Seat 3: patrick0708 (big blind) showed [8c 7h] and lost with a pair of Threes
Seat 4: Wildag00 folded before Flop (didn't bet)
Seat 5: manuknife showed [Th Jh] and won (€0.07) with a pair of Threes
Seat 6: caduceus369 folded before Flop (didn't bet)



PokerStars Zoom Hand #258040280207:  Hold'em No Limit (€0.01/€0.02) [ADM ID: M62C03044AE79CRJ] - 2025/10/08 1:24:28 CET [2025/10/07 19:24:28 ET]
Table 'Sirio' 6-max Seat #1 is the button
Seat 1: PIRULO1235 (€2.79 in chips) 
Seat 2: muhozhuk788 (€2.04 in chips) 
Seat 3: QUATTRODAME (€5.51 in chips) 
Seat 4: caduceus369 (€14.18 in chips) 
Seat 5: DRAGONE67 (€2.19 in chips) 
Seat 6: Wildag00 (€1.95 in chips) 
muhozhuk788: posts small blind €0.01
QUATTRODAME: posts big blind €0.02
*** HOLE CARDS ***
Dealt to caduceus369 [Ks 7s]
caduceus369: folds 
DRAGONE67: raises €0.02 to €0.04
Wildag00: calls €0.04
PIRULO1235: folds 
muhozhuk788: calls €0.03
QUATTRODAME: folds 
*** FLOP *** [8d 2d Qc]
muhozhuk788: checks 
DRAGONE67: checks 
Wildag00: bets €0.07
muhozhuk788: folds 
DRAGONE67: folds 
Uncalled bet (€0.07) returned to Wildag00
Wildag00 collected €0.14 from pot
Wildag00: doesn't show hand 
*** SUMMARY ***
Total pot €0.14 | Rake €0 
Board [8d 2d Qc]
Seat 1: PIRULO1235 (button) folded before Flop (didn't bet)
Seat 2: muhozhuk788 (small blind) folded on the Flop
Seat 3: QUATTRODAME (big blind) folded before Flop
Seat 4: caduceus369 folded before Flop (didn't bet)
Seat 5: DRAGONE67 folded on the Flop
Seat 6: Wildag00 collected (€0.14)



PokerStars Zoom Hand #258040281805:  Hold'em No Limit (€0.01/€0.02) [ADM ID: M62C03044AE79CRJ] - 2025/10/08 1:24:38 CET [2025/10/07 19:24:38 ET]
Table 'Sirio' 6-max Seat #1 is the button
Seat 1: ormaxam (€1.90 in chips) 
Seat 2: PIRULO1235 (€2.79 in chips) 
Seat 3: gitikappa (€2.07 in chips) 
Seat 4: Zeeebbiiiiii778 (€1.85 in chips) 
Seat 5: caduceus369 (€14.17 in chips) 
Seat 6: QUATTRODAME (€5.49 in chips) 
PIRULO1235: posts small blind €0.01
gitikappa: posts big blind €0.02
*** HOLE CARDS ***
Dealt to caduceus369 [6h 3d]
Zeeebbiiiiii778: folds 
caduceus369: folds 
QUATTRODAME: folds 
ormaxam: raises €0.03 to €0.05
PIRULO1235: folds 
gitikappa: folds 
Uncalled bet (€0.03) returned to ormaxam
ormaxam collected €0.05 from pot
ormaxam: doesn't show hand 
*** SUMMARY ***
Total pot €0.05 | Rake €0 
Seat 1: ormaxam (button) collected (€0.05)
Seat 2: PIRULO1235 (small blind) folded before Flop
Seat 3: gitikappa (big blind) folded before Flop
Seat 4: Zeeebbiiiiii778 folded before Flop (didn't bet)
Seat 5: caduceus369 folded before Flop (didn't bet)
Seat 6: QUATTRODAME folded before Flop (didn't bet)



